"Mes","Dia","Ano","Hora","Minutos","Dia da semana","city_name","road_num","road_name","current_speed","free_flow_speed","speed_diff","current_travel_time","free_flow_travel_time","time_diff"
7,24,2018,16,0,3,"Braga",1,"Avenida da Liberdade",25,25,0,124,124,0
7,24,2018,16,0,3,"Braga",2,"Avenida Central",25,25,0,124,124,0
7,24,2018,16,0,3,"Braga",3,"Rua de Caires",28,37,9,48,36,12
7,24,2018,16,0,3,"Braga",4,"N14 Bosch",21,47,26,107,48,59
7,24,2018,16,0,3,"Braga",5,"Avenida João Paulo II",39,39,0,9,9,0
7,24,2018,16,0,3,"Braga",6,"Avenida Padre Júlio Fragata",67,67,0,83,83,0
7,24,2018,16,0,3,"Braga",7,"Rua Nova Santa Cruz",43,43,0,40,40,0
7,24,2018,16,0,3,"Braga",8,"Rua Costa Gomes",40,40,0,43,43,0
7,24,2018,17,0,3,"Braga",1,"Avenida da Liberdade",25,25,0,124,124,0
7,24,2018,17,0,3,"Braga",2,"Avenida Central",25,25,0,124,124,0
7,24,2018,17,0,3,"Braga",3,"Rua de Caires",23,37,14,59,36,23
7,24,2018,17,0,3,"Braga",4,"N14 Bosch",12,47,35,187,48,139
7,24,2018,17,0,3,"Braga",5,"Avenida João Paulo II",21,39,18,17,9,8
7,24,2018,17,0,3,"Braga",6,"Avenida Padre Júlio Fragata",17,67,50,328,83,245
7,24,2018,17,0,3,"Braga",7,"Rua Nova Santa Cruz",32,43,11,54,40,14
7,24,2018,17,0,3,"Braga",8,"Rua Costa Gomes",40,40,0,43,43,0
7,24,2018,18,0,3,"Braga",1,"Avenida da Liberdade",18,25,7,172,124,48
7,24,2018,18,0,3,"Braga",2,"Avenida Central",18,25,7,172,124,48
7,24,2018,18,0,3,"Braga",3,"Rua de Caires",27,37,10,50,36,14
7,24,2018,18,0,3,"Braga",4,"N14 Bosch",10,47,37,225,48,177
7,24,2018,18,0,3,"Braga",5,"Avenida João Paulo II",10,39,29,35,9,26
7,24,2018,18,0,3,"Braga",6,"Avenida Padre Júlio Fragata",23,67,44,242,83,159
7,24,2018,18,0,3,"Braga",7,"Rua Nova Santa Cruz",43,43,0,40,40,0
7,24,2018,18,0,3,"Braga",8,"Rua Costa Gomes",25,40,15,69,43,26
7,24,2018,19,0,3,"Braga",1,"Avenida da Liberdade",25,25,0,124,124,0
7,24,2018,19,0,3,"Braga",2,"Avenida Central",25,25,0,124,124,0
7,24,2018,19,0,3,"Braga",3,"Rua de Caires",37,37,0,36,36,0
7,24,2018,19,0,3,"Braga",4,"N14 Bosch",47,47,0,48,48,0
7,24,2018,19,0,3,"Braga",5,"Avenida João Paulo II",39,39,0,9,9,0
7,24,2018,19,0,3,"Braga",6,"Avenida Padre Júlio Fragata",67,67,0,83,83,0
7,24,2018,19,0,3,"Braga",7,"Rua Nova Santa Cruz",43,43,0,40,40,0
7,24,2018,19,0,3,"Braga",8,"Rua Costa Gomes",25,40,15,69,43,26
7,24,2018,20,0,3,"Braga",1,"Avenida da Liberdade",25,25,0,124,124,0
7,24,2018,20,0,3,"Braga",2,"Avenida Central",25,25,0,124,124,0
7,24,2018,20,0,3,"Braga",3,"Rua de Caires",37,37,0,36,36,0
7,24,2018,20,0,3,"Braga",4,"N14 Bosch",47,47,0,48,48,0
7,24,2018,20,0,3,"Braga",5,"Avenida João Paulo II",39,39,0,9,9,0
7,24,2018,20,0,3,"Braga",6,"Avenida Padre Júlio Fragata",67,67,0,83,83,0
7,24,2018,20,0,3,"Braga",7,"Rua Nova Santa Cruz",43,43,0,40,40,0
7,24,2018,20,0,3,"Braga",8,"Rua Costa Gomes",40,40,0,43,43,0
7,24,2018,21,0,3,"Braga",1,"Avenida da Liberdade",25,25,0,124,124,0
7,24,2018,21,0,3,"Braga",2,"Avenida Central",25,25,0,124,124,0
7,24,2018,21,0,3,"Braga",3,"Rua de Caires",37,37,0,36,36,0
7,24,2018,21,0,3,"Braga",4,"N14 Bosch",35,47,12,64,48,16
7,24,2018,21,0,3,"Braga",5,"Avenida João Paulo II",39,39,0,9,9,0
7,24,2018,21,0,3,"Braga",6,"Avenida Padre Júlio Fragata",67,67,0,83,83,0
7,24,2018,21,0,3,"Braga",7,"Rua Nova Santa Cruz",43,43,0,40,40,0
7,24,2018,21,0,3,"Braga",8,"Rua Costa Gomes",40,40,0,43,43,0
7,24,2018,22,0,3,"Braga",1,"Avenida da Liberdade",25,25,0,124,124,0
7,24,2018,22,0,3,"Braga",2,"Avenida Central",25,25,0,124,124,0
7,24,2018,22,0,3,"Braga",3,"Rua de Caires",37,37,0,36,36,0
7,24,2018,22,0,3,"Braga",4,"N14 Bosch",47,47,0,48,48,0
7,24,2018,22,0,3,"Braga",5,"Avenida João Paulo II",39,39,0,9,9,0
7,24,2018,22,0,3,"Braga",6,"Avenida Padre Júlio Fragata",67,67,0,83,83,0
7,24,2018,22,0,3,"Braga",7,"Rua Nova Santa Cruz",43,43,0,40,40,0
7,24,2018,22,0,3,"Braga",8,"Rua Costa Gomes",40,40,0,43,43,0
7,24,2018,23,0,3,"Braga",1,"Avenida da Liberdade",25,25,0,124,124,0
7,24,2018,23,0,3,"Braga",2,"Avenida Central",25,25,0,124,124,0
7,24,2018,23,0,3,"Braga",3,"Rua de Caires",37,37,0,36,36,0
7,24,2018,23,0,3,"Braga",4,"N14 Bosch",47,47,0,48,48,0
7,24,2018,23,0,3,"Braga",5,"Avenida João Paulo II",39,39,0,9,9,0
7,24,2018,23,0,3,"Braga",6,"Avenida Padre Júlio Fragata",67,67,0,83,83,0
7,24,2018,23,0,3,"Braga",7,"Rua Nova Santa Cruz",43,43,0,40,40,0
7,24,2018,23,0,3,"Braga",8,"Rua Costa Gomes",40,40,0,43,43,0
7,25,2018,0,0,4,"Braga",1,"Avenida da Liberdade",25,25,0,124,124,0
7,25,2018,0,0,4,"Braga",2,"Avenida Central",25,25,0,124,124,0
7,25,2018,0,0,4,"Braga",3,"Rua de Caires",37,37,0,36,36,0
7,25,2018,0,0,4,"Braga",4,"N14 Bosch",47,47,0,48,48,0
7,25,2018,0,0,4,"Braga",5,"Avenida João Paulo II",39,39,0,9,9,0
7,25,2018,0,0,4,"Braga",6,"Avenida Padre Júlio Fragata",67,67,0,83,83,0
7,25,2018,0,0,4,"Braga",7,"Rua Nova Santa Cruz",43,43,0,40,40,0
7,25,2018,0,0,4,"Braga",8,"Rua Costa Gomes",40,40,0,43,43,0
7,25,2018,1,0,4,"Braga",1,"Avenida da Liberdade",25,25,0,124,124,0
7,25,2018,1,0,4,"Braga",2,"Avenida Central",25,25,0,124,124,0
7,25,2018,1,0,4,"Braga",3,"Rua de Caires",37,37,0,36,36,0
7,25,2018,1,0,4,"Braga",4,"N14 Bosch",47,47,0,48,48,0
7,25,2018,1,0,4,"Braga",5,"Avenida João Paulo II",39,39,0,9,9,0
7,25,2018,1,0,4,"Braga",6,"Avenida Padre Júlio Fragata",67,67,0,83,83,0
7,25,2018,1,0,4,"Braga",7,"Rua Nova Santa Cruz",43,43,0,40,40,0
7,25,2018,1,0,4,"Braga",8,"Rua Costa Gomes",40,40,0,43,43,0
7,25,2018,2,0,4,"Braga",1,"Avenida da Liberdade",25,25,0,124,124,0
7,25,2018,2,0,4,"Braga",2,"Avenida Central",25,25,0,124,124,0
7,25,2018,2,0,4,"Braga",3,"Rua de Caires",37,37,0,36,36,0
7,25,2018,2,0,4,"Braga",4,"N14 Bosch",47,47,0,48,48,0
7,25,2018,2,0,4,"Braga",5,"Avenida João Paulo II",39,39,0,9,9,0
7,25,2018,2,0,4,"Braga",6,"Avenida Padre Júlio Fragata",67,67,0,83,83,0
7,25,2018,2,0,4,"Braga",7,"Rua Nova Santa Cruz",43,43,0,40,40,0
7,25,2018,2,0,4,"Braga",8,"Rua Costa Gomes",40,40,0,43,43,0
7,25,2018,3,0,4,"Braga",1,"Avenida da Liberdade",25,25,0,124,124,0
7,25,2018,3,0,4,"Braga",2,"Avenida Central",25,25,0,124,124,0
7,25,2018,3,0,4,"Braga",3,"Rua de Caires",37,37,0,36,36,0
7,25,2018,3,0,4,"Braga",4,"N14 Bosch",47,47,0,48,48,0
7,25,2018,3,0,4,"Braga",5,"Avenida João Paulo II",39,39,0,9,9,0
7,25,2018,3,0,4,"Braga",6,"Avenida Padre Júlio Fragata",67,67,0,83,83,0
7,25,2018,3,0,4,"Braga",7,"Rua Nova Santa Cruz",43,43,0,40,40,0
7,25,2018,3,0,4,"Braga",8,"Rua Costa Gomes",40,40,0,43,43,0
7,25,2018,4,0,4,"Braga",1,"Avenida da Liberdade",25,25,0,124,124,0
7,25,2018,4,0,4,"Braga",2,"Avenida Central",25,25,0,124,124,0
7,25,2018,4,0,4,"Braga",3,"Rua de Caires",37,37,0,36,36,0
7,25,2018,4,0,4,"Braga",4,"N14 Bosch",47,47,0,48,48,0
7,25,2018,4,0,4,"Braga",5,"Avenida João Paulo II",39,39,0,9,9,0
7,25,2018,4,0,4,"Braga",6,"Avenida Padre Júlio Fragata",67,67,0,83,83,0
7,25,2018,4,0,4,"Braga",7,"Rua Nova Santa Cruz",43,43,0,40,40,0
7,25,2018,4,0,4,"Braga",8,"Rua Costa Gomes",40,40,0,43,43,0
7,25,2018,5,0,4,"Braga",1,"Avenida da Liberdade",25,25,0,124,124,0
7,25,2018,5,0,4,"Braga",2,"Avenida Central",25,25,0,124,124,0
7,25,2018,5,0,4,"Braga",3,"Rua de Caires",37,37,0,36,36,0
7,25,2018,5,0,4,"Braga",4,"N14 Bosch",47,47,0,48,48,0
7,25,2018,5,0,4,"Braga",5,"Avenida João Paulo II",39,39,0,9,9,0
7,25,2018,5,0,4,"Braga",6,"Avenida Padre Júlio Fragata",67,67,0,83,83,0
7,25,2018,5,0,4,"Braga",7,"Rua Nova Santa Cruz",43,43,0,40,40,0
7,25,2018,5,0,4,"Braga",8,"Rua Costa Gomes",40,40,0,43,43,0
7,25,2018,6,0,4,"Braga",1,"Avenida da Liberdade",25,25,0,124,124,0
7,25,2018,6,0,4,"Braga",2,"Avenida Central",25,25,0,124,124,0
7,25,2018,6,0,4,"Braga",3,"Rua de Caires",37,37,0,36,36,0
7,25,2018,6,0,4,"Braga",4,"N14 Bosch",47,47,0,48,48,0
7,25,2018,6,0,4,"Braga",5,"Avenida João Paulo II",39,39,0,9,9,0
7,25,2018,6,0,4,"Braga",6,"Avenida Padre Júlio Fragata",67,67,0,83,83,0
7,25,2018,6,0,4,"Braga",7,"Rua Nova Santa Cruz",43,43,0,40,40,0
7,25,2018,6,0,4,"Braga",8,"Rua Costa Gomes",40,40,0,43,43,0
7,25,2018,7,0,4,"Braga",1,"Avenida da Liberdade",25,25,0,124,124,0
7,25,2018,7,0,4,"Braga",2,"Avenida Central",25,25,0,124,124,0
7,25,2018,7,0,4,"Braga",3,"Rua de Caires",37,37,0,36,36,0
7,25,2018,7,0,4,"Braga",4,"N14 Bosch",47,47,0,48,48,0
7,25,2018,7,0,4,"Braga",5,"Avenida João Paulo II",39,39,0,9,9,0
7,25,2018,7,0,4,"Braga",6,"Avenida Padre Júlio Fragata",67,67,0,83,83,0
7,25,2018,7,0,4,"Braga",7,"Rua Nova Santa Cruz",43,43,0,40,40,0
7,25,2018,7,0,4,"Braga",8,"Rua Costa Gomes",40,40,0,43,43,0
7,25,2018,8,0,4,"Braga",1,"Avenida da Liberdade",25,25,0,124,124,0
7,25,2018,8,0,4,"Braga",2,"Avenida Central",25,25,0,124,124,0
7,25,2018,8,0,4,"Braga",3,"Rua de Caires",13,37,24,104,36,68
7,25,2018,8,0,4,"Braga",4,"N14 Bosch",28,47,19,80,48,32
7,25,2018,8,0,4,"Braga",5,"Avenida João Paulo II",28,39,11,12,9,3
7,25,2018,8,0,4,"Braga",6,"Avenida Padre Júlio Fragata",26,67,41,214,83,131
7,25,2018,8,0,4,"Braga",7,"Rua Nova Santa Cruz",19,43,24,91,40,51
7,25,2018,8,0,4,"Braga",8,"Rua Costa Gomes",40,40,0,43,43,0
7,25,2018,9,0,4,"Braga",1,"Avenida da Liberdade",25,25,0,124,124,0
7,25,2018,9,0,4,"Braga",2,"Avenida Central",25,25,0,124,124,0
7,25,2018,9,0,4,"Braga",3,"Rua de Caires",25,37,12,54,36,18
7,25,2018,9,0,4,"Braga",4,"N14 Bosch",30,47,17,75,48,27
7,25,2018,9,0,4,"Braga",5,"Avenida João Paulo II",39,39,0,9,9,0
7,25,2018,9,0,4,"Braga",6,"Avenida Padre Júlio Fragata",67,67,0,83,83,0
7,25,2018,9,0,4,"Braga",7,"Rua Nova Santa Cruz",43,43,0,40,40,0
7,25,2018,9,0,4,"Braga",8,"Rua Costa Gomes",40,40,0,43,43,0
7,25,2018,10,0,4,"Braga",1,"Avenida da Liberdade",25,25,0,124,124,0
7,25,2018,10,0,4,"Braga",2,"Avenida Central",25,25,0,124,124,0
7,25,2018,10,0,4,"Braga",3,"Rua de Caires",28,37,9,48,36,12
7,25,2018,10,0,4,"Braga",4,"N14 Bosch",18,47,29,125,48,77
7,25,2018,10,0,4,"Braga",5,"Avenida João Paulo II",39,39,0,9,9,0
7,25,2018,10,0,4,"Braga",6,"Avenida Padre Júlio Fragata",67,67,0,83,83,0
7,25,2018,10,0,4,"Braga",7,"Rua Nova Santa Cruz",43,43,0,40,40,0
7,25,2018,10,0,4,"Braga",8,"Rua Costa Gomes",40,40,0,43,43,0
7,25,2018,11,0,4,"Braga",1,"Avenida da Liberdade",25,25,0,124,124,0
7,25,2018,11,0,4,"Braga",2,"Avenida Central",25,25,0,124,124,0
7,25,2018,11,0,4,"Braga",3,"Rua de Caires",37,37,0,36,36,0
7,25,2018,11,0,4,"Braga",4,"N14 Bosch",47,47,0,48,48,0
7,25,2018,11,0,4,"Braga",5,"Avenida João Paulo II",39,39,0,9,9,0
7,25,2018,11,0,4,"Braga",6,"Avenida Padre Júlio Fragata",67,67,0,83,83,0
7,25,2018,11,0,4,"Braga",7,"Rua Nova Santa Cruz",43,43,0,40,40,0
7,25,2018,11,0,4,"Braga",8,"Rua Costa Gomes",13,40,27,133,43,90
7,25,2018,12,0,4,"Braga",1,"Avenida da Liberdade",25,25,0,124,124,0
7,25,2018,12,0,4,"Braga",2,"Avenida Central",25,25,0,124,124,0
7,25,2018,12,0,4,"Braga",3,"Rua de Caires",37,37,0,36,36,0
7,25,2018,12,0,4,"Braga",4,"N14 Bosch",15,47,32,150,48,102
7,25,2018,12,0,4,"Braga",5,"Avenida João Paulo II",39,39,0,9,9,0
7,25,2018,12,0,4,"Braga",6,"Avenida Padre Júlio Fragata",67,67,0,83,83,0
7,25,2018,12,0,4,"Braga",7,"Rua Nova Santa Cruz",23,43,20,75,40,35
7,25,2018,12,0,4,"Braga",8,"Rua Costa Gomes",26,40,14,67,43,24
7,25,2018,13,0,4,"Braga",1,"Avenida da Liberdade",25,25,0,124,124,0
7,25,2018,13,0,4,"Braga",2,"Avenida Central",25,25,0,124,124,0
7,25,2018,13,0,4,"Braga",3,"Rua de Caires",37,37,0,36,36,0
7,25,2018,13,0,4,"Braga",4,"N14 Bosch",47,47,0,48,48,0
7,25,2018,13,0,4,"Braga",5,"Avenida João Paulo II",39,39,0,9,9,0
7,25,2018,13,0,4,"Braga",6,"Avenida Padre Júlio Fragata",67,67,0,83,83,0
7,25,2018,13,0,4,"Braga",7,"Rua Nova Santa Cruz",43,43,0,40,40,0
7,25,2018,13,0,4,"Braga",8,"Rua Costa Gomes",40,40,0,43,43,0
7,25,2018,14,0,4,"Braga",1,"Avenida da Liberdade",25,25,0,124,124,0
7,25,2018,14,0,4,"Braga",2,"Avenida Central",25,25,0,124,124,0
7,25,2018,14,0,4,"Braga",3,"Rua de Caires",26,37,11,52,36,16
7,25,2018,14,0,4,"Braga",4,"N14 Bosch",29,47,18,77,48,29
7,25,2018,14,0,4,"Braga",5,"Avenida João Paulo II",28,39,11,12,9,3
7,25,2018,14,0,4,"Braga",6,"Avenida Padre Júlio Fragata",67,67,0,83,83,0
7,25,2018,14,0,4,"Braga",7,"Rua Nova Santa Cruz",32,43,11,54,40,14
7,25,2018,14,0,4,"Braga",8,"Rua Costa Gomes",31,40,9,56,43,13
7,25,2018,15,0,4,"Braga",1,"Avenida da Liberdade",19,25,6,163,124,39
7,25,2018,15,0,4,"Braga",2,"Avenida Central",19,25,6,163,124,39
7,25,2018,15,0,4,"Braga",3,"Rua de Caires",24,37,13,56,36,20
7,25,2018,15,0,4,"Braga",4,"N14 Bosch",32,47,15,70,48,22
7,25,2018,15,0,4,"Braga",5,"Avenida João Paulo II",24,39,15,15,9,6
7,25,2018,15,0,4,"Braga",6,"Avenida Padre Júlio Fragata",15,67,52,372,83,289
7,25,2018,15,0,4,"Braga",7,"Rua Nova Santa Cruz",28,43,15,62,40,22
7,25,2018,15,0,4,"Braga",8,"Rua Costa Gomes",30,40,10,58,43,15
7,25,2018,16,0,4,"Braga",1,"Avenida da Liberdade",19,25,6,163,124,39
7,25,2018,16,0,4,"Braga",2,"Avenida Central",19,25,6,163,124,39
7,25,2018,16,0,4,"Braga",3,"Rua de Caires",28,37,9,48,36,12
7,25,2018,16,0,4,"Braga",4,"N14 Bosch",36,47,11,62,48,14
7,25,2018,16,0,4,"Braga",5,"Avenida João Paulo II",39,39,0,9,9,0
7,25,2018,16,0,4,"Braga",6,"Avenida Padre Júlio Fragata",20,67,47,279,83,196
7,25,2018,16,0,4,"Braga",7,"Rua Nova Santa Cruz",43,43,0,40,40,0
7,25,2018,16,0,4,"Braga",8,"Rua Costa Gomes",40,40,0,43,43,0
7,25,2018,17,0,4,"Braga",1,"Avenida da Liberdade",18,25,7,172,124,48
7,25,2018,17,0,4,"Braga",2,"Avenida Central",18,25,7,172,124,48
7,25,2018,17,0,4,"Braga",3,"Rua de Caires",14,37,23,96,36,60
7,25,2018,17,0,4,"Braga",4,"N14 Bosch",17,47,30,132,48,84
7,25,2018,17,0,4,"Braga",5,"Avenida João Paulo II",22,39,17,16,9,7
7,25,2018,17,0,4,"Braga",6,"Avenida Padre Júlio Fragata",38,67,29,147,83,64
7,25,2018,17,0,4,"Braga",7,"Rua Nova Santa Cruz",34,43,9,51,40,11
7,25,2018,17,0,4,"Braga",8,"Rua Costa Gomes",23,40,17,75,43,32
7,25,2018,18,0,4,"Braga",1,"Avenida da Liberdade",17,25,8,182,124,58
7,25,2018,18,0,4,"Braga",2,"Avenida Central",17,25,8,182,124,58
7,25,2018,18,0,4,"Braga",3,"Rua de Caires",25,37,12,54,36,18
7,25,2018,18,0,4,"Braga",4,"N14 Bosch",25,47,22,90,48,42
7,25,2018,18,0,4,"Braga",5,"Avenida João Paulo II",22,39,17,16,9,7
7,25,2018,18,0,4,"Braga",6,"Avenida Padre Júlio Fragata",19,67,48,293,83,210
7,25,2018,18,0,4,"Braga",7,"Rua Nova Santa Cruz",34,43,9,51,40,11
7,25,2018,18,0,4,"Braga",8,"Rua Costa Gomes",17,40,23,102,43,59
7,25,2018,19,0,4,"Braga",1,"Avenida da Liberdade",25,25,0,124,124,0
7,25,2018,19,0,4,"Braga",2,"Avenida Central",25,25,0,124,124,0
7,25,2018,19,0,4,"Braga",3,"Rua de Caires",37,37,0,36,36,0
7,25,2018,19,0,4,"Braga",4,"N14 Bosch",34,47,13,66,48,18
7,25,2018,19,0,4,"Braga",5,"Avenida João Paulo II",29,39,10,12,9,3
7,25,2018,19,0,4,"Braga",6,"Avenida Padre Júlio Fragata",52,67,15,107,83,24
7,25,2018,19,0,4,"Braga",7,"Rua Nova Santa Cruz",26,43,17,66,40,26
7,25,2018,19,0,4,"Braga",8,"Rua Costa Gomes",40,40,0,43,43,0
7,25,2018,20,0,4,"Braga",1,"Avenida da Liberdade",25,25,0,124,124,0
7,25,2018,20,0,4,"Braga",2,"Avenida Central",25,25,0,124,124,0
7,25,2018,20,0,4,"Braga",3,"Rua de Caires",37,37,0,36,36,0
7,25,2018,20,0,4,"Braga",4,"N14 Bosch",47,47,0,48,48,0
7,25,2018,20,0,4,"Braga",5,"Avenida João Paulo II",39,39,0,9,9,0
7,25,2018,20,0,4,"Braga",6,"Avenida Padre Júlio Fragata",67,67,0,83,83,0
7,25,2018,20,0,4,"Braga",7,"Rua Nova Santa Cruz",43,43,0,40,40,0
7,25,2018,20,0,4,"Braga",8,"Rua Costa Gomes",40,40,0,43,43,0
7,25,2018,21,0,4,"Braga",1,"Avenida da Liberdade",25,25,0,124,124,0
7,25,2018,21,0,4,"Braga",2,"Avenida Central",25,25,0,124,124,0
7,25,2018,21,0,4,"Braga",3,"Rua de Caires",37,37,0,36,36,0
7,25,2018,21,0,4,"Braga",4,"N14 Bosch",47,47,0,48,48,0
7,25,2018,21,0,4,"Braga",5,"Avenida João Paulo II",39,39,0,9,9,0
7,25,2018,21,0,4,"Braga",6,"Avenida Padre Júlio Fragata",67,67,0,83,83,0
7,25,2018,21,0,4,"Braga",7,"Rua Nova Santa Cruz",27,43,16,64,40,24
7,25,2018,21,0,4,"Braga",8,"Rua Costa Gomes",40,40,0,43,43,0
7,25,2018,22,0,4,"Braga",1,"Avenida da Liberdade",25,25,0,124,124,0
7,25,2018,22,0,4,"Braga",2,"Avenida Central",25,25,0,124,124,0
7,25,2018,22,0,4,"Braga",3,"Rua de Caires",37,37,0,36,36,0
7,25,2018,22,0,4,"Braga",4,"N14 Bosch",31,47,16,72,48,24
7,25,2018,22,0,4,"Braga",5,"Avenida João Paulo II",39,39,0,9,9,0
7,25,2018,22,0,4,"Braga",6,"Avenida Padre Júlio Fragata",51,67,16,109,83,26
7,25,2018,22,0,4,"Braga",7,"Rua Nova Santa Cruz",43,43,0,40,40,0
7,25,2018,22,0,4,"Braga",8,"Rua Costa Gomes",40,40,0,43,43,0
7,26,2018,0,0,5,"Braga",1,"Avenida da Liberdade",25,25,0,124,124,0
7,26,2018,0,0,5,"Braga",2,"Avenida Central",25,25,0,124,124,0
7,26,2018,0,0,5,"Braga",3,"Rua de Caires",37,37,0,36,36,0
7,26,2018,0,0,5,"Braga",4,"N14 Bosch",47,47,0,48,48,0
7,26,2018,0,0,5,"Braga",5,"Avenida João Paulo II",39,39,0,9,9,0
7,26,2018,0,0,5,"Braga",6,"Avenida Padre Júlio Fragata",67,67,0,83,83,0
7,26,2018,0,0,5,"Braga",7,"Rua Nova Santa Cruz",43,43,0,40,40,0
7,26,2018,0,0,5,"Braga",8,"Rua Costa Gomes",40,40,0,43,43,0
7,26,2018,1,0,5,"Braga",1,"Avenida da Liberdade",25,25,0,124,124,0
7,26,2018,1,0,5,"Braga",2,"Avenida Central",25,25,0,124,124,0
7,26,2018,1,0,5,"Braga",3,"Rua de Caires",37,37,0,36,36,0
7,26,2018,1,0,5,"Braga",4,"N14 Bosch",47,47,0,48,48,0
7,26,2018,1,0,5,"Braga",5,"Avenida João Paulo II",39,39,0,9,9,0
7,26,2018,1,0,5,"Braga",6,"Avenida Padre Júlio Fragata",67,67,0,83,83,0
7,26,2018,1,0,5,"Braga",7,"Rua Nova Santa Cruz",43,43,0,40,40,0
7,26,2018,1,0,5,"Braga",8,"Rua Costa Gomes",40,40,0,43,43,0
7,26,2018,2,0,5,"Braga",1,"Avenida da Liberdade",25,25,0,124,124,0
7,26,2018,2,0,5,"Braga",2,"Avenida Central",25,25,0,124,124,0
7,26,2018,2,0,5,"Braga",3,"Rua de Caires",37,37,0,36,36,0
7,26,2018,2,0,5,"Braga",4,"N14 Bosch",47,47,0,48,48,0
7,26,2018,2,0,5,"Braga",5,"Avenida João Paulo II",39,39,0,9,9,0
7,26,2018,2,0,5,"Braga",6,"Avenida Padre Júlio Fragata",67,67,0,83,83,0
7,26,2018,2,0,5,"Braga",7,"Rua Nova Santa Cruz",43,43,0,40,40,0
7,26,2018,2,0,5,"Braga",8,"Rua Costa Gomes",40,40,0,43,43,0
7,26,2018,3,0,5,"Braga",1,"Avenida da Liberdade",25,25,0,124,124,0
7,26,2018,3,0,5,"Braga",2,"Avenida Central",25,25,0,124,124,0
7,26,2018,3,0,5,"Braga",3,"Rua de Caires",37,37,0,36,36,0
7,26,2018,3,0,5,"Braga",4,"N14 Bosch",47,47,0,48,48,0
7,26,2018,3,0,5,"Braga",5,"Avenida João Paulo II",39,39,0,9,9,0
7,26,2018,3,0,5,"Braga",6,"Avenida Padre Júlio Fragata",67,67,0,83,83,0
7,26,2018,3,0,5,"Braga",7,"Rua Nova Santa Cruz",43,43,0,40,40,0
7,26,2018,3,0,5,"Braga",8,"Rua Costa Gomes",40,40,0,43,43,0
7,26,2018,4,0,5,"Braga",1,"Avenida da Liberdade",25,25,0,124,124,0
7,26,2018,4,0,5,"Braga",2,"Avenida Central",25,25,0,124,124,0
7,26,2018,4,0,5,"Braga",3,"Rua de Caires",37,37,0,36,36,0
7,26,2018,4,0,5,"Braga",4,"N14 Bosch",47,47,0,48,48,0
7,26,2018,4,0,5,"Braga",5,"Avenida João Paulo II",39,39,0,9,9,0
7,26,2018,4,0,5,"Braga",6,"Avenida Padre Júlio Fragata",67,67,0,83,83,0
7,26,2018,4,0,5,"Braga",7,"Rua Nova Santa Cruz",43,43,0,40,40,0
7,26,2018,4,0,5,"Braga",8,"Rua Costa Gomes",40,40,0,43,43,0
7,26,2018,5,0,5,"Braga",1,"Avenida da Liberdade",25,25,0,124,124,0
7,26,2018,5,0,5,"Braga",2,"Avenida Central",25,25,0,124,124,0
7,26,2018,5,0,5,"Braga",3,"Rua de Caires",37,37,0,36,36,0
7,26,2018,5,0,5,"Braga",4,"N14 Bosch",47,47,0,48,48,0
7,26,2018,5,0,5,"Braga",5,"Avenida João Paulo II",39,39,0,9,9,0
7,26,2018,5,0,5,"Braga",6,"Avenida Padre Júlio Fragata",67,67,0,83,83,0
7,26,2018,5,0,5,"Braga",7,"Rua Nova Santa Cruz",43,43,0,40,40,0
7,26,2018,5,0,5,"Braga",8,"Rua Costa Gomes",40,40,0,43,43,0
7,26,2018,6,0,5,"Braga",1,"Avenida da Liberdade",25,25,0,124,124,0
7,26,2018,6,0,5,"Braga",2,"Avenida Central",25,25,0,124,124,0
7,26,2018,6,0,5,"Braga",3,"Rua de Caires",37,37,0,36,36,0
7,26,2018,6,0,5,"Braga",4,"N14 Bosch",47,47,0,48,48,0
7,26,2018,6,0,5,"Braga",5,"Avenida João Paulo II",39,39,0,9,9,0
7,26,2018,6,0,5,"Braga",6,"Avenida Padre Júlio Fragata",67,67,0,83,83,0
7,26,2018,6,0,5,"Braga",7,"Rua Nova Santa Cruz",43,43,0,40,40,0
7,26,2018,6,0,5,"Braga",8,"Rua Costa Gomes",40,40,0,43,43,0
7,26,2018,7,0,5,"Braga",1,"Avenida da Liberdade",19,25,6,163,124,39
7,26,2018,7,0,5,"Braga",2,"Avenida Central",19,25,6,163,124,39
7,26,2018,7,0,5,"Braga",3,"Rua de Caires",37,37,0,36,36,0
7,26,2018,7,0,5,"Braga",4,"N14 Bosch",31,47,16,72,48,24
7,26,2018,7,0,5,"Braga",5,"Avenida João Paulo II",39,39,0,9,9,0
7,26,2018,7,0,5,"Braga",6,"Avenida Padre Júlio Fragata",67,67,0,83,83,0
7,26,2018,7,0,5,"Braga",7,"Rua Nova Santa Cruz",33,43,10,52,40,12
7,26,2018,7,0,5,"Braga",8,"Rua Costa Gomes",40,40,0,43,43,0
7,26,2018,8,0,5,"Braga",1,"Avenida da Liberdade",25,25,0,124,124,0
7,26,2018,8,0,5,"Braga",2,"Avenida Central",25,25,0,124,124,0
7,26,2018,8,0,5,"Braga",3,"Rua de Caires",20,37,17,67,36,31
7,26,2018,8,0,5,"Braga",4,"N14 Bosch",28,47,19,80,48,32
7,26,2018,8,0,5,"Braga",5,"Avenida João Paulo II",39,39,0,9,9,0
7,26,2018,8,0,5,"Braga",6,"Avenida Padre Júlio Fragata",67,67,0,83,83,0
7,26,2018,8,0,5,"Braga",7,"Rua Nova Santa Cruz",11,43,32,157,40,117
7,26,2018,8,0,5,"Braga",8,"Rua Costa Gomes",40,40,0,43,43,0
7,26,2018,9,0,5,"Braga",1,"Avenida da Liberdade",25,25,0,124,124,0
7,26,2018,9,0,5,"Braga",2,"Avenida Central",25,25,0,124,124,0
7,26,2018,9,0,5,"Braga",3,"Rua de Caires",37,37,0,36,36,0
7,26,2018,9,0,5,"Braga",4,"N14 Bosch",26,47,21,86,48,38
7,26,2018,9,0,5,"Braga",5,"Avenida João Paulo II",39,39,0,9,9,0
7,26,2018,9,0,5,"Braga",6,"Avenida Padre Júlio Fragata",67,67,0,83,83,0
7,26,2018,9,0,5,"Braga",7,"Rua Nova Santa Cruz",43,43,0,40,40,0
7,26,2018,9,0,5,"Braga",8,"Rua Costa Gomes",40,40,0,43,43,0
7,26,2018,10,0,5,"Braga",1,"Avenida da Liberdade",25,25,0,124,124,0
7,26,2018,10,0,5,"Braga",2,"Avenida Central",25,25,0,124,124,0
7,26,2018,10,0,5,"Braga",3,"Rua de Caires",37,37,0,36,36,0
7,26,2018,10,0,5,"Braga",4,"N14 Bosch",32,47,15,70,48,22
7,26,2018,10,0,5,"Braga",5,"Avenida João Paulo II",39,39,0,9,9,0
7,26,2018,10,0,5,"Braga",6,"Avenida Padre Júlio Fragata",67,67,0,83,83,0
7,26,2018,10,0,5,"Braga",7,"Rua Nova Santa Cruz",43,43,0,40,40,0
7,26,2018,10,0,5,"Braga",8,"Rua Costa Gomes",40,40,0,43,43,0
7,26,2018,11,0,5,"Braga",1,"Avenida da Liberdade",25,25,0,124,124,0
7,26,2018,11,0,5,"Braga",2,"Avenida Central",25,25,0,124,124,0
7,26,2018,11,0,5,"Braga",3,"Rua de Caires",37,37,0,36,36,0
7,26,2018,11,0,5,"Braga",4,"N14 Bosch",33,47,14,68,48,20
7,26,2018,11,0,5,"Braga",5,"Avenida João Paulo II",39,39,0,9,9,0
7,26,2018,11,0,5,"Braga",6,"Avenida Padre Júlio Fragata",67,67,0,83,83,0
7,26,2018,11,0,5,"Braga",7,"Rua Nova Santa Cruz",43,43,0,40,40,0
7,26,2018,11,0,5,"Braga",8,"Rua Costa Gomes",31,40,9,56,43,13
7,26,2018,12,0,5,"Braga",1,"Avenida da Liberdade",25,25,0,124,124,0
7,26,2018,12,0,5,"Braga",2,"Avenida Central",25,25,0,124,124,0
7,26,2018,12,0,5,"Braga",3,"Rua de Caires",37,37,0,36,36,0
7,26,2018,12,0,5,"Braga",4,"N14 Bosch",22,47,25,102,48,54
7,26,2018,12,0,5,"Braga",5,"Avenida João Paulo II",39,39,0,9,9,0
7,26,2018,12,0,5,"Braga",6,"Avenida Padre Júlio Fragata",67,67,0,83,83,0
7,26,2018,12,0,5,"Braga",7,"Rua Nova Santa Cruz",43,43,0,40,40,0
7,26,2018,12,0,5,"Braga",8,"Rua Costa Gomes",25,40,15,69,43,26
7,26,2018,13,0,5,"Braga",1,"Avenida da Liberdade",25,25,0,124,124,0
7,26,2018,13,0,5,"Braga",2,"Avenida Central",25,25,0,124,124,0
7,26,2018,13,0,5,"Braga",3,"Rua de Caires",18,37,19,75,36,39
7,26,2018,13,0,5,"Braga",4,"N14 Bosch",28,47,19,80,48,32
7,26,2018,13,0,5,"Braga",5,"Avenida João Paulo II",30,39,9,12,9,3
7,26,2018,13,0,5,"Braga",6,"Avenida Padre Júlio Fragata",67,67,0,83,83,0
7,26,2018,13,0,5,"Braga",7,"Rua Nova Santa Cruz",43,43,0,40,40,0
7,26,2018,13,0,5,"Braga",8,"Rua Costa Gomes",40,40,0,43,43,0
7,26,2018,14,0,5,"Braga",1,"Avenida da Liberdade",25,25,0,124,124,0
7,26,2018,14,0,5,"Braga",2,"Avenida Central",25,25,0,124,124,0
7,26,2018,14,0,5,"Braga",3,"Rua de Caires",37,37,0,36,36,0
7,26,2018,14,0,5,"Braga",4,"N14 Bosch",26,47,21,86,48,38
7,26,2018,14,0,5,"Braga",5,"Avenida João Paulo II",39,39,0,9,9,0
7,26,2018,14,0,5,"Braga",6,"Avenida Padre Júlio Fragata",67,67,0,83,83,0
7,26,2018,14,0,5,"Braga",7,"Rua Nova Santa Cruz",43,43,0,40,40,0
7,26,2018,14,0,5,"Braga",8,"Rua Costa Gomes",40,40,0,43,43,0
7,26,2018,15,0,5,"Braga",1,"Avenida da Liberdade",19,25,6,163,124,39
7,26,2018,15,0,5,"Braga",2,"Avenida Central",19,25,6,163,124,39
7,26,2018,15,0,5,"Braga",3,"Rua de Caires",28,37,9,48,36,12
7,26,2018,15,0,5,"Braga",4,"N14 Bosch",47,47,0,48,48,0
7,26,2018,15,0,5,"Braga",5,"Avenida João Paulo II",22,39,17,16,9,7
7,26,2018,15,0,5,"Braga",6,"Avenida Padre Júlio Fragata",67,67,0,83,83,0
7,26,2018,15,0,5,"Braga",7,"Rua Nova Santa Cruz",43,43,0,40,40,0
7,26,2018,15,0,5,"Braga",8,"Rua Costa Gomes",25,40,15,69,43,26
7,26,2018,16,0,5,"Braga",1,"Avenida da Liberdade",19,25,6,163,124,39
7,26,2018,16,0,5,"Braga",2,"Avenida Central",19,25,6,163,124,39
7,26,2018,16,0,5,"Braga",3,"Rua de Caires",37,37,0,36,36,0
7,26,2018,16,0,5,"Braga",4,"N14 Bosch",21,47,26,107,48,59
7,26,2018,16,0,5,"Braga",5,"Avenida João Paulo II",39,39,0,9,9,0
7,26,2018,16,0,5,"Braga",6,"Avenida Padre Júlio Fragata",67,67,0,83,83,0
7,26,2018,16,0,5,"Braga",7,"Rua Nova Santa Cruz",43,43,0,40,40,0
7,26,2018,16,0,5,"Braga",8,"Rua Costa Gomes",40,40,0,43,43,0
7,26,2018,17,0,5,"Braga",1,"Avenida da Liberdade",16,25,9,194,124,70
7,26,2018,17,0,5,"Braga",2,"Avenida Central",17,25,8,182,124,58
7,26,2018,17,0,5,"Braga",3,"Rua de Caires",24,37,13,56,36,20
7,26,2018,17,0,5,"Braga",4,"N14 Bosch",18,47,29,125,48,77
7,26,2018,17,0,5,"Braga",5,"Avenida João Paulo II",27,39,12,13,9,4
7,26,2018,17,0,5,"Braga",6,"Avenida Padre Júlio Fragata",41,67,26,136,83,53
7,26,2018,17,0,5,"Braga",7,"Rua Nova Santa Cruz",25,43,18,69,40,29
7,26,2018,17,0,5,"Braga",8,"Rua Costa Gomes",17,40,23,102,43,59
7,26,2018,18,0,5,"Braga",1,"Avenida da Liberdade",18,25,7,172,124,48
7,26,2018,18,0,5,"Braga",2,"Avenida Central",18,25,7,172,124,48
7,26,2018,18,0,5,"Braga",3,"Rua de Caires",18,37,19,75,36,39
7,26,2018,18,0,5,"Braga",4,"N14 Bosch",28,47,19,80,48,32
7,26,2018,18,0,5,"Braga",5,"Avenida João Paulo II",25,39,14,14,9,5
7,26,2018,18,0,5,"Braga",6,"Avenida Padre Júlio Fragata",22,67,45,253,83,170
7,26,2018,18,0,5,"Braga",7,"Rua Nova Santa Cruz",30,43,13,58,40,18
7,26,2018,18,0,5,"Braga",8,"Rua Costa Gomes",29,40,11,60,43,17
7,26,2018,19,0,5,"Braga",1,"Avenida da Liberdade",25,25,0,124,124,0
7,26,2018,19,0,5,"Braga",2,"Avenida Central",25,25,0,124,124,0
7,26,2018,19,0,5,"Braga",3,"Rua de Caires",37,37,0,36,36,0
7,26,2018,19,0,5,"Braga",4,"N14 Bosch",34,47,13,66,48,18
7,26,2018,19,0,5,"Braga",5,"Avenida João Paulo II",39,39,0,9,9,0
7,26,2018,19,0,5,"Braga",6,"Avenida Padre Júlio Fragata",52,67,15,107,83,24
7,26,2018,19,0,5,"Braga",7,"Rua Nova Santa Cruz",31,43,12,56,40,16
7,26,2018,19,0,5,"Braga",8,"Rua Costa Gomes",25,40,15,69,43,26
7,26,2018,20,0,5,"Braga",1,"Avenida da Liberdade",25,25,0,124,124,0
7,26,2018,20,0,5,"Braga",2,"Avenida Central",25,25,0,124,124,0
7,26,2018,20,0,5,"Braga",3,"Rua de Caires",37,37,0,36,36,0
7,26,2018,20,0,5,"Braga",4,"N14 Bosch",47,47,0,48,48,0
7,26,2018,20,0,5,"Braga",5,"Avenida João Paulo II",39,39,0,9,9,0
7,26,2018,20,0,5,"Braga",6,"Avenida Padre Júlio Fragata",67,67,0,83,83,0
7,26,2018,20,0,5,"Braga",7,"Rua Nova Santa Cruz",43,43,0,40,40,0
7,26,2018,20,0,5,"Braga",8,"Rua Costa Gomes",40,40,0,43,43,0
7,26,2018,21,0,5,"Braga",1,"Avenida da Liberdade",25,25,0,124,124,0
7,26,2018,21,0,5,"Braga",2,"Avenida Central",25,25,0,124,124,0
7,26,2018,21,0,5,"Braga",3,"Rua de Caires",37,37,0,36,36,0
7,26,2018,21,0,5,"Braga",4,"N14 Bosch",47,47,0,48,48,0
7,26,2018,21,0,5,"Braga",5,"Avenida João Paulo II",39,39,0,9,9,0
7,26,2018,21,0,5,"Braga",6,"Avenida Padre Júlio Fragata",67,67,0,83,83,0
7,26,2018,21,0,5,"Braga",7,"Rua Nova Santa Cruz",43,43,0,40,40,0
7,26,2018,21,0,5,"Braga",8,"Rua Costa Gomes",40,40,0,43,43,0
7,26,2018,22,0,5,"Braga",1,"Avenida da Liberdade",25,25,0,124,124,0
7,26,2018,22,0,5,"Braga",2,"Avenida Central",25,25,0,124,124,0
7,26,2018,22,0,5,"Braga",3,"Rua de Caires",37,37,0,36,36,0
7,26,2018,22,0,5,"Braga",4,"N14 Bosch",47,47,0,48,48,0
7,26,2018,22,0,5,"Braga",5,"Avenida João Paulo II",39,39,0,9,9,0
7,26,2018,22,0,5,"Braga",6,"Avenida Padre Júlio Fragata",67,67,0,83,83,0
7,26,2018,22,0,5,"Braga",7,"Rua Nova Santa Cruz",43,43,0,40,40,0
7,26,2018,22,0,5,"Braga",8,"Rua Costa Gomes",40,40,0,43,43,0
7,27,2018,0,0,6,"Braga",1,"Avenida da Liberdade",25,25,0,124,124,0
7,27,2018,0,0,6,"Braga",2,"Avenida Central",25,25,0,124,124,0
7,27,2018,0,0,6,"Braga",3,"Rua de Caires",37,37,0,36,36,0
7,27,2018,0,0,6,"Braga",4,"N14 Bosch",47,47,0,48,48,0
7,27,2018,0,0,6,"Braga",5,"Avenida João Paulo II",39,39,0,9,9,0
7,27,2018,0,0,6,"Braga",6,"Avenida Padre Júlio Fragata",67,67,0,83,83,0
7,27,2018,0,0,6,"Braga",7,"Rua Nova Santa Cruz",43,43,0,40,40,0
7,27,2018,0,0,6,"Braga",8,"Rua Costa Gomes",40,40,0,43,43,0
7,27,2018,1,0,6,"Braga",1,"Avenida da Liberdade",25,25,0,124,124,0
7,27,2018,1,0,6,"Braga",2,"Avenida Central",25,25,0,124,124,0
7,27,2018,1,0,6,"Braga",3,"Rua de Caires",37,37,0,36,36,0
7,27,2018,1,0,6,"Braga",4,"N14 Bosch",47,47,0,48,48,0
7,27,2018,1,0,6,"Braga",5,"Avenida João Paulo II",39,39,0,9,9,0
7,27,2018,1,0,6,"Braga",6,"Avenida Padre Júlio Fragata",67,67,0,83,83,0
7,27,2018,1,0,6,"Braga",7,"Rua Nova Santa Cruz",43,43,0,40,40,0
7,27,2018,1,0,6,"Braga",8,"Rua Costa Gomes",40,40,0,43,43,0
7,27,2018,2,0,6,"Braga",1,"Avenida da Liberdade",25,25,0,124,124,0
7,27,2018,2,0,6,"Braga",2,"Avenida Central",25,25,0,124,124,0
7,27,2018,2,0,6,"Braga",3,"Rua de Caires",37,37,0,36,36,0
7,27,2018,2,0,6,"Braga",4,"N14 Bosch",47,47,0,48,48,0
7,27,2018,2,0,6,"Braga",5,"Avenida João Paulo II",39,39,0,9,9,0
7,27,2018,2,0,6,"Braga",6,"Avenida Padre Júlio Fragata",67,67,0,83,83,0
7,27,2018,2,0,6,"Braga",7,"Rua Nova Santa Cruz",43,43,0,40,40,0
7,27,2018,2,0,6,"Braga",8,"Rua Costa Gomes",40,40,0,43,43,0
7,27,2018,3,0,6,"Braga",1,"Avenida da Liberdade",25,25,0,124,124,0
7,27,2018,3,0,6,"Braga",2,"Avenida Central",25,25,0,124,124,0
7,27,2018,3,0,6,"Braga",3,"Rua de Caires",37,37,0,36,36,0
7,27,2018,3,0,6,"Braga",4,"N14 Bosch",47,47,0,48,48,0
7,27,2018,3,0,6,"Braga",5,"Avenida João Paulo II",39,39,0,9,9,0
7,27,2018,3,0,6,"Braga",6,"Avenida Padre Júlio Fragata",67,67,0,83,83,0
7,27,2018,3,0,6,"Braga",7,"Rua Nova Santa Cruz",43,43,0,40,40,0
7,27,2018,3,0,6,"Braga",8,"Rua Costa Gomes",40,40,0,43,43,0
7,27,2018,4,0,6,"Braga",1,"Avenida da Liberdade",25,25,0,124,124,0
7,27,2018,4,0,6,"Braga",2,"Avenida Central",25,25,0,124,124,0
7,27,2018,4,0,6,"Braga",3,"Rua de Caires",37,37,0,36,36,0
7,27,2018,4,0,6,"Braga",4,"N14 Bosch",47,47,0,48,48,0
7,27,2018,4,0,6,"Braga",5,"Avenida João Paulo II",39,39,0,9,9,0
7,27,2018,4,0,6,"Braga",6,"Avenida Padre Júlio Fragata",67,67,0,83,83,0
7,27,2018,4,0,6,"Braga",7,"Rua Nova Santa Cruz",43,43,0,40,40,0
7,27,2018,4,0,6,"Braga",8,"Rua Costa Gomes",40,40,0,43,43,0
7,27,2018,5,0,6,"Braga",1,"Avenida da Liberdade",25,25,0,124,124,0
7,27,2018,5,0,6,"Braga",2,"Avenida Central",25,25,0,124,124,0
7,27,2018,5,0,6,"Braga",3,"Rua de Caires",37,37,0,36,36,0
7,27,2018,5,0,6,"Braga",4,"N14 Bosch",47,47,0,48,48,0
7,27,2018,5,0,6,"Braga",5,"Avenida João Paulo II",39,39,0,9,9,0
7,27,2018,5,0,6,"Braga",6,"Avenida Padre Júlio Fragata",67,67,0,83,83,0
7,27,2018,5,0,6,"Braga",7,"Rua Nova Santa Cruz",43,43,0,40,40,0
7,27,2018,5,0,6,"Braga",8,"Rua Costa Gomes",40,40,0,43,43,0
7,27,2018,6,0,6,"Braga",1,"Avenida da Liberdade",25,25,0,124,124,0
7,27,2018,6,0,6,"Braga",2,"Avenida Central",25,25,0,124,124,0
7,27,2018,6,0,6,"Braga",3,"Rua de Caires",37,37,0,36,36,0
7,27,2018,6,0,6,"Braga",4,"N14 Bosch",47,47,0,48,48,0
7,27,2018,6,0,6,"Braga",5,"Avenida João Paulo II",39,39,0,9,9,0
7,27,2018,6,0,6,"Braga",6,"Avenida Padre Júlio Fragata",67,67,0,83,83,0
7,27,2018,6,0,6,"Braga",7,"Rua Nova Santa Cruz",43,43,0,40,40,0
7,27,2018,6,0,6,"Braga",8,"Rua Costa Gomes",40,40,0,43,43,0
7,27,2018,7,0,6,"Braga",1,"Avenida da Liberdade",25,25,0,124,124,0
7,27,2018,7,0,6,"Braga",2,"Avenida Central",25,25,0,124,124,0
7,27,2018,7,0,6,"Braga",3,"Rua de Caires",25,37,12,54,36,18
7,27,2018,7,0,6,"Braga",4,"N14 Bosch",21,47,26,107,48,59
7,27,2018,7,0,6,"Braga",5,"Avenida João Paulo II",39,39,0,9,9,0
7,27,2018,7,0,6,"Braga",6,"Avenida Padre Júlio Fragata",67,67,0,83,83,0
7,27,2018,7,0,6,"Braga",7,"Rua Nova Santa Cruz",43,43,0,40,40,0
7,27,2018,7,0,6,"Braga",8,"Rua Costa Gomes",40,40,0,43,43,0
7,27,2018,8,0,6,"Braga",1,"Avenida da Liberdade",25,25,0,124,124,0
7,27,2018,8,0,6,"Braga",2,"Avenida Central",25,25,0,124,124,0
7,27,2018,8,0,6,"Braga",3,"Rua de Caires",21,37,16,64,36,28
7,27,2018,8,0,6,"Braga",4,"N14 Bosch",47,47,0,48,48,0
7,27,2018,8,0,6,"Braga",5,"Avenida João Paulo II",39,39,0,9,9,0
7,27,2018,8,0,6,"Braga",6,"Avenida Padre Júlio Fragata",67,67,0,83,83,0
7,27,2018,8,0,6,"Braga",7,"Rua Nova Santa Cruz",43,43,0,40,40,0
7,27,2018,8,0,6,"Braga",8,"Rua Costa Gomes",26,40,14,67,43,24
7,27,2018,9,0,6,"Braga",1,"Avenida da Liberdade",25,25,0,124,124,0
7,27,2018,9,0,6,"Braga",2,"Avenida Central",25,25,0,124,124,0
7,27,2018,9,0,6,"Braga",3,"Rua de Caires",29,37,8,46,36,10
7,27,2018,9,0,6,"Braga",4,"N14 Bosch",47,47,0,48,48,0
7,27,2018,9,0,6,"Braga",5,"Avenida João Paulo II",39,39,0,9,9,0
7,27,2018,9,0,6,"Braga",6,"Avenida Padre Júlio Fragata",67,67,0,83,83,0
7,27,2018,9,0,6,"Braga",7,"Rua Nova Santa Cruz",43,43,0,40,40,0
7,27,2018,9,0,6,"Braga",8,"Rua Costa Gomes",40,40,0,43,43,0
7,27,2018,10,0,6,"Braga",1,"Avenida da Liberdade",25,25,0,124,124,0
7,27,2018,10,0,6,"Braga",2,"Avenida Central",25,25,0,124,124,0
7,27,2018,10,0,6,"Braga",3,"Rua de Caires",29,37,8,46,36,10
7,27,2018,10,0,6,"Braga",4,"N14 Bosch",23,47,24,98,48,50
7,27,2018,10,0,6,"Braga",5,"Avenida João Paulo II",39,39,0,9,9,0
7,27,2018,10,0,6,"Braga",6,"Avenida Padre Júlio Fragata",67,67,0,83,83,0
7,27,2018,10,0,6,"Braga",7,"Rua Nova Santa Cruz",43,43,0,40,40,0
7,27,2018,10,0,6,"Braga",8,"Rua Costa Gomes",40,40,0,43,43,0
8,1,2018,10,0,4,"Braga",1,"Avenida da Liberdade",25,25,0,124,124,0
8,1,2018,10,0,4,"Braga",2,"Avenida Central",25,25,0,124,124,0
8,1,2018,10,0,4,"Braga",3,"Rua de Caires",37,37,0,36,36,0
8,1,2018,10,0,4,"Braga",4,"N14 Bosch",33,47,14,68,48,20
8,1,2018,10,0,4,"Braga",5,"Avenida João Paulo II",39,39,0,9,9,0
8,1,2018,10,0,4,"Braga",6,"Avenida Padre Júlio Fragata",67,67,0,83,83,0
8,1,2018,10,0,4,"Braga",7,"Rua Nova Santa Cruz",43,43,0,40,40,0
8,1,2018,10,0,4,"Braga",8,"Rua Costa Gomes",40,40,0,43,43,0
8,1,2018,11,0,4,"Braga",1,"Avenida da Liberdade",18,25,7,172,124,48
8,1,2018,11,0,4,"Braga",2,"Avenida Central",18,25,7,172,124,48
8,1,2018,11,0,4,"Braga",3,"Rua de Caires",10,37,27,135,36,99
8,1,2018,11,0,4,"Braga",4,"N14 Bosch",35,47,12,64,48,16
8,1,2018,11,0,4,"Braga",5,"Avenida João Paulo II",39,39,0,9,9,0
8,1,2018,11,0,4,"Braga",6,"Avenida Padre Júlio Fragata",67,67,0,83,83,0
8,1,2018,11,0,4,"Braga",7,"Rua Nova Santa Cruz",43,43,0,40,40,0
8,1,2018,11,0,4,"Braga",8,"Rua Costa Gomes",31,40,9,56,43,13
8,1,2018,12,0,4,"Braga",1,"Avenida da Liberdade",25,25,0,124,124,0
8,1,2018,12,0,4,"Braga",2,"Avenida Central",25,25,0,124,124,0
8,1,2018,12,0,4,"Braga",3,"Rua de Caires",37,37,0,36,36,0
8,1,2018,12,0,4,"Braga",4,"N14 Bosch",26,47,21,86,48,38
8,1,2018,12,0,4,"Braga",5,"Avenida João Paulo II",39,39,0,9,9,0
8,1,2018,12,0,4,"Braga",6,"Avenida Padre Júlio Fragata",67,67,0,83,83,0
8,1,2018,12,0,4,"Braga",7,"Rua Nova Santa Cruz",43,43,0,40,40,0
8,1,2018,12,0,4,"Braga",8,"Rua Costa Gomes",40,40,0,43,43,0
8,1,2018,13,0,4,"Braga",1,"Avenida da Liberdade",25,25,0,124,124,0
8,1,2018,13,0,4,"Braga",2,"Avenida Central",25,25,0,124,124,0
8,1,2018,13,0,4,"Braga",3,"Rua de Caires",28,37,9,48,36,12
8,1,2018,13,0,4,"Braga",4,"N14 Bosch",31,47,16,72,48,24
8,1,2018,13,0,4,"Braga",5,"Avenida João Paulo II",39,39,0,9,9,0
8,1,2018,13,0,4,"Braga",6,"Avenida Padre Júlio Fragata",67,67,0,83,83,0
8,1,2018,13,0,4,"Braga",7,"Rua Nova Santa Cruz",43,43,0,40,40,0
8,1,2018,13,0,4,"Braga",8,"Rua Costa Gomes",40,40,0,43,43,0
8,1,2018,14,0,4,"Braga",1,"Avenida da Liberdade",20,25,5,155,124,31
8,1,2018,14,0,4,"Braga",2,"Avenida Central",20,25,5,155,124,31
8,1,2018,14,0,4,"Braga",3,"Rua de Caires",14,37,23,96,36,60
8,1,2018,14,0,4,"Braga",4,"N14 Bosch",47,47,0,48,48,0
8,1,2018,14,0,4,"Braga",5,"Avenida João Paulo II",39,39,0,9,9,0
8,1,2018,14,0,4,"Braga",6,"Avenida Padre Júlio Fragata",67,67,0,83,83,0
8,1,2018,14,0,4,"Braga",7,"Rua Nova Santa Cruz",32,43,11,54,40,14
8,1,2018,14,0,4,"Braga",8,"Rua Costa Gomes",40,40,0,43,43,0
8,1,2018,15,0,4,"Braga",1,"Avenida da Liberdade",18,25,7,172,124,48
8,1,2018,15,0,4,"Braga",2,"Avenida Central",18,25,7,172,124,48
8,1,2018,15,0,4,"Braga",3,"Rua de Caires",37,37,0,36,36,0
8,1,2018,15,0,4,"Braga",4,"N14 Bosch",18,47,29,125,48,77
8,1,2018,15,0,4,"Braga",5,"Avenida João Paulo II",39,39,0,9,9,0
8,1,2018,15,0,4,"Braga",6,"Avenida Padre Júlio Fragata",67,67,0,83,83,0
8,1,2018,15,0,4,"Braga",7,"Rua Nova Santa Cruz",43,43,0,40,40,0
8,1,2018,15,0,4,"Braga",8,"Rua Costa Gomes",30,40,10,58,43,15
8,1,2018,16,0,4,"Braga",1,"Avenida da Liberdade",25,25,0,124,124,0
8,1,2018,16,0,4,"Braga",2,"Avenida Central",19,25,6,163,124,39
8,1,2018,16,0,4,"Braga",3,"Rua de Caires",27,37,10,50,36,14
8,1,2018,16,0,4,"Braga",4,"N14 Bosch",31,47,16,72,48,24
8,1,2018,16,0,4,"Braga",5,"Avenida João Paulo II",39,39,0,9,9,0
8,1,2018,16,0,4,"Braga",6,"Avenida Padre Júlio Fragata",67,67,0,83,83,0
8,1,2018,16,0,4,"Braga",7,"Rua Nova Santa Cruz",43,43,0,40,40,0
8,1,2018,16,0,4,"Braga",8,"Rua Costa Gomes",28,40,12,62,43,19
8,1,2018,17,0,4,"Braga",1,"Avenida da Liberdade",19,25,6,163,124,39
8,1,2018,17,0,4,"Braga",2,"Avenida Central",19,25,6,163,124,39
8,1,2018,17,0,4,"Braga",3,"Rua de Caires",28,37,9,48,36,12
8,1,2018,17,0,4,"Braga",4,"N14 Bosch",26,47,21,86,48,38
8,1,2018,17,0,4,"Braga",5,"Avenida João Paulo II",29,39,10,12,9,3
8,1,2018,17,0,4,"Braga",6,"Avenida Padre Júlio Fragata",42,67,25,133,83,50
8,1,2018,17,0,4,"Braga",7,"Rua Nova Santa Cruz",43,43,0,40,40,0
8,1,2018,17,0,4,"Braga",8,"Rua Costa Gomes",18,40,22,96,43,53
8,1,2018,18,0,4,"Braga",1,"Avenida da Liberdade",18,25,7,172,124,48
8,1,2018,18,0,4,"Braga",2,"Avenida Central",18,25,7,172,124,48
8,1,2018,18,0,4,"Braga",3,"Rua de Caires",28,37,9,48,36,12
8,1,2018,18,0,4,"Braga",4,"N14 Bosch",19,47,28,118,48,70
8,1,2018,18,0,4,"Braga",5,"Avenida João Paulo II",10,39,29,35,9,26
8,1,2018,18,0,4,"Braga",6,"Avenida Padre Júlio Fragata",23,67,44,242,83,159
8,1,2018,18,0,4,"Braga",7,"Rua Nova Santa Cruz",43,43,0,40,40,0
8,1,2018,18,0,4,"Braga",8,"Rua Costa Gomes",16,40,24,108,43,65
8,1,2018,19,0,4,"Braga",1,"Avenida da Liberdade",25,25,0,124,124,0
8,1,2018,19,0,4,"Braga",2,"Avenida Central",25,25,0,124,124,0
8,1,2018,19,0,4,"Braga",3,"Rua de Caires",37,37,0,36,36,0
8,1,2018,19,0,4,"Braga",4,"N14 Bosch",47,47,0,48,48,0
8,1,2018,19,0,4,"Braga",5,"Avenida João Paulo II",39,39,0,9,9,0
8,1,2018,19,0,4,"Braga",6,"Avenida Padre Júlio Fragata",36,67,31,155,83,72
8,1,2018,19,0,4,"Braga",7,"Rua Nova Santa Cruz",29,43,14,60,40,20
8,1,2018,19,0,4,"Braga",8,"Rua Costa Gomes",12,40,28,144,43,101
8,1,2018,20,0,4,"Braga",1,"Avenida da Liberdade",25,25,0,124,124,0
8,1,2018,20,0,4,"Braga",2,"Avenida Central",25,25,0,124,124,0
8,1,2018,20,0,4,"Braga",3,"Rua de Caires",37,37,0,36,36,0
8,1,2018,20,0,4,"Braga",4,"N14 Bosch",47,47,0,48,48,0
8,1,2018,20,0,4,"Braga",5,"Avenida João Paulo II",39,39,0,9,9,0
8,1,2018,20,0,4,"Braga",6,"Avenida Padre Júlio Fragata",67,67,0,83,83,0
8,1,2018,20,0,4,"Braga",7,"Rua Nova Santa Cruz",43,43,0,40,40,0
8,1,2018,20,0,4,"Braga",8,"Rua Costa Gomes",40,40,0,43,43,0
8,1,2018,21,0,4,"Braga",1,"Avenida da Liberdade",25,25,0,124,124,0
8,1,2018,21,0,4,"Braga",2,"Avenida Central",25,25,0,124,124,0
8,1,2018,21,0,4,"Braga",3,"Rua de Caires",26,37,11,52,36,16
8,1,2018,21,0,4,"Braga",4,"N14 Bosch",47,47,0,48,48,0
8,1,2018,21,0,4,"Braga",5,"Avenida João Paulo II",39,39,0,9,9,0
8,1,2018,21,0,4,"Braga",6,"Avenida Padre Júlio Fragata",67,67,0,83,83,0
8,1,2018,21,0,4,"Braga",7,"Rua Nova Santa Cruz",43,43,0,40,40,0
8,1,2018,21,0,4,"Braga",8,"Rua Costa Gomes",24,40,16,72,43,29
8,1,2018,22,0,4,"Braga",1,"Avenida da Liberdade",25,25,0,124,124,0
8,1,2018,22,0,4,"Braga",2,"Avenida Central",25,25,0,124,124,0
8,1,2018,22,0,4,"Braga",3,"Rua de Caires",37,37,0,36,36,0
8,1,2018,22,0,4,"Braga",4,"N14 Bosch",47,47,0,48,48,0
8,1,2018,22,0,4,"Braga",5,"Avenida João Paulo II",39,39,0,9,9,0
8,1,2018,22,0,4,"Braga",6,"Avenida Padre Júlio Fragata",48,67,19,116,83,33
8,1,2018,22,0,4,"Braga",7,"Rua Nova Santa Cruz",43,43,0,40,40,0
8,1,2018,22,0,4,"Braga",8,"Rua Costa Gomes",40,40,0,43,43,0
8,1,2018,23,0,4,"Braga",1,"Avenida da Liberdade",19,25,6,163,124,39
8,1,2018,23,0,4,"Braga",2,"Avenida Central",19,25,6,163,124,39
8,1,2018,23,0,4,"Braga",3,"Rua de Caires",37,37,0,36,36,0
8,1,2018,23,0,4,"Braga",4,"N14 Bosch",47,47,0,48,48,0
8,1,2018,23,0,4,"Braga",5,"Avenida João Paulo II",39,39,0,9,9,0
8,1,2018,23,0,4,"Braga",6,"Avenida Padre Júlio Fragata",67,67,0,83,83,0
8,1,2018,23,0,4,"Braga",7,"Rua Nova Santa Cruz",43,43,0,40,40,0
8,1,2018,23,0,4,"Braga",8,"Rua Costa Gomes",40,40,0,43,43,0
8,2,2018,0,0,5,"Braga",1,"Avenida da Liberdade",25,25,0,124,124,0
8,2,2018,0,0,5,"Braga",2,"Avenida Central",25,25,0,124,124,0
8,2,2018,0,0,5,"Braga",3,"Rua de Caires",37,37,0,36,36,0
8,2,2018,0,0,5,"Braga",4,"N14 Bosch",47,47,0,48,48,0
8,2,2018,0,0,5,"Braga",5,"Avenida João Paulo II",39,39,0,9,9,0
8,2,2018,0,0,5,"Braga",6,"Avenida Padre Júlio Fragata",67,67,0,83,83,0
8,2,2018,0,0,5,"Braga",7,"Rua Nova Santa Cruz",43,43,0,40,40,0
8,2,2018,0,0,5,"Braga",8,"Rua Costa Gomes",40,40,0,43,43,0
8,2,2018,1,0,5,"Braga",1,"Avenida da Liberdade",25,25,0,124,124,0
8,2,2018,1,0,5,"Braga",2,"Avenida Central",25,25,0,124,124,0
8,2,2018,1,0,5,"Braga",3,"Rua de Caires",37,37,0,36,36,0
8,2,2018,1,0,5,"Braga",4,"N14 Bosch",47,47,0,48,48,0
8,2,2018,1,0,5,"Braga",5,"Avenida João Paulo II",39,39,0,9,9,0
8,2,2018,1,0,5,"Braga",6,"Avenida Padre Júlio Fragata",67,67,0,83,83,0
8,2,2018,1,0,5,"Braga",7,"Rua Nova Santa Cruz",43,43,0,40,40,0
8,2,2018,1,0,5,"Braga",8,"Rua Costa Gomes",40,40,0,43,43,0
8,2,2018,2,0,5,"Braga",1,"Avenida da Liberdade",25,25,0,124,124,0
8,2,2018,2,0,5,"Braga",2,"Avenida Central",25,25,0,124,124,0
8,2,2018,2,0,5,"Braga",3,"Rua de Caires",37,37,0,36,36,0
8,2,2018,2,0,5,"Braga",4,"N14 Bosch",47,47,0,48,48,0
8,2,2018,2,0,5,"Braga",5,"Avenida João Paulo II",39,39,0,9,9,0
8,2,2018,2,0,5,"Braga",6,"Avenida Padre Júlio Fragata",67,67,0,83,83,0
8,2,2018,2,0,5,"Braga",7,"Rua Nova Santa Cruz",43,43,0,40,40,0
8,2,2018,2,0,5,"Braga",8,"Rua Costa Gomes",40,40,0,43,43,0
8,2,2018,3,0,5,"Braga",1,"Avenida da Liberdade",25,25,0,124,124,0
8,2,2018,3,0,5,"Braga",2,"Avenida Central",25,25,0,124,124,0
8,2,2018,3,0,5,"Braga",3,"Rua de Caires",37,37,0,36,36,0
8,2,2018,3,0,5,"Braga",4,"N14 Bosch",47,47,0,48,48,0
8,2,2018,3,0,5,"Braga",5,"Avenida João Paulo II",39,39,0,9,9,0
8,2,2018,3,0,5,"Braga",6,"Avenida Padre Júlio Fragata",67,67,0,83,83,0
8,2,2018,3,0,5,"Braga",7,"Rua Nova Santa Cruz",43,43,0,40,40,0
8,2,2018,3,0,5,"Braga",8,"Rua Costa Gomes",40,40,0,43,43,0
8,2,2018,4,0,5,"Braga",1,"Avenida da Liberdade",25,25,0,124,124,0
8,2,2018,4,0,5,"Braga",2,"Avenida Central",25,25,0,124,124,0
8,2,2018,4,0,5,"Braga",3,"Rua de Caires",37,37,0,36,36,0
8,2,2018,4,0,5,"Braga",4,"N14 Bosch",47,47,0,48,48,0
8,2,2018,4,0,5,"Braga",5,"Avenida João Paulo II",39,39,0,9,9,0
8,2,2018,4,0,5,"Braga",6,"Avenida Padre Júlio Fragata",67,67,0,83,83,0
8,2,2018,4,0,5,"Braga",7,"Rua Nova Santa Cruz",43,43,0,40,40,0
8,2,2018,4,0,5,"Braga",8,"Rua Costa Gomes",40,40,0,43,43,0
8,2,2018,5,0,5,"Braga",1,"Avenida da Liberdade",25,25,0,124,124,0
8,2,2018,5,0,5,"Braga",2,"Avenida Central",25,25,0,124,124,0
8,2,2018,5,0,5,"Braga",3,"Rua de Caires",37,37,0,36,36,0
8,2,2018,5,0,5,"Braga",4,"N14 Bosch",47,47,0,48,48,0
8,2,2018,5,0,5,"Braga",5,"Avenida João Paulo II",39,39,0,9,9,0
8,2,2018,5,0,5,"Braga",6,"Avenida Padre Júlio Fragata",67,67,0,83,83,0
8,2,2018,5,0,5,"Braga",7,"Rua Nova Santa Cruz",43,43,0,40,40,0
8,2,2018,5,0,5,"Braga",8,"Rua Costa Gomes",40,40,0,43,43,0
8,2,2018,7,0,5,"Braga",1,"Avenida da Liberdade",25,25,0,124,124,0
8,2,2018,7,0,5,"Braga",2,"Avenida Central",25,25,0,124,124,0
8,2,2018,7,0,5,"Braga",3,"Rua de Caires",26,37,11,52,36,16
8,2,2018,7,0,5,"Braga",4,"N14 Bosch",47,47,0,48,48,0
8,2,2018,7,0,5,"Braga",5,"Avenida João Paulo II",39,39,0,9,9,0
8,2,2018,7,0,5,"Braga",6,"Avenida Padre Júlio Fragata",67,67,0,83,83,0
8,2,2018,7,0,5,"Braga",7,"Rua Nova Santa Cruz",43,43,0,40,40,0
8,2,2018,7,0,5,"Braga",8,"Rua Costa Gomes",40,40,0,43,43,0
8,2,2018,10,0,5,"Braga",1,"Avenida da Liberdade",17,25,8,182,124,58
8,2,2018,10,0,5,"Braga",2,"Avenida Central",17,25,8,182,124,58
8,2,2018,10,0,5,"Braga",3,"Rua de Caires",37,37,0,36,36,0
8,2,2018,10,0,5,"Braga",4,"N14 Bosch",25,47,22,90,48,42
8,2,2018,10,0,5,"Braga",5,"Avenida João Paulo II",24,39,15,15,9,6
8,2,2018,10,0,5,"Braga",6,"Avenida Padre Júlio Fragata",67,67,0,83,83,0
8,2,2018,10,0,5,"Braga",7,"Rua Nova Santa Cruz",43,43,0,40,40,0
8,2,2018,10,0,5,"Braga",8,"Rua Costa Gomes",30,40,10,58,43,15
8,2,2018,11,0,5,"Braga",1,"Avenida da Liberdade",19,25,6,163,124,39
8,2,2018,11,0,5,"Braga",2,"Avenida Central",25,25,0,124,124,0
8,2,2018,11,0,5,"Braga",3,"Rua de Caires",37,37,0,36,36,0
8,2,2018,11,0,5,"Braga",4,"N14 Bosch",28,47,19,80,48,32
8,2,2018,11,0,5,"Braga",5,"Avenida João Paulo II",39,39,0,9,9,0
8,2,2018,11,0,5,"Braga",6,"Avenida Padre Júlio Fragata",67,67,0,83,83,0
8,2,2018,11,0,5,"Braga",7,"Rua Nova Santa Cruz",43,43,0,40,40,0
8,2,2018,11,0,5,"Braga",8,"Rua Costa Gomes",19,40,21,91,43,48
8,2,2018,12,0,5,"Braga",1,"Avenida da Liberdade",25,25,0,124,124,0
8,2,2018,12,0,5,"Braga",2,"Avenida Central",25,25,0,124,124,0
8,2,2018,12,0,5,"Braga",3,"Rua de Caires",37,37,0,36,36,0
8,2,2018,12,0,5,"Braga",4,"N14 Bosch",31,47,16,72,48,24
8,2,2018,12,0,5,"Braga",5,"Avenida João Paulo II",39,39,0,9,9,0
8,2,2018,12,0,5,"Braga",6,"Avenida Padre Júlio Fragata",52,67,15,107,83,24
8,2,2018,12,0,5,"Braga",7,"Rua Nova Santa Cruz",43,43,0,40,40,0
8,2,2018,12,0,5,"Braga",8,"Rua Costa Gomes",29,40,11,60,43,17
8,2,2018,13,0,5,"Braga",1,"Avenida da Liberdade",25,25,0,124,124,0
8,2,2018,13,0,5,"Braga",2,"Avenida Central",25,25,0,124,124,0
8,2,2018,13,0,5,"Braga",3,"Rua de Caires",37,37,0,36,36,0
8,2,2018,13,0,5,"Braga",4,"N14 Bosch",31,47,16,72,48,24
8,2,2018,13,0,5,"Braga",5,"Avenida João Paulo II",39,39,0,9,9,0
8,2,2018,13,0,5,"Braga",6,"Avenida Padre Júlio Fragata",67,67,0,83,83,0
8,2,2018,13,0,5,"Braga",7,"Rua Nova Santa Cruz",24,43,19,72,40,32
8,2,2018,13,0,5,"Braga",8,"Rua Costa Gomes",40,40,0,43,43,0
8,2,2018,14,0,5,"Braga",1,"Avenida da Liberdade",25,25,0,124,124,0
8,2,2018,14,0,5,"Braga",2,"Avenida Central",25,25,0,124,124,0
8,2,2018,14,0,5,"Braga",3,"Rua de Caires",37,37,0,36,36,0
8,2,2018,14,0,5,"Braga",4,"N14 Bosch",47,47,0,48,48,0
8,2,2018,14,0,5,"Braga",5,"Avenida João Paulo II",31,39,8,11,9,2
8,2,2018,14,0,5,"Braga",6,"Avenida Padre Júlio Fragata",52,67,15,107,83,24
8,2,2018,14,0,5,"Braga",7,"Rua Nova Santa Cruz",43,43,0,40,40,0
8,2,2018,14,0,5,"Braga",8,"Rua Costa Gomes",28,40,12,62,43,19
8,2,2018,15,0,5,"Braga",1,"Avenida da Liberdade",25,25,0,124,124,0
8,2,2018,15,0,5,"Braga",2,"Avenida Central",25,25,0,124,124,0
8,2,2018,15,0,5,"Braga",3,"Rua de Caires",37,37,0,36,36,0
8,2,2018,15,0,5,"Braga",4,"N14 Bosch",34,47,13,66,48,18
8,2,2018,15,0,5,"Braga",5,"Avenida João Paulo II",21,39,18,17,9,8
8,2,2018,15,0,5,"Braga",6,"Avenida Padre Júlio Fragata",67,67,0,83,83,0
8,2,2018,15,0,5,"Braga",7,"Rua Nova Santa Cruz",43,43,0,40,40,0
8,2,2018,15,0,5,"Braga",8,"Rua Costa Gomes",30,40,10,58,43,15
8,2,2018,16,0,5,"Braga",1,"Avenida da Liberdade",25,25,0,124,124,0
8,2,2018,16,0,5,"Braga",2,"Avenida Central",25,25,0,124,124,0
8,2,2018,16,0,5,"Braga",3,"Rua de Caires",26,37,11,52,36,16
8,2,2018,16,0,5,"Braga",4,"N14 Bosch",35,47,12,64,48,16
8,2,2018,16,0,5,"Braga",5,"Avenida João Paulo II",39,39,0,9,9,0
8,2,2018,16,0,5,"Braga",6,"Avenida Padre Júlio Fragata",67,67,0,83,83,0
8,2,2018,16,0,5,"Braga",7,"Rua Nova Santa Cruz",43,43,0,40,40,0
8,2,2018,16,0,5,"Braga",8,"Rua Costa Gomes",17,40,23,102,43,59
8,2,2018,17,0,5,"Braga",1,"Avenida da Liberdade",25,25,0,124,124,0
8,2,2018,17,0,5,"Braga",2,"Avenida Central",25,25,0,124,124,0
8,2,2018,17,0,5,"Braga",3,"Rua de Caires",10,37,27,135,36,99
8,2,2018,17,0,5,"Braga",4,"N14 Bosch",37,47,10,61,48,13
8,2,2018,17,0,5,"Braga",5,"Avenida João Paulo II",15,39,24,23,9,14
8,2,2018,17,0,5,"Braga",6,"Avenida Padre Júlio Fragata",52,67,15,107,83,24
8,2,2018,17,0,5,"Braga",7,"Rua Nova Santa Cruz",43,43,0,40,40,0
8,2,2018,17,0,5,"Braga",8,"Rua Costa Gomes",20,40,20,87,43,44
8,2,2018,18,0,5,"Braga",1,"Avenida da Liberdade",25,25,0,124,124,0
8,2,2018,18,0,5,"Braga",2,"Avenida Central",25,25,0,124,124,0
8,2,2018,18,0,5,"Braga",3,"Rua de Caires",27,37,10,50,36,14
8,2,2018,18,0,5,"Braga",4,"N14 Bosch",47,47,0,48,48,0
8,2,2018,18,0,5,"Braga",5,"Avenida João Paulo II",39,39,0,9,9,0
8,2,2018,18,0,5,"Braga",6,"Avenida Padre Júlio Fragata",36,67,31,155,83,72
8,2,2018,18,0,5,"Braga",7,"Rua Nova Santa Cruz",43,43,0,40,40,0
8,2,2018,18,0,5,"Braga",8,"Rua Costa Gomes",10,40,30,173,43,130
8,2,2018,19,0,5,"Braga",1,"Avenida da Liberdade",17,25,8,182,124,58
8,2,2018,19,0,5,"Braga",2,"Avenida Central",17,25,8,182,124,58
8,2,2018,19,0,5,"Braga",3,"Rua de Caires",37,37,0,36,36,0
8,2,2018,19,0,5,"Braga",4,"N14 Bosch",47,47,0,48,48,0
8,2,2018,19,0,5,"Braga",5,"Avenida João Paulo II",39,39,0,9,9,0
8,2,2018,19,0,5,"Braga",6,"Avenida Padre Júlio Fragata",52,67,15,107,83,24
8,2,2018,19,0,5,"Braga",7,"Rua Nova Santa Cruz",43,43,0,40,40,0
8,2,2018,19,0,5,"Braga",8,"Rua Costa Gomes",40,40,0,43,43,0
8,2,2018,20,0,5,"Braga",1,"Avenida da Liberdade",25,25,0,124,124,0
8,2,2018,20,0,5,"Braga",2,"Avenida Central",25,25,0,124,124,0
8,2,2018,20,0,5,"Braga",3,"Rua de Caires",37,37,0,36,36,0
8,2,2018,20,0,5,"Braga",4,"N14 Bosch",47,47,0,48,48,0
8,2,2018,20,0,5,"Braga",5,"Avenida João Paulo II",39,39,0,9,9,0
8,2,2018,20,0,5,"Braga",6,"Avenida Padre Júlio Fragata",67,67,0,83,83,0
8,2,2018,20,0,5,"Braga",7,"Rua Nova Santa Cruz",43,43,0,40,40,0
8,2,2018,20,0,5,"Braga",8,"Rua Costa Gomes",40,40,0,43,43,0
8,2,2018,21,0,5,"Braga",1,"Avenida da Liberdade",25,25,0,124,124,0
8,2,2018,21,0,5,"Braga",2,"Avenida Central",25,25,0,124,124,0
8,2,2018,21,0,5,"Braga",3,"Rua de Caires",37,37,0,36,36,0
8,2,2018,21,0,5,"Braga",4,"N14 Bosch",47,47,0,48,48,0
8,2,2018,21,0,5,"Braga",5,"Avenida João Paulo II",26,39,13,13,9,4
8,2,2018,21,0,5,"Braga",6,"Avenida Padre Júlio Fragata",47,67,20,119,83,36
8,2,2018,21,0,5,"Braga",7,"Rua Nova Santa Cruz",43,43,0,40,40,0
8,2,2018,21,0,5,"Braga",8,"Rua Costa Gomes",40,40,0,43,43,0
8,2,2018,22,0,5,"Braga",1,"Avenida da Liberdade",25,25,0,124,124,0
8,2,2018,22,0,5,"Braga",2,"Avenida Central",25,25,0,124,124,0
8,2,2018,22,0,5,"Braga",3,"Rua de Caires",37,37,0,36,36,0
8,2,2018,22,0,5,"Braga",4,"N14 Bosch",47,47,0,48,48,0
8,2,2018,22,0,5,"Braga",5,"Avenida João Paulo II",39,39,0,9,9,0
8,2,2018,22,0,5,"Braga",6,"Avenida Padre Júlio Fragata",67,67,0,83,83,0
8,2,2018,22,0,5,"Braga",7,"Rua Nova Santa Cruz",43,43,0,40,40,0
8,2,2018,22,0,5,"Braga",8,"Rua Costa Gomes",40,40,0,43,43,0
8,2,2018,23,0,5,"Braga",1,"Avenida da Liberdade",25,25,0,124,124,0
8,2,2018,23,0,5,"Braga",2,"Avenida Central",25,25,0,124,124,0
8,2,2018,23,0,5,"Braga",3,"Rua de Caires",37,37,0,36,36,0
8,2,2018,23,0,5,"Braga",4,"N14 Bosch",8,47,39,281,48,233
8,2,2018,23,0,5,"Braga",5,"Avenida João Paulo II",39,39,0,9,9,0
8,2,2018,23,0,5,"Braga",6,"Avenida Padre Júlio Fragata",67,67,0,83,83,0
8,2,2018,23,0,5,"Braga",7,"Rua Nova Santa Cruz",43,43,0,40,40,0
8,2,2018,23,0,5,"Braga",8,"Rua Costa Gomes",40,40,0,43,43,0
8,3,2018,0,0,6,"Braga",1,"Avenida da Liberdade",25,25,0,124,124,0
8,3,2018,0,0,6,"Braga",2,"Avenida Central",25,25,0,124,124,0
8,3,2018,0,0,6,"Braga",3,"Rua de Caires",37,37,0,36,36,0
8,3,2018,0,0,6,"Braga",4,"N14 Bosch",47,47,0,48,48,0
8,3,2018,0,0,6,"Braga",5,"Avenida João Paulo II",39,39,0,9,9,0
8,3,2018,0,0,6,"Braga",6,"Avenida Padre Júlio Fragata",67,67,0,83,83,0
8,3,2018,0,0,6,"Braga",7,"Rua Nova Santa Cruz",43,43,0,40,40,0
8,3,2018,0,0,6,"Braga",8,"Rua Costa Gomes",40,40,0,43,43,0
8,3,2018,1,0,6,"Braga",1,"Avenida da Liberdade",25,25,0,124,124,0
8,3,2018,1,0,6,"Braga",2,"Avenida Central",25,25,0,124,124,0
8,3,2018,1,0,6,"Braga",3,"Rua de Caires",37,37,0,36,36,0
8,3,2018,1,0,6,"Braga",4,"N14 Bosch",47,47,0,48,48,0
8,3,2018,1,0,6,"Braga",5,"Avenida João Paulo II",39,39,0,9,9,0
8,3,2018,1,0,6,"Braga",6,"Avenida Padre Júlio Fragata",67,67,0,83,83,0
8,3,2018,1,0,6,"Braga",7,"Rua Nova Santa Cruz",43,43,0,40,40,0
8,3,2018,1,0,6,"Braga",8,"Rua Costa Gomes",40,40,0,43,43,0
8,3,2018,2,0,6,"Braga",1,"Avenida da Liberdade",25,25,0,124,124,0
8,3,2018,2,0,6,"Braga",2,"Avenida Central",25,25,0,124,124,0
8,3,2018,2,0,6,"Braga",3,"Rua de Caires",37,37,0,36,36,0
8,3,2018,2,0,6,"Braga",4,"N14 Bosch",47,47,0,48,48,0
8,3,2018,2,0,6,"Braga",5,"Avenida João Paulo II",39,39,0,9,9,0
8,3,2018,2,0,6,"Braga",6,"Avenida Padre Júlio Fragata",67,67,0,83,83,0
8,3,2018,2,0,6,"Braga",7,"Rua Nova Santa Cruz",43,43,0,40,40,0
8,3,2018,2,0,6,"Braga",8,"Rua Costa Gomes",40,40,0,43,43,0
8,3,2018,3,0,6,"Braga",1,"Avenida da Liberdade",25,25,0,124,124,0
8,3,2018,3,0,6,"Braga",2,"Avenida Central",25,25,0,124,124,0
8,3,2018,3,0,6,"Braga",3,"Rua de Caires",37,37,0,36,36,0
8,3,2018,3,0,6,"Braga",4,"N14 Bosch",47,47,0,48,48,0
8,3,2018,3,0,6,"Braga",5,"Avenida João Paulo II",39,39,0,9,9,0
8,3,2018,3,0,6,"Braga",6,"Avenida Padre Júlio Fragata",67,67,0,83,83,0
8,3,2018,3,0,6,"Braga",7,"Rua Nova Santa Cruz",43,43,0,40,40,0
8,3,2018,3,0,6,"Braga",8,"Rua Costa Gomes",40,40,0,43,43,0
8,3,2018,4,0,6,"Braga",1,"Avenida da Liberdade",25,25,0,124,124,0
8,3,2018,4,0,6,"Braga",2,"Avenida Central",25,25,0,124,124,0
8,3,2018,4,0,6,"Braga",3,"Rua de Caires",37,37,0,36,36,0
8,3,2018,4,0,6,"Braga",4,"N14 Bosch",47,47,0,48,48,0
8,3,2018,4,0,6,"Braga",5,"Avenida João Paulo II",39,39,0,9,9,0
8,3,2018,4,0,6,"Braga",6,"Avenida Padre Júlio Fragata",67,67,0,83,83,0
8,3,2018,4,0,6,"Braga",7,"Rua Nova Santa Cruz",43,43,0,40,40,0
8,3,2018,4,0,6,"Braga",8,"Rua Costa Gomes",40,40,0,43,43,0
8,3,2018,5,0,6,"Braga",1,"Avenida da Liberdade",25,25,0,124,124,0
8,3,2018,5,0,6,"Braga",2,"Avenida Central",25,25,0,124,124,0
8,3,2018,5,0,6,"Braga",3,"Rua de Caires",37,37,0,36,36,0
8,3,2018,5,0,6,"Braga",4,"N14 Bosch",47,47,0,48,48,0
8,3,2018,5,0,6,"Braga",5,"Avenida João Paulo II",39,39,0,9,9,0
8,3,2018,5,0,6,"Braga",6,"Avenida Padre Júlio Fragata",67,67,0,83,83,0
8,3,2018,5,0,6,"Braga",7,"Rua Nova Santa Cruz",43,43,0,40,40,0
8,3,2018,5,0,6,"Braga",8,"Rua Costa Gomes",40,40,0,43,43,0
8,3,2018,6,0,6,"Braga",1,"Avenida da Liberdade",25,25,0,124,124,0
8,3,2018,6,0,6,"Braga",2,"Avenida Central",25,25,0,124,124,0
8,3,2018,6,0,6,"Braga",3,"Rua de Caires",37,37,0,36,36,0
8,3,2018,6,0,6,"Braga",4,"N14 Bosch",47,47,0,48,48,0
8,3,2018,6,0,6,"Braga",5,"Avenida João Paulo II",39,39,0,9,9,0
8,3,2018,6,0,6,"Braga",6,"Avenida Padre Júlio Fragata",67,67,0,83,83,0
8,3,2018,6,0,6,"Braga",7,"Rua Nova Santa Cruz",43,43,0,40,40,0
8,3,2018,6,0,6,"Braga",8,"Rua Costa Gomes",40,40,0,43,43,0
8,3,2018,7,0,6,"Braga",1,"Avenida da Liberdade",25,25,0,124,124,0
8,3,2018,7,0,6,"Braga",2,"Avenida Central",25,25,0,124,124,0
8,3,2018,7,0,6,"Braga",3,"Rua de Caires",25,37,12,54,36,18
8,3,2018,7,0,6,"Braga",4,"N14 Bosch",47,47,0,48,48,0
8,3,2018,7,0,6,"Braga",5,"Avenida João Paulo II",39,39,0,9,9,0
8,3,2018,7,0,6,"Braga",6,"Avenida Padre Júlio Fragata",67,67,0,83,83,0
8,3,2018,7,0,6,"Braga",7,"Rua Nova Santa Cruz",43,43,0,40,40,0
8,3,2018,7,0,6,"Braga",8,"Rua Costa Gomes",40,40,0,43,43,0
8,3,2018,8,0,6,"Braga",1,"Avenida da Liberdade",19,25,6,163,124,39
8,3,2018,8,0,6,"Braga",2,"Avenida Central",19,25,6,163,124,39
8,3,2018,8,0,6,"Braga",3,"Rua de Caires",29,37,8,46,36,10
8,3,2018,8,0,6,"Braga",4,"N14 Bosch",30,47,17,75,48,27
8,3,2018,8,0,6,"Braga",5,"Avenida João Paulo II",39,39,0,9,9,0
8,3,2018,8,0,6,"Braga",6,"Avenida Padre Júlio Fragata",67,67,0,83,83,0
8,3,2018,8,0,6,"Braga",7,"Rua Nova Santa Cruz",33,43,10,52,40,12
8,3,2018,8,0,6,"Braga",8,"Rua Costa Gomes",31,40,9,56,43,13
8,3,2018,9,0,6,"Braga",1,"Avenida da Liberdade",25,25,0,124,124,0
8,3,2018,9,0,6,"Braga",2,"Avenida Central",25,25,0,124,124,0
8,3,2018,9,0,6,"Braga",3,"Rua de Caires",21,37,16,64,36,28
8,3,2018,9,0,6,"Braga",4,"N14 Bosch",36,47,11,62,48,14
8,3,2018,9,0,6,"Braga",5,"Avenida João Paulo II",23,39,16,15,9,6
8,3,2018,9,0,6,"Braga",6,"Avenida Padre Júlio Fragata",67,67,0,83,83,0
8,3,2018,9,0,6,"Braga",7,"Rua Nova Santa Cruz",43,43,0,40,40,0
8,3,2018,9,0,6,"Braga",8,"Rua Costa Gomes",40,40,0,43,43,0
8,3,2018,10,0,6,"Braga",1,"Avenida da Liberdade",25,25,0,124,124,0
8,3,2018,10,0,6,"Braga",2,"Avenida Central",25,25,0,124,124,0
8,3,2018,10,0,6,"Braga",3,"Rua de Caires",26,37,11,52,36,16
8,3,2018,10,0,6,"Braga",4,"N14 Bosch",29,47,18,77,48,29
8,3,2018,10,0,6,"Braga",5,"Avenida João Paulo II",28,39,11,12,9,3
8,3,2018,10,0,6,"Braga",6,"Avenida Padre Júlio Fragata",49,67,18,114,83,31
8,3,2018,10,0,6,"Braga",7,"Rua Nova Santa Cruz",43,43,0,40,40,0
8,3,2018,10,0,6,"Braga",8,"Rua Costa Gomes",31,40,9,56,43,13
8,3,2018,11,0,6,"Braga",1,"Avenida da Liberdade",15,25,10,207,124,83
8,3,2018,11,0,6,"Braga",2,"Avenida Central",15,25,10,207,124,83
8,3,2018,11,0,6,"Braga",3,"Rua de Caires",22,37,15,61,36,25
8,3,2018,11,0,6,"Braga",4,"N14 Bosch",14,47,33,160,48,112
8,3,2018,11,0,6,"Braga",5,"Avenida João Paulo II",39,39,0,9,9,0
8,3,2018,11,0,6,"Braga",6,"Avenida Padre Júlio Fragata",67,67,0,83,83,0
8,3,2018,11,0,6,"Braga",7,"Rua Nova Santa Cruz",33,43,10,52,40,12
8,3,2018,11,0,6,"Braga",8,"Rua Costa Gomes",40,40,0,43,43,0
8,3,2018,12,0,6,"Braga",1,"Avenida da Liberdade",15,25,10,207,124,83
8,3,2018,12,0,6,"Braga",2,"Avenida Central",15,25,10,207,124,83
8,3,2018,12,0,6,"Braga",3,"Rua de Caires",37,37,0,36,36,0
8,3,2018,12,0,6,"Braga",4,"N14 Bosch",29,47,18,77,48,29
8,3,2018,12,0,6,"Braga",5,"Avenida João Paulo II",39,39,0,9,9,0
8,3,2018,12,0,6,"Braga",6,"Avenida Padre Júlio Fragata",67,67,0,83,83,0
8,3,2018,12,0,6,"Braga",7,"Rua Nova Santa Cruz",43,43,0,40,40,0
8,3,2018,12,0,6,"Braga",8,"Rua Costa Gomes",32,40,8,54,43,11
8,3,2018,13,0,6,"Braga",1,"Avenida da Liberdade",25,25,0,124,124,0
8,3,2018,13,0,6,"Braga",2,"Avenida Central",25,25,0,124,124,0
8,3,2018,13,0,6,"Braga",3,"Rua de Caires",22,37,15,61,36,25
8,3,2018,13,0,6,"Braga",4,"N14 Bosch",4,47,43,562,48,514
8,3,2018,13,0,6,"Braga",5,"Avenida João Paulo II",39,39,0,9,9,0
8,3,2018,13,0,6,"Braga",6,"Avenida Padre Júlio Fragata",67,67,0,83,83,0
8,3,2018,13,0,6,"Braga",7,"Rua Nova Santa Cruz",43,43,0,40,40,0
8,3,2018,13,0,6,"Braga",8,"Rua Costa Gomes",28,40,12,62,43,19
8,3,2018,14,0,6,"Braga",1,"Avenida da Liberdade",25,25,0,124,124,0
8,3,2018,14,0,6,"Braga",2,"Avenida Central",25,25,0,124,124,0
8,3,2018,14,0,6,"Braga",3,"Rua de Caires",37,37,0,36,36,0
8,3,2018,14,0,6,"Braga",4,"N14 Bosch",21,47,26,107,48,59
8,3,2018,14,0,6,"Braga",5,"Avenida João Paulo II",39,39,0,9,9,0
8,3,2018,14,0,6,"Braga",6,"Avenida Padre Júlio Fragata",67,67,0,83,83,0
8,3,2018,14,0,6,"Braga",7,"Rua Nova Santa Cruz",43,43,0,40,40,0
8,3,2018,14,0,6,"Braga",8,"Rua Costa Gomes",30,40,10,58,43,15
8,3,2018,15,0,6,"Braga",1,"Avenida da Liberdade",15,25,10,207,124,83
8,3,2018,15,0,6,"Braga",2,"Avenida Central",15,25,10,207,124,83
8,3,2018,15,0,6,"Braga",3,"Rua de Caires",29,37,8,46,36,10
8,3,2018,15,0,6,"Braga",4,"N14 Bosch",47,47,0,48,48,0
8,3,2018,15,0,6,"Braga",5,"Avenida João Paulo II",39,39,0,9,9,0
8,3,2018,15,0,6,"Braga",6,"Avenida Padre Júlio Fragata",67,67,0,83,83,0
8,3,2018,15,0,6,"Braga",7,"Rua Nova Santa Cruz",43,43,0,40,40,0
8,3,2018,15,0,6,"Braga",8,"Rua Costa Gomes",28,40,12,62,43,19
8,3,2018,16,0,6,"Braga",1,"Avenida da Liberdade",18,25,7,172,124,48
8,3,2018,16,0,6,"Braga",2,"Avenida Central",18,25,7,172,124,48
8,3,2018,16,0,6,"Braga",3,"Rua de Caires",29,37,8,46,36,10
8,3,2018,16,0,6,"Braga",4,"N14 Bosch",31,47,16,72,48,24
8,3,2018,16,0,6,"Braga",5,"Avenida João Paulo II",39,39,0,9,9,0
8,3,2018,16,0,6,"Braga",6,"Avenida Padre Júlio Fragata",53,67,14,105,83,22
8,3,2018,16,0,6,"Braga",7,"Rua Nova Santa Cruz",43,43,0,40,40,0
8,3,2018,16,0,6,"Braga",8,"Rua Costa Gomes",40,40,0,43,43,0
8,3,2018,17,0,6,"Braga",1,"Avenida da Liberdade",17,25,8,182,124,58
8,3,2018,17,0,6,"Braga",2,"Avenida Central",17,25,8,182,124,58
8,3,2018,17,0,6,"Braga",3,"Rua de Caires",37,37,0,36,36,0
8,3,2018,17,0,6,"Braga",4,"N14 Bosch",27,47,20,83,48,35
8,3,2018,17,0,6,"Braga",5,"Avenida João Paulo II",39,39,0,9,9,0
8,3,2018,17,0,6,"Braga",6,"Avenida Padre Júlio Fragata",51,67,16,109,83,26
8,3,2018,17,0,6,"Braga",7,"Rua Nova Santa Cruz",43,43,0,40,40,0
8,3,2018,17,0,6,"Braga",8,"Rua Costa Gomes",26,40,14,67,43,24
8,3,2018,18,0,6,"Braga",1,"Avenida da Liberdade",18,25,7,172,124,48
8,3,2018,18,0,6,"Braga",2,"Avenida Central",18,25,7,172,124,48
8,3,2018,18,0,6,"Braga",3,"Rua de Caires",37,37,0,36,36,0
8,3,2018,18,0,6,"Braga",4,"N14 Bosch",9,47,38,250,48,202
8,3,2018,18,0,6,"Braga",5,"Avenida João Paulo II",14,39,25,25,9,16
8,3,2018,18,0,6,"Braga",6,"Avenida Padre Júlio Fragata",38,67,29,147,83,64
8,3,2018,18,0,6,"Braga",7,"Rua Nova Santa Cruz",43,43,0,40,40,0
8,3,2018,18,0,6,"Braga",8,"Rua Costa Gomes",14,40,26,124,43,81
8,3,2018,19,0,6,"Braga",1,"Avenida da Liberdade",25,25,0,124,124,0
8,3,2018,19,0,6,"Braga",2,"Avenida Central",25,25,0,124,124,0
8,3,2018,19,0,6,"Braga",3,"Rua de Caires",26,37,11,52,36,16
8,3,2018,19,0,6,"Braga",4,"N14 Bosch",13,47,34,173,48,125
8,3,2018,19,0,6,"Braga",5,"Avenida João Paulo II",39,39,0,9,9,0
8,3,2018,19,0,6,"Braga",6,"Avenida Padre Júlio Fragata",52,67,15,107,83,24
8,3,2018,19,0,6,"Braga",7,"Rua Nova Santa Cruz",43,43,0,40,40,0
8,3,2018,19,0,6,"Braga",8,"Rua Costa Gomes",40,40,0,43,43,0
8,3,2018,20,0,6,"Braga",1,"Avenida da Liberdade",25,25,0,124,124,0
8,3,2018,20,0,6,"Braga",2,"Avenida Central",25,25,0,124,124,0
8,3,2018,20,0,6,"Braga",3,"Rua de Caires",17,37,20,79,36,43
8,3,2018,20,0,6,"Braga",4,"N14 Bosch",47,47,0,48,48,0
8,3,2018,20,0,6,"Braga",5,"Avenida João Paulo II",39,39,0,9,9,0
8,3,2018,20,0,6,"Braga",6,"Avenida Padre Júlio Fragata",67,67,0,83,83,0
8,3,2018,20,0,6,"Braga",7,"Rua Nova Santa Cruz",43,43,0,40,40,0
8,3,2018,20,0,6,"Braga",8,"Rua Costa Gomes",29,40,11,60,43,17
8,3,2018,21,0,6,"Braga",1,"Avenida da Liberdade",25,25,0,124,124,0
8,3,2018,21,0,6,"Braga",2,"Avenida Central",25,25,0,124,124,0
8,3,2018,21,0,6,"Braga",3,"Rua de Caires",37,37,0,36,36,0
8,3,2018,21,0,6,"Braga",4,"N14 Bosch",47,47,0,48,48,0
8,3,2018,21,0,6,"Braga",5,"Avenida João Paulo II",26,39,13,13,9,4
8,3,2018,21,0,6,"Braga",6,"Avenida Padre Júlio Fragata",67,67,0,83,83,0
8,3,2018,21,0,6,"Braga",7,"Rua Nova Santa Cruz",43,43,0,40,40,0
8,3,2018,21,0,6,"Braga",8,"Rua Costa Gomes",40,40,0,43,43,0
8,3,2018,22,0,6,"Braga",1,"Avenida da Liberdade",25,25,0,124,124,0
8,3,2018,22,0,6,"Braga",2,"Avenida Central",25,25,0,124,124,0
8,3,2018,22,0,6,"Braga",3,"Rua de Caires",37,37,0,36,36,0
8,3,2018,22,0,6,"Braga",4,"N14 Bosch",47,47,0,48,48,0
8,3,2018,22,0,6,"Braga",5,"Avenida João Paulo II",39,39,0,9,9,0
8,3,2018,22,0,6,"Braga",6,"Avenida Padre Júlio Fragata",67,67,0,83,83,0
8,3,2018,22,0,6,"Braga",7,"Rua Nova Santa Cruz",43,43,0,40,40,0
8,3,2018,22,0,6,"Braga",8,"Rua Costa Gomes",40,40,0,43,43,0
8,3,2018,23,0,6,"Braga",1,"Avenida da Liberdade",25,25,0,124,124,0
8,3,2018,23,0,6,"Braga",2,"Avenida Central",25,25,0,124,124,0
8,3,2018,23,0,6,"Braga",3,"Rua de Caires",37,37,0,36,36,0
8,3,2018,23,0,6,"Braga",4,"N14 Bosch",47,47,0,48,48,0
8,3,2018,23,0,6,"Braga",5,"Avenida João Paulo II",39,39,0,9,9,0
8,3,2018,23,0,6,"Braga",6,"Avenida Padre Júlio Fragata",67,67,0,83,83,0
8,3,2018,23,0,6,"Braga",7,"Rua Nova Santa Cruz",43,43,0,40,40,0
8,3,2018,23,0,6,"Braga",8,"Rua Costa Gomes",40,40,0,43,43,0
8,4,2018,0,0,7,"Braga",1,"Avenida da Liberdade",25,25,0,124,124,0
8,4,2018,0,0,7,"Braga",2,"Avenida Central",25,25,0,124,124,0
8,4,2018,0,0,7,"Braga",3,"Rua de Caires",37,37,0,36,36,0
8,4,2018,0,0,7,"Braga",4,"N14 Bosch",47,47,0,48,48,0
8,4,2018,0,0,7,"Braga",5,"Avenida João Paulo II",39,39,0,9,9,0
8,4,2018,0,0,7,"Braga",6,"Avenida Padre Júlio Fragata",67,67,0,83,83,0
8,4,2018,0,0,7,"Braga",7,"Rua Nova Santa Cruz",43,43,0,40,40,0
8,4,2018,0,0,7,"Braga",8,"Rua Costa Gomes",40,40,0,43,43,0
8,4,2018,1,0,7,"Braga",1,"Avenida da Liberdade",25,25,0,124,124,0
8,4,2018,1,0,7,"Braga",2,"Avenida Central",25,25,0,124,124,0
8,4,2018,1,0,7,"Braga",3,"Rua de Caires",37,37,0,36,36,0
8,4,2018,1,0,7,"Braga",4,"N14 Bosch",47,47,0,48,48,0
8,4,2018,1,0,7,"Braga",5,"Avenida João Paulo II",39,39,0,9,9,0
8,4,2018,1,0,7,"Braga",6,"Avenida Padre Júlio Fragata",67,67,0,83,83,0
8,4,2018,1,0,7,"Braga",7,"Rua Nova Santa Cruz",43,43,0,40,40,0
8,4,2018,1,0,7,"Braga",8,"Rua Costa Gomes",40,40,0,43,43,0
8,4,2018,2,0,7,"Braga",1,"Avenida da Liberdade",25,25,0,124,124,0
8,4,2018,2,0,7,"Braga",2,"Avenida Central",25,25,0,124,124,0
8,4,2018,2,0,7,"Braga",3,"Rua de Caires",37,37,0,36,36,0
8,4,2018,2,0,7,"Braga",4,"N14 Bosch",47,47,0,48,48,0
8,4,2018,2,0,7,"Braga",5,"Avenida João Paulo II",39,39,0,9,9,0
8,4,2018,2,0,7,"Braga",6,"Avenida Padre Júlio Fragata",67,67,0,83,83,0
8,4,2018,2,0,7,"Braga",7,"Rua Nova Santa Cruz",43,43,0,40,40,0
8,4,2018,2,0,7,"Braga",8,"Rua Costa Gomes",40,40,0,43,43,0
8,4,2018,3,0,7,"Braga",1,"Avenida da Liberdade",25,25,0,124,124,0
8,4,2018,3,0,7,"Braga",2,"Avenida Central",25,25,0,124,124,0
8,4,2018,3,0,7,"Braga",3,"Rua de Caires",37,37,0,36,36,0
8,4,2018,3,0,7,"Braga",4,"N14 Bosch",47,47,0,48,48,0
8,4,2018,3,0,7,"Braga",5,"Avenida João Paulo II",39,39,0,9,9,0
8,4,2018,3,0,7,"Braga",6,"Avenida Padre Júlio Fragata",67,67,0,83,83,0
8,4,2018,3,0,7,"Braga",7,"Rua Nova Santa Cruz",43,43,0,40,40,0
8,4,2018,3,0,7,"Braga",8,"Rua Costa Gomes",40,40,0,43,43,0
8,4,2018,4,0,7,"Braga",1,"Avenida da Liberdade",25,25,0,124,124,0
8,4,2018,4,0,7,"Braga",2,"Avenida Central",25,25,0,124,124,0
8,4,2018,4,0,7,"Braga",3,"Rua de Caires",37,37,0,36,36,0
8,4,2018,4,0,7,"Braga",4,"N14 Bosch",47,47,0,48,48,0
8,4,2018,4,0,7,"Braga",5,"Avenida João Paulo II",39,39,0,9,9,0
8,4,2018,4,0,7,"Braga",6,"Avenida Padre Júlio Fragata",67,67,0,83,83,0
8,4,2018,4,0,7,"Braga",7,"Rua Nova Santa Cruz",43,43,0,40,40,0
8,4,2018,4,0,7,"Braga",8,"Rua Costa Gomes",40,40,0,43,43,0
8,4,2018,5,0,7,"Braga",1,"Avenida da Liberdade",25,25,0,124,124,0
8,4,2018,5,0,7,"Braga",2,"Avenida Central",25,25,0,124,124,0
8,4,2018,5,0,7,"Braga",3,"Rua de Caires",37,37,0,36,36,0
8,4,2018,5,0,7,"Braga",4,"N14 Bosch",47,47,0,48,48,0
8,4,2018,5,0,7,"Braga",5,"Avenida João Paulo II",39,39,0,9,9,0
8,4,2018,5,0,7,"Braga",6,"Avenida Padre Júlio Fragata",67,67,0,83,83,0
8,4,2018,5,0,7,"Braga",7,"Rua Nova Santa Cruz",43,43,0,40,40,0
8,4,2018,5,0,7,"Braga",8,"Rua Costa Gomes",40,40,0,43,43,0
8,4,2018,6,0,7,"Braga",1,"Avenida da Liberdade",25,25,0,124,124,0
8,4,2018,6,0,7,"Braga",2,"Avenida Central",25,25,0,124,124,0
8,4,2018,6,0,7,"Braga",3,"Rua de Caires",37,37,0,36,36,0
8,4,2018,6,0,7,"Braga",4,"N14 Bosch",47,47,0,48,48,0
8,4,2018,6,0,7,"Braga",5,"Avenida João Paulo II",39,39,0,9,9,0
8,4,2018,6,0,7,"Braga",6,"Avenida Padre Júlio Fragata",67,67,0,83,83,0
8,4,2018,6,0,7,"Braga",7,"Rua Nova Santa Cruz",43,43,0,40,40,0
8,4,2018,6,0,7,"Braga",8,"Rua Costa Gomes",40,40,0,43,43,0
8,4,2018,7,0,7,"Braga",1,"Avenida da Liberdade",25,25,0,124,124,0
8,4,2018,7,0,7,"Braga",2,"Avenida Central",25,25,0,124,124,0
8,4,2018,7,0,7,"Braga",3,"Rua de Caires",37,37,0,36,36,0
8,4,2018,7,0,7,"Braga",4,"N14 Bosch",47,47,0,48,48,0
8,4,2018,7,0,7,"Braga",5,"Avenida João Paulo II",39,39,0,9,9,0
8,4,2018,7,0,7,"Braga",6,"Avenida Padre Júlio Fragata",67,67,0,83,83,0
8,4,2018,7,0,7,"Braga",7,"Rua Nova Santa Cruz",43,43,0,40,40,0
8,4,2018,7,0,7,"Braga",8,"Rua Costa Gomes",40,40,0,43,43,0
8,4,2018,8,0,7,"Braga",1,"Avenida da Liberdade",25,25,0,124,124,0
8,4,2018,8,0,7,"Braga",2,"Avenida Central",25,25,0,124,124,0
8,4,2018,8,0,7,"Braga",3,"Rua de Caires",37,37,0,36,36,0
8,4,2018,8,0,7,"Braga",4,"N14 Bosch",47,47,0,48,48,0
8,4,2018,8,0,7,"Braga",5,"Avenida João Paulo II",39,39,0,9,9,0
8,4,2018,8,0,7,"Braga",6,"Avenida Padre Júlio Fragata",67,67,0,83,83,0
8,4,2018,8,0,7,"Braga",7,"Rua Nova Santa Cruz",43,43,0,40,40,0
8,4,2018,8,0,7,"Braga",8,"Rua Costa Gomes",40,40,0,43,43,0
8,4,2018,9,0,7,"Braga",1,"Avenida da Liberdade",25,25,0,124,124,0
8,4,2018,9,0,7,"Braga",2,"Avenida Central",25,25,0,124,124,0
8,4,2018,9,0,7,"Braga",3,"Rua de Caires",20,37,17,67,36,31
8,4,2018,9,0,7,"Braga",4,"N14 Bosch",30,47,17,75,48,27
8,4,2018,9,0,7,"Braga",5,"Avenida João Paulo II",39,39,0,9,9,0
8,4,2018,9,0,7,"Braga",6,"Avenida Padre Júlio Fragata",67,67,0,83,83,0
8,4,2018,9,0,7,"Braga",7,"Rua Nova Santa Cruz",43,43,0,40,40,0
8,4,2018,9,0,7,"Braga",8,"Rua Costa Gomes",23,40,17,75,43,32
8,4,2018,10,0,7,"Braga",1,"Avenida da Liberdade",25,25,0,124,124,0
8,4,2018,10,0,7,"Braga",2,"Avenida Central",25,25,0,124,124,0
8,4,2018,10,0,7,"Braga",3,"Rua de Caires",29,37,8,46,36,10
8,4,2018,10,0,7,"Braga",4,"N14 Bosch",36,47,11,62,48,14
8,4,2018,10,0,7,"Braga",5,"Avenida João Paulo II",39,39,0,9,9,0
8,4,2018,10,0,7,"Braga",6,"Avenida Padre Júlio Fragata",67,67,0,83,83,0
8,4,2018,10,0,7,"Braga",7,"Rua Nova Santa Cruz",43,43,0,40,40,0
8,4,2018,10,0,7,"Braga",8,"Rua Costa Gomes",40,40,0,43,43,0
8,4,2018,11,0,7,"Braga",1,"Avenida da Liberdade",25,25,0,124,124,0
8,4,2018,11,0,7,"Braga",2,"Avenida Central",25,25,0,124,124,0
8,4,2018,11,0,7,"Braga",3,"Rua de Caires",27,37,10,50,36,14
8,4,2018,11,0,7,"Braga",4,"N14 Bosch",47,47,0,48,48,0
8,4,2018,11,0,7,"Braga",5,"Avenida João Paulo II",20,39,19,17,9,8
8,4,2018,11,0,7,"Braga",6,"Avenida Padre Júlio Fragata",67,67,0,83,83,0
8,4,2018,11,0,7,"Braga",7,"Rua Nova Santa Cruz",25,43,18,69,40,29
8,4,2018,11,0,7,"Braga",8,"Rua Costa Gomes",28,40,12,62,43,19
8,4,2018,12,0,7,"Braga",1,"Avenida da Liberdade",25,25,0,124,124,0
8,4,2018,12,0,7,"Braga",2,"Avenida Central",25,25,0,124,124,0
8,4,2018,12,0,7,"Braga",3,"Rua de Caires",37,37,0,36,36,0
8,4,2018,12,0,7,"Braga",4,"N14 Bosch",47,47,0,48,48,0
8,4,2018,12,0,7,"Braga",5,"Avenida João Paulo II",39,39,0,9,9,0
8,4,2018,12,0,7,"Braga",6,"Avenida Padre Júlio Fragata",67,67,0,83,83,0
8,4,2018,12,0,7,"Braga",7,"Rua Nova Santa Cruz",29,43,14,60,40,20
8,4,2018,12,0,7,"Braga",8,"Rua Costa Gomes",40,40,0,43,43,0
8,4,2018,13,0,7,"Braga",1,"Avenida da Liberdade",25,25,0,124,124,0
8,4,2018,13,0,7,"Braga",2,"Avenida Central",25,25,0,124,124,0
8,4,2018,13,0,7,"Braga",3,"Rua de Caires",37,37,0,36,36,0
8,4,2018,13,0,7,"Braga",4,"N14 Bosch",47,47,0,48,48,0
8,4,2018,13,0,7,"Braga",5,"Avenida João Paulo II",30,39,9,12,9,3
8,4,2018,13,0,7,"Braga",6,"Avenida Padre Júlio Fragata",67,67,0,83,83,0
8,4,2018,13,0,7,"Braga",7,"Rua Nova Santa Cruz",43,43,0,40,40,0
8,4,2018,13,0,7,"Braga",8,"Rua Costa Gomes",40,40,0,43,43,0
8,4,2018,14,0,7,"Braga",1,"Avenida da Liberdade",25,25,0,124,124,0
8,4,2018,14,0,7,"Braga",2,"Avenida Central",25,25,0,124,124,0
8,4,2018,14,0,7,"Braga",3,"Rua de Caires",37,37,0,36,36,0
8,4,2018,14,0,7,"Braga",4,"N14 Bosch",47,47,0,48,48,0
8,4,2018,14,0,7,"Braga",5,"Avenida João Paulo II",28,39,11,12,9,3
8,4,2018,14,0,7,"Braga",6,"Avenida Padre Júlio Fragata",67,67,0,83,83,0
8,4,2018,14,0,7,"Braga",7,"Rua Nova Santa Cruz",43,43,0,40,40,0
8,4,2018,14,0,7,"Braga",8,"Rua Costa Gomes",40,40,0,43,43,0
8,4,2018,15,0,7,"Braga",1,"Avenida da Liberdade",25,25,0,124,124,0
8,4,2018,15,0,7,"Braga",2,"Avenida Central",25,25,0,124,124,0
8,4,2018,15,0,7,"Braga",3,"Rua de Caires",13,37,24,104,36,68
8,4,2018,15,0,7,"Braga",4,"N14 Bosch",47,47,0,48,48,0
8,4,2018,15,0,7,"Braga",5,"Avenida João Paulo II",39,39,0,9,9,0
8,4,2018,15,0,7,"Braga",6,"Avenida Padre Júlio Fragata",67,67,0,83,83,0
8,4,2018,15,0,7,"Braga",7,"Rua Nova Santa Cruz",43,43,0,40,40,0
8,4,2018,15,0,7,"Braga",8,"Rua Costa Gomes",40,40,0,43,43,0
8,4,2018,16,0,7,"Braga",1,"Avenida da Liberdade",25,25,0,124,124,0
8,4,2018,16,0,7,"Braga",2,"Avenida Central",25,25,0,124,124,0
8,4,2018,16,0,7,"Braga",3,"Rua de Caires",37,37,0,36,36,0
8,4,2018,16,0,7,"Braga",4,"N14 Bosch",47,47,0,48,48,0
8,4,2018,16,0,7,"Braga",5,"Avenida João Paulo II",25,39,14,14,9,5
8,4,2018,16,0,7,"Braga",6,"Avenida Padre Júlio Fragata",67,67,0,83,83,0
8,4,2018,16,0,7,"Braga",7,"Rua Nova Santa Cruz",34,43,9,51,40,11
8,4,2018,16,0,7,"Braga",8,"Rua Costa Gomes",31,40,9,56,43,13
8,4,2018,17,0,7,"Braga",1,"Avenida da Liberdade",25,25,0,124,124,0
8,4,2018,17,0,7,"Braga",2,"Avenida Central",25,25,0,124,124,0
8,4,2018,17,0,7,"Braga",3,"Rua de Caires",37,37,0,36,36,0
8,4,2018,17,0,7,"Braga",4,"N14 Bosch",47,47,0,48,48,0
8,4,2018,17,0,7,"Braga",5,"Avenida João Paulo II",39,39,0,9,9,0
8,4,2018,17,0,7,"Braga",6,"Avenida Padre Júlio Fragata",67,67,0,83,83,0
8,4,2018,17,0,7,"Braga",7,"Rua Nova Santa Cruz",43,43,0,40,40,0
8,4,2018,17,0,7,"Braga",8,"Rua Costa Gomes",30,40,10,58,43,15
8,4,2018,18,0,7,"Braga",1,"Avenida da Liberdade",25,25,0,124,124,0
8,4,2018,18,0,7,"Braga",2,"Avenida Central",25,25,0,124,124,0
8,4,2018,18,0,7,"Braga",3,"Rua de Caires",37,37,0,36,36,0
8,4,2018,18,0,7,"Braga",4,"N14 Bosch",47,47,0,48,48,0
8,4,2018,18,0,7,"Braga",5,"Avenida João Paulo II",39,39,0,9,9,0
8,4,2018,18,0,7,"Braga",6,"Avenida Padre Júlio Fragata",67,67,0,83,83,0
8,4,2018,18,0,7,"Braga",7,"Rua Nova Santa Cruz",43,43,0,40,40,0
8,4,2018,18,0,7,"Braga",8,"Rua Costa Gomes",40,40,0,43,43,0
8,4,2018,19,0,7,"Braga",1,"Avenida da Liberdade",25,25,0,124,124,0
8,4,2018,19,0,7,"Braga",2,"Avenida Central",25,25,0,124,124,0
8,4,2018,19,0,7,"Braga",3,"Rua de Caires",37,37,0,36,36,0
8,4,2018,19,0,7,"Braga",4,"N14 Bosch",47,47,0,48,48,0
8,4,2018,19,0,7,"Braga",5,"Avenida João Paulo II",39,39,0,9,9,0
8,4,2018,19,0,7,"Braga",6,"Avenida Padre Júlio Fragata",67,67,0,83,83,0
8,4,2018,19,0,7,"Braga",7,"Rua Nova Santa Cruz",43,43,0,40,40,0
8,4,2018,19,0,7,"Braga",8,"Rua Costa Gomes",40,40,0,43,43,0
8,4,2018,20,0,7,"Braga",1,"Avenida da Liberdade",25,25,0,124,124,0
8,4,2018,20,0,7,"Braga",2,"Avenida Central",25,25,0,124,124,0
8,4,2018,20,0,7,"Braga",3,"Rua de Caires",37,37,0,36,36,0
8,4,2018,20,0,7,"Braga",4,"N14 Bosch",47,47,0,48,48,0
8,4,2018,20,0,7,"Braga",5,"Avenida João Paulo II",39,39,0,9,9,0
8,4,2018,20,0,7,"Braga",6,"Avenida Padre Júlio Fragata",67,67,0,83,83,0
8,4,2018,20,0,7,"Braga",7,"Rua Nova Santa Cruz",43,43,0,40,40,0
8,4,2018,20,0,7,"Braga",8,"Rua Costa Gomes",40,40,0,43,43,0
8,4,2018,21,0,7,"Braga",1,"Avenida da Liberdade",25,25,0,124,124,0
8,4,2018,21,0,7,"Braga",2,"Avenida Central",25,25,0,124,124,0
8,4,2018,21,0,7,"Braga",3,"Rua de Caires",37,37,0,36,36,0
8,4,2018,21,0,7,"Braga",4,"N14 Bosch",47,47,0,48,48,0
8,4,2018,21,0,7,"Braga",5,"Avenida João Paulo II",39,39,0,9,9,0
8,4,2018,21,0,7,"Braga",6,"Avenida Padre Júlio Fragata",67,67,0,83,83,0
8,4,2018,21,0,7,"Braga",7,"Rua Nova Santa Cruz",43,43,0,40,40,0
8,4,2018,21,0,7,"Braga",8,"Rua Costa Gomes",40,40,0,43,43,0
8,4,2018,22,0,7,"Braga",1,"Avenida da Liberdade",25,25,0,124,124,0
8,4,2018,22,0,7,"Braga",2,"Avenida Central",25,25,0,124,124,0
8,4,2018,22,0,7,"Braga",3,"Rua de Caires",37,37,0,36,36,0
8,4,2018,22,0,7,"Braga",4,"N14 Bosch",47,47,0,48,48,0
8,4,2018,22,0,7,"Braga",5,"Avenida João Paulo II",39,39,0,9,9,0
8,4,2018,22,0,7,"Braga",6,"Avenida Padre Júlio Fragata",67,67,0,83,83,0
8,4,2018,22,0,7,"Braga",7,"Rua Nova Santa Cruz",43,43,0,40,40,0
8,4,2018,22,0,7,"Braga",8,"Rua Costa Gomes",40,40,0,43,43,0
8,4,2018,23,0,7,"Braga",1,"Avenida da Liberdade",20,25,5,155,124,31
8,4,2018,23,0,7,"Braga",2,"Avenida Central",20,25,5,155,124,31
8,4,2018,23,0,7,"Braga",3,"Rua de Caires",37,37,0,36,36,0
8,4,2018,23,0,7,"Braga",4,"N14 Bosch",47,47,0,48,48,0
8,4,2018,23,0,7,"Braga",5,"Avenida João Paulo II",39,39,0,9,9,0
8,4,2018,23,0,7,"Braga",6,"Avenida Padre Júlio Fragata",67,67,0,83,83,0
8,4,2018,23,0,7,"Braga",7,"Rua Nova Santa Cruz",43,43,0,40,40,0
8,4,2018,23,0,7,"Braga",8,"Rua Costa Gomes",40,40,0,43,43,0
8,5,2018,0,0,8,"Braga",1,"Avenida da Liberdade",15,25,10,207,124,83
8,5,2018,0,0,8,"Braga",2,"Avenida Central",15,25,10,207,124,83
8,5,2018,0,0,8,"Braga",3,"Rua de Caires",37,37,0,36,36,0
8,5,2018,0,0,8,"Braga",4,"N14 Bosch",47,47,0,48,48,0
8,5,2018,0,0,8,"Braga",5,"Avenida João Paulo II",39,39,0,9,9,0
8,5,2018,0,0,8,"Braga",6,"Avenida Padre Júlio Fragata",67,67,0,83,83,0
8,5,2018,0,0,8,"Braga",7,"Rua Nova Santa Cruz",43,43,0,40,40,0
8,5,2018,0,0,8,"Braga",8,"Rua Costa Gomes",40,40,0,43,43,0
8,5,2018,1,0,8,"Braga",1,"Avenida da Liberdade",25,25,0,124,124,0
8,5,2018,1,0,8,"Braga",2,"Avenida Central",25,25,0,124,124,0
8,5,2018,1,0,8,"Braga",3,"Rua de Caires",37,37,0,36,36,0
8,5,2018,1,0,8,"Braga",4,"N14 Bosch",47,47,0,48,48,0
8,5,2018,1,0,8,"Braga",5,"Avenida João Paulo II",39,39,0,9,9,0
8,5,2018,1,0,8,"Braga",6,"Avenida Padre Júlio Fragata",67,67,0,83,83,0
8,5,2018,1,0,8,"Braga",7,"Rua Nova Santa Cruz",43,43,0,40,40,0
8,5,2018,1,0,8,"Braga",8,"Rua Costa Gomes",40,40,0,43,43,0
8,5,2018,2,0,8,"Braga",1,"Avenida da Liberdade",25,25,0,124,124,0
8,5,2018,2,0,8,"Braga",2,"Avenida Central",25,25,0,124,124,0
8,5,2018,2,0,8,"Braga",3,"Rua de Caires",37,37,0,36,36,0
8,5,2018,2,0,8,"Braga",4,"N14 Bosch",47,47,0,48,48,0
8,5,2018,2,0,8,"Braga",5,"Avenida João Paulo II",39,39,0,9,9,0
8,5,2018,2,0,8,"Braga",6,"Avenida Padre Júlio Fragata",67,67,0,83,83,0
8,5,2018,2,0,8,"Braga",7,"Rua Nova Santa Cruz",43,43,0,40,40,0
8,5,2018,2,0,8,"Braga",8,"Rua Costa Gomes",40,40,0,43,43,0
8,5,2018,3,0,8,"Braga",1,"Avenida da Liberdade",25,25,0,124,124,0
8,5,2018,3,0,8,"Braga",2,"Avenida Central",25,25,0,124,124,0
8,5,2018,3,0,8,"Braga",3,"Rua de Caires",37,37,0,36,36,0
8,5,2018,3,0,8,"Braga",4,"N14 Bosch",47,47,0,48,48,0
8,5,2018,3,0,8,"Braga",5,"Avenida João Paulo II",39,39,0,9,9,0
8,5,2018,3,0,8,"Braga",6,"Avenida Padre Júlio Fragata",67,67,0,83,83,0
8,5,2018,3,0,8,"Braga",7,"Rua Nova Santa Cruz",43,43,0,40,40,0
8,5,2018,3,0,8,"Braga",8,"Rua Costa Gomes",40,40,0,43,43,0
8,5,2018,4,0,8,"Braga",1,"Avenida da Liberdade",25,25,0,124,124,0
8,5,2018,4,0,8,"Braga",2,"Avenida Central",25,25,0,124,124,0
8,5,2018,4,0,8,"Braga",3,"Rua de Caires",37,37,0,36,36,0
8,5,2018,4,0,8,"Braga",4,"N14 Bosch",47,47,0,48,48,0
8,5,2018,4,0,8,"Braga",5,"Avenida João Paulo II",39,39,0,9,9,0
8,5,2018,4,0,8,"Braga",6,"Avenida Padre Júlio Fragata",67,67,0,83,83,0
8,5,2018,4,0,8,"Braga",7,"Rua Nova Santa Cruz",43,43,0,40,40,0
8,5,2018,4,0,8,"Braga",8,"Rua Costa Gomes",40,40,0,43,43,0
8,5,2018,5,0,8,"Braga",1,"Avenida da Liberdade",25,25,0,124,124,0
8,5,2018,5,0,8,"Braga",2,"Avenida Central",25,25,0,124,124,0
8,5,2018,5,0,8,"Braga",3,"Rua de Caires",37,37,0,36,36,0
8,5,2018,5,0,8,"Braga",4,"N14 Bosch",47,47,0,48,48,0
8,5,2018,5,0,8,"Braga",5,"Avenida João Paulo II",39,39,0,9,9,0
8,5,2018,5,0,8,"Braga",6,"Avenida Padre Júlio Fragata",67,67,0,83,83,0
8,5,2018,5,0,8,"Braga",7,"Rua Nova Santa Cruz",43,43,0,40,40,0
8,5,2018,5,0,8,"Braga",8,"Rua Costa Gomes",40,40,0,43,43,0
8,5,2018,6,0,8,"Braga",1,"Avenida da Liberdade",25,25,0,124,124,0
8,5,2018,6,0,8,"Braga",2,"Avenida Central",25,25,0,124,124,0
8,5,2018,6,0,8,"Braga",3,"Rua de Caires",37,37,0,36,36,0
8,5,2018,6,0,8,"Braga",4,"N14 Bosch",47,47,0,48,48,0
8,5,2018,6,0,8,"Braga",5,"Avenida João Paulo II",39,39,0,9,9,0
8,5,2018,6,0,8,"Braga",6,"Avenida Padre Júlio Fragata",67,67,0,83,83,0
8,5,2018,6,0,8,"Braga",7,"Rua Nova Santa Cruz",43,43,0,40,40,0
8,5,2018,6,0,8,"Braga",8,"Rua Costa Gomes",40,40,0,43,43,0
8,5,2018,7,0,8,"Braga",1,"Avenida da Liberdade",25,25,0,124,124,0
8,5,2018,7,0,8,"Braga",2,"Avenida Central",25,25,0,124,124,0
8,5,2018,7,0,8,"Braga",3,"Rua de Caires",37,37,0,36,36,0
8,5,2018,7,0,8,"Braga",4,"N14 Bosch",47,47,0,48,48,0
8,5,2018,7,0,8,"Braga",5,"Avenida João Paulo II",39,39,0,9,9,0
8,5,2018,7,0,8,"Braga",6,"Avenida Padre Júlio Fragata",67,67,0,83,83,0
8,5,2018,7,0,8,"Braga",7,"Rua Nova Santa Cruz",43,43,0,40,40,0
8,5,2018,7,0,8,"Braga",8,"Rua Costa Gomes",40,40,0,43,43,0
8,5,2018,8,0,8,"Braga",1,"Avenida da Liberdade",25,25,0,124,124,0
8,5,2018,8,0,8,"Braga",2,"Avenida Central",25,25,0,124,124,0
8,5,2018,8,0,8,"Braga",3,"Rua de Caires",37,37,0,36,36,0
8,5,2018,8,0,8,"Braga",4,"N14 Bosch",47,47,0,48,48,0
8,5,2018,8,0,8,"Braga",5,"Avenida João Paulo II",39,39,0,9,9,0
8,5,2018,8,0,8,"Braga",6,"Avenida Padre Júlio Fragata",67,67,0,83,83,0
8,5,2018,8,0,8,"Braga",7,"Rua Nova Santa Cruz",43,43,0,40,40,0
8,5,2018,8,0,8,"Braga",8,"Rua Costa Gomes",40,40,0,43,43,0
8,5,2018,9,0,8,"Braga",1,"Avenida da Liberdade",25,25,0,124,124,0
8,5,2018,9,0,8,"Braga",2,"Avenida Central",25,25,0,124,124,0
8,5,2018,9,0,8,"Braga",3,"Rua de Caires",28,37,9,48,36,12
8,5,2018,9,0,8,"Braga",4,"N14 Bosch",47,47,0,48,48,0
8,5,2018,9,0,8,"Braga",5,"Avenida João Paulo II",39,39,0,9,9,0
8,5,2018,9,0,8,"Braga",6,"Avenida Padre Júlio Fragata",67,67,0,83,83,0
8,5,2018,9,0,8,"Braga",7,"Rua Nova Santa Cruz",43,43,0,40,40,0
8,5,2018,9,0,8,"Braga",8,"Rua Costa Gomes",40,40,0,43,43,0
8,5,2018,10,0,8,"Braga",1,"Avenida da Liberdade",25,25,0,124,124,0
8,5,2018,10,0,8,"Braga",2,"Avenida Central",25,25,0,124,124,0
8,5,2018,10,0,8,"Braga",3,"Rua de Caires",37,37,0,36,36,0
8,5,2018,10,0,8,"Braga",4,"N14 Bosch",47,47,0,48,48,0
8,5,2018,10,0,8,"Braga",5,"Avenida João Paulo II",39,39,0,9,9,0
8,5,2018,10,0,8,"Braga",6,"Avenida Padre Júlio Fragata",67,67,0,83,83,0
8,5,2018,10,0,8,"Braga",7,"Rua Nova Santa Cruz",43,43,0,40,40,0
8,5,2018,10,0,8,"Braga",8,"Rua Costa Gomes",40,40,0,43,43,0
8,5,2018,11,0,8,"Braga",1,"Avenida da Liberdade",25,25,0,124,124,0
8,5,2018,11,0,8,"Braga",2,"Avenida Central",25,25,0,124,124,0
8,5,2018,11,0,8,"Braga",3,"Rua de Caires",37,37,0,36,36,0
8,5,2018,11,0,8,"Braga",4,"N14 Bosch",47,47,0,48,48,0
8,5,2018,11,0,8,"Braga",5,"Avenida João Paulo II",39,39,0,9,9,0
8,5,2018,11,0,8,"Braga",6,"Avenida Padre Júlio Fragata",67,67,0,83,83,0
8,5,2018,11,0,8,"Braga",7,"Rua Nova Santa Cruz",43,43,0,40,40,0
8,5,2018,11,0,8,"Braga",8,"Rua Costa Gomes",40,40,0,43,43,0
8,5,2018,12,0,8,"Braga",1,"Avenida da Liberdade",25,25,0,124,124,0
8,5,2018,12,0,8,"Braga",2,"Avenida Central",25,25,0,124,124,0
8,5,2018,12,0,8,"Braga",3,"Rua de Caires",37,37,0,36,36,0
8,5,2018,12,0,8,"Braga",4,"N14 Bosch",47,47,0,48,48,0
8,5,2018,12,0,8,"Braga",5,"Avenida João Paulo II",39,39,0,9,9,0
8,5,2018,12,0,8,"Braga",6,"Avenida Padre Júlio Fragata",67,67,0,83,83,0
8,5,2018,12,0,8,"Braga",7,"Rua Nova Santa Cruz",43,43,0,40,40,0
8,5,2018,12,0,8,"Braga",8,"Rua Costa Gomes",40,40,0,43,43,0
8,5,2018,13,0,8,"Braga",1,"Avenida da Liberdade",25,25,0,124,124,0
8,5,2018,13,0,8,"Braga",2,"Avenida Central",19,25,6,163,124,39
8,5,2018,13,0,8,"Braga",3,"Rua de Caires",37,37,0,36,36,0
8,5,2018,13,0,8,"Braga",4,"N14 Bosch",47,47,0,48,48,0
8,5,2018,13,0,8,"Braga",5,"Avenida João Paulo II",39,39,0,9,9,0
8,5,2018,13,0,8,"Braga",6,"Avenida Padre Júlio Fragata",67,67,0,83,83,0
8,5,2018,13,0,8,"Braga",7,"Rua Nova Santa Cruz",43,43,0,40,40,0
8,5,2018,13,0,8,"Braga",8,"Rua Costa Gomes",40,40,0,43,43,0
8,5,2018,14,0,8,"Braga",1,"Avenida da Liberdade",25,25,0,124,124,0
8,5,2018,14,0,8,"Braga",2,"Avenida Central",25,25,0,124,124,0
8,5,2018,14,0,8,"Braga",3,"Rua de Caires",37,37,0,36,36,0
8,5,2018,14,0,8,"Braga",4,"N14 Bosch",47,47,0,48,48,0
8,5,2018,14,0,8,"Braga",5,"Avenida João Paulo II",39,39,0,9,9,0
8,5,2018,14,0,8,"Braga",6,"Avenida Padre Júlio Fragata",67,67,0,83,83,0
8,5,2018,14,0,8,"Braga",7,"Rua Nova Santa Cruz",43,43,0,40,40,0
8,5,2018,14,0,8,"Braga",8,"Rua Costa Gomes",40,40,0,43,43,0
8,5,2018,15,0,8,"Braga",1,"Avenida da Liberdade",16,25,9,194,124,70
8,5,2018,15,0,8,"Braga",2,"Avenida Central",16,25,9,194,124,70
8,5,2018,15,0,8,"Braga",3,"Rua de Caires",37,37,0,36,36,0
8,5,2018,15,0,8,"Braga",4,"N14 Bosch",47,47,0,48,48,0
8,5,2018,15,0,8,"Braga",5,"Avenida João Paulo II",39,39,0,9,9,0
8,5,2018,15,0,8,"Braga",6,"Avenida Padre Júlio Fragata",67,67,0,83,83,0
8,5,2018,15,0,8,"Braga",7,"Rua Nova Santa Cruz",43,43,0,40,40,0
8,5,2018,15,0,8,"Braga",8,"Rua Costa Gomes",31,40,9,56,43,13
8,5,2018,16,0,8,"Braga",1,"Avenida da Liberdade",25,25,0,124,124,0
8,5,2018,16,0,8,"Braga",2,"Avenida Central",25,25,0,124,124,0
8,5,2018,16,0,8,"Braga",3,"Rua de Caires",37,37,0,36,36,0
8,5,2018,16,0,8,"Braga",4,"N14 Bosch",47,47,0,48,48,0
8,5,2018,16,0,8,"Braga",5,"Avenida João Paulo II",39,39,0,9,9,0
8,5,2018,16,0,8,"Braga",6,"Avenida Padre Júlio Fragata",67,67,0,83,83,0
8,5,2018,16,0,8,"Braga",7,"Rua Nova Santa Cruz",43,43,0,40,40,0
8,5,2018,16,0,8,"Braga",8,"Rua Costa Gomes",40,40,0,43,43,0
8,5,2018,17,0,8,"Braga",1,"Avenida da Liberdade",25,25,0,124,124,0
8,5,2018,17,0,8,"Braga",2,"Avenida Central",25,25,0,124,124,0
8,5,2018,17,0,8,"Braga",3,"Rua de Caires",25,37,12,54,36,18
8,5,2018,17,0,8,"Braga",4,"N14 Bosch",47,47,0,48,48,0
8,5,2018,17,0,8,"Braga",5,"Avenida João Paulo II",39,39,0,9,9,0
8,5,2018,17,0,8,"Braga",6,"Avenida Padre Júlio Fragata",67,67,0,83,83,0
8,5,2018,17,0,8,"Braga",7,"Rua Nova Santa Cruz",43,43,0,40,40,0
8,5,2018,17,0,8,"Braga",8,"Rua Costa Gomes",40,40,0,43,43,0
8,5,2018,18,0,8,"Braga",1,"Avenida da Liberdade",25,25,0,124,124,0
8,5,2018,18,0,8,"Braga",2,"Avenida Central",25,25,0,124,124,0
8,5,2018,18,0,8,"Braga",3,"Rua de Caires",29,37,8,46,36,10
8,5,2018,18,0,8,"Braga",4,"N14 Bosch",47,47,0,48,48,0
8,5,2018,18,0,8,"Braga",5,"Avenida João Paulo II",39,39,0,9,9,0
8,5,2018,18,0,8,"Braga",6,"Avenida Padre Júlio Fragata",51,67,16,109,83,26
8,5,2018,18,0,8,"Braga",7,"Rua Nova Santa Cruz",43,43,0,40,40,0
8,5,2018,18,0,8,"Braga",8,"Rua Costa Gomes",40,40,0,43,43,0
8,5,2018,19,0,8,"Braga",1,"Avenida da Liberdade",25,25,0,124,124,0
8,5,2018,19,0,8,"Braga",2,"Avenida Central",25,25,0,124,124,0
8,5,2018,19,0,8,"Braga",3,"Rua de Caires",37,37,0,36,36,0
8,5,2018,19,0,8,"Braga",4,"N14 Bosch",47,47,0,48,48,0
8,5,2018,19,0,8,"Braga",5,"Avenida João Paulo II",39,39,0,9,9,0
8,5,2018,19,0,8,"Braga",6,"Avenida Padre Júlio Fragata",67,67,0,83,83,0
8,5,2018,19,0,8,"Braga",7,"Rua Nova Santa Cruz",43,43,0,40,40,0
8,5,2018,19,0,8,"Braga",8,"Rua Costa Gomes",40,40,0,43,43,0
8,5,2018,20,0,8,"Braga",1,"Avenida da Liberdade",25,25,0,124,124,0
8,5,2018,20,0,8,"Braga",2,"Avenida Central",25,25,0,124,124,0
8,5,2018,20,0,8,"Braga",3,"Rua de Caires",37,37,0,36,36,0
8,5,2018,20,0,8,"Braga",4,"N14 Bosch",47,47,0,48,48,0
8,5,2018,20,0,8,"Braga",5,"Avenida João Paulo II",39,39,0,9,9,0
8,5,2018,20,0,8,"Braga",6,"Avenida Padre Júlio Fragata",67,67,0,83,83,0
8,5,2018,20,0,8,"Braga",7,"Rua Nova Santa Cruz",43,43,0,40,40,0
8,5,2018,20,0,8,"Braga",8,"Rua Costa Gomes",40,40,0,43,43,0
8,5,2018,21,0,8,"Braga",1,"Avenida da Liberdade",25,25,0,124,124,0
8,5,2018,21,0,8,"Braga",2,"Avenida Central",25,25,0,124,124,0
8,5,2018,21,0,8,"Braga",3,"Rua de Caires",26,37,11,52,36,16
8,5,2018,21,0,8,"Braga",4,"N14 Bosch",47,47,0,48,48,0
8,5,2018,21,0,8,"Braga",5,"Avenida João Paulo II",39,39,0,9,9,0
8,5,2018,21,0,8,"Braga",6,"Avenida Padre Júlio Fragata",67,67,0,83,83,0
8,5,2018,21,0,8,"Braga",7,"Rua Nova Santa Cruz",25,43,18,69,40,29
8,5,2018,21,0,8,"Braga",8,"Rua Costa Gomes",40,40,0,43,43,0
8,5,2018,22,0,8,"Braga",1,"Avenida da Liberdade",25,25,0,124,124,0
8,5,2018,22,0,8,"Braga",2,"Avenida Central",25,25,0,124,124,0
8,5,2018,22,0,8,"Braga",3,"Rua de Caires",37,37,0,36,36,0
8,5,2018,22,0,8,"Braga",4,"N14 Bosch",47,47,0,48,48,0
8,5,2018,22,0,8,"Braga",5,"Avenida João Paulo II",39,39,0,9,9,0
8,5,2018,22,0,8,"Braga",6,"Avenida Padre Júlio Fragata",67,67,0,83,83,0
8,5,2018,22,0,8,"Braga",7,"Rua Nova Santa Cruz",43,43,0,40,40,0
8,5,2018,22,0,8,"Braga",8,"Rua Costa Gomes",40,40,0,43,43,0
8,5,2018,23,0,8,"Braga",1,"Avenida da Liberdade",25,25,0,124,124,0
8,5,2018,23,0,8,"Braga",2,"Avenida Central",25,25,0,124,124,0
8,5,2018,23,0,8,"Braga",3,"Rua de Caires",37,37,0,36,36,0
8,5,2018,23,0,8,"Braga",4,"N14 Bosch",47,47,0,48,48,0
8,5,2018,23,0,8,"Braga",5,"Avenida João Paulo II",39,39,0,9,9,0
8,5,2018,23,0,8,"Braga",6,"Avenida Padre Júlio Fragata",67,67,0,83,83,0
8,5,2018,23,0,8,"Braga",7,"Rua Nova Santa Cruz",43,43,0,40,40,0
8,5,2018,23,0,8,"Braga",8,"Rua Costa Gomes",40,40,0,43,43,0
8,6,2018,0,0,2,"Braga",1,"Avenida da Liberdade",25,25,0,124,124,0
8,6,2018,0,0,2,"Braga",2,"Avenida Central",25,25,0,124,124,0
8,6,2018,0,0,2,"Braga",3,"Rua de Caires",37,37,0,36,36,0
8,6,2018,0,0,2,"Braga",4,"N14 Bosch",47,47,0,48,48,0
8,6,2018,0,0,2,"Braga",5,"Avenida João Paulo II",39,39,0,9,9,0
8,6,2018,0,0,2,"Braga",6,"Avenida Padre Júlio Fragata",67,67,0,83,83,0
8,6,2018,0,0,2,"Braga",7,"Rua Nova Santa Cruz",43,43,0,40,40,0
8,6,2018,0,0,2,"Braga",8,"Rua Costa Gomes",40,40,0,43,43,0
8,6,2018,1,0,2,"Braga",1,"Avenida da Liberdade",25,25,0,124,124,0
8,6,2018,1,0,2,"Braga",2,"Avenida Central",25,25,0,124,124,0
8,6,2018,1,0,2,"Braga",3,"Rua de Caires",37,37,0,36,36,0
8,6,2018,1,0,2,"Braga",4,"N14 Bosch",47,47,0,48,48,0
8,6,2018,1,0,2,"Braga",5,"Avenida João Paulo II",39,39,0,9,9,0
8,6,2018,1,0,2,"Braga",6,"Avenida Padre Júlio Fragata",67,67,0,83,83,0
8,6,2018,1,0,2,"Braga",7,"Rua Nova Santa Cruz",43,43,0,40,40,0
8,6,2018,1,0,2,"Braga",8,"Rua Costa Gomes",40,40,0,43,43,0
8,6,2018,2,0,2,"Braga",1,"Avenida da Liberdade",25,25,0,124,124,0
8,6,2018,2,0,2,"Braga",2,"Avenida Central",25,25,0,124,124,0
8,6,2018,2,0,2,"Braga",3,"Rua de Caires",37,37,0,36,36,0
8,6,2018,2,0,2,"Braga",4,"N14 Bosch",47,47,0,48,48,0
8,6,2018,2,0,2,"Braga",5,"Avenida João Paulo II",39,39,0,9,9,0
8,6,2018,2,0,2,"Braga",6,"Avenida Padre Júlio Fragata",67,67,0,83,83,0
8,6,2018,2,0,2,"Braga",7,"Rua Nova Santa Cruz",43,43,0,40,40,0
8,6,2018,2,0,2,"Braga",8,"Rua Costa Gomes",40,40,0,43,43,0
8,6,2018,3,0,2,"Braga",1,"Avenida da Liberdade",25,25,0,124,124,0
8,6,2018,3,0,2,"Braga",2,"Avenida Central",25,25,0,124,124,0
8,6,2018,3,0,2,"Braga",3,"Rua de Caires",37,37,0,36,36,0
8,6,2018,3,0,2,"Braga",4,"N14 Bosch",47,47,0,48,48,0
8,6,2018,3,0,2,"Braga",5,"Avenida João Paulo II",39,39,0,9,9,0
8,6,2018,3,0,2,"Braga",6,"Avenida Padre Júlio Fragata",67,67,0,83,83,0
8,6,2018,3,0,2,"Braga",7,"Rua Nova Santa Cruz",43,43,0,40,40,0
8,6,2018,3,0,2,"Braga",8,"Rua Costa Gomes",40,40,0,43,43,0
8,6,2018,4,0,2,"Braga",1,"Avenida da Liberdade",25,25,0,124,124,0
8,6,2018,4,0,2,"Braga",2,"Avenida Central",25,25,0,124,124,0
8,6,2018,4,0,2,"Braga",3,"Rua de Caires",37,37,0,36,36,0
8,6,2018,4,0,2,"Braga",4,"N14 Bosch",47,47,0,48,48,0
8,6,2018,4,0,2,"Braga",5,"Avenida João Paulo II",39,39,0,9,9,0
8,6,2018,4,0,2,"Braga",6,"Avenida Padre Júlio Fragata",67,67,0,83,83,0
8,6,2018,4,0,2,"Braga",7,"Rua Nova Santa Cruz",43,43,0,40,40,0
8,6,2018,4,0,2,"Braga",8,"Rua Costa Gomes",40,40,0,43,43,0
8,6,2018,5,0,2,"Braga",1,"Avenida da Liberdade",25,25,0,124,124,0
8,6,2018,5,0,2,"Braga",2,"Avenida Central",25,25,0,124,124,0
8,6,2018,5,0,2,"Braga",3,"Rua de Caires",37,37,0,36,36,0
8,6,2018,5,0,2,"Braga",4,"N14 Bosch",47,47,0,48,48,0
8,6,2018,5,0,2,"Braga",5,"Avenida João Paulo II",39,39,0,9,9,0
8,6,2018,5,0,2,"Braga",6,"Avenida Padre Júlio Fragata",67,67,0,83,83,0
8,6,2018,5,0,2,"Braga",7,"Rua Nova Santa Cruz",43,43,0,40,40,0
8,6,2018,5,0,2,"Braga",8,"Rua Costa Gomes",40,40,0,43,43,0
8,6,2018,6,0,2,"Braga",1,"Avenida da Liberdade",25,25,0,124,124,0
8,6,2018,6,0,2,"Braga",2,"Avenida Central",25,25,0,124,124,0
8,6,2018,6,0,2,"Braga",3,"Rua de Caires",37,37,0,36,36,0
8,6,2018,6,0,2,"Braga",4,"N14 Bosch",47,47,0,48,48,0
8,6,2018,6,0,2,"Braga",5,"Avenida João Paulo II",39,39,0,9,9,0
8,6,2018,6,0,2,"Braga",6,"Avenida Padre Júlio Fragata",67,67,0,83,83,0
8,6,2018,6,0,2,"Braga",7,"Rua Nova Santa Cruz",43,43,0,40,40,0
8,6,2018,6,0,2,"Braga",8,"Rua Costa Gomes",40,40,0,43,43,0
8,6,2018,7,0,2,"Braga",1,"Avenida da Liberdade",25,25,0,124,124,0
8,6,2018,7,0,2,"Braga",2,"Avenida Central",25,25,0,124,124,0
8,6,2018,7,0,2,"Braga",3,"Rua de Caires",37,37,0,36,36,0
8,6,2018,7,0,2,"Braga",4,"N14 Bosch",47,47,0,48,48,0
8,6,2018,7,0,2,"Braga",5,"Avenida João Paulo II",39,39,0,9,9,0
8,6,2018,7,0,2,"Braga",6,"Avenida Padre Júlio Fragata",67,67,0,83,83,0
8,6,2018,7,0,2,"Braga",7,"Rua Nova Santa Cruz",43,43,0,40,40,0
8,6,2018,7,0,2,"Braga",8,"Rua Costa Gomes",40,40,0,43,43,0
8,6,2018,8,0,2,"Braga",1,"Avenida da Liberdade",25,25,0,124,124,0
8,6,2018,8,0,2,"Braga",2,"Avenida Central",25,25,0,124,124,0
8,6,2018,8,0,2,"Braga",3,"Rua de Caires",19,37,18,71,36,35
8,6,2018,8,0,2,"Braga",4,"N14 Bosch",34,47,13,66,48,18
8,6,2018,8,0,2,"Braga",5,"Avenida João Paulo II",39,39,0,9,9,0
8,6,2018,8,0,2,"Braga",6,"Avenida Padre Júlio Fragata",67,67,0,83,83,0
8,6,2018,8,0,2,"Braga",7,"Rua Nova Santa Cruz",43,43,0,40,40,0
8,6,2018,8,0,2,"Braga",8,"Rua Costa Gomes",30,40,10,58,43,15
8,6,2018,9,0,2,"Braga",1,"Avenida da Liberdade",19,25,6,163,124,39
8,6,2018,9,0,2,"Braga",2,"Avenida Central",25,25,0,124,124,0
8,6,2018,9,0,2,"Braga",3,"Rua de Caires",21,37,16,64,36,28
8,6,2018,9,0,2,"Braga",4,"N14 Bosch",47,47,0,48,48,0
8,6,2018,9,0,2,"Braga",5,"Avenida João Paulo II",39,39,0,9,9,0
8,6,2018,9,0,2,"Braga",6,"Avenida Padre Júlio Fragata",67,67,0,83,83,0
8,6,2018,9,0,2,"Braga",7,"Rua Nova Santa Cruz",43,43,0,40,40,0
8,6,2018,9,0,2,"Braga",8,"Rua Costa Gomes",40,40,0,43,43,0
8,6,2018,10,0,2,"Braga",1,"Avenida da Liberdade",25,25,0,124,124,0
8,6,2018,10,0,2,"Braga",2,"Avenida Central",25,25,0,124,124,0
8,6,2018,10,0,2,"Braga",3,"Rua de Caires",23,37,14,59,36,23
8,6,2018,10,0,2,"Braga",4,"N14 Bosch",25,47,22,90,48,42
8,6,2018,10,0,2,"Braga",5,"Avenida João Paulo II",39,39,0,9,9,0
8,6,2018,10,0,2,"Braga",6,"Avenida Padre Júlio Fragata",67,67,0,83,83,0
8,6,2018,10,0,2,"Braga",7,"Rua Nova Santa Cruz",43,43,0,40,40,0
8,6,2018,10,0,2,"Braga",8,"Rua Costa Gomes",40,40,0,43,43,0
8,6,2018,11,0,2,"Braga",1,"Avenida da Liberdade",25,25,0,124,124,0
8,6,2018,11,0,2,"Braga",2,"Avenida Central",25,25,0,124,124,0
8,6,2018,11,0,2,"Braga",3,"Rua de Caires",24,37,13,56,36,20
8,6,2018,11,0,2,"Braga",4,"N14 Bosch",47,47,0,48,48,0
8,6,2018,11,0,2,"Braga",5,"Avenida João Paulo II",39,39,0,9,9,0
8,6,2018,11,0,2,"Braga",6,"Avenida Padre Júlio Fragata",67,67,0,83,83,0
8,6,2018,11,0,2,"Braga",7,"Rua Nova Santa Cruz",43,43,0,40,40,0
8,6,2018,11,0,2,"Braga",8,"Rua Costa Gomes",29,40,11,60,43,17
8,6,2018,12,0,2,"Braga",1,"Avenida da Liberdade",19,25,6,163,124,39
8,6,2018,12,0,2,"Braga",2,"Avenida Central",25,25,0,124,124,0
8,6,2018,12,0,2,"Braga",3,"Rua de Caires",16,37,21,84,36,48
8,6,2018,12,0,2,"Braga",4,"N14 Bosch",36,47,11,62,48,14
8,6,2018,12,0,2,"Braga",5,"Avenida João Paulo II",29,39,10,12,9,3
8,6,2018,12,0,2,"Braga",6,"Avenida Padre Júlio Fragata",67,67,0,83,83,0
8,6,2018,12,0,2,"Braga",7,"Rua Nova Santa Cruz",43,43,0,40,40,0
8,6,2018,12,0,2,"Braga",8,"Rua Costa Gomes",40,40,0,43,43,0
8,6,2018,13,0,2,"Braga",1,"Avenida da Liberdade",14,25,11,221,124,97
8,6,2018,13,0,2,"Braga",2,"Avenida Central",14,25,11,221,124,97
8,6,2018,13,0,2,"Braga",3,"Rua de Caires",27,37,10,50,36,14
8,6,2018,13,0,2,"Braga",4,"N14 Bosch",26,47,21,86,48,38
8,6,2018,13,0,2,"Braga",5,"Avenida João Paulo II",25,39,14,14,9,5
8,6,2018,13,0,2,"Braga",6,"Avenida Padre Júlio Fragata",67,67,0,83,83,0
8,6,2018,13,0,2,"Braga",7,"Rua Nova Santa Cruz",43,43,0,40,40,0
8,6,2018,13,0,2,"Braga",8,"Rua Costa Gomes",24,40,16,72,43,29
8,6,2018,15,0,2,"Braga",1,"Avenida da Liberdade",17,25,8,182,124,58
8,6,2018,15,0,2,"Braga",2,"Avenida Central",17,25,8,182,124,58
8,6,2018,15,0,2,"Braga",3,"Rua de Caires",27,37,10,50,36,14
8,6,2018,15,0,2,"Braga",4,"N14 Bosch",20,47,27,112,48,64
8,6,2018,15,0,2,"Braga",5,"Avenida João Paulo II",10,39,29,35,9,26
8,6,2018,15,0,2,"Braga",6,"Avenida Padre Júlio Fragata",47,67,20,119,83,36
8,6,2018,15,0,2,"Braga",7,"Rua Nova Santa Cruz",43,43,0,40,40,0
8,6,2018,15,0,2,"Braga",8,"Rua Costa Gomes",40,40,0,43,43,0
8,6,2018,16,0,2,"Braga",1,"Avenida da Liberdade",19,25,6,163,124,39
8,6,2018,16,0,2,"Braga",2,"Avenida Central",19,25,6,163,124,39
8,6,2018,16,0,2,"Braga",3,"Rua de Caires",28,37,9,48,36,12
8,6,2018,16,0,2,"Braga",4,"N14 Bosch",24,47,23,94,48,46
8,6,2018,16,0,2,"Braga",5,"Avenida João Paulo II",27,39,12,13,9,4
8,6,2018,16,0,2,"Braga",6,"Avenida Padre Júlio Fragata",48,67,19,116,83,33
8,6,2018,16,0,2,"Braga",7,"Rua Nova Santa Cruz",43,43,0,40,40,0
8,6,2018,16,0,2,"Braga",8,"Rua Costa Gomes",26,40,14,67,43,24
8,6,2018,17,0,2,"Braga",1,"Avenida da Liberdade",19,25,6,163,124,39
8,6,2018,17,0,2,"Braga",2,"Avenida Central",18,25,7,172,124,48
8,6,2018,17,0,2,"Braga",3,"Rua de Caires",19,37,18,71,36,35
8,6,2018,17,0,2,"Braga",4,"N14 Bosch",22,47,25,102,48,54
8,6,2018,17,0,2,"Braga",5,"Avenida João Paulo II",10,39,29,35,9,26
8,6,2018,17,0,2,"Braga",6,"Avenida Padre Júlio Fragata",17,67,50,328,83,245
8,6,2018,17,0,2,"Braga",7,"Rua Nova Santa Cruz",43,43,0,40,40,0
8,6,2018,17,0,2,"Braga",8,"Rua Costa Gomes",24,40,16,72,43,29
8,6,2018,18,0,2,"Braga",1,"Avenida da Liberdade",19,25,6,163,124,39
8,6,2018,18,0,2,"Braga",2,"Avenida Central",19,25,6,163,124,39
8,6,2018,18,0,2,"Braga",3,"Rua de Caires",27,37,10,50,36,14
8,6,2018,18,0,2,"Braga",4,"N14 Bosch",10,47,37,225,48,177
8,6,2018,18,0,2,"Braga",5,"Avenida João Paulo II",6,39,33,58,9,49
8,6,2018,18,0,2,"Braga",6,"Avenida Padre Júlio Fragata",17,67,50,328,83,245
8,6,2018,18,0,2,"Braga",7,"Rua Nova Santa Cruz",43,43,0,40,40,0
8,6,2018,18,0,2,"Braga",8,"Rua Costa Gomes",4,40,36,433,43,390
8,6,2018,19,0,2,"Braga",1,"Avenida da Liberdade",17,25,8,182,124,58
8,6,2018,19,0,2,"Braga",2,"Avenida Central",17,25,8,182,124,58
8,6,2018,19,0,2,"Braga",3,"Rua de Caires",24,37,13,56,36,20
8,6,2018,19,0,2,"Braga",4,"N14 Bosch",20,47,27,112,48,64
8,6,2018,19,0,2,"Braga",5,"Avenida João Paulo II",39,39,0,9,9,0
8,6,2018,19,0,2,"Braga",6,"Avenida Padre Júlio Fragata",29,67,38,192,83,109
8,6,2018,19,0,2,"Braga",7,"Rua Nova Santa Cruz",43,43,0,40,40,0
8,6,2018,19,0,2,"Braga",8,"Rua Costa Gomes",17,40,23,102,43,59
8,6,2018,20,0,2,"Braga",1,"Avenida da Liberdade",25,25,0,124,124,0
8,6,2018,20,0,2,"Braga",2,"Avenida Central",25,25,0,124,124,0
8,6,2018,20,0,2,"Braga",3,"Rua de Caires",37,37,0,36,36,0
8,6,2018,20,0,2,"Braga",4,"N14 Bosch",47,47,0,48,48,0
8,6,2018,20,0,2,"Braga",5,"Avenida João Paulo II",39,39,0,9,9,0
8,6,2018,20,0,2,"Braga",6,"Avenida Padre Júlio Fragata",53,67,14,105,83,22
8,6,2018,20,0,2,"Braga",7,"Rua Nova Santa Cruz",43,43,0,40,40,0
8,6,2018,20,0,2,"Braga",8,"Rua Costa Gomes",40,40,0,43,43,0
8,6,2018,21,0,2,"Braga",1,"Avenida da Liberdade",25,25,0,124,124,0
8,6,2018,21,0,2,"Braga",2,"Avenida Central",25,25,0,124,124,0
8,6,2018,21,0,2,"Braga",3,"Rua de Caires",37,37,0,36,36,0
8,6,2018,21,0,2,"Braga",4,"N14 Bosch",47,47,0,48,48,0
8,6,2018,21,0,2,"Braga",5,"Avenida João Paulo II",39,39,0,9,9,0
8,6,2018,21,0,2,"Braga",6,"Avenida Padre Júlio Fragata",67,67,0,83,83,0
8,6,2018,21,0,2,"Braga",7,"Rua Nova Santa Cruz",43,43,0,40,40,0
8,6,2018,21,0,2,"Braga",8,"Rua Costa Gomes",40,40,0,43,43,0
8,6,2018,22,0,2,"Braga",1,"Avenida da Liberdade",25,25,0,124,124,0
8,6,2018,22,0,2,"Braga",2,"Avenida Central",25,25,0,124,124,0
8,6,2018,22,0,2,"Braga",3,"Rua de Caires",37,37,0,36,36,0
8,6,2018,22,0,2,"Braga",4,"N14 Bosch",47,47,0,48,48,0
8,6,2018,22,0,2,"Braga",5,"Avenida João Paulo II",39,39,0,9,9,0
8,6,2018,22,0,2,"Braga",6,"Avenida Padre Júlio Fragata",67,67,0,83,83,0
8,6,2018,22,0,2,"Braga",7,"Rua Nova Santa Cruz",43,43,0,40,40,0
8,6,2018,22,0,2,"Braga",8,"Rua Costa Gomes",40,40,0,43,43,0
8,6,2018,23,0,2,"Braga",1,"Avenida da Liberdade",25,25,0,124,124,0
8,6,2018,23,0,2,"Braga",2,"Avenida Central",25,25,0,124,124,0
8,6,2018,23,0,2,"Braga",3,"Rua de Caires",37,37,0,36,36,0
8,6,2018,23,0,2,"Braga",4,"N14 Bosch",47,47,0,48,48,0
8,6,2018,23,0,2,"Braga",5,"Avenida João Paulo II",39,39,0,9,9,0
8,6,2018,23,0,2,"Braga",6,"Avenida Padre Júlio Fragata",67,67,0,83,83,0
8,6,2018,23,0,2,"Braga",7,"Rua Nova Santa Cruz",43,43,0,40,40,0
8,6,2018,23,0,2,"Braga",8,"Rua Costa Gomes",40,40,0,43,43,0
8,7,2018,0,0,3,"Braga",1,"Avenida da Liberdade",25,25,0,124,124,0
8,7,2018,0,0,3,"Braga",2,"Avenida Central",25,25,0,124,124,0
8,7,2018,0,0,3,"Braga",3,"Rua de Caires",37,37,0,36,36,0
8,7,2018,0,0,3,"Braga",4,"N14 Bosch",47,47,0,48,48,0
8,7,2018,0,0,3,"Braga",5,"Avenida João Paulo II",39,39,0,9,9,0
8,7,2018,0,0,3,"Braga",6,"Avenida Padre Júlio Fragata",67,67,0,83,83,0
8,7,2018,0,0,3,"Braga",7,"Rua Nova Santa Cruz",43,43,0,40,40,0
8,7,2018,0,0,3,"Braga",8,"Rua Costa Gomes",40,40,0,43,43,0
8,7,2018,1,0,3,"Braga",1,"Avenida da Liberdade",19,25,6,163,124,39
8,7,2018,1,0,3,"Braga",2,"Avenida Central",19,25,6,163,124,39
8,7,2018,1,0,3,"Braga",3,"Rua de Caires",37,37,0,36,36,0
8,7,2018,1,0,3,"Braga",4,"N14 Bosch",47,47,0,48,48,0
8,7,2018,1,0,3,"Braga",5,"Avenida João Paulo II",39,39,0,9,9,0
8,7,2018,1,0,3,"Braga",6,"Avenida Padre Júlio Fragata",67,67,0,83,83,0
8,7,2018,1,0,3,"Braga",7,"Rua Nova Santa Cruz",12,43,31,144,40,104
8,7,2018,1,0,3,"Braga",8,"Rua Costa Gomes",40,40,0,43,43,0
8,7,2018,2,0,3,"Braga",1,"Avenida da Liberdade",25,25,0,124,124,0
8,7,2018,2,0,3,"Braga",2,"Avenida Central",25,25,0,124,124,0
8,7,2018,2,0,3,"Braga",3,"Rua de Caires",37,37,0,36,36,0
8,7,2018,2,0,3,"Braga",4,"N14 Bosch",47,47,0,48,48,0
8,7,2018,2,0,3,"Braga",5,"Avenida João Paulo II",39,39,0,9,9,0
8,7,2018,2,0,3,"Braga",6,"Avenida Padre Júlio Fragata",67,67,0,83,83,0
8,7,2018,2,0,3,"Braga",7,"Rua Nova Santa Cruz",43,43,0,40,40,0
8,7,2018,2,0,3,"Braga",8,"Rua Costa Gomes",40,40,0,43,43,0
8,7,2018,3,0,3,"Braga",1,"Avenida da Liberdade",25,25,0,124,124,0
8,7,2018,3,0,3,"Braga",2,"Avenida Central",25,25,0,124,124,0
8,7,2018,3,0,3,"Braga",3,"Rua de Caires",37,37,0,36,36,0
8,7,2018,3,0,3,"Braga",4,"N14 Bosch",47,47,0,48,48,0
8,7,2018,3,0,3,"Braga",5,"Avenida João Paulo II",39,39,0,9,9,0
8,7,2018,3,0,3,"Braga",6,"Avenida Padre Júlio Fragata",67,67,0,83,83,0
8,7,2018,3,0,3,"Braga",7,"Rua Nova Santa Cruz",43,43,0,40,40,0
8,7,2018,3,0,3,"Braga",8,"Rua Costa Gomes",40,40,0,43,43,0
8,7,2018,4,0,3,"Braga",1,"Avenida da Liberdade",25,25,0,124,124,0
8,7,2018,4,0,3,"Braga",2,"Avenida Central",25,25,0,124,124,0
8,7,2018,4,0,3,"Braga",3,"Rua de Caires",37,37,0,36,36,0
8,7,2018,4,0,3,"Braga",4,"N14 Bosch",47,47,0,48,48,0
8,7,2018,4,0,3,"Braga",5,"Avenida João Paulo II",39,39,0,9,9,0
8,7,2018,4,0,3,"Braga",6,"Avenida Padre Júlio Fragata",67,67,0,83,83,0
8,7,2018,4,0,3,"Braga",7,"Rua Nova Santa Cruz",43,43,0,40,40,0
8,7,2018,4,0,3,"Braga",8,"Rua Costa Gomes",40,40,0,43,43,0
8,7,2018,5,0,3,"Braga",1,"Avenida da Liberdade",25,25,0,124,124,0
8,7,2018,5,0,3,"Braga",2,"Avenida Central",25,25,0,124,124,0
8,7,2018,5,0,3,"Braga",3,"Rua de Caires",37,37,0,36,36,0
8,7,2018,5,0,3,"Braga",4,"N14 Bosch",47,47,0,48,48,0
8,7,2018,5,0,3,"Braga",5,"Avenida João Paulo II",39,39,0,9,9,0
8,7,2018,5,0,3,"Braga",6,"Avenida Padre Júlio Fragata",67,67,0,83,83,0
8,7,2018,5,0,3,"Braga",7,"Rua Nova Santa Cruz",43,43,0,40,40,0
8,7,2018,5,0,3,"Braga",8,"Rua Costa Gomes",40,40,0,43,43,0
8,7,2018,6,0,3,"Braga",1,"Avenida da Liberdade",25,25,0,124,124,0
8,7,2018,6,0,3,"Braga",2,"Avenida Central",25,25,0,124,124,0
8,7,2018,6,0,3,"Braga",3,"Rua de Caires",37,37,0,36,36,0
8,7,2018,6,0,3,"Braga",4,"N14 Bosch",47,47,0,48,48,0
8,7,2018,6,0,3,"Braga",5,"Avenida João Paulo II",39,39,0,9,9,0
8,7,2018,6,0,3,"Braga",6,"Avenida Padre Júlio Fragata",67,67,0,83,83,0
8,7,2018,6,0,3,"Braga",7,"Rua Nova Santa Cruz",43,43,0,40,40,0
8,7,2018,6,0,3,"Braga",8,"Rua Costa Gomes",40,40,0,43,43,0
8,7,2018,7,0,3,"Braga",1,"Avenida da Liberdade",25,25,0,124,124,0
8,7,2018,7,0,3,"Braga",2,"Avenida Central",25,25,0,124,124,0
8,7,2018,7,0,3,"Braga",3,"Rua de Caires",37,37,0,36,36,0
8,7,2018,7,0,3,"Braga",4,"N14 Bosch",47,47,0,48,48,0
8,7,2018,7,0,3,"Braga",5,"Avenida João Paulo II",39,39,0,9,9,0
8,7,2018,7,0,3,"Braga",6,"Avenida Padre Júlio Fragata",67,67,0,83,83,0
8,7,2018,7,0,3,"Braga",7,"Rua Nova Santa Cruz",43,43,0,40,40,0
8,7,2018,7,0,3,"Braga",8,"Rua Costa Gomes",40,40,0,43,43,0
8,7,2018,8,0,3,"Braga",1,"Avenida da Liberdade",25,25,0,124,124,0
8,7,2018,8,0,3,"Braga",2,"Avenida Central",25,25,0,124,124,0
8,7,2018,8,0,3,"Braga",3,"Rua de Caires",28,37,9,48,36,12
8,7,2018,8,0,3,"Braga",4,"N14 Bosch",31,47,16,72,48,24
8,7,2018,8,0,3,"Braga",5,"Avenida João Paulo II",39,39,0,9,9,0
8,7,2018,8,0,3,"Braga",6,"Avenida Padre Júlio Fragata",67,67,0,83,83,0
8,7,2018,8,0,3,"Braga",7,"Rua Nova Santa Cruz",43,43,0,40,40,0
8,7,2018,8,0,3,"Braga",8,"Rua Costa Gomes",28,40,12,62,43,19
8,7,2018,9,0,3,"Braga",1,"Avenida da Liberdade",25,25,0,124,124,0
8,7,2018,9,0,3,"Braga",2,"Avenida Central",25,25,0,124,124,0
8,7,2018,9,0,3,"Braga",3,"Rua de Caires",28,37,9,48,36,12
8,7,2018,9,0,3,"Braga",4,"N14 Bosch",33,47,14,68,48,20
8,7,2018,9,0,3,"Braga",5,"Avenida João Paulo II",39,39,0,9,9,0
8,7,2018,9,0,3,"Braga",6,"Avenida Padre Júlio Fragata",67,67,0,83,83,0
8,7,2018,9,0,3,"Braga",7,"Rua Nova Santa Cruz",43,43,0,40,40,0
8,7,2018,9,0,3,"Braga",8,"Rua Costa Gomes",31,40,9,56,43,13
8,7,2018,10,0,3,"Braga",1,"Avenida da Liberdade",25,25,0,124,124,0
8,7,2018,10,0,3,"Braga",2,"Avenida Central",25,25,0,124,124,0
8,7,2018,10,0,3,"Braga",3,"Rua de Caires",23,37,14,59,36,23
8,7,2018,10,0,3,"Braga",4,"N14 Bosch",24,47,23,94,48,46
8,7,2018,10,0,3,"Braga",5,"Avenida João Paulo II",39,39,0,9,9,0
8,7,2018,10,0,3,"Braga",6,"Avenida Padre Júlio Fragata",67,67,0,83,83,0
8,7,2018,10,0,3,"Braga",7,"Rua Nova Santa Cruz",43,43,0,40,40,0
8,7,2018,10,0,3,"Braga",8,"Rua Costa Gomes",30,40,10,58,43,15
8,7,2018,11,0,3,"Braga",1,"Avenida da Liberdade",17,25,8,182,124,58
8,7,2018,11,0,3,"Braga",2,"Avenida Central",17,25,8,182,124,58
8,7,2018,11,0,3,"Braga",3,"Rua de Caires",37,37,0,36,36,0
8,7,2018,11,0,3,"Braga",4,"N14 Bosch",15,47,32,150,48,102
8,7,2018,11,0,3,"Braga",5,"Avenida João Paulo II",30,39,9,12,9,3
8,7,2018,11,0,3,"Braga",6,"Avenida Padre Júlio Fragata",67,67,0,83,83,0
8,7,2018,11,0,3,"Braga",7,"Rua Nova Santa Cruz",43,43,0,40,40,0
8,7,2018,11,0,3,"Braga",8,"Rua Costa Gomes",29,40,11,60,43,17
8,7,2018,12,0,3,"Braga",1,"Avenida da Liberdade",18,25,7,172,124,48
8,7,2018,12,0,3,"Braga",2,"Avenida Central",18,25,7,172,124,48
8,7,2018,12,0,3,"Braga",3,"Rua de Caires",37,37,0,36,36,0
8,7,2018,12,0,3,"Braga",4,"N14 Bosch",36,47,11,62,48,14
8,7,2018,12,0,3,"Braga",5,"Avenida João Paulo II",39,39,0,9,9,0
8,7,2018,12,0,3,"Braga",6,"Avenida Padre Júlio Fragata",53,67,14,105,83,22
8,7,2018,12,0,3,"Braga",7,"Rua Nova Santa Cruz",43,43,0,40,40,0
8,7,2018,12,0,3,"Braga",8,"Rua Costa Gomes",29,40,11,60,43,17
8,7,2018,13,0,3,"Braga",1,"Avenida da Liberdade",25,25,0,124,124,0
8,7,2018,13,0,3,"Braga",2,"Avenida Central",25,25,0,124,124,0
8,7,2018,13,0,3,"Braga",3,"Rua de Caires",37,37,0,36,36,0
8,7,2018,13,0,3,"Braga",4,"N14 Bosch",37,47,10,61,48,13
8,7,2018,13,0,3,"Braga",5,"Avenida João Paulo II",39,39,0,9,9,0
8,7,2018,13,0,3,"Braga",6,"Avenida Padre Júlio Fragata",67,67,0,83,83,0
8,7,2018,13,0,3,"Braga",7,"Rua Nova Santa Cruz",43,43,0,40,40,0
8,7,2018,13,0,3,"Braga",8,"Rua Costa Gomes",26,40,14,67,43,24
8,7,2018,14,0,3,"Braga",1,"Avenida da Liberdade",25,25,0,124,124,0
8,7,2018,14,0,3,"Braga",2,"Avenida Central",25,25,0,124,124,0
8,7,2018,14,0,3,"Braga",3,"Rua de Caires",37,37,0,36,36,0
8,7,2018,14,0,3,"Braga",4,"N14 Bosch",15,47,32,150,48,102
8,7,2018,14,0,3,"Braga",5,"Avenida João Paulo II",27,39,12,13,9,4
8,7,2018,14,0,3,"Braga",6,"Avenida Padre Júlio Fragata",67,67,0,83,83,0
8,7,2018,14,0,3,"Braga",7,"Rua Nova Santa Cruz",43,43,0,40,40,0
8,7,2018,14,0,3,"Braga",8,"Rua Costa Gomes",40,40,0,43,43,0
8,7,2018,15,0,3,"Braga",1,"Avenida da Liberdade",17,25,8,182,124,58
8,7,2018,15,0,3,"Braga",2,"Avenida Central",17,25,8,182,124,58
8,7,2018,15,0,3,"Braga",3,"Rua de Caires",25,37,12,54,36,18
8,7,2018,15,0,3,"Braga",4,"N14 Bosch",47,47,0,48,48,0
8,7,2018,15,0,3,"Braga",5,"Avenida João Paulo II",14,39,25,25,9,16
8,7,2018,15,0,3,"Braga",6,"Avenida Padre Júlio Fragata",48,67,19,116,83,33
8,7,2018,15,0,3,"Braga",7,"Rua Nova Santa Cruz",43,43,0,40,40,0
8,7,2018,15,0,3,"Braga",8,"Rua Costa Gomes",24,40,16,72,43,29
8,7,2018,16,0,3,"Braga",1,"Avenida da Liberdade",17,25,8,182,124,58
8,7,2018,16,0,3,"Braga",2,"Avenida Central",17,25,8,182,124,58
8,7,2018,16,0,3,"Braga",3,"Rua de Caires",37,37,0,36,36,0
8,7,2018,16,0,3,"Braga",4,"N14 Bosch",22,47,25,102,48,54
8,7,2018,16,0,3,"Braga",5,"Avenida João Paulo II",22,39,17,16,9,7
8,7,2018,16,0,3,"Braga",6,"Avenida Padre Júlio Fragata",53,67,14,105,83,22
8,7,2018,16,0,3,"Braga",7,"Rua Nova Santa Cruz",43,43,0,40,40,0
8,7,2018,16,0,3,"Braga",8,"Rua Costa Gomes",40,40,0,43,43,0
8,7,2018,17,0,3,"Braga",1,"Avenida da Liberdade",17,25,8,182,124,58
8,7,2018,17,0,3,"Braga",2,"Avenida Central",17,25,8,182,124,58
8,7,2018,17,0,3,"Braga",3,"Rua de Caires",21,37,16,64,36,28
8,7,2018,17,0,3,"Braga",4,"N14 Bosch",14,47,33,160,48,112
8,7,2018,17,0,3,"Braga",5,"Avenida João Paulo II",39,39,0,9,9,0
8,7,2018,17,0,3,"Braga",6,"Avenida Padre Júlio Fragata",24,67,43,232,83,149
8,7,2018,17,0,3,"Braga",7,"Rua Nova Santa Cruz",43,43,0,40,40,0
8,7,2018,17,0,3,"Braga",8,"Rua Costa Gomes",15,40,25,115,43,72
8,7,2018,18,0,3,"Braga",1,"Avenida da Liberdade",25,25,0,124,124,0
8,7,2018,18,0,3,"Braga",2,"Avenida Central",25,25,0,124,124,0
8,7,2018,18,0,3,"Braga",3,"Rua de Caires",25,37,12,54,36,18
8,7,2018,18,0,3,"Braga",4,"N14 Bosch",25,47,22,90,48,42
8,7,2018,18,0,3,"Braga",5,"Avenida João Paulo II",6,39,33,58,9,49
8,7,2018,18,0,3,"Braga",6,"Avenida Padre Júlio Fragata",20,67,47,279,83,196
8,7,2018,18,0,3,"Braga",7,"Rua Nova Santa Cruz",32,43,11,54,40,14
8,7,2018,18,0,3,"Braga",8,"Rua Costa Gomes",10,40,30,173,43,130
8,7,2018,19,0,3,"Braga",1,"Avenida da Liberdade",25,25,0,124,124,0
8,7,2018,19,0,3,"Braga",2,"Avenida Central",25,25,0,124,124,0
8,7,2018,19,0,3,"Braga",3,"Rua de Caires",37,37,0,36,36,0
8,7,2018,19,0,3,"Braga",4,"N14 Bosch",47,47,0,48,48,0
8,7,2018,19,0,3,"Braga",5,"Avenida João Paulo II",39,39,0,9,9,0
8,7,2018,19,0,3,"Braga",6,"Avenida Padre Júlio Fragata",29,67,38,192,83,109
8,7,2018,19,0,3,"Braga",7,"Rua Nova Santa Cruz",43,43,0,40,40,0
8,7,2018,19,0,3,"Braga",8,"Rua Costa Gomes",21,40,19,82,43,39
8,7,2018,20,0,3,"Braga",1,"Avenida da Liberdade",25,25,0,124,124,0
8,7,2018,20,0,3,"Braga",2,"Avenida Central",25,25,0,124,124,0
8,7,2018,20,0,3,"Braga",3,"Rua de Caires",37,37,0,36,36,0
8,7,2018,20,0,3,"Braga",4,"N14 Bosch",47,47,0,48,48,0
8,7,2018,20,0,3,"Braga",5,"Avenida João Paulo II",39,39,0,9,9,0
8,7,2018,20,0,3,"Braga",6,"Avenida Padre Júlio Fragata",67,67,0,83,83,0
8,7,2018,20,0,3,"Braga",7,"Rua Nova Santa Cruz",43,43,0,40,40,0
8,7,2018,20,0,3,"Braga",8,"Rua Costa Gomes",40,40,0,43,43,0
8,7,2018,21,0,3,"Braga",1,"Avenida da Liberdade",25,25,0,124,124,0
8,7,2018,21,0,3,"Braga",2,"Avenida Central",25,25,0,124,124,0
8,7,2018,21,0,3,"Braga",3,"Rua de Caires",37,37,0,36,36,0
8,7,2018,21,0,3,"Braga",4,"N14 Bosch",47,47,0,48,48,0
8,7,2018,21,0,3,"Braga",5,"Avenida João Paulo II",39,39,0,9,9,0
8,7,2018,21,0,3,"Braga",6,"Avenida Padre Júlio Fragata",67,67,0,83,83,0
8,7,2018,21,0,3,"Braga",7,"Rua Nova Santa Cruz",43,43,0,40,40,0
8,7,2018,21,0,3,"Braga",8,"Rua Costa Gomes",40,40,0,43,43,0
8,7,2018,22,0,3,"Braga",1,"Avenida da Liberdade",19,25,6,163,124,39
8,7,2018,22,0,3,"Braga",2,"Avenida Central",19,25,6,163,124,39
8,7,2018,22,0,3,"Braga",3,"Rua de Caires",28,37,9,48,36,12
8,7,2018,22,0,3,"Braga",4,"N14 Bosch",47,47,0,48,48,0
8,7,2018,22,0,3,"Braga",5,"Avenida João Paulo II",39,39,0,9,9,0
8,7,2018,22,0,3,"Braga",6,"Avenida Padre Júlio Fragata",67,67,0,83,83,0
8,7,2018,22,0,3,"Braga",7,"Rua Nova Santa Cruz",43,43,0,40,40,0
8,7,2018,22,0,3,"Braga",8,"Rua Costa Gomes",40,40,0,43,43,0
8,7,2018,23,0,3,"Braga",1,"Avenida da Liberdade",25,25,0,124,124,0
8,7,2018,23,0,3,"Braga",2,"Avenida Central",25,25,0,124,124,0
8,7,2018,23,0,3,"Braga",3,"Rua de Caires",37,37,0,36,36,0
8,7,2018,23,0,3,"Braga",4,"N14 Bosch",47,47,0,48,48,0
8,7,2018,23,0,3,"Braga",5,"Avenida João Paulo II",39,39,0,9,9,0
8,7,2018,23,0,3,"Braga",6,"Avenida Padre Júlio Fragata",67,67,0,83,83,0
8,7,2018,23,0,3,"Braga",7,"Rua Nova Santa Cruz",43,43,0,40,40,0
8,7,2018,23,0,3,"Braga",8,"Rua Costa Gomes",40,40,0,43,43,0
8,8,2018,0,0,4,"Braga",1,"Avenida da Liberdade",25,25,0,124,124,0
8,8,2018,0,0,4,"Braga",2,"Avenida Central",25,25,0,124,124,0
8,8,2018,0,0,4,"Braga",3,"Rua de Caires",37,37,0,36,36,0
8,8,2018,0,0,4,"Braga",4,"N14 Bosch",47,47,0,48,48,0
8,8,2018,0,0,4,"Braga",5,"Avenida João Paulo II",39,39,0,9,9,0
8,8,2018,0,0,4,"Braga",6,"Avenida Padre Júlio Fragata",67,67,0,83,83,0
8,8,2018,0,0,4,"Braga",7,"Rua Nova Santa Cruz",43,43,0,40,40,0
8,8,2018,0,0,4,"Braga",8,"Rua Costa Gomes",40,40,0,43,43,0
8,8,2018,1,0,4,"Braga",1,"Avenida da Liberdade",25,25,0,124,124,0
8,8,2018,1,0,4,"Braga",2,"Avenida Central",25,25,0,124,124,0
8,8,2018,1,0,4,"Braga",3,"Rua de Caires",37,37,0,36,36,0
8,8,2018,1,0,4,"Braga",4,"N14 Bosch",47,47,0,48,48,0
8,8,2018,1,0,4,"Braga",5,"Avenida João Paulo II",39,39,0,9,9,0
8,8,2018,1,0,4,"Braga",6,"Avenida Padre Júlio Fragata",67,67,0,83,83,0
8,8,2018,1,0,4,"Braga",7,"Rua Nova Santa Cruz",43,43,0,40,40,0
8,8,2018,1,0,4,"Braga",8,"Rua Costa Gomes",40,40,0,43,43,0
8,8,2018,2,0,4,"Braga",1,"Avenida da Liberdade",25,25,0,124,124,0
8,8,2018,2,0,4,"Braga",2,"Avenida Central",25,25,0,124,124,0
8,8,2018,2,0,4,"Braga",3,"Rua de Caires",37,37,0,36,36,0
8,8,2018,2,0,4,"Braga",4,"N14 Bosch",47,47,0,48,48,0
8,8,2018,2,0,4,"Braga",5,"Avenida João Paulo II",39,39,0,9,9,0
8,8,2018,2,0,4,"Braga",6,"Avenida Padre Júlio Fragata",67,67,0,83,83,0
8,8,2018,2,0,4,"Braga",7,"Rua Nova Santa Cruz",43,43,0,40,40,0
8,8,2018,2,0,4,"Braga",8,"Rua Costa Gomes",40,40,0,43,43,0
8,8,2018,3,0,4,"Braga",1,"Avenida da Liberdade",25,25,0,124,124,0
8,8,2018,3,0,4,"Braga",2,"Avenida Central",25,25,0,124,124,0
8,8,2018,3,0,4,"Braga",3,"Rua de Caires",37,37,0,36,36,0
8,8,2018,3,0,4,"Braga",4,"N14 Bosch",47,47,0,48,48,0
8,8,2018,3,0,4,"Braga",5,"Avenida João Paulo II",39,39,0,9,9,0
8,8,2018,3,0,4,"Braga",6,"Avenida Padre Júlio Fragata",67,67,0,83,83,0
8,8,2018,3,0,4,"Braga",7,"Rua Nova Santa Cruz",43,43,0,40,40,0
8,8,2018,3,0,4,"Braga",8,"Rua Costa Gomes",40,40,0,43,43,0
8,8,2018,4,0,4,"Braga",1,"Avenida da Liberdade",25,25,0,124,124,0
8,8,2018,4,0,4,"Braga",2,"Avenida Central",25,25,0,124,124,0
8,8,2018,4,0,4,"Braga",3,"Rua de Caires",37,37,0,36,36,0
8,8,2018,4,0,4,"Braga",4,"N14 Bosch",47,47,0,48,48,0
8,8,2018,4,0,4,"Braga",5,"Avenida João Paulo II",39,39,0,9,9,0
8,8,2018,4,0,4,"Braga",6,"Avenida Padre Júlio Fragata",67,67,0,83,83,0
8,8,2018,4,0,4,"Braga",7,"Rua Nova Santa Cruz",43,43,0,40,40,0
8,8,2018,4,0,4,"Braga",8,"Rua Costa Gomes",40,40,0,43,43,0
8,8,2018,5,0,4,"Braga",1,"Avenida da Liberdade",25,25,0,124,124,0
8,8,2018,5,0,4,"Braga",2,"Avenida Central",25,25,0,124,124,0
8,8,2018,5,0,4,"Braga",3,"Rua de Caires",37,37,0,36,36,0
8,8,2018,5,0,4,"Braga",4,"N14 Bosch",47,47,0,48,48,0
8,8,2018,5,0,4,"Braga",5,"Avenida João Paulo II",39,39,0,9,9,0
8,8,2018,5,0,4,"Braga",6,"Avenida Padre Júlio Fragata",67,67,0,83,83,0
8,8,2018,5,0,4,"Braga",7,"Rua Nova Santa Cruz",43,43,0,40,40,0
8,8,2018,5,0,4,"Braga",8,"Rua Costa Gomes",40,40,0,43,43,0
8,8,2018,6,0,4,"Braga",1,"Avenida da Liberdade",25,25,0,124,124,0
8,8,2018,6,0,4,"Braga",2,"Avenida Central",25,25,0,124,124,0
8,8,2018,6,0,4,"Braga",3,"Rua de Caires",37,37,0,36,36,0
8,8,2018,6,0,4,"Braga",4,"N14 Bosch",47,47,0,48,48,0
8,8,2018,6,0,4,"Braga",5,"Avenida João Paulo II",39,39,0,9,9,0
8,8,2018,6,0,4,"Braga",6,"Avenida Padre Júlio Fragata",67,67,0,83,83,0
8,8,2018,6,0,4,"Braga",7,"Rua Nova Santa Cruz",43,43,0,40,40,0
8,8,2018,6,0,4,"Braga",8,"Rua Costa Gomes",40,40,0,43,43,0
8,8,2018,8,0,4,"Braga",1,"Avenida da Liberdade",25,25,0,124,124,0
8,8,2018,8,0,4,"Braga",2,"Avenida Central",25,25,0,124,124,0
8,8,2018,8,0,4,"Braga",3,"Rua de Caires",26,37,11,52,36,16
8,8,2018,8,0,4,"Braga",4,"N14 Bosch",32,47,15,70,48,22
8,8,2018,8,0,4,"Braga",5,"Avenida João Paulo II",39,39,0,9,9,0
8,8,2018,8,0,4,"Braga",6,"Avenida Padre Júlio Fragata",67,67,0,83,83,0
8,8,2018,8,0,4,"Braga",7,"Rua Nova Santa Cruz",43,43,0,40,40,0
8,8,2018,8,0,4,"Braga",8,"Rua Costa Gomes",40,40,0,43,43,0
8,8,2018,9,0,4,"Braga",1,"Avenida da Liberdade",25,25,0,124,124,0
8,8,2018,9,0,4,"Braga",2,"Avenida Central",25,25,0,124,124,0
8,8,2018,9,0,4,"Braga",3,"Rua de Caires",22,37,15,61,36,25
8,8,2018,9,0,4,"Braga",4,"N14 Bosch",29,47,18,77,48,29
8,8,2018,9,0,4,"Braga",5,"Avenida João Paulo II",39,39,0,9,9,0
8,8,2018,9,0,4,"Braga",6,"Avenida Padre Júlio Fragata",67,67,0,83,83,0
8,8,2018,9,0,4,"Braga",7,"Rua Nova Santa Cruz",43,43,0,40,40,0
8,8,2018,9,0,4,"Braga",8,"Rua Costa Gomes",29,40,11,60,43,17
8,8,2018,10,0,4,"Braga",1,"Avenida da Liberdade",25,25,0,124,124,0
8,8,2018,10,0,4,"Braga",2,"Avenida Central",25,25,0,124,124,0
8,8,2018,10,0,4,"Braga",3,"Rua de Caires",27,37,10,50,36,14
8,8,2018,10,0,4,"Braga",4,"N14 Bosch",31,47,16,72,48,24
8,8,2018,10,0,4,"Braga",5,"Avenida João Paulo II",39,39,0,9,9,0
8,8,2018,10,0,4,"Braga",6,"Avenida Padre Júlio Fragata",67,67,0,83,83,0
8,8,2018,10,0,4,"Braga",7,"Rua Nova Santa Cruz",43,43,0,40,40,0
8,8,2018,10,0,4,"Braga",8,"Rua Costa Gomes",40,40,0,43,43,0
8,8,2018,11,0,4,"Braga",1,"Avenida da Liberdade",25,25,0,124,124,0
8,8,2018,11,0,4,"Braga",2,"Avenida Central",25,25,0,124,124,0
8,8,2018,11,0,4,"Braga",3,"Rua de Caires",37,37,0,36,36,0
8,8,2018,11,0,4,"Braga",4,"N14 Bosch",47,47,0,48,48,0
8,8,2018,11,0,4,"Braga",5,"Avenida João Paulo II",39,39,0,9,9,0
8,8,2018,11,0,4,"Braga",6,"Avenida Padre Júlio Fragata",67,67,0,83,83,0
8,8,2018,11,0,4,"Braga",7,"Rua Nova Santa Cruz",43,43,0,40,40,0
8,8,2018,11,0,4,"Braga",8,"Rua Costa Gomes",40,40,0,43,43,0
8,8,2018,12,0,4,"Braga",1,"Avenida da Liberdade",25,25,0,124,124,0
8,8,2018,12,0,4,"Braga",2,"Avenida Central",25,25,0,124,124,0
8,8,2018,12,0,4,"Braga",3,"Rua de Caires",23,37,14,59,36,23
8,8,2018,12,0,4,"Braga",4,"N14 Bosch",26,47,21,86,48,38
8,8,2018,12,0,4,"Braga",5,"Avenida João Paulo II",39,39,0,9,9,0
8,8,2018,12,0,4,"Braga",6,"Avenida Padre Júlio Fragata",67,67,0,83,83,0
8,8,2018,12,0,4,"Braga",7,"Rua Nova Santa Cruz",43,43,0,40,40,0
8,8,2018,12,0,4,"Braga",8,"Rua Costa Gomes",18,40,22,96,43,53
8,8,2018,13,0,4,"Braga",1,"Avenida da Liberdade",25,25,0,124,124,0
8,8,2018,13,0,4,"Braga",2,"Avenida Central",25,25,0,124,124,0
8,8,2018,13,0,4,"Braga",3,"Rua de Caires",22,37,15,61,36,25
8,8,2018,13,0,4,"Braga",4,"N14 Bosch",28,47,19,80,48,32
8,8,2018,13,0,4,"Braga",5,"Avenida João Paulo II",39,39,0,9,9,0
8,8,2018,13,0,4,"Braga",6,"Avenida Padre Júlio Fragata",67,67,0,83,83,0
8,8,2018,13,0,4,"Braga",7,"Rua Nova Santa Cruz",30,43,13,58,40,18
8,8,2018,13,0,4,"Braga",8,"Rua Costa Gomes",31,40,9,56,43,13
8,8,2018,14,0,4,"Braga",1,"Avenida da Liberdade",25,25,0,124,124,0
8,8,2018,14,0,4,"Braga",2,"Avenida Central",25,25,0,124,124,0
8,8,2018,14,0,4,"Braga",3,"Rua de Caires",24,37,13,56,36,20
8,8,2018,14,0,4,"Braga",4,"N14 Bosch",27,47,20,83,48,35
8,8,2018,14,0,4,"Braga",5,"Avenida João Paulo II",20,39,19,17,9,8
8,8,2018,14,0,4,"Braga",6,"Avenida Padre Júlio Fragata",67,67,0,83,83,0
8,8,2018,14,0,4,"Braga",7,"Rua Nova Santa Cruz",43,43,0,40,40,0
8,8,2018,14,0,4,"Braga",8,"Rua Costa Gomes",40,40,0,43,43,0
8,8,2018,16,0,4,"Braga",1,"Avenida da Liberdade",17,25,8,182,124,58
8,8,2018,16,0,4,"Braga",2,"Avenida Central",17,25,8,182,124,58
8,8,2018,16,0,4,"Braga",3,"Rua de Caires",37,37,0,36,36,0
8,8,2018,16,0,4,"Braga",4,"N14 Bosch",20,47,27,112,48,64
8,8,2018,16,0,4,"Braga",5,"Avenida João Paulo II",39,39,0,9,9,0
8,8,2018,16,0,4,"Braga",6,"Avenida Padre Júlio Fragata",67,67,0,83,83,0
8,8,2018,16,0,4,"Braga",7,"Rua Nova Santa Cruz",25,43,18,69,40,29
8,8,2018,16,0,4,"Braga",8,"Rua Costa Gomes",22,40,18,79,43,36
8,8,2018,17,0,4,"Braga",1,"Avenida da Liberdade",15,25,10,207,124,83
8,8,2018,17,0,4,"Braga",2,"Avenida Central",15,25,10,207,124,83
8,8,2018,17,0,4,"Braga",3,"Rua de Caires",37,37,0,36,36,0
8,8,2018,17,0,4,"Braga",4,"N14 Bosch",25,47,22,90,48,42
8,8,2018,17,0,4,"Braga",5,"Avenida João Paulo II",20,39,19,17,9,8
8,8,2018,17,0,4,"Braga",6,"Avenida Padre Júlio Fragata",25,67,42,223,83,140
8,8,2018,17,0,4,"Braga",7,"Rua Nova Santa Cruz",43,43,0,40,40,0
8,8,2018,17,0,4,"Braga",8,"Rua Costa Gomes",16,40,24,108,43,65
8,8,2018,18,0,4,"Braga",1,"Avenida da Liberdade",18,25,7,172,124,48
8,8,2018,18,0,4,"Braga",2,"Avenida Central",18,25,7,172,124,48
8,8,2018,18,0,4,"Braga",3,"Rua de Caires",24,37,13,56,36,20
8,8,2018,18,0,4,"Braga",4,"N14 Bosch",15,47,32,150,48,102
8,8,2018,18,0,4,"Braga",5,"Avenida João Paulo II",15,39,24,23,9,14
8,8,2018,18,0,4,"Braga",6,"Avenida Padre Júlio Fragata",19,67,48,293,83,210
8,8,2018,18,0,4,"Braga",7,"Rua Nova Santa Cruz",43,43,0,40,40,0
8,8,2018,18,0,4,"Braga",8,"Rua Costa Gomes",8,40,32,216,43,173
8,8,2018,19,0,4,"Braga",1,"Avenida da Liberdade",25,25,0,124,124,0
8,8,2018,19,0,4,"Braga",2,"Avenida Central",25,25,0,124,124,0
8,8,2018,19,0,4,"Braga",3,"Rua de Caires",37,37,0,36,36,0
8,8,2018,19,0,4,"Braga",4,"N14 Bosch",47,47,0,48,48,0
8,8,2018,19,0,4,"Braga",5,"Avenida João Paulo II",13,39,26,27,9,18
8,8,2018,19,0,4,"Braga",6,"Avenida Padre Júlio Fragata",22,67,45,253,83,170
8,8,2018,19,0,4,"Braga",7,"Rua Nova Santa Cruz",34,43,9,51,40,11
8,8,2018,19,0,4,"Braga",8,"Rua Costa Gomes",26,40,14,67,43,24
8,8,2018,20,0,4,"Braga",1,"Avenida da Liberdade",25,25,0,124,124,0
8,8,2018,20,0,4,"Braga",2,"Avenida Central",25,25,0,124,124,0
8,8,2018,20,0,4,"Braga",3,"Rua de Caires",37,37,0,36,36,0
8,8,2018,20,0,4,"Braga",4,"N14 Bosch",47,47,0,48,48,0
8,8,2018,20,0,4,"Braga",5,"Avenida João Paulo II",39,39,0,9,9,0
8,8,2018,20,0,4,"Braga",6,"Avenida Padre Júlio Fragata",67,67,0,83,83,0
8,8,2018,20,0,4,"Braga",7,"Rua Nova Santa Cruz",43,43,0,40,40,0
8,8,2018,20,0,4,"Braga",8,"Rua Costa Gomes",40,40,0,43,43,0
8,8,2018,21,0,4,"Braga",1,"Avenida da Liberdade",25,25,0,124,124,0
8,8,2018,21,0,4,"Braga",2,"Avenida Central",25,25,0,124,124,0
8,8,2018,21,0,4,"Braga",3,"Rua de Caires",37,37,0,36,36,0
8,8,2018,21,0,4,"Braga",4,"N14 Bosch",47,47,0,48,48,0
8,8,2018,21,0,4,"Braga",5,"Avenida João Paulo II",39,39,0,9,9,0
8,8,2018,21,0,4,"Braga",6,"Avenida Padre Júlio Fragata",67,67,0,83,83,0
8,8,2018,21,0,4,"Braga",7,"Rua Nova Santa Cruz",43,43,0,40,40,0
8,8,2018,21,0,4,"Braga",8,"Rua Costa Gomes",40,40,0,43,43,0
8,8,2018,22,0,4,"Braga",1,"Avenida da Liberdade",25,25,0,124,124,0
8,8,2018,22,0,4,"Braga",2,"Avenida Central",25,25,0,124,124,0
8,8,2018,22,0,4,"Braga",3,"Rua de Caires",37,37,0,36,36,0
8,8,2018,22,0,4,"Braga",4,"N14 Bosch",47,47,0,48,48,0
8,8,2018,22,0,4,"Braga",5,"Avenida João Paulo II",39,39,0,9,9,0
8,8,2018,22,0,4,"Braga",6,"Avenida Padre Júlio Fragata",67,67,0,83,83,0
8,8,2018,22,0,4,"Braga",7,"Rua Nova Santa Cruz",43,43,0,40,40,0
8,8,2018,22,0,4,"Braga",8,"Rua Costa Gomes",40,40,0,43,43,0
8,8,2018,23,0,4,"Braga",1,"Avenida da Liberdade",25,25,0,124,124,0
8,8,2018,23,0,4,"Braga",2,"Avenida Central",25,25,0,124,124,0
8,8,2018,23,0,4,"Braga",3,"Rua de Caires",37,37,0,36,36,0
8,8,2018,23,0,4,"Braga",4,"N14 Bosch",47,47,0,48,48,0
8,8,2018,23,0,4,"Braga",5,"Avenida João Paulo II",39,39,0,9,9,0
8,8,2018,23,0,4,"Braga",6,"Avenida Padre Júlio Fragata",67,67,0,83,83,0
8,8,2018,23,0,4,"Braga",7,"Rua Nova Santa Cruz",43,43,0,40,40,0
8,8,2018,23,0,4,"Braga",8,"Rua Costa Gomes",40,40,0,43,43,0
8,9,2018,0,0,5,"Braga",1,"Avenida da Liberdade",25,25,0,124,124,0
8,9,2018,0,0,5,"Braga",2,"Avenida Central",25,25,0,124,124,0
8,9,2018,0,0,5,"Braga",3,"Rua de Caires",37,37,0,36,36,0
8,9,2018,0,0,5,"Braga",4,"N14 Bosch",47,47,0,48,48,0
8,9,2018,0,0,5,"Braga",5,"Avenida João Paulo II",39,39,0,9,9,0
8,9,2018,0,0,5,"Braga",6,"Avenida Padre Júlio Fragata",67,67,0,83,83,0
8,9,2018,0,0,5,"Braga",7,"Rua Nova Santa Cruz",43,43,0,40,40,0
8,9,2018,0,0,5,"Braga",8,"Rua Costa Gomes",40,40,0,43,43,0
8,9,2018,1,0,5,"Braga",1,"Avenida da Liberdade",25,25,0,124,124,0
8,9,2018,1,0,5,"Braga",2,"Avenida Central",25,25,0,124,124,0
8,9,2018,1,0,5,"Braga",3,"Rua de Caires",37,37,0,36,36,0
8,9,2018,1,0,5,"Braga",4,"N14 Bosch",47,47,0,48,48,0
8,9,2018,1,0,5,"Braga",5,"Avenida João Paulo II",39,39,0,9,9,0
8,9,2018,1,0,5,"Braga",6,"Avenida Padre Júlio Fragata",67,67,0,83,83,0
8,9,2018,1,0,5,"Braga",7,"Rua Nova Santa Cruz",43,43,0,40,40,0
8,9,2018,1,0,5,"Braga",8,"Rua Costa Gomes",40,40,0,43,43,0
8,9,2018,2,0,5,"Braga",1,"Avenida da Liberdade",25,25,0,124,124,0
8,9,2018,2,0,5,"Braga",2,"Avenida Central",25,25,0,124,124,0
8,9,2018,2,0,5,"Braga",3,"Rua de Caires",37,37,0,36,36,0
8,9,2018,2,0,5,"Braga",4,"N14 Bosch",47,47,0,48,48,0
8,9,2018,2,0,5,"Braga",5,"Avenida João Paulo II",39,39,0,9,9,0
8,9,2018,2,0,5,"Braga",6,"Avenida Padre Júlio Fragata",67,67,0,83,83,0
8,9,2018,2,0,5,"Braga",7,"Rua Nova Santa Cruz",43,43,0,40,40,0
8,9,2018,2,0,5,"Braga",8,"Rua Costa Gomes",40,40,0,43,43,0
8,9,2018,3,0,5,"Braga",1,"Avenida da Liberdade",25,25,0,124,124,0
8,9,2018,3,0,5,"Braga",2,"Avenida Central",25,25,0,124,124,0
8,9,2018,3,0,5,"Braga",3,"Rua de Caires",37,37,0,36,36,0
8,9,2018,3,0,5,"Braga",4,"N14 Bosch",47,47,0,48,48,0
8,9,2018,3,0,5,"Braga",5,"Avenida João Paulo II",39,39,0,9,9,0
8,9,2018,3,0,5,"Braga",6,"Avenida Padre Júlio Fragata",67,67,0,83,83,0
8,9,2018,3,0,5,"Braga",7,"Rua Nova Santa Cruz",43,43,0,40,40,0
8,9,2018,3,0,5,"Braga",8,"Rua Costa Gomes",40,40,0,43,43,0
8,9,2018,4,0,5,"Braga",1,"Avenida da Liberdade",25,25,0,124,124,0
8,9,2018,4,0,5,"Braga",2,"Avenida Central",25,25,0,124,124,0
8,9,2018,4,0,5,"Braga",3,"Rua de Caires",37,37,0,36,36,0
8,9,2018,4,0,5,"Braga",4,"N14 Bosch",47,47,0,48,48,0
8,9,2018,4,0,5,"Braga",5,"Avenida João Paulo II",39,39,0,9,9,0
8,9,2018,4,0,5,"Braga",6,"Avenida Padre Júlio Fragata",67,67,0,83,83,0
8,9,2018,4,0,5,"Braga",7,"Rua Nova Santa Cruz",43,43,0,40,40,0
8,9,2018,4,0,5,"Braga",8,"Rua Costa Gomes",40,40,0,43,43,0
8,9,2018,5,0,5,"Braga",1,"Avenida da Liberdade",25,25,0,124,124,0
8,9,2018,5,0,5,"Braga",2,"Avenida Central",25,25,0,124,124,0
8,9,2018,5,0,5,"Braga",3,"Rua de Caires",37,37,0,36,36,0
8,9,2018,5,0,5,"Braga",4,"N14 Bosch",47,47,0,48,48,0
8,9,2018,5,0,5,"Braga",5,"Avenida João Paulo II",39,39,0,9,9,0
8,9,2018,5,0,5,"Braga",6,"Avenida Padre Júlio Fragata",67,67,0,83,83,0
8,9,2018,5,0,5,"Braga",7,"Rua Nova Santa Cruz",43,43,0,40,40,0
8,9,2018,5,0,5,"Braga",8,"Rua Costa Gomes",40,40,0,43,43,0
8,9,2018,7,0,5,"Braga",1,"Avenida da Liberdade",25,25,0,124,124,0
8,9,2018,7,0,5,"Braga",2,"Avenida Central",25,25,0,124,124,0
8,9,2018,7,0,5,"Braga",3,"Rua de Caires",37,37,0,36,36,0
8,9,2018,7,0,5,"Braga",4,"N14 Bosch",47,47,0,48,48,0
8,9,2018,7,0,5,"Braga",5,"Avenida João Paulo II",39,39,0,9,9,0
8,9,2018,7,0,5,"Braga",6,"Avenida Padre Júlio Fragata",67,67,0,83,83,0
8,9,2018,7,0,5,"Braga",7,"Rua Nova Santa Cruz",30,43,13,58,40,18
8,9,2018,7,0,5,"Braga",8,"Rua Costa Gomes",40,40,0,43,43,0
8,9,2018,9,0,5,"Braga",1,"Avenida da Liberdade",25,25,0,124,124,0
8,9,2018,9,0,5,"Braga",2,"Avenida Central",25,25,0,124,124,0
8,9,2018,9,0,5,"Braga",3,"Rua de Caires",27,37,10,50,36,14
8,9,2018,9,0,5,"Braga",4,"N14 Bosch",31,47,16,72,48,24
8,9,2018,9,0,5,"Braga",5,"Avenida João Paulo II",39,39,0,9,9,0
8,9,2018,9,0,5,"Braga",6,"Avenida Padre Júlio Fragata",67,67,0,83,83,0
8,9,2018,9,0,5,"Braga",7,"Rua Nova Santa Cruz",43,43,0,40,40,0
8,9,2018,9,0,5,"Braga",8,"Rua Costa Gomes",31,40,9,56,43,13
8,9,2018,10,0,5,"Braga",1,"Avenida da Liberdade",25,25,0,124,124,0
8,9,2018,10,0,5,"Braga",2,"Avenida Central",25,25,0,124,124,0
8,9,2018,10,0,5,"Braga",3,"Rua de Caires",26,37,11,52,36,16
8,9,2018,10,0,5,"Braga",4,"N14 Bosch",23,47,24,98,48,50
8,9,2018,10,0,5,"Braga",5,"Avenida João Paulo II",39,39,0,9,9,0
8,9,2018,10,0,5,"Braga",6,"Avenida Padre Júlio Fragata",67,67,0,83,83,0
8,9,2018,10,0,5,"Braga",7,"Rua Nova Santa Cruz",43,43,0,40,40,0
8,9,2018,10,0,5,"Braga",8,"Rua Costa Gomes",30,40,10,58,43,15
8,9,2018,11,0,5,"Braga",1,"Avenida da Liberdade",25,25,0,124,124,0
8,9,2018,11,0,5,"Braga",2,"Avenida Central",25,25,0,124,124,0
8,9,2018,11,0,5,"Braga",3,"Rua de Caires",8,37,29,168,36,132
8,9,2018,11,0,5,"Braga",4,"N14 Bosch",22,47,25,102,48,54
8,9,2018,11,0,5,"Braga",5,"Avenida João Paulo II",39,39,0,9,9,0
8,9,2018,11,0,5,"Braga",6,"Avenida Padre Júlio Fragata",67,67,0,83,83,0
8,9,2018,11,0,5,"Braga",7,"Rua Nova Santa Cruz",34,43,9,51,40,11
8,9,2018,11,0,5,"Braga",8,"Rua Costa Gomes",30,40,10,58,43,15
8,9,2018,12,0,5,"Braga",1,"Avenida da Liberdade",25,25,0,124,124,0
8,9,2018,12,0,5,"Braga",2,"Avenida Central",25,25,0,124,124,0
8,9,2018,12,0,5,"Braga",3,"Rua de Caires",37,37,0,36,36,0
8,9,2018,12,0,5,"Braga",4,"N14 Bosch",47,47,0,48,48,0
8,9,2018,12,0,5,"Braga",5,"Avenida João Paulo II",39,39,0,9,9,0
8,9,2018,12,0,5,"Braga",6,"Avenida Padre Júlio Fragata",67,67,0,83,83,0
8,9,2018,12,0,5,"Braga",7,"Rua Nova Santa Cruz",43,43,0,40,40,0
8,9,2018,12,0,5,"Braga",8,"Rua Costa Gomes",30,40,10,58,43,15
8,9,2018,13,0,5,"Braga",1,"Avenida da Liberdade",25,25,0,124,124,0
8,9,2018,13,0,5,"Braga",2,"Avenida Central",25,25,0,124,124,0
8,9,2018,13,0,5,"Braga",3,"Rua de Caires",28,37,9,48,36,12
8,9,2018,13,0,5,"Braga",4,"N14 Bosch",29,47,18,77,48,29
8,9,2018,13,0,5,"Braga",5,"Avenida João Paulo II",39,39,0,9,9,0
8,9,2018,13,0,5,"Braga",6,"Avenida Padre Júlio Fragata",67,67,0,83,83,0
8,9,2018,13,0,5,"Braga",7,"Rua Nova Santa Cruz",16,43,27,108,40,68
8,9,2018,13,0,5,"Braga",8,"Rua Costa Gomes",40,40,0,43,43,0
8,9,2018,14,0,5,"Braga",1,"Avenida da Liberdade",18,25,7,172,124,48
8,9,2018,14,0,5,"Braga",2,"Avenida Central",18,25,7,172,124,48
8,9,2018,14,0,5,"Braga",3,"Rua de Caires",27,37,10,50,36,14
8,9,2018,14,0,5,"Braga",4,"N14 Bosch",33,47,14,68,48,20
8,9,2018,14,0,5,"Braga",5,"Avenida João Paulo II",25,39,14,14,9,5
8,9,2018,14,0,5,"Braga",6,"Avenida Padre Júlio Fragata",50,67,17,111,83,28
8,9,2018,14,0,5,"Braga",7,"Rua Nova Santa Cruz",32,43,11,54,40,14
8,9,2018,14,0,5,"Braga",8,"Rua Costa Gomes",40,40,0,43,43,0
8,9,2018,15,0,5,"Braga",1,"Avenida da Liberdade",25,25,0,124,124,0
8,9,2018,15,0,5,"Braga",2,"Avenida Central",25,25,0,124,124,0
8,9,2018,15,0,5,"Braga",3,"Rua de Caires",29,37,8,46,36,10
8,9,2018,15,0,5,"Braga",4,"N14 Bosch",31,47,16,72,48,24
8,9,2018,15,0,5,"Braga",5,"Avenida João Paulo II",16,39,23,22,9,13
8,9,2018,15,0,5,"Braga",6,"Avenida Padre Júlio Fragata",45,67,22,124,83,41
8,9,2018,15,0,5,"Braga",7,"Rua Nova Santa Cruz",43,43,0,40,40,0
8,9,2018,15,0,5,"Braga",8,"Rua Costa Gomes",40,40,0,43,43,0
8,9,2018,16,0,5,"Braga",1,"Avenida da Liberdade",19,25,6,163,124,39
8,9,2018,16,0,5,"Braga",2,"Avenida Central",19,25,6,163,124,39
8,9,2018,16,0,5,"Braga",3,"Rua de Caires",37,37,0,36,36,0
8,9,2018,16,0,5,"Braga",4,"N14 Bosch",34,47,13,66,48,18
8,9,2018,16,0,5,"Braga",5,"Avenida João Paulo II",31,39,8,11,9,2
8,9,2018,16,0,5,"Braga",6,"Avenida Padre Júlio Fragata",67,67,0,83,83,0
8,9,2018,16,0,5,"Braga",7,"Rua Nova Santa Cruz",43,43,0,40,40,0
8,9,2018,16,0,5,"Braga",8,"Rua Costa Gomes",40,40,0,43,43,0
8,9,2018,17,0,5,"Braga",1,"Avenida da Liberdade",19,25,6,163,124,39
8,9,2018,17,0,5,"Braga",2,"Avenida Central",19,25,6,163,124,39
8,9,2018,17,0,5,"Braga",3,"Rua de Caires",24,37,13,56,36,20
8,9,2018,17,0,5,"Braga",4,"N14 Bosch",16,47,31,140,48,92
8,9,2018,17,0,5,"Braga",5,"Avenida João Paulo II",22,39,17,16,9,7
8,9,2018,17,0,5,"Braga",6,"Avenida Padre Júlio Fragata",26,67,41,214,83,131
8,9,2018,17,0,5,"Braga",7,"Rua Nova Santa Cruz",33,43,10,52,40,12
8,9,2018,17,0,5,"Braga",8,"Rua Costa Gomes",16,40,24,108,43,65
8,9,2018,18,0,5,"Braga",1,"Avenida da Liberdade",16,25,9,194,124,70
8,9,2018,18,0,5,"Braga",2,"Avenida Central",16,25,9,194,124,70
8,9,2018,18,0,5,"Braga",3,"Rua de Caires",22,37,15,61,36,25
8,9,2018,18,0,5,"Braga",4,"N14 Bosch",17,47,30,132,48,84
8,9,2018,18,0,5,"Braga",5,"Avenida João Paulo II",11,39,28,32,9,23
8,9,2018,18,0,5,"Braga",6,"Avenida Padre Júlio Fragata",26,67,41,214,83,131
8,9,2018,18,0,5,"Braga",7,"Rua Nova Santa Cruz",43,43,0,40,40,0
8,9,2018,18,0,5,"Braga",8,"Rua Costa Gomes",10,40,30,173,43,130
8,9,2018,19,0,5,"Braga",1,"Avenida da Liberdade",25,25,0,124,124,0
8,9,2018,19,0,5,"Braga",2,"Avenida Central",25,25,0,124,124,0
8,9,2018,19,0,5,"Braga",3,"Rua de Caires",37,37,0,36,36,0
8,9,2018,19,0,5,"Braga",4,"N14 Bosch",47,47,0,48,48,0
8,9,2018,19,0,5,"Braga",5,"Avenida João Paulo II",39,39,0,9,9,0
8,9,2018,19,0,5,"Braga",6,"Avenida Padre Júlio Fragata",33,67,34,169,83,86
8,9,2018,19,0,5,"Braga",7,"Rua Nova Santa Cruz",43,43,0,40,40,0
8,9,2018,19,0,5,"Braga",8,"Rua Costa Gomes",13,40,27,133,43,90
8,9,2018,20,0,5,"Braga",1,"Avenida da Liberdade",25,25,0,124,124,0
8,9,2018,20,0,5,"Braga",2,"Avenida Central",25,25,0,124,124,0
8,9,2018,20,0,5,"Braga",3,"Rua de Caires",37,37,0,36,36,0
8,9,2018,20,0,5,"Braga",4,"N14 Bosch",47,47,0,48,48,0
8,9,2018,20,0,5,"Braga",5,"Avenida João Paulo II",39,39,0,9,9,0
8,9,2018,20,0,5,"Braga",6,"Avenida Padre Júlio Fragata",67,67,0,83,83,0
8,9,2018,20,0,5,"Braga",7,"Rua Nova Santa Cruz",43,43,0,40,40,0
8,9,2018,20,0,5,"Braga",8,"Rua Costa Gomes",40,40,0,43,43,0
8,9,2018,21,0,5,"Braga",1,"Avenida da Liberdade",25,25,0,124,124,0
8,9,2018,21,0,5,"Braga",2,"Avenida Central",25,25,0,124,124,0
8,9,2018,21,0,5,"Braga",3,"Rua de Caires",29,37,8,46,36,10
8,9,2018,21,0,5,"Braga",4,"N14 Bosch",36,47,11,62,48,14
8,9,2018,21,0,5,"Braga",5,"Avenida João Paulo II",39,39,0,9,9,0
8,9,2018,21,0,5,"Braga",6,"Avenida Padre Júlio Fragata",67,67,0,83,83,0
8,9,2018,21,0,5,"Braga",7,"Rua Nova Santa Cruz",43,43,0,40,40,0
8,9,2018,21,0,5,"Braga",8,"Rua Costa Gomes",27,40,13,64,43,21
8,9,2018,22,0,5,"Braga",1,"Avenida da Liberdade",25,25,0,124,124,0
8,9,2018,22,0,5,"Braga",2,"Avenida Central",25,25,0,124,124,0
8,9,2018,22,0,5,"Braga",3,"Rua de Caires",37,37,0,36,36,0
8,9,2018,22,0,5,"Braga",4,"N14 Bosch",47,47,0,48,48,0
8,9,2018,22,0,5,"Braga",5,"Avenida João Paulo II",39,39,0,9,9,0
8,9,2018,22,0,5,"Braga",6,"Avenida Padre Júlio Fragata",67,67,0,83,83,0
8,9,2018,22,0,5,"Braga",7,"Rua Nova Santa Cruz",43,43,0,40,40,0
8,9,2018,22,0,5,"Braga",8,"Rua Costa Gomes",40,40,0,43,43,0
8,9,2018,23,0,5,"Braga",1,"Avenida da Liberdade",25,25,0,124,124,0
8,9,2018,23,0,5,"Braga",2,"Avenida Central",25,25,0,124,124,0
8,9,2018,23,0,5,"Braga",3,"Rua de Caires",37,37,0,36,36,0
8,9,2018,23,0,5,"Braga",4,"N14 Bosch",47,47,0,48,48,0
8,9,2018,23,0,5,"Braga",5,"Avenida João Paulo II",39,39,0,9,9,0
8,9,2018,23,0,5,"Braga",6,"Avenida Padre Júlio Fragata",67,67,0,83,83,0
8,9,2018,23,0,5,"Braga",7,"Rua Nova Santa Cruz",43,43,0,40,40,0
8,9,2018,23,0,5,"Braga",8,"Rua Costa Gomes",40,40,0,43,43,0
8,10,2018,0,0,6,"Braga",1,"Avenida da Liberdade",25,25,0,124,124,0
8,10,2018,0,0,6,"Braga",2,"Avenida Central",25,25,0,124,124,0
8,10,2018,0,0,6,"Braga",3,"Rua de Caires",37,37,0,36,36,0
8,10,2018,0,0,6,"Braga",4,"N14 Bosch",47,47,0,48,48,0
8,10,2018,0,0,6,"Braga",5,"Avenida João Paulo II",39,39,0,9,9,0
8,10,2018,0,0,6,"Braga",6,"Avenida Padre Júlio Fragata",67,67,0,83,83,0
8,10,2018,0,0,6,"Braga",7,"Rua Nova Santa Cruz",43,43,0,40,40,0
8,10,2018,0,0,6,"Braga",8,"Rua Costa Gomes",40,40,0,43,43,0
8,10,2018,1,0,6,"Braga",1,"Avenida da Liberdade",25,25,0,124,124,0
8,10,2018,1,0,6,"Braga",2,"Avenida Central",25,25,0,124,124,0
8,10,2018,1,0,6,"Braga",3,"Rua de Caires",29,37,8,46,36,10
8,10,2018,1,0,6,"Braga",4,"N14 Bosch",47,47,0,48,48,0
8,10,2018,1,0,6,"Braga",5,"Avenida João Paulo II",39,39,0,9,9,0
8,10,2018,1,0,6,"Braga",6,"Avenida Padre Júlio Fragata",67,67,0,83,83,0
8,10,2018,1,0,6,"Braga",7,"Rua Nova Santa Cruz",43,43,0,40,40,0
8,10,2018,1,0,6,"Braga",8,"Rua Costa Gomes",40,40,0,43,43,0
8,10,2018,2,0,6,"Braga",1,"Avenida da Liberdade",25,25,0,124,124,0
8,10,2018,2,0,6,"Braga",2,"Avenida Central",25,25,0,124,124,0
8,10,2018,2,0,6,"Braga",3,"Rua de Caires",37,37,0,36,36,0
8,10,2018,2,0,6,"Braga",4,"N14 Bosch",47,47,0,48,48,0
8,10,2018,2,0,6,"Braga",5,"Avenida João Paulo II",39,39,0,9,9,0
8,10,2018,2,0,6,"Braga",6,"Avenida Padre Júlio Fragata",67,67,0,83,83,0
8,10,2018,2,0,6,"Braga",7,"Rua Nova Santa Cruz",43,43,0,40,40,0
8,10,2018,2,0,6,"Braga",8,"Rua Costa Gomes",40,40,0,43,43,0
8,10,2018,3,0,6,"Braga",1,"Avenida da Liberdade",25,25,0,124,124,0
8,10,2018,3,0,6,"Braga",2,"Avenida Central",25,25,0,124,124,0
8,10,2018,3,0,6,"Braga",3,"Rua de Caires",37,37,0,36,36,0
8,10,2018,3,0,6,"Braga",4,"N14 Bosch",47,47,0,48,48,0
8,10,2018,3,0,6,"Braga",5,"Avenida João Paulo II",39,39,0,9,9,0
8,10,2018,3,0,6,"Braga",6,"Avenida Padre Júlio Fragata",67,67,0,83,83,0
8,10,2018,3,0,6,"Braga",7,"Rua Nova Santa Cruz",43,43,0,40,40,0
8,10,2018,3,0,6,"Braga",8,"Rua Costa Gomes",40,40,0,43,43,0
8,10,2018,4,0,6,"Braga",1,"Avenida da Liberdade",25,25,0,124,124,0
8,10,2018,4,0,6,"Braga",2,"Avenida Central",25,25,0,124,124,0
8,10,2018,4,0,6,"Braga",3,"Rua de Caires",37,37,0,36,36,0
8,10,2018,4,0,6,"Braga",4,"N14 Bosch",47,47,0,48,48,0
8,10,2018,4,0,6,"Braga",5,"Avenida João Paulo II",39,39,0,9,9,0
8,10,2018,4,0,6,"Braga",6,"Avenida Padre Júlio Fragata",67,67,0,83,83,0
8,10,2018,4,0,6,"Braga",7,"Rua Nova Santa Cruz",43,43,0,40,40,0
8,10,2018,4,0,6,"Braga",8,"Rua Costa Gomes",40,40,0,43,43,0
8,10,2018,5,0,6,"Braga",1,"Avenida da Liberdade",25,25,0,124,124,0
8,10,2018,5,0,6,"Braga",2,"Avenida Central",25,25,0,124,124,0
8,10,2018,5,0,6,"Braga",3,"Rua de Caires",37,37,0,36,36,0
8,10,2018,5,0,6,"Braga",4,"N14 Bosch",47,47,0,48,48,0
8,10,2018,5,0,6,"Braga",5,"Avenida João Paulo II",39,39,0,9,9,0
8,10,2018,5,0,6,"Braga",6,"Avenida Padre Júlio Fragata",67,67,0,83,83,0
8,10,2018,5,0,6,"Braga",7,"Rua Nova Santa Cruz",43,43,0,40,40,0
8,10,2018,5,0,6,"Braga",8,"Rua Costa Gomes",40,40,0,43,43,0
8,10,2018,6,0,6,"Braga",1,"Avenida da Liberdade",25,25,0,124,124,0
8,10,2018,6,0,6,"Braga",2,"Avenida Central",25,25,0,124,124,0
8,10,2018,6,0,6,"Braga",3,"Rua de Caires",37,37,0,36,36,0
8,10,2018,6,0,6,"Braga",4,"N14 Bosch",47,47,0,48,48,0
8,10,2018,6,0,6,"Braga",5,"Avenida João Paulo II",39,39,0,9,9,0
8,10,2018,6,0,6,"Braga",6,"Avenida Padre Júlio Fragata",67,67,0,83,83,0
8,10,2018,6,0,6,"Braga",7,"Rua Nova Santa Cruz",43,43,0,40,40,0
8,10,2018,6,0,6,"Braga",8,"Rua Costa Gomes",40,40,0,43,43,0
8,10,2018,7,0,6,"Braga",1,"Avenida da Liberdade",25,25,0,124,124,0
8,10,2018,7,0,6,"Braga",2,"Avenida Central",25,25,0,124,124,0
8,10,2018,7,0,6,"Braga",3,"Rua de Caires",37,37,0,36,36,0
8,10,2018,7,0,6,"Braga",4,"N14 Bosch",47,47,0,48,48,0
8,10,2018,7,0,6,"Braga",5,"Avenida João Paulo II",39,39,0,9,9,0
8,10,2018,7,0,6,"Braga",6,"Avenida Padre Júlio Fragata",67,67,0,83,83,0
8,10,2018,7,0,6,"Braga",7,"Rua Nova Santa Cruz",31,43,12,56,40,16
8,10,2018,7,0,6,"Braga",8,"Rua Costa Gomes",29,40,11,60,43,17
8,10,2018,8,0,6,"Braga",1,"Avenida da Liberdade",19,25,6,163,124,39
8,10,2018,8,0,6,"Braga",2,"Avenida Central",16,25,9,194,124,70
8,10,2018,8,0,6,"Braga",3,"Rua de Caires",13,37,24,104,36,68
8,10,2018,8,0,6,"Braga",4,"N14 Bosch",28,47,19,80,48,32
8,10,2018,8,0,6,"Braga",5,"Avenida João Paulo II",39,39,0,9,9,0
8,10,2018,8,0,6,"Braga",6,"Avenida Padre Júlio Fragata",67,67,0,83,83,0
8,10,2018,8,0,6,"Braga",7,"Rua Nova Santa Cruz",43,43,0,40,40,0
8,10,2018,8,0,6,"Braga",8,"Rua Costa Gomes",30,40,10,58,43,15
8,10,2018,9,0,6,"Braga",1,"Avenida da Liberdade",25,25,0,124,124,0
8,10,2018,9,0,6,"Braga",2,"Avenida Central",25,25,0,124,124,0
8,10,2018,9,0,6,"Braga",3,"Rua de Caires",37,37,0,36,36,0
8,10,2018,9,0,6,"Braga",4,"N14 Bosch",33,47,14,68,48,20
8,10,2018,9,0,6,"Braga",5,"Avenida João Paulo II",39,39,0,9,9,0
8,10,2018,9,0,6,"Braga",6,"Avenida Padre Júlio Fragata",67,67,0,83,83,0
8,10,2018,9,0,6,"Braga",7,"Rua Nova Santa Cruz",43,43,0,40,40,0
8,10,2018,9,0,6,"Braga",8,"Rua Costa Gomes",40,40,0,43,43,0
8,10,2018,10,0,6,"Braga",1,"Avenida da Liberdade",18,25,7,172,124,48
8,10,2018,10,0,6,"Braga",2,"Avenida Central",18,25,7,172,124,48
8,10,2018,10,0,6,"Braga",3,"Rua de Caires",37,37,0,36,36,0
8,10,2018,10,0,6,"Braga",4,"N14 Bosch",20,47,27,112,48,64
8,10,2018,10,0,6,"Braga",5,"Avenida João Paulo II",30,39,9,12,9,3
8,10,2018,10,0,6,"Braga",6,"Avenida Padre Júlio Fragata",67,67,0,83,83,0
8,10,2018,10,0,6,"Braga",7,"Rua Nova Santa Cruz",43,43,0,40,40,0
8,10,2018,10,0,6,"Braga",8,"Rua Costa Gomes",40,40,0,43,43,0
8,10,2018,11,0,6,"Braga",1,"Avenida da Liberdade",9,25,16,344,124,220
8,10,2018,11,0,6,"Braga",2,"Avenida Central",9,25,16,344,124,220
8,10,2018,11,0,6,"Braga",3,"Rua de Caires",24,37,13,56,36,20
8,10,2018,11,0,6,"Braga",4,"N14 Bosch",32,47,15,70,48,22
8,10,2018,11,0,6,"Braga",5,"Avenida João Paulo II",31,39,8,11,9,2
8,10,2018,11,0,6,"Braga",6,"Avenida Padre Júlio Fragata",67,67,0,83,83,0
8,10,2018,11,0,6,"Braga",7,"Rua Nova Santa Cruz",43,43,0,40,40,0
8,10,2018,11,0,6,"Braga",8,"Rua Costa Gomes",29,40,11,60,43,17
8,10,2018,12,0,6,"Braga",1,"Avenida da Liberdade",15,25,10,207,124,83
8,10,2018,12,0,6,"Braga",2,"Avenida Central",15,25,10,207,124,83
8,10,2018,12,0,6,"Braga",3,"Rua de Caires",37,37,0,36,36,0
8,10,2018,12,0,6,"Braga",4,"N14 Bosch",47,47,0,48,48,0
8,10,2018,12,0,6,"Braga",5,"Avenida João Paulo II",39,39,0,9,9,0
8,10,2018,12,0,6,"Braga",6,"Avenida Padre Júlio Fragata",67,67,0,83,83,0
8,10,2018,12,0,6,"Braga",7,"Rua Nova Santa Cruz",43,43,0,40,40,0
8,10,2018,12,0,6,"Braga",8,"Rua Costa Gomes",22,40,18,79,43,36
8,10,2018,13,0,6,"Braga",1,"Avenida da Liberdade",25,25,0,124,124,0
8,10,2018,13,0,6,"Braga",2,"Avenida Central",25,25,0,124,124,0
8,10,2018,13,0,6,"Braga",3,"Rua de Caires",29,37,8,46,36,10
8,10,2018,13,0,6,"Braga",4,"N14 Bosch",21,47,26,107,48,59
8,10,2018,13,0,6,"Braga",5,"Avenida João Paulo II",39,39,0,9,9,0
8,10,2018,13,0,6,"Braga",6,"Avenida Padre Júlio Fragata",67,67,0,83,83,0
8,10,2018,13,0,6,"Braga",7,"Rua Nova Santa Cruz",43,43,0,40,40,0
8,10,2018,13,0,6,"Braga",8,"Rua Costa Gomes",40,40,0,43,43,0
8,10,2018,14,0,6,"Braga",1,"Avenida da Liberdade",25,25,0,124,124,0
8,10,2018,14,0,6,"Braga",2,"Avenida Central",25,25,0,124,124,0
8,10,2018,14,0,6,"Braga",3,"Rua de Caires",28,37,9,48,36,12
8,10,2018,14,0,6,"Braga",4,"N14 Bosch",11,47,36,204,48,156
8,10,2018,14,0,6,"Braga",5,"Avenida João Paulo II",39,39,0,9,9,0
8,10,2018,14,0,6,"Braga",6,"Avenida Padre Júlio Fragata",67,67,0,83,83,0
8,10,2018,14,0,6,"Braga",7,"Rua Nova Santa Cruz",32,43,11,54,40,14
8,10,2018,14,0,6,"Braga",8,"Rua Costa Gomes",31,40,9,56,43,13
8,10,2018,15,0,6,"Braga",1,"Avenida da Liberdade",16,25,9,194,124,70
8,10,2018,15,0,6,"Braga",2,"Avenida Central",16,25,9,194,124,70
8,10,2018,15,0,6,"Braga",3,"Rua de Caires",23,37,14,59,36,23
8,10,2018,15,0,6,"Braga",4,"N14 Bosch",47,47,0,48,48,0
8,10,2018,15,0,6,"Braga",5,"Avenida João Paulo II",27,39,12,13,9,4
8,10,2018,15,0,6,"Braga",6,"Avenida Padre Júlio Fragata",67,67,0,83,83,0
8,10,2018,15,0,6,"Braga",7,"Rua Nova Santa Cruz",43,43,0,40,40,0
8,10,2018,15,0,6,"Braga",8,"Rua Costa Gomes",40,40,0,43,43,0
8,10,2018,16,0,6,"Braga",1,"Avenida da Liberdade",6,25,19,517,124,393
8,10,2018,16,0,6,"Braga",2,"Avenida Central",6,25,19,517,124,393
8,10,2018,16,0,6,"Braga",3,"Rua de Caires",27,37,10,50,36,14
8,10,2018,16,0,6,"Braga",4,"N14 Bosch",32,47,15,70,48,22
8,10,2018,16,0,6,"Braga",5,"Avenida João Paulo II",27,39,12,13,9,4
8,10,2018,16,0,6,"Braga",6,"Avenida Padre Júlio Fragata",47,67,20,119,83,36
8,10,2018,16,0,6,"Braga",7,"Rua Nova Santa Cruz",20,43,23,86,40,46
8,10,2018,16,0,6,"Braga",8,"Rua Costa Gomes",30,40,10,58,43,15
8,10,2018,17,0,6,"Braga",1,"Avenida da Liberdade",5,25,20,620,124,496
8,10,2018,17,0,6,"Braga",2,"Avenida Central",5,25,20,620,124,496
8,10,2018,17,0,6,"Braga",3,"Rua de Caires",26,37,11,52,36,16
8,10,2018,17,0,6,"Braga",4,"N14 Bosch",13,47,34,173,48,125
8,10,2018,17,0,6,"Braga",5,"Avenida João Paulo II",10,39,29,35,9,26
8,10,2018,17,0,6,"Braga",6,"Avenida Padre Júlio Fragata",29,67,38,192,83,109
8,10,2018,17,0,6,"Braga",7,"Rua Nova Santa Cruz",43,43,0,40,40,0
8,10,2018,17,0,6,"Braga",8,"Rua Costa Gomes",27,40,13,64,43,21
8,10,2018,18,0,6,"Braga",1,"Avenida da Liberdade",10,25,15,310,124,186
8,10,2018,18,0,6,"Braga",2,"Avenida Central",10,25,15,310,124,186
8,10,2018,18,0,6,"Braga",3,"Rua de Caires",26,37,11,52,36,16
8,10,2018,18,0,6,"Braga",4,"N14 Bosch",17,47,30,132,48,84
8,10,2018,18,0,6,"Braga",5,"Avenida João Paulo II",22,39,17,16,9,7
8,10,2018,18,0,6,"Braga",6,"Avenida Padre Júlio Fragata",21,67,46,265,83,182
8,10,2018,18,0,6,"Braga",7,"Rua Nova Santa Cruz",29,43,14,60,40,20
8,10,2018,18,0,6,"Braga",8,"Rua Costa Gomes",7,40,33,247,43,204
8,10,2018,19,0,6,"Braga",1,"Avenida da Liberdade",18,25,7,172,124,48
8,10,2018,19,0,6,"Braga",2,"Avenida Central",18,25,7,172,124,48
8,10,2018,19,0,6,"Braga",3,"Rua de Caires",26,37,11,52,36,16
8,10,2018,19,0,6,"Braga",4,"N14 Bosch",31,47,16,72,48,24
8,10,2018,19,0,6,"Braga",5,"Avenida João Paulo II",39,39,0,9,9,0
8,10,2018,19,0,6,"Braga",6,"Avenida Padre Júlio Fragata",34,67,33,164,83,81
8,10,2018,19,0,6,"Braga",7,"Rua Nova Santa Cruz",43,43,0,40,40,0
8,10,2018,19,0,6,"Braga",8,"Rua Costa Gomes",9,40,31,192,43,149
8,10,2018,20,0,6,"Braga",1,"Avenida da Liberdade",25,25,0,124,124,0
8,10,2018,20,0,6,"Braga",2,"Avenida Central",25,25,0,124,124,0
8,10,2018,20,0,6,"Braga",3,"Rua de Caires",37,37,0,36,36,0
8,10,2018,20,0,6,"Braga",4,"N14 Bosch",47,47,0,48,48,0
8,10,2018,20,0,6,"Braga",5,"Avenida João Paulo II",39,39,0,9,9,0
8,10,2018,20,0,6,"Braga",6,"Avenida Padre Júlio Fragata",67,67,0,83,83,0
8,10,2018,20,0,6,"Braga",7,"Rua Nova Santa Cruz",43,43,0,40,40,0
8,10,2018,20,0,6,"Braga",8,"Rua Costa Gomes",40,40,0,43,43,0
8,10,2018,21,0,6,"Braga",1,"Avenida da Liberdade",25,25,0,124,124,0
8,10,2018,21,0,6,"Braga",2,"Avenida Central",25,25,0,124,124,0
8,10,2018,21,0,6,"Braga",3,"Rua de Caires",28,37,9,48,36,12
8,10,2018,21,0,6,"Braga",4,"N14 Bosch",47,47,0,48,48,0
8,10,2018,21,0,6,"Braga",5,"Avenida João Paulo II",39,39,0,9,9,0
8,10,2018,21,0,6,"Braga",6,"Avenida Padre Júlio Fragata",53,67,14,105,83,22
8,10,2018,21,0,6,"Braga",7,"Rua Nova Santa Cruz",43,43,0,40,40,0
8,10,2018,21,0,6,"Braga",8,"Rua Costa Gomes",40,40,0,43,43,0
8,10,2018,22,0,6,"Braga",1,"Avenida da Liberdade",25,25,0,124,124,0
8,10,2018,22,0,6,"Braga",2,"Avenida Central",25,25,0,124,124,0
8,10,2018,22,0,6,"Braga",3,"Rua de Caires",37,37,0,36,36,0
8,10,2018,22,0,6,"Braga",4,"N14 Bosch",47,47,0,48,48,0
8,10,2018,22,0,6,"Braga",5,"Avenida João Paulo II",39,39,0,9,9,0
8,10,2018,22,0,6,"Braga",6,"Avenida Padre Júlio Fragata",67,67,0,83,83,0
8,10,2018,22,0,6,"Braga",7,"Rua Nova Santa Cruz",43,43,0,40,40,0
8,10,2018,22,0,6,"Braga",8,"Rua Costa Gomes",40,40,0,43,43,0
8,10,2018,23,0,6,"Braga",1,"Avenida da Liberdade",25,25,0,124,124,0
8,10,2018,23,0,6,"Braga",2,"Avenida Central",25,25,0,124,124,0
8,10,2018,23,0,6,"Braga",3,"Rua de Caires",29,37,8,46,36,10
8,10,2018,23,0,6,"Braga",4,"N14 Bosch",47,47,0,48,48,0
8,10,2018,23,0,6,"Braga",5,"Avenida João Paulo II",39,39,0,9,9,0
8,10,2018,23,0,6,"Braga",6,"Avenida Padre Júlio Fragata",67,67,0,83,83,0
8,10,2018,23,0,6,"Braga",7,"Rua Nova Santa Cruz",30,43,13,58,40,18
8,10,2018,23,0,6,"Braga",8,"Rua Costa Gomes",40,40,0,43,43,0
8,11,2018,0,0,7,"Braga",1,"Avenida da Liberdade",25,25,0,124,124,0
8,11,2018,0,0,7,"Braga",2,"Avenida Central",25,25,0,124,124,0
8,11,2018,0,0,7,"Braga",3,"Rua de Caires",37,37,0,36,36,0
8,11,2018,0,0,7,"Braga",4,"N14 Bosch",47,47,0,48,48,0
8,11,2018,0,0,7,"Braga",5,"Avenida João Paulo II",39,39,0,9,9,0
8,11,2018,0,0,7,"Braga",6,"Avenida Padre Júlio Fragata",67,67,0,83,83,0
8,11,2018,0,0,7,"Braga",7,"Rua Nova Santa Cruz",43,43,0,40,40,0
8,11,2018,0,0,7,"Braga",8,"Rua Costa Gomes",40,40,0,43,43,0
8,11,2018,1,0,7,"Braga",1,"Avenida da Liberdade",25,25,0,124,124,0
8,11,2018,1,0,7,"Braga",2,"Avenida Central",25,25,0,124,124,0
8,11,2018,1,0,7,"Braga",3,"Rua de Caires",37,37,0,36,36,0
8,11,2018,1,0,7,"Braga",4,"N14 Bosch",47,47,0,48,48,0
8,11,2018,1,0,7,"Braga",5,"Avenida João Paulo II",39,39,0,9,9,0
8,11,2018,1,0,7,"Braga",6,"Avenida Padre Júlio Fragata",67,67,0,83,83,0
8,11,2018,1,0,7,"Braga",7,"Rua Nova Santa Cruz",43,43,0,40,40,0
8,11,2018,1,0,7,"Braga",8,"Rua Costa Gomes",40,40,0,43,43,0
8,11,2018,2,0,7,"Braga",1,"Avenida da Liberdade",25,25,0,124,124,0
8,11,2018,2,0,7,"Braga",2,"Avenida Central",25,25,0,124,124,0
8,11,2018,2,0,7,"Braga",3,"Rua de Caires",37,37,0,36,36,0
8,11,2018,2,0,7,"Braga",4,"N14 Bosch",47,47,0,48,48,0
8,11,2018,2,0,7,"Braga",5,"Avenida João Paulo II",39,39,0,9,9,0
8,11,2018,2,0,7,"Braga",6,"Avenida Padre Júlio Fragata",67,67,0,83,83,0
8,11,2018,2,0,7,"Braga",7,"Rua Nova Santa Cruz",43,43,0,40,40,0
8,11,2018,2,0,7,"Braga",8,"Rua Costa Gomes",40,40,0,43,43,0
8,11,2018,3,0,7,"Braga",1,"Avenida da Liberdade",25,25,0,124,124,0
8,11,2018,3,0,7,"Braga",2,"Avenida Central",25,25,0,124,124,0
8,11,2018,3,0,7,"Braga",3,"Rua de Caires",37,37,0,36,36,0
8,11,2018,3,0,7,"Braga",4,"N14 Bosch",47,47,0,48,48,0
8,11,2018,3,0,7,"Braga",5,"Avenida João Paulo II",39,39,0,9,9,0
8,11,2018,3,0,7,"Braga",6,"Avenida Padre Júlio Fragata",67,67,0,83,83,0
8,11,2018,3,0,7,"Braga",7,"Rua Nova Santa Cruz",43,43,0,40,40,0
8,11,2018,3,0,7,"Braga",8,"Rua Costa Gomes",40,40,0,43,43,0
8,11,2018,4,0,7,"Braga",1,"Avenida da Liberdade",25,25,0,124,124,0
8,11,2018,4,0,7,"Braga",2,"Avenida Central",25,25,0,124,124,0
8,11,2018,4,0,7,"Braga",3,"Rua de Caires",37,37,0,36,36,0
8,11,2018,4,0,7,"Braga",4,"N14 Bosch",47,47,0,48,48,0
8,11,2018,4,0,7,"Braga",5,"Avenida João Paulo II",39,39,0,9,9,0
8,11,2018,4,0,7,"Braga",6,"Avenida Padre Júlio Fragata",67,67,0,83,83,0
8,11,2018,4,0,7,"Braga",7,"Rua Nova Santa Cruz",43,43,0,40,40,0
8,11,2018,4,0,7,"Braga",8,"Rua Costa Gomes",40,40,0,43,43,0
8,11,2018,5,0,7,"Braga",1,"Avenida da Liberdade",25,25,0,124,124,0
8,11,2018,5,0,7,"Braga",2,"Avenida Central",25,25,0,124,124,0
8,11,2018,5,0,7,"Braga",3,"Rua de Caires",37,37,0,36,36,0
8,11,2018,5,0,7,"Braga",4,"N14 Bosch",47,47,0,48,48,0
8,11,2018,5,0,7,"Braga",5,"Avenida João Paulo II",39,39,0,9,9,0
8,11,2018,5,0,7,"Braga",6,"Avenida Padre Júlio Fragata",67,67,0,83,83,0
8,11,2018,5,0,7,"Braga",7,"Rua Nova Santa Cruz",43,43,0,40,40,0
8,11,2018,5,0,7,"Braga",8,"Rua Costa Gomes",40,40,0,43,43,0
8,11,2018,6,0,7,"Braga",1,"Avenida da Liberdade",25,25,0,124,124,0
8,11,2018,6,0,7,"Braga",2,"Avenida Central",25,25,0,124,124,0
8,11,2018,6,0,7,"Braga",3,"Rua de Caires",37,37,0,36,36,0
8,11,2018,6,0,7,"Braga",4,"N14 Bosch",47,47,0,48,48,0
8,11,2018,6,0,7,"Braga",5,"Avenida João Paulo II",39,39,0,9,9,0
8,11,2018,6,0,7,"Braga",6,"Avenida Padre Júlio Fragata",67,67,0,83,83,0
8,11,2018,6,0,7,"Braga",7,"Rua Nova Santa Cruz",43,43,0,40,40,0
8,11,2018,6,0,7,"Braga",8,"Rua Costa Gomes",40,40,0,43,43,0
8,11,2018,7,0,7,"Braga",1,"Avenida da Liberdade",25,25,0,124,124,0
8,11,2018,7,0,7,"Braga",2,"Avenida Central",25,25,0,124,124,0
8,11,2018,7,0,7,"Braga",3,"Rua de Caires",29,37,8,46,36,10
8,11,2018,7,0,7,"Braga",4,"N14 Bosch",47,47,0,48,48,0
8,11,2018,7,0,7,"Braga",5,"Avenida João Paulo II",39,39,0,9,9,0
8,11,2018,7,0,7,"Braga",6,"Avenida Padre Júlio Fragata",67,67,0,83,83,0
8,11,2018,7,0,7,"Braga",7,"Rua Nova Santa Cruz",43,43,0,40,40,0
8,11,2018,7,0,7,"Braga",8,"Rua Costa Gomes",40,40,0,43,43,0
8,11,2018,8,0,7,"Braga",1,"Avenida da Liberdade",25,25,0,124,124,0
8,11,2018,8,0,7,"Braga",2,"Avenida Central",25,25,0,124,124,0
8,11,2018,8,0,7,"Braga",3,"Rua de Caires",37,37,0,36,36,0
8,11,2018,8,0,7,"Braga",4,"N14 Bosch",47,47,0,48,48,0
8,11,2018,8,0,7,"Braga",5,"Avenida João Paulo II",39,39,0,9,9,0
8,11,2018,8,0,7,"Braga",6,"Avenida Padre Júlio Fragata",67,67,0,83,83,0
8,11,2018,8,0,7,"Braga",7,"Rua Nova Santa Cruz",43,43,0,40,40,0
8,11,2018,8,0,7,"Braga",8,"Rua Costa Gomes",40,40,0,43,43,0
8,11,2018,9,0,7,"Braga",1,"Avenida da Liberdade",25,25,0,124,124,0
8,11,2018,9,0,7,"Braga",2,"Avenida Central",25,25,0,124,124,0
8,11,2018,9,0,7,"Braga",3,"Rua de Caires",16,37,21,84,36,48
8,11,2018,9,0,7,"Braga",4,"N14 Bosch",47,47,0,48,48,0
8,11,2018,9,0,7,"Braga",5,"Avenida João Paulo II",22,39,17,16,9,7
8,11,2018,9,0,7,"Braga",6,"Avenida Padre Júlio Fragata",67,67,0,83,83,0
8,11,2018,9,0,7,"Braga",7,"Rua Nova Santa Cruz",43,43,0,40,40,0
8,11,2018,9,0,7,"Braga",8,"Rua Costa Gomes",40,40,0,43,43,0
8,11,2018,12,0,7,"Braga",1,"Avenida da Liberdade",25,25,0,124,124,0
8,11,2018,12,0,7,"Braga",2,"Avenida Central",25,25,0,124,124,0
8,11,2018,12,0,7,"Braga",3,"Rua de Caires",37,37,0,36,36,0
8,11,2018,12,0,7,"Braga",4,"N14 Bosch",47,47,0,48,48,0
8,11,2018,12,0,7,"Braga",5,"Avenida João Paulo II",29,39,10,12,9,3
8,11,2018,12,0,7,"Braga",6,"Avenida Padre Júlio Fragata",67,67,0,83,83,0
8,11,2018,12,0,7,"Braga",7,"Rua Nova Santa Cruz",43,43,0,40,40,0
8,11,2018,12,0,7,"Braga",8,"Rua Costa Gomes",30,40,10,58,43,15
8,11,2018,13,0,7,"Braga",1,"Avenida da Liberdade",25,25,0,124,124,0
8,11,2018,13,0,7,"Braga",2,"Avenida Central",25,25,0,124,124,0
8,11,2018,13,0,7,"Braga",3,"Rua de Caires",29,37,8,46,36,10
8,11,2018,13,0,7,"Braga",4,"N14 Bosch",47,47,0,48,48,0
8,11,2018,13,0,7,"Braga",5,"Avenida João Paulo II",39,39,0,9,9,0
8,11,2018,13,0,7,"Braga",6,"Avenida Padre Júlio Fragata",67,67,0,83,83,0
8,11,2018,13,0,7,"Braga",7,"Rua Nova Santa Cruz",43,43,0,40,40,0
8,11,2018,13,0,7,"Braga",8,"Rua Costa Gomes",31,40,9,56,43,13
8,11,2018,15,0,7,"Braga",1,"Avenida da Liberdade",25,25,0,124,124,0
8,11,2018,15,0,7,"Braga",2,"Avenida Central",25,25,0,124,124,0
8,11,2018,15,0,7,"Braga",3,"Rua de Caires",37,37,0,36,36,0
8,11,2018,15,0,7,"Braga",4,"N14 Bosch",47,47,0,48,48,0
8,11,2018,15,0,7,"Braga",5,"Avenida João Paulo II",39,39,0,9,9,0
8,11,2018,15,0,7,"Braga",6,"Avenida Padre Júlio Fragata",67,67,0,83,83,0
8,11,2018,15,0,7,"Braga",7,"Rua Nova Santa Cruz",43,43,0,40,40,0
8,11,2018,15,0,7,"Braga",8,"Rua Costa Gomes",40,40,0,43,43,0
8,11,2018,16,0,7,"Braga",1,"Avenida da Liberdade",25,25,0,124,124,0
8,11,2018,16,0,7,"Braga",2,"Avenida Central",25,25,0,124,124,0
8,11,2018,16,0,7,"Braga",3,"Rua de Caires",28,37,9,48,36,12
8,11,2018,16,0,7,"Braga",4,"N14 Bosch",47,47,0,48,48,0
8,11,2018,16,0,7,"Braga",5,"Avenida João Paulo II",39,39,0,9,9,0
8,11,2018,16,0,7,"Braga",6,"Avenida Padre Júlio Fragata",67,67,0,83,83,0
8,11,2018,16,0,7,"Braga",7,"Rua Nova Santa Cruz",43,43,0,40,40,0
8,11,2018,16,0,7,"Braga",8,"Rua Costa Gomes",40,40,0,43,43,0
8,11,2018,19,0,7,"Braga",1,"Avenida da Liberdade",25,25,0,124,124,0
8,11,2018,19,0,7,"Braga",2,"Avenida Central",25,25,0,124,124,0
8,11,2018,19,0,7,"Braga",3,"Rua de Caires",37,37,0,36,36,0
8,11,2018,19,0,7,"Braga",4,"N14 Bosch",21,47,26,107,48,59
8,11,2018,19,0,7,"Braga",5,"Avenida João Paulo II",39,39,0,9,9,0
8,11,2018,19,0,7,"Braga",6,"Avenida Padre Júlio Fragata",67,67,0,83,83,0
8,11,2018,19,0,7,"Braga",7,"Rua Nova Santa Cruz",43,43,0,40,40,0
8,11,2018,19,0,7,"Braga",8,"Rua Costa Gomes",31,40,9,56,43,13
8,11,2018,21,0,7,"Braga",1,"Avenida da Liberdade",25,25,0,124,124,0
8,11,2018,21,0,7,"Braga",2,"Avenida Central",25,25,0,124,124,0
8,11,2018,21,0,7,"Braga",3,"Rua de Caires",37,37,0,36,36,0
8,11,2018,21,0,7,"Braga",4,"N14 Bosch",36,47,11,62,48,14
8,11,2018,21,0,7,"Braga",5,"Avenida João Paulo II",39,39,0,9,9,0
8,11,2018,21,0,7,"Braga",6,"Avenida Padre Júlio Fragata",67,67,0,83,83,0
8,11,2018,21,0,7,"Braga",7,"Rua Nova Santa Cruz",43,43,0,40,40,0
8,11,2018,21,0,7,"Braga",8,"Rua Costa Gomes",40,40,0,43,43,0
8,11,2018,22,0,7,"Braga",1,"Avenida da Liberdade",25,25,0,124,124,0
8,11,2018,22,0,7,"Braga",2,"Avenida Central",25,25,0,124,124,0
8,11,2018,22,0,7,"Braga",3,"Rua de Caires",37,37,0,36,36,0
8,11,2018,22,0,7,"Braga",4,"N14 Bosch",47,47,0,48,48,0
8,11,2018,22,0,7,"Braga",5,"Avenida João Paulo II",39,39,0,9,9,0
8,11,2018,22,0,7,"Braga",6,"Avenida Padre Júlio Fragata",67,67,0,83,83,0
8,11,2018,22,0,7,"Braga",7,"Rua Nova Santa Cruz",43,43,0,40,40,0
8,11,2018,22,0,7,"Braga",8,"Rua Costa Gomes",40,40,0,43,43,0
8,11,2018,23,0,7,"Braga",1,"Avenida da Liberdade",25,25,0,124,124,0
8,11,2018,23,0,7,"Braga",2,"Avenida Central",19,25,6,163,124,39
8,11,2018,23,0,7,"Braga",3,"Rua de Caires",37,37,0,36,36,0
8,11,2018,23,0,7,"Braga",4,"N14 Bosch",47,47,0,48,48,0
8,11,2018,23,0,7,"Braga",5,"Avenida João Paulo II",39,39,0,9,9,0
8,11,2018,23,0,7,"Braga",6,"Avenida Padre Júlio Fragata",67,67,0,83,83,0
8,11,2018,23,0,7,"Braga",7,"Rua Nova Santa Cruz",43,43,0,40,40,0
8,11,2018,23,0,7,"Braga",8,"Rua Costa Gomes",40,40,0,43,43,0
8,12,2018,0,0,8,"Braga",1,"Avenida da Liberdade",25,25,0,124,124,0
8,12,2018,0,0,8,"Braga",2,"Avenida Central",25,25,0,124,124,0
8,12,2018,0,0,8,"Braga",3,"Rua de Caires",37,37,0,36,36,0
8,12,2018,0,0,8,"Braga",4,"N14 Bosch",47,47,0,48,48,0
8,12,2018,0,0,8,"Braga",5,"Avenida João Paulo II",39,39,0,9,9,0
8,12,2018,0,0,8,"Braga",6,"Avenida Padre Júlio Fragata",67,67,0,83,83,0
8,12,2018,0,0,8,"Braga",7,"Rua Nova Santa Cruz",43,43,0,40,40,0
8,12,2018,0,0,8,"Braga",8,"Rua Costa Gomes",40,40,0,43,43,0
8,12,2018,1,0,8,"Braga",1,"Avenida da Liberdade",25,25,0,124,124,0
8,12,2018,1,0,8,"Braga",2,"Avenida Central",25,25,0,124,124,0
8,12,2018,1,0,8,"Braga",3,"Rua de Caires",37,37,0,36,36,0
8,12,2018,1,0,8,"Braga",4,"N14 Bosch",47,47,0,48,48,0
8,12,2018,1,0,8,"Braga",5,"Avenida João Paulo II",39,39,0,9,9,0
8,12,2018,1,0,8,"Braga",6,"Avenida Padre Júlio Fragata",67,67,0,83,83,0
8,12,2018,1,0,8,"Braga",7,"Rua Nova Santa Cruz",43,43,0,40,40,0
8,12,2018,1,0,8,"Braga",8,"Rua Costa Gomes",40,40,0,43,43,0
8,12,2018,2,0,8,"Braga",1,"Avenida da Liberdade",25,25,0,124,124,0
8,12,2018,2,0,8,"Braga",2,"Avenida Central",25,25,0,124,124,0
8,12,2018,2,0,8,"Braga",3,"Rua de Caires",37,37,0,36,36,0
8,12,2018,2,0,8,"Braga",4,"N14 Bosch",47,47,0,48,48,0
8,12,2018,2,0,8,"Braga",5,"Avenida João Paulo II",29,39,10,12,9,3
8,12,2018,2,0,8,"Braga",6,"Avenida Padre Júlio Fragata",67,67,0,83,83,0
8,12,2018,2,0,8,"Braga",7,"Rua Nova Santa Cruz",43,43,0,40,40,0
8,12,2018,2,0,8,"Braga",8,"Rua Costa Gomes",40,40,0,43,43,0
8,12,2018,3,0,8,"Braga",1,"Avenida da Liberdade",25,25,0,124,124,0
8,12,2018,3,0,8,"Braga",2,"Avenida Central",25,25,0,124,124,0
8,12,2018,3,0,8,"Braga",3,"Rua de Caires",37,37,0,36,36,0
8,12,2018,3,0,8,"Braga",4,"N14 Bosch",47,47,0,48,48,0
8,12,2018,3,0,8,"Braga",5,"Avenida João Paulo II",39,39,0,9,9,0
8,12,2018,3,0,8,"Braga",6,"Avenida Padre Júlio Fragata",67,67,0,83,83,0
8,12,2018,3,0,8,"Braga",7,"Rua Nova Santa Cruz",43,43,0,40,40,0
8,12,2018,3,0,8,"Braga",8,"Rua Costa Gomes",40,40,0,43,43,0
8,12,2018,4,0,8,"Braga",1,"Avenida da Liberdade",25,25,0,124,124,0
8,12,2018,4,0,8,"Braga",2,"Avenida Central",25,25,0,124,124,0
8,12,2018,4,0,8,"Braga",3,"Rua de Caires",37,37,0,36,36,0
8,12,2018,4,0,8,"Braga",4,"N14 Bosch",47,47,0,48,48,0
8,12,2018,4,0,8,"Braga",5,"Avenida João Paulo II",39,39,0,9,9,0
8,12,2018,4,0,8,"Braga",6,"Avenida Padre Júlio Fragata",67,67,0,83,83,0
8,12,2018,4,0,8,"Braga",7,"Rua Nova Santa Cruz",43,43,0,40,40,0
8,12,2018,4,0,8,"Braga",8,"Rua Costa Gomes",40,40,0,43,43,0
8,12,2018,5,0,8,"Braga",1,"Avenida da Liberdade",25,25,0,124,124,0
8,12,2018,5,0,8,"Braga",2,"Avenida Central",25,25,0,124,124,0
8,12,2018,5,0,8,"Braga",3,"Rua de Caires",37,37,0,36,36,0
8,12,2018,5,0,8,"Braga",4,"N14 Bosch",47,47,0,48,48,0
8,12,2018,5,0,8,"Braga",5,"Avenida João Paulo II",39,39,0,9,9,0
8,12,2018,5,0,8,"Braga",6,"Avenida Padre Júlio Fragata",67,67,0,83,83,0
8,12,2018,5,0,8,"Braga",7,"Rua Nova Santa Cruz",43,43,0,40,40,0
8,12,2018,5,0,8,"Braga",8,"Rua Costa Gomes",40,40,0,43,43,0
8,12,2018,6,0,8,"Braga",1,"Avenida da Liberdade",25,25,0,124,124,0
8,12,2018,6,0,8,"Braga",2,"Avenida Central",25,25,0,124,124,0
8,12,2018,6,0,8,"Braga",3,"Rua de Caires",37,37,0,36,36,0
8,12,2018,6,0,8,"Braga",4,"N14 Bosch",47,47,0,48,48,0
8,12,2018,6,0,8,"Braga",5,"Avenida João Paulo II",39,39,0,9,9,0
8,12,2018,6,0,8,"Braga",6,"Avenida Padre Júlio Fragata",67,67,0,83,83,0
8,12,2018,6,0,8,"Braga",7,"Rua Nova Santa Cruz",43,43,0,40,40,0
8,12,2018,6,0,8,"Braga",8,"Rua Costa Gomes",40,40,0,43,43,0
8,12,2018,7,0,8,"Braga",1,"Avenida da Liberdade",25,25,0,124,124,0
8,12,2018,7,0,8,"Braga",2,"Avenida Central",25,25,0,124,124,0
8,12,2018,7,0,8,"Braga",3,"Rua de Caires",37,37,0,36,36,0
8,12,2018,7,0,8,"Braga",4,"N14 Bosch",47,47,0,48,48,0
8,12,2018,7,0,8,"Braga",5,"Avenida João Paulo II",39,39,0,9,9,0
8,12,2018,7,0,8,"Braga",6,"Avenida Padre Júlio Fragata",67,67,0,83,83,0
8,12,2018,7,0,8,"Braga",7,"Rua Nova Santa Cruz",43,43,0,40,40,0
8,12,2018,7,0,8,"Braga",8,"Rua Costa Gomes",40,40,0,43,43,0
8,12,2018,8,0,8,"Braga",1,"Avenida da Liberdade",25,25,0,124,124,0
8,12,2018,8,0,8,"Braga",2,"Avenida Central",25,25,0,124,124,0
8,12,2018,8,0,8,"Braga",3,"Rua de Caires",37,37,0,36,36,0
8,12,2018,8,0,8,"Braga",4,"N14 Bosch",47,47,0,48,48,0
8,12,2018,8,0,8,"Braga",5,"Avenida João Paulo II",39,39,0,9,9,0
8,12,2018,8,0,8,"Braga",6,"Avenida Padre Júlio Fragata",67,67,0,83,83,0
8,12,2018,8,0,8,"Braga",7,"Rua Nova Santa Cruz",43,43,0,40,40,0
8,12,2018,8,0,8,"Braga",8,"Rua Costa Gomes",40,40,0,43,43,0
8,12,2018,9,0,8,"Braga",1,"Avenida da Liberdade",25,25,0,124,124,0
8,12,2018,9,0,8,"Braga",2,"Avenida Central",25,25,0,124,124,0
8,12,2018,9,0,8,"Braga",3,"Rua de Caires",37,37,0,36,36,0
8,12,2018,9,0,8,"Braga",4,"N14 Bosch",47,47,0,48,48,0
8,12,2018,9,0,8,"Braga",5,"Avenida João Paulo II",39,39,0,9,9,0
8,12,2018,9,0,8,"Braga",6,"Avenida Padre Júlio Fragata",67,67,0,83,83,0
8,12,2018,9,0,8,"Braga",7,"Rua Nova Santa Cruz",43,43,0,40,40,0
8,12,2018,9,0,8,"Braga",8,"Rua Costa Gomes",40,40,0,43,43,0
8,12,2018,10,0,8,"Braga",1,"Avenida da Liberdade",25,25,0,124,124,0
8,12,2018,10,0,8,"Braga",2,"Avenida Central",25,25,0,124,124,0
8,12,2018,10,0,8,"Braga",3,"Rua de Caires",37,37,0,36,36,0
8,12,2018,10,0,8,"Braga",4,"N14 Bosch",47,47,0,48,48,0
8,12,2018,10,0,8,"Braga",5,"Avenida João Paulo II",39,39,0,9,9,0
8,12,2018,10,0,8,"Braga",6,"Avenida Padre Júlio Fragata",67,67,0,83,83,0
8,12,2018,10,0,8,"Braga",7,"Rua Nova Santa Cruz",43,43,0,40,40,0
8,12,2018,10,0,8,"Braga",8,"Rua Costa Gomes",40,40,0,43,43,0
8,12,2018,11,0,8,"Braga",1,"Avenida da Liberdade",25,25,0,124,124,0
8,12,2018,11,0,8,"Braga",2,"Avenida Central",25,25,0,124,124,0
8,12,2018,11,0,8,"Braga",3,"Rua de Caires",37,37,0,36,36,0
8,12,2018,11,0,8,"Braga",4,"N14 Bosch",47,47,0,48,48,0
8,12,2018,11,0,8,"Braga",5,"Avenida João Paulo II",39,39,0,9,9,0
8,12,2018,11,0,8,"Braga",6,"Avenida Padre Júlio Fragata",67,67,0,83,83,0
8,12,2018,11,0,8,"Braga",7,"Rua Nova Santa Cruz",43,43,0,40,40,0
8,12,2018,11,0,8,"Braga",8,"Rua Costa Gomes",40,40,0,43,43,0
8,12,2018,12,0,8,"Braga",1,"Avenida da Liberdade",25,25,0,124,124,0
8,12,2018,12,0,8,"Braga",2,"Avenida Central",25,25,0,124,124,0
8,12,2018,12,0,8,"Braga",3,"Rua de Caires",37,37,0,36,36,0
8,12,2018,12,0,8,"Braga",4,"N14 Bosch",47,47,0,48,48,0
8,12,2018,12,0,8,"Braga",5,"Avenida João Paulo II",39,39,0,9,9,0
8,12,2018,12,0,8,"Braga",6,"Avenida Padre Júlio Fragata",67,67,0,83,83,0
8,12,2018,12,0,8,"Braga",7,"Rua Nova Santa Cruz",43,43,0,40,40,0
8,12,2018,12,0,8,"Braga",8,"Rua Costa Gomes",29,40,11,60,43,17
8,12,2018,13,0,8,"Braga",1,"Avenida da Liberdade",25,25,0,124,124,0
8,12,2018,13,0,8,"Braga",2,"Avenida Central",25,25,0,124,124,0
8,12,2018,13,0,8,"Braga",3,"Rua de Caires",37,37,0,36,36,0
8,12,2018,13,0,8,"Braga",4,"N14 Bosch",47,47,0,48,48,0
8,12,2018,13,0,8,"Braga",5,"Avenida João Paulo II",25,39,14,14,9,5
8,12,2018,13,0,8,"Braga",6,"Avenida Padre Júlio Fragata",67,67,0,83,83,0
8,12,2018,13,0,8,"Braga",7,"Rua Nova Santa Cruz",43,43,0,40,40,0
8,12,2018,13,0,8,"Braga",8,"Rua Costa Gomes",40,40,0,43,43,0
8,12,2018,14,0,8,"Braga",1,"Avenida da Liberdade",25,25,0,124,124,0
8,12,2018,14,0,8,"Braga",2,"Avenida Central",25,25,0,124,124,0
8,12,2018,14,0,8,"Braga",3,"Rua de Caires",37,37,0,36,36,0
8,12,2018,14,0,8,"Braga",4,"N14 Bosch",47,47,0,48,48,0
8,12,2018,14,0,8,"Braga",5,"Avenida João Paulo II",39,39,0,9,9,0
8,12,2018,14,0,8,"Braga",6,"Avenida Padre Júlio Fragata",67,67,0,83,83,0
8,12,2018,14,0,8,"Braga",7,"Rua Nova Santa Cruz",43,43,0,40,40,0
8,12,2018,14,0,8,"Braga",8,"Rua Costa Gomes",40,40,0,43,43,0
8,12,2018,15,0,8,"Braga",1,"Avenida da Liberdade",25,25,0,124,124,0
8,12,2018,15,0,8,"Braga",2,"Avenida Central",25,25,0,124,124,0
8,12,2018,15,0,8,"Braga",3,"Rua de Caires",37,37,0,36,36,0
8,12,2018,15,0,8,"Braga",4,"N14 Bosch",47,47,0,48,48,0
8,12,2018,15,0,8,"Braga",5,"Avenida João Paulo II",39,39,0,9,9,0
8,12,2018,15,0,8,"Braga",6,"Avenida Padre Júlio Fragata",48,67,19,116,83,33
8,12,2018,15,0,8,"Braga",7,"Rua Nova Santa Cruz",43,43,0,40,40,0
8,12,2018,15,0,8,"Braga",8,"Rua Costa Gomes",40,40,0,43,43,0
8,12,2018,16,0,8,"Braga",1,"Avenida da Liberdade",25,25,0,124,124,0
8,12,2018,16,0,8,"Braga",2,"Avenida Central",25,25,0,124,124,0
8,12,2018,16,0,8,"Braga",3,"Rua de Caires",37,37,0,36,36,0
8,12,2018,16,0,8,"Braga",4,"N14 Bosch",47,47,0,48,48,0
8,12,2018,16,0,8,"Braga",5,"Avenida João Paulo II",39,39,0,9,9,0
8,12,2018,16,0,8,"Braga",6,"Avenida Padre Júlio Fragata",67,67,0,83,83,0
8,12,2018,16,0,8,"Braga",7,"Rua Nova Santa Cruz",43,43,0,40,40,0
8,12,2018,16,0,8,"Braga",8,"Rua Costa Gomes",40,40,0,43,43,0
8,12,2018,17,0,8,"Braga",1,"Avenida da Liberdade",25,25,0,124,124,0
8,12,2018,17,0,8,"Braga",2,"Avenida Central",25,25,0,124,124,0
8,12,2018,17,0,8,"Braga",3,"Rua de Caires",28,37,9,48,36,12
8,12,2018,17,0,8,"Braga",4,"N14 Bosch",32,47,15,70,48,22
8,12,2018,17,0,8,"Braga",5,"Avenida João Paulo II",30,39,9,12,9,3
8,12,2018,17,0,8,"Braga",6,"Avenida Padre Júlio Fragata",67,67,0,83,83,0
8,12,2018,17,0,8,"Braga",7,"Rua Nova Santa Cruz",43,43,0,40,40,0
8,12,2018,17,0,8,"Braga",8,"Rua Costa Gomes",25,40,15,69,43,26
8,12,2018,18,0,8,"Braga",1,"Avenida da Liberdade",25,25,0,124,124,0
8,12,2018,18,0,8,"Braga",2,"Avenida Central",25,25,0,124,124,0
8,12,2018,18,0,8,"Braga",3,"Rua de Caires",27,37,10,50,36,14
8,12,2018,18,0,8,"Braga",4,"N14 Bosch",47,47,0,48,48,0
8,12,2018,18,0,8,"Braga",5,"Avenida João Paulo II",27,39,12,13,9,4
8,12,2018,18,0,8,"Braga",6,"Avenida Padre Júlio Fragata",53,67,14,105,83,22
8,12,2018,18,0,8,"Braga",7,"Rua Nova Santa Cruz",43,43,0,40,40,0
8,12,2018,18,0,8,"Braga",8,"Rua Costa Gomes",40,40,0,43,43,0
8,12,2018,19,0,8,"Braga",1,"Avenida da Liberdade",17,25,8,182,124,58
8,12,2018,19,0,8,"Braga",2,"Avenida Central",17,25,8,182,124,58
8,12,2018,19,0,8,"Braga",3,"Rua de Caires",37,37,0,36,36,0
8,12,2018,19,0,8,"Braga",4,"N14 Bosch",47,47,0,48,48,0
8,12,2018,19,0,8,"Braga",5,"Avenida João Paulo II",39,39,0,9,9,0
8,12,2018,19,0,8,"Braga",6,"Avenida Padre Júlio Fragata",26,67,41,214,83,131
8,12,2018,19,0,8,"Braga",7,"Rua Nova Santa Cruz",43,43,0,40,40,0
8,12,2018,19,0,8,"Braga",8,"Rua Costa Gomes",28,40,12,62,43,19
8,12,2018,20,0,8,"Braga",1,"Avenida da Liberdade",25,25,0,124,124,0
8,12,2018,20,0,8,"Braga",2,"Avenida Central",25,25,0,124,124,0
8,12,2018,20,0,8,"Braga",3,"Rua de Caires",37,37,0,36,36,0
8,12,2018,20,0,8,"Braga",4,"N14 Bosch",47,47,0,48,48,0
8,12,2018,20,0,8,"Braga",5,"Avenida João Paulo II",39,39,0,9,9,0
8,12,2018,20,0,8,"Braga",6,"Avenida Padre Júlio Fragata",67,67,0,83,83,0
8,12,2018,20,0,8,"Braga",7,"Rua Nova Santa Cruz",43,43,0,40,40,0
8,12,2018,20,0,8,"Braga",8,"Rua Costa Gomes",40,40,0,43,43,0
8,12,2018,21,0,8,"Braga",1,"Avenida da Liberdade",25,25,0,124,124,0
8,12,2018,21,0,8,"Braga",2,"Avenida Central",25,25,0,124,124,0
8,12,2018,21,0,8,"Braga",3,"Rua de Caires",37,37,0,36,36,0
8,12,2018,21,0,8,"Braga",4,"N14 Bosch",47,47,0,48,48,0
8,12,2018,21,0,8,"Braga",5,"Avenida João Paulo II",39,39,0,9,9,0
8,12,2018,21,0,8,"Braga",6,"Avenida Padre Júlio Fragata",67,67,0,83,83,0
8,12,2018,21,0,8,"Braga",7,"Rua Nova Santa Cruz",43,43,0,40,40,0
8,12,2018,21,0,8,"Braga",8,"Rua Costa Gomes",40,40,0,43,43,0
8,12,2018,22,0,8,"Braga",1,"Avenida da Liberdade",25,25,0,124,124,0
8,12,2018,22,0,8,"Braga",2,"Avenida Central",25,25,0,124,124,0
8,12,2018,22,0,8,"Braga",3,"Rua de Caires",29,37,8,46,36,10
8,12,2018,22,0,8,"Braga",4,"N14 Bosch",47,47,0,48,48,0
8,12,2018,22,0,8,"Braga",5,"Avenida João Paulo II",39,39,0,9,9,0
8,12,2018,22,0,8,"Braga",6,"Avenida Padre Júlio Fragata",67,67,0,83,83,0
8,12,2018,22,0,8,"Braga",7,"Rua Nova Santa Cruz",43,43,0,40,40,0
8,12,2018,22,0,8,"Braga",8,"Rua Costa Gomes",40,40,0,43,43,0
8,12,2018,23,0,8,"Braga",1,"Avenida da Liberdade",25,25,0,124,124,0
8,12,2018,23,0,8,"Braga",2,"Avenida Central",25,25,0,124,124,0
8,12,2018,23,0,8,"Braga",3,"Rua de Caires",37,37,0,36,36,0
8,12,2018,23,0,8,"Braga",4,"N14 Bosch",47,47,0,48,48,0
8,12,2018,23,0,8,"Braga",5,"Avenida João Paulo II",39,39,0,9,9,0
8,12,2018,23,0,8,"Braga",6,"Avenida Padre Júlio Fragata",67,67,0,83,83,0
8,12,2018,23,0,8,"Braga",7,"Rua Nova Santa Cruz",43,43,0,40,40,0
8,12,2018,23,0,8,"Braga",8,"Rua Costa Gomes",40,40,0,43,43,0
8,13,2018,0,0,2,"Braga",1,"Avenida da Liberdade",25,25,0,124,124,0
8,13,2018,0,0,2,"Braga",2,"Avenida Central",25,25,0,124,124,0
8,13,2018,0,0,2,"Braga",3,"Rua de Caires",37,37,0,36,36,0
8,13,2018,0,0,2,"Braga",4,"N14 Bosch",47,47,0,48,48,0
8,13,2018,0,0,2,"Braga",5,"Avenida João Paulo II",39,39,0,9,9,0
8,13,2018,0,0,2,"Braga",6,"Avenida Padre Júlio Fragata",67,67,0,83,83,0
8,13,2018,0,0,2,"Braga",7,"Rua Nova Santa Cruz",43,43,0,40,40,0
8,13,2018,0,0,2,"Braga",8,"Rua Costa Gomes",40,40,0,43,43,0
8,13,2018,1,0,2,"Braga",1,"Avenida da Liberdade",25,25,0,124,124,0
8,13,2018,1,0,2,"Braga",2,"Avenida Central",25,25,0,124,124,0
8,13,2018,1,0,2,"Braga",3,"Rua de Caires",37,37,0,36,36,0
8,13,2018,1,0,2,"Braga",4,"N14 Bosch",47,47,0,48,48,0
8,13,2018,1,0,2,"Braga",5,"Avenida João Paulo II",39,39,0,9,9,0
8,13,2018,1,0,2,"Braga",6,"Avenida Padre Júlio Fragata",67,67,0,83,83,0
8,13,2018,1,0,2,"Braga",7,"Rua Nova Santa Cruz",43,43,0,40,40,0
8,13,2018,1,0,2,"Braga",8,"Rua Costa Gomes",40,40,0,43,43,0
8,13,2018,2,0,2,"Braga",1,"Avenida da Liberdade",25,25,0,124,124,0
8,13,2018,2,0,2,"Braga",2,"Avenida Central",25,25,0,124,124,0
8,13,2018,2,0,2,"Braga",3,"Rua de Caires",37,37,0,36,36,0
8,13,2018,2,0,2,"Braga",4,"N14 Bosch",47,47,0,48,48,0
8,13,2018,2,0,2,"Braga",5,"Avenida João Paulo II",39,39,0,9,9,0
8,13,2018,2,0,2,"Braga",6,"Avenida Padre Júlio Fragata",67,67,0,83,83,0
8,13,2018,2,0,2,"Braga",7,"Rua Nova Santa Cruz",43,43,0,40,40,0
8,13,2018,2,0,2,"Braga",8,"Rua Costa Gomes",40,40,0,43,43,0
8,13,2018,3,0,2,"Braga",1,"Avenida da Liberdade",25,25,0,124,124,0
8,13,2018,3,0,2,"Braga",2,"Avenida Central",25,25,0,124,124,0
8,13,2018,3,0,2,"Braga",3,"Rua de Caires",37,37,0,36,36,0
8,13,2018,3,0,2,"Braga",4,"N14 Bosch",47,47,0,48,48,0
8,13,2018,3,0,2,"Braga",5,"Avenida João Paulo II",39,39,0,9,9,0
8,13,2018,3,0,2,"Braga",6,"Avenida Padre Júlio Fragata",67,67,0,83,83,0
8,13,2018,3,0,2,"Braga",7,"Rua Nova Santa Cruz",43,43,0,40,40,0
8,13,2018,3,0,2,"Braga",8,"Rua Costa Gomes",40,40,0,43,43,0
8,13,2018,4,0,2,"Braga",1,"Avenida da Liberdade",25,25,0,124,124,0
8,13,2018,4,0,2,"Braga",2,"Avenida Central",25,25,0,124,124,0
8,13,2018,4,0,2,"Braga",3,"Rua de Caires",37,37,0,36,36,0
8,13,2018,4,0,2,"Braga",4,"N14 Bosch",47,47,0,48,48,0
8,13,2018,4,0,2,"Braga",5,"Avenida João Paulo II",39,39,0,9,9,0
8,13,2018,4,0,2,"Braga",6,"Avenida Padre Júlio Fragata",67,67,0,83,83,0
8,13,2018,4,0,2,"Braga",7,"Rua Nova Santa Cruz",43,43,0,40,40,0
8,13,2018,4,0,2,"Braga",8,"Rua Costa Gomes",40,40,0,43,43,0
8,13,2018,5,0,2,"Braga",1,"Avenida da Liberdade",25,25,0,124,124,0
8,13,2018,5,0,2,"Braga",2,"Avenida Central",25,25,0,124,124,0
8,13,2018,5,0,2,"Braga",3,"Rua de Caires",37,37,0,36,36,0
8,13,2018,5,0,2,"Braga",4,"N14 Bosch",47,47,0,48,48,0
8,13,2018,5,0,2,"Braga",5,"Avenida João Paulo II",39,39,0,9,9,0
8,13,2018,5,0,2,"Braga",6,"Avenida Padre Júlio Fragata",67,67,0,83,83,0
8,13,2018,5,0,2,"Braga",7,"Rua Nova Santa Cruz",43,43,0,40,40,0
8,13,2018,5,0,2,"Braga",8,"Rua Costa Gomes",40,40,0,43,43,0
8,13,2018,6,0,2,"Braga",1,"Avenida da Liberdade",25,25,0,124,124,0
8,13,2018,6,0,2,"Braga",2,"Avenida Central",25,25,0,124,124,0
8,13,2018,6,0,2,"Braga",3,"Rua de Caires",37,37,0,36,36,0
8,13,2018,6,0,2,"Braga",4,"N14 Bosch",47,47,0,48,48,0
8,13,2018,6,0,2,"Braga",5,"Avenida João Paulo II",39,39,0,9,9,0
8,13,2018,6,0,2,"Braga",6,"Avenida Padre Júlio Fragata",67,67,0,83,83,0
8,13,2018,6,0,2,"Braga",7,"Rua Nova Santa Cruz",43,43,0,40,40,0
8,13,2018,6,0,2,"Braga",8,"Rua Costa Gomes",40,40,0,43,43,0
8,13,2018,7,0,2,"Braga",1,"Avenida da Liberdade",25,25,0,124,124,0
8,13,2018,7,0,2,"Braga",2,"Avenida Central",25,25,0,124,124,0
8,13,2018,7,0,2,"Braga",3,"Rua de Caires",37,37,0,36,36,0
8,13,2018,7,0,2,"Braga",4,"N14 Bosch",47,47,0,48,48,0
8,13,2018,7,0,2,"Braga",5,"Avenida João Paulo II",39,39,0,9,9,0
8,13,2018,7,0,2,"Braga",6,"Avenida Padre Júlio Fragata",67,67,0,83,83,0
8,13,2018,7,0,2,"Braga",7,"Rua Nova Santa Cruz",29,43,14,60,40,20
8,13,2018,7,0,2,"Braga",8,"Rua Costa Gomes",40,40,0,43,43,0
8,13,2018,8,0,2,"Braga",1,"Avenida da Liberdade",25,25,0,124,124,0
8,13,2018,8,0,2,"Braga",2,"Avenida Central",25,25,0,124,124,0
8,13,2018,8,0,2,"Braga",3,"Rua de Caires",18,37,19,75,36,39
8,13,2018,8,0,2,"Braga",4,"N14 Bosch",31,47,16,72,48,24
8,13,2018,8,0,2,"Braga",5,"Avenida João Paulo II",39,39,0,9,9,0
8,13,2018,8,0,2,"Braga",6,"Avenida Padre Júlio Fragata",67,67,0,83,83,0
8,13,2018,8,0,2,"Braga",7,"Rua Nova Santa Cruz",43,43,0,40,40,0
8,13,2018,8,0,2,"Braga",8,"Rua Costa Gomes",24,40,16,72,43,29
8,13,2018,9,0,2,"Braga",1,"Avenida da Liberdade",25,25,0,124,124,0
8,13,2018,9,0,2,"Braga",2,"Avenida Central",25,25,0,124,124,0
8,13,2018,9,0,2,"Braga",3,"Rua de Caires",23,37,14,59,36,23
8,13,2018,9,0,2,"Braga",4,"N14 Bosch",33,47,14,68,48,20
8,13,2018,9,0,2,"Braga",5,"Avenida João Paulo II",39,39,0,9,9,0
8,13,2018,9,0,2,"Braga",6,"Avenida Padre Júlio Fragata",67,67,0,83,83,0
8,13,2018,9,0,2,"Braga",7,"Rua Nova Santa Cruz",26,43,17,66,40,26
8,13,2018,9,0,2,"Braga",8,"Rua Costa Gomes",40,40,0,43,43,0
8,13,2018,10,0,2,"Braga",1,"Avenida da Liberdade",25,25,0,124,124,0
8,13,2018,10,0,2,"Braga",2,"Avenida Central",25,25,0,124,124,0
8,13,2018,10,0,2,"Braga",3,"Rua de Caires",18,37,19,75,36,39
8,13,2018,10,0,2,"Braga",4,"N14 Bosch",22,47,25,102,48,54
8,13,2018,10,0,2,"Braga",5,"Avenida João Paulo II",29,39,10,12,9,3
8,13,2018,10,0,2,"Braga",6,"Avenida Padre Júlio Fragata",67,67,0,83,83,0
8,13,2018,10,0,2,"Braga",7,"Rua Nova Santa Cruz",43,43,0,40,40,0
8,13,2018,10,0,2,"Braga",8,"Rua Costa Gomes",40,40,0,43,43,0
8,13,2018,11,0,2,"Braga",1,"Avenida da Liberdade",25,25,0,124,124,0
8,13,2018,11,0,2,"Braga",2,"Avenida Central",25,25,0,124,124,0
8,13,2018,11,0,2,"Braga",3,"Rua de Caires",26,37,11,52,36,16
8,13,2018,11,0,2,"Braga",4,"N14 Bosch",21,47,26,107,48,59
8,13,2018,11,0,2,"Braga",5,"Avenida João Paulo II",28,39,11,12,9,3
8,13,2018,11,0,2,"Braga",6,"Avenida Padre Júlio Fragata",67,67,0,83,83,0
8,13,2018,11,0,2,"Braga",7,"Rua Nova Santa Cruz",43,43,0,40,40,0
8,13,2018,11,0,2,"Braga",8,"Rua Costa Gomes",31,40,9,56,43,13
8,13,2018,12,0,2,"Braga",1,"Avenida da Liberdade",25,25,0,124,124,0
8,13,2018,12,0,2,"Braga",2,"Avenida Central",25,25,0,124,124,0
8,13,2018,12,0,2,"Braga",3,"Rua de Caires",9,37,28,150,36,114
8,13,2018,12,0,2,"Braga",4,"N14 Bosch",47,47,0,48,48,0
8,13,2018,12,0,2,"Braga",5,"Avenida João Paulo II",18,39,21,19,9,10
8,13,2018,12,0,2,"Braga",6,"Avenida Padre Júlio Fragata",67,67,0,83,83,0
8,13,2018,12,0,2,"Braga",7,"Rua Nova Santa Cruz",43,43,0,40,40,0
8,13,2018,12,0,2,"Braga",8,"Rua Costa Gomes",40,40,0,43,43,0
8,13,2018,13,0,2,"Braga",1,"Avenida da Liberdade",25,25,0,124,124,0
8,13,2018,13,0,2,"Braga",2,"Avenida Central",25,25,0,124,124,0
8,13,2018,13,0,2,"Braga",3,"Rua de Caires",37,37,0,36,36,0
8,13,2018,13,0,2,"Braga",4,"N14 Bosch",28,47,19,80,48,32
8,13,2018,13,0,2,"Braga",5,"Avenida João Paulo II",29,39,10,12,9,3
8,13,2018,13,0,2,"Braga",6,"Avenida Padre Júlio Fragata",67,67,0,83,83,0
8,13,2018,13,0,2,"Braga",7,"Rua Nova Santa Cruz",43,43,0,40,40,0
8,13,2018,13,0,2,"Braga",8,"Rua Costa Gomes",40,40,0,43,43,0
8,13,2018,14,0,2,"Braga",1,"Avenida da Liberdade",25,25,0,124,124,0
8,13,2018,14,0,2,"Braga",2,"Avenida Central",25,25,0,124,124,0
8,13,2018,14,0,2,"Braga",3,"Rua de Caires",37,37,0,36,36,0
8,13,2018,14,0,2,"Braga",4,"N14 Bosch",35,47,12,64,48,16
8,13,2018,14,0,2,"Braga",5,"Avenida João Paulo II",11,39,28,32,9,23
8,13,2018,14,0,2,"Braga",6,"Avenida Padre Júlio Fragata",36,67,31,155,83,72
8,13,2018,14,0,2,"Braga",7,"Rua Nova Santa Cruz",43,43,0,40,40,0
8,13,2018,14,0,2,"Braga",8,"Rua Costa Gomes",31,40,9,56,43,13
8,13,2018,15,0,2,"Braga",1,"Avenida da Liberdade",16,25,9,194,124,70
8,13,2018,15,0,2,"Braga",2,"Avenida Central",16,25,9,194,124,70
8,13,2018,15,0,2,"Braga",3,"Rua de Caires",23,37,14,59,36,23
8,13,2018,15,0,2,"Braga",4,"N14 Bosch",22,47,25,102,48,54
8,13,2018,15,0,2,"Braga",5,"Avenida João Paulo II",26,39,13,13,9,4
8,13,2018,15,0,2,"Braga",6,"Avenida Padre Júlio Fragata",26,67,41,214,83,131
8,13,2018,15,0,2,"Braga",7,"Rua Nova Santa Cruz",43,43,0,40,40,0
8,13,2018,15,0,2,"Braga",8,"Rua Costa Gomes",29,40,11,60,43,17
8,13,2018,16,0,2,"Braga",1,"Avenida da Liberdade",14,25,11,221,124,97
8,13,2018,16,0,2,"Braga",2,"Avenida Central",14,25,11,221,124,97
8,13,2018,16,0,2,"Braga",3,"Rua de Caires",19,37,18,71,36,35
8,13,2018,16,0,2,"Braga",4,"N14 Bosch",21,47,26,107,48,59
8,13,2018,16,0,2,"Braga",5,"Avenida João Paulo II",25,39,14,14,9,5
8,13,2018,16,0,2,"Braga",6,"Avenida Padre Júlio Fragata",33,67,34,169,83,86
8,13,2018,16,0,2,"Braga",7,"Rua Nova Santa Cruz",43,43,0,40,40,0
8,13,2018,16,0,2,"Braga",8,"Rua Costa Gomes",31,40,9,56,43,13
8,13,2018,17,0,2,"Braga",1,"Avenida da Liberdade",15,25,10,207,124,83
8,13,2018,17,0,2,"Braga",2,"Avenida Central",15,25,10,207,124,83
8,13,2018,17,0,2,"Braga",3,"Rua de Caires",37,37,0,36,36,0
8,13,2018,17,0,2,"Braga",4,"N14 Bosch",18,47,29,125,48,77
8,13,2018,17,0,2,"Braga",5,"Avenida João Paulo II",10,39,29,35,9,26
8,13,2018,17,0,2,"Braga",6,"Avenida Padre Júlio Fragata",18,67,49,310,83,227
8,13,2018,17,0,2,"Braga",7,"Rua Nova Santa Cruz",43,43,0,40,40,0
8,13,2018,17,0,2,"Braga",8,"Rua Costa Gomes",25,40,15,69,43,26
8,13,2018,18,0,2,"Braga",1,"Avenida da Liberdade",16,25,9,194,124,70
8,13,2018,18,0,2,"Braga",2,"Avenida Central",16,25,9,194,124,70
8,13,2018,18,0,2,"Braga",3,"Rua de Caires",23,37,14,59,36,23
8,13,2018,18,0,2,"Braga",4,"N14 Bosch",29,47,18,77,48,29
8,13,2018,18,0,2,"Braga",5,"Avenida João Paulo II",7,39,32,50,9,41
8,13,2018,18,0,2,"Braga",6,"Avenida Padre Júlio Fragata",17,67,50,328,83,245
8,13,2018,18,0,2,"Braga",7,"Rua Nova Santa Cruz",43,43,0,40,40,0
8,13,2018,18,0,2,"Braga",8,"Rua Costa Gomes",23,40,17,75,43,32
8,13,2018,19,0,2,"Braga",1,"Avenida da Liberdade",25,25,0,124,124,0
8,13,2018,19,0,2,"Braga",2,"Avenida Central",25,25,0,124,124,0
8,13,2018,19,0,2,"Braga",3,"Rua de Caires",37,37,0,36,36,0
8,13,2018,19,0,2,"Braga",4,"N14 Bosch",47,47,0,48,48,0
8,13,2018,19,0,2,"Braga",5,"Avenida João Paulo II",16,39,23,22,9,13
8,13,2018,19,0,2,"Braga",6,"Avenida Padre Júlio Fragata",18,67,49,310,83,227
8,13,2018,19,0,2,"Braga",7,"Rua Nova Santa Cruz",43,43,0,40,40,0
8,13,2018,19,0,2,"Braga",8,"Rua Costa Gomes",40,40,0,43,43,0
8,13,2018,20,0,2,"Braga",1,"Avenida da Liberdade",19,25,6,163,124,39
8,13,2018,20,0,2,"Braga",2,"Avenida Central",19,25,6,163,124,39
8,13,2018,20,0,2,"Braga",3,"Rua de Caires",37,37,0,36,36,0
8,13,2018,20,0,2,"Braga",4,"N14 Bosch",47,47,0,48,48,0
8,13,2018,20,0,2,"Braga",5,"Avenida João Paulo II",39,39,0,9,9,0
8,13,2018,20,0,2,"Braga",6,"Avenida Padre Júlio Fragata",67,67,0,83,83,0
8,13,2018,20,0,2,"Braga",7,"Rua Nova Santa Cruz",43,43,0,40,40,0
8,13,2018,20,0,2,"Braga",8,"Rua Costa Gomes",40,40,0,43,43,0
8,13,2018,21,0,2,"Braga",1,"Avenida da Liberdade",25,25,0,124,124,0
8,13,2018,21,0,2,"Braga",2,"Avenida Central",25,25,0,124,124,0
8,13,2018,21,0,2,"Braga",3,"Rua de Caires",37,37,0,36,36,0
8,13,2018,21,0,2,"Braga",4,"N14 Bosch",47,47,0,48,48,0
8,13,2018,21,0,2,"Braga",5,"Avenida João Paulo II",39,39,0,9,9,0
8,13,2018,21,0,2,"Braga",6,"Avenida Padre Júlio Fragata",67,67,0,83,83,0
8,13,2018,21,0,2,"Braga",7,"Rua Nova Santa Cruz",43,43,0,40,40,0
8,13,2018,21,0,2,"Braga",8,"Rua Costa Gomes",40,40,0,43,43,0
8,13,2018,22,0,2,"Braga",1,"Avenida da Liberdade",25,25,0,124,124,0
8,13,2018,22,0,2,"Braga",2,"Avenida Central",25,25,0,124,124,0
8,13,2018,22,0,2,"Braga",3,"Rua de Caires",37,37,0,36,36,0
8,13,2018,22,0,2,"Braga",4,"N14 Bosch",47,47,0,48,48,0
8,13,2018,22,0,2,"Braga",5,"Avenida João Paulo II",39,39,0,9,9,0
8,13,2018,22,0,2,"Braga",6,"Avenida Padre Júlio Fragata",67,67,0,83,83,0
8,13,2018,22,0,2,"Braga",7,"Rua Nova Santa Cruz",43,43,0,40,40,0
8,13,2018,22,0,2,"Braga",8,"Rua Costa Gomes",40,40,0,43,43,0
8,13,2018,23,0,2,"Braga",1,"Avenida da Liberdade",19,25,6,163,124,39
8,13,2018,23,0,2,"Braga",2,"Avenida Central",19,25,6,163,124,39
8,13,2018,23,0,2,"Braga",3,"Rua de Caires",37,37,0,36,36,0
8,13,2018,23,0,2,"Braga",4,"N14 Bosch",47,47,0,48,48,0
8,13,2018,23,0,2,"Braga",5,"Avenida João Paulo II",39,39,0,9,9,0
8,13,2018,23,0,2,"Braga",6,"Avenida Padre Júlio Fragata",67,67,0,83,83,0
8,13,2018,23,0,2,"Braga",7,"Rua Nova Santa Cruz",43,43,0,40,40,0
8,13,2018,23,0,2,"Braga",8,"Rua Costa Gomes",40,40,0,43,43,0
8,14,2018,0,0,3,"Braga",1,"Avenida da Liberdade",25,25,0,124,124,0
8,14,2018,0,0,3,"Braga",2,"Avenida Central",25,25,0,124,124,0
8,14,2018,0,0,3,"Braga",3,"Rua de Caires",37,37,0,36,36,0
8,14,2018,0,0,3,"Braga",4,"N14 Bosch",47,47,0,48,48,0
8,14,2018,0,0,3,"Braga",5,"Avenida João Paulo II",39,39,0,9,9,0
8,14,2018,0,0,3,"Braga",6,"Avenida Padre Júlio Fragata",67,67,0,83,83,0
8,14,2018,0,0,3,"Braga",7,"Rua Nova Santa Cruz",43,43,0,40,40,0
8,14,2018,0,0,3,"Braga",8,"Rua Costa Gomes",40,40,0,43,43,0
8,14,2018,1,0,3,"Braga",1,"Avenida da Liberdade",25,25,0,124,124,0
8,14,2018,1,0,3,"Braga",2,"Avenida Central",25,25,0,124,124,0
8,14,2018,1,0,3,"Braga",3,"Rua de Caires",37,37,0,36,36,0
8,14,2018,1,0,3,"Braga",4,"N14 Bosch",47,47,0,48,48,0
8,14,2018,1,0,3,"Braga",5,"Avenida João Paulo II",39,39,0,9,9,0
8,14,2018,1,0,3,"Braga",6,"Avenida Padre Júlio Fragata",67,67,0,83,83,0
8,14,2018,1,0,3,"Braga",7,"Rua Nova Santa Cruz",43,43,0,40,40,0
8,14,2018,1,0,3,"Braga",8,"Rua Costa Gomes",40,40,0,43,43,0
8,14,2018,2,0,3,"Braga",1,"Avenida da Liberdade",25,25,0,124,124,0
8,14,2018,2,0,3,"Braga",2,"Avenida Central",25,25,0,124,124,0
8,14,2018,2,0,3,"Braga",3,"Rua de Caires",37,37,0,36,36,0
8,14,2018,2,0,3,"Braga",4,"N14 Bosch",47,47,0,48,48,0
8,14,2018,2,0,3,"Braga",5,"Avenida João Paulo II",39,39,0,9,9,0
8,14,2018,2,0,3,"Braga",6,"Avenida Padre Júlio Fragata",67,67,0,83,83,0
8,14,2018,2,0,3,"Braga",7,"Rua Nova Santa Cruz",43,43,0,40,40,0
8,14,2018,2,0,3,"Braga",8,"Rua Costa Gomes",40,40,0,43,43,0
8,14,2018,3,0,3,"Braga",1,"Avenida da Liberdade",25,25,0,124,124,0
8,14,2018,3,0,3,"Braga",2,"Avenida Central",25,25,0,124,124,0
8,14,2018,3,0,3,"Braga",3,"Rua de Caires",37,37,0,36,36,0
8,14,2018,3,0,3,"Braga",4,"N14 Bosch",47,47,0,48,48,0
8,14,2018,3,0,3,"Braga",5,"Avenida João Paulo II",39,39,0,9,9,0
8,14,2018,3,0,3,"Braga",6,"Avenida Padre Júlio Fragata",67,67,0,83,83,0
8,14,2018,3,0,3,"Braga",7,"Rua Nova Santa Cruz",43,43,0,40,40,0
8,14,2018,3,0,3,"Braga",8,"Rua Costa Gomes",40,40,0,43,43,0
8,14,2018,4,0,3,"Braga",1,"Avenida da Liberdade",25,25,0,124,124,0
8,14,2018,4,0,3,"Braga",2,"Avenida Central",25,25,0,124,124,0
8,14,2018,4,0,3,"Braga",3,"Rua de Caires",37,37,0,36,36,0
8,14,2018,4,0,3,"Braga",4,"N14 Bosch",47,47,0,48,48,0
8,14,2018,4,0,3,"Braga",5,"Avenida João Paulo II",39,39,0,9,9,0
8,14,2018,4,0,3,"Braga",6,"Avenida Padre Júlio Fragata",67,67,0,83,83,0
8,14,2018,4,0,3,"Braga",7,"Rua Nova Santa Cruz",43,43,0,40,40,0
8,14,2018,4,0,3,"Braga",8,"Rua Costa Gomes",40,40,0,43,43,0
8,14,2018,5,0,3,"Braga",1,"Avenida da Liberdade",25,25,0,124,124,0
8,14,2018,5,0,3,"Braga",2,"Avenida Central",25,25,0,124,124,0
8,14,2018,5,0,3,"Braga",3,"Rua de Caires",37,37,0,36,36,0
8,14,2018,5,0,3,"Braga",4,"N14 Bosch",47,47,0,48,48,0
8,14,2018,5,0,3,"Braga",5,"Avenida João Paulo II",39,39,0,9,9,0
8,14,2018,5,0,3,"Braga",6,"Avenida Padre Júlio Fragata",67,67,0,83,83,0
8,14,2018,5,0,3,"Braga",7,"Rua Nova Santa Cruz",43,43,0,40,40,0
8,14,2018,5,0,3,"Braga",8,"Rua Costa Gomes",40,40,0,43,43,0
8,14,2018,6,0,3,"Braga",1,"Avenida da Liberdade",25,25,0,124,124,0
8,14,2018,6,0,3,"Braga",2,"Avenida Central",25,25,0,124,124,0
8,14,2018,6,0,3,"Braga",3,"Rua de Caires",37,37,0,36,36,0
8,14,2018,6,0,3,"Braga",4,"N14 Bosch",47,47,0,48,48,0
8,14,2018,6,0,3,"Braga",5,"Avenida João Paulo II",39,39,0,9,9,0
8,14,2018,6,0,3,"Braga",6,"Avenida Padre Júlio Fragata",67,67,0,83,83,0
8,14,2018,6,0,3,"Braga",7,"Rua Nova Santa Cruz",43,43,0,40,40,0
8,14,2018,6,0,3,"Braga",8,"Rua Costa Gomes",40,40,0,43,43,0
8,14,2018,7,0,3,"Braga",1,"Avenida da Liberdade",25,25,0,124,124,0
8,14,2018,7,0,3,"Braga",2,"Avenida Central",25,25,0,124,124,0
8,14,2018,7,0,3,"Braga",3,"Rua de Caires",28,37,9,48,36,12
8,14,2018,7,0,3,"Braga",4,"N14 Bosch",47,47,0,48,48,0
8,14,2018,7,0,3,"Braga",5,"Avenida João Paulo II",39,39,0,9,9,0
8,14,2018,7,0,3,"Braga",6,"Avenida Padre Júlio Fragata",67,67,0,83,83,0
8,14,2018,7,0,3,"Braga",7,"Rua Nova Santa Cruz",27,43,16,64,40,24
8,14,2018,7,0,3,"Braga",8,"Rua Costa Gomes",40,40,0,43,43,0
8,14,2018,8,0,3,"Braga",1,"Avenida da Liberdade",25,25,0,124,124,0
8,14,2018,8,0,3,"Braga",2,"Avenida Central",25,25,0,124,124,0
8,14,2018,8,0,3,"Braga",3,"Rua de Caires",24,37,13,56,36,20
8,14,2018,8,0,3,"Braga",4,"N14 Bosch",47,47,0,48,48,0
8,14,2018,8,0,3,"Braga",5,"Avenida João Paulo II",39,39,0,9,9,0
8,14,2018,8,0,3,"Braga",6,"Avenida Padre Júlio Fragata",67,67,0,83,83,0
8,14,2018,8,0,3,"Braga",7,"Rua Nova Santa Cruz",43,43,0,40,40,0
8,14,2018,8,0,3,"Braga",8,"Rua Costa Gomes",31,40,9,56,43,13
8,14,2018,9,0,3,"Braga",1,"Avenida da Liberdade",25,25,0,124,124,0
8,14,2018,9,0,3,"Braga",2,"Avenida Central",25,25,0,124,124,0
8,14,2018,9,0,3,"Braga",3,"Rua de Caires",27,37,10,50,36,14
8,14,2018,9,0,3,"Braga",4,"N14 Bosch",20,47,27,112,48,64
8,14,2018,9,0,3,"Braga",5,"Avenida João Paulo II",39,39,0,9,9,0
8,14,2018,9,0,3,"Braga",6,"Avenida Padre Júlio Fragata",67,67,0,83,83,0
8,14,2018,9,0,3,"Braga",7,"Rua Nova Santa Cruz",43,43,0,40,40,0
8,14,2018,9,0,3,"Braga",8,"Rua Costa Gomes",40,40,0,43,43,0
8,14,2018,10,0,3,"Braga",1,"Avenida da Liberdade",17,25,8,182,124,58
8,14,2018,10,0,3,"Braga",2,"Avenida Central",16,25,9,194,124,70
8,14,2018,10,0,3,"Braga",3,"Rua de Caires",37,37,0,36,36,0
8,14,2018,10,0,3,"Braga",4,"N14 Bosch",32,47,15,70,48,22
8,14,2018,10,0,3,"Braga",5,"Avenida João Paulo II",39,39,0,9,9,0
8,14,2018,10,0,3,"Braga",6,"Avenida Padre Júlio Fragata",67,67,0,83,83,0
8,14,2018,10,0,3,"Braga",7,"Rua Nova Santa Cruz",43,43,0,40,40,0
8,14,2018,10,0,3,"Braga",8,"Rua Costa Gomes",40,40,0,43,43,0
8,14,2018,11,0,3,"Braga",1,"Avenida da Liberdade",25,25,0,124,124,0
8,14,2018,11,0,3,"Braga",2,"Avenida Central",25,25,0,124,124,0
8,14,2018,11,0,3,"Braga",3,"Rua de Caires",37,37,0,36,36,0
8,14,2018,11,0,3,"Braga",4,"N14 Bosch",19,47,28,118,48,70
8,14,2018,11,0,3,"Braga",5,"Avenida João Paulo II",19,39,20,18,9,9
8,14,2018,11,0,3,"Braga",6,"Avenida Padre Júlio Fragata",67,67,0,83,83,0
8,14,2018,11,0,3,"Braga",7,"Rua Nova Santa Cruz",43,43,0,40,40,0
8,14,2018,11,0,3,"Braga",8,"Rua Costa Gomes",40,40,0,43,43,0
8,14,2018,12,0,3,"Braga",1,"Avenida da Liberdade",25,25,0,124,124,0
8,14,2018,12,0,3,"Braga",2,"Avenida Central",25,25,0,124,124,0
8,14,2018,12,0,3,"Braga",3,"Rua de Caires",24,37,13,56,36,20
8,14,2018,12,0,3,"Braga",4,"N14 Bosch",33,47,14,68,48,20
8,14,2018,12,0,3,"Braga",5,"Avenida João Paulo II",29,39,10,12,9,3
8,14,2018,12,0,3,"Braga",6,"Avenida Padre Júlio Fragata",67,67,0,83,83,0
8,14,2018,12,0,3,"Braga",7,"Rua Nova Santa Cruz",26,43,17,66,40,26
8,14,2018,12,0,3,"Braga",8,"Rua Costa Gomes",26,40,14,67,43,24
8,14,2018,13,0,3,"Braga",1,"Avenida da Liberdade",25,25,0,124,124,0
8,14,2018,13,0,3,"Braga",2,"Avenida Central",25,25,0,124,124,0
8,14,2018,13,0,3,"Braga",3,"Rua de Caires",24,37,13,56,36,20
8,14,2018,13,0,3,"Braga",4,"N14 Bosch",34,47,13,66,48,18
8,14,2018,13,0,3,"Braga",5,"Avenida João Paulo II",39,39,0,9,9,0
8,14,2018,13,0,3,"Braga",6,"Avenida Padre Júlio Fragata",67,67,0,83,83,0
8,14,2018,13,0,3,"Braga",7,"Rua Nova Santa Cruz",43,43,0,40,40,0
8,14,2018,13,0,3,"Braga",8,"Rua Costa Gomes",40,40,0,43,43,0
8,14,2018,14,0,3,"Braga",1,"Avenida da Liberdade",25,25,0,124,124,0
8,14,2018,14,0,3,"Braga",2,"Avenida Central",25,25,0,124,124,0
8,14,2018,14,0,3,"Braga",3,"Rua de Caires",27,37,10,50,36,14
8,14,2018,14,0,3,"Braga",4,"N14 Bosch",34,47,13,66,48,18
8,14,2018,14,0,3,"Braga",5,"Avenida João Paulo II",24,39,15,15,9,6
8,14,2018,14,0,3,"Braga",6,"Avenida Padre Júlio Fragata",67,67,0,83,83,0
8,14,2018,14,0,3,"Braga",7,"Rua Nova Santa Cruz",43,43,0,40,40,0
8,14,2018,14,0,3,"Braga",8,"Rua Costa Gomes",30,40,10,58,43,15
8,14,2018,15,0,3,"Braga",1,"Avenida da Liberdade",16,25,9,194,124,70
8,14,2018,15,0,3,"Braga",2,"Avenida Central",16,25,9,194,124,70
8,14,2018,15,0,3,"Braga",3,"Rua de Caires",27,37,10,50,36,14
8,14,2018,15,0,3,"Braga",4,"N14 Bosch",28,47,19,80,48,32
8,14,2018,15,0,3,"Braga",5,"Avenida João Paulo II",39,39,0,9,9,0
8,14,2018,15,0,3,"Braga",6,"Avenida Padre Júlio Fragata",53,67,14,105,83,22
8,14,2018,15,0,3,"Braga",7,"Rua Nova Santa Cruz",43,43,0,40,40,0
8,14,2018,15,0,3,"Braga",8,"Rua Costa Gomes",30,40,10,58,43,15
8,14,2018,16,0,3,"Braga",1,"Avenida da Liberdade",25,25,0,124,124,0
8,14,2018,16,0,3,"Braga",2,"Avenida Central",25,25,0,124,124,0
8,14,2018,16,0,3,"Braga",3,"Rua de Caires",28,37,9,48,36,12
8,14,2018,16,0,3,"Braga",4,"N14 Bosch",25,47,22,90,48,42
8,14,2018,16,0,3,"Braga",5,"Avenida João Paulo II",39,39,0,9,9,0
8,14,2018,16,0,3,"Braga",6,"Avenida Padre Júlio Fragata",47,67,20,119,83,36
8,14,2018,16,0,3,"Braga",7,"Rua Nova Santa Cruz",31,43,12,56,40,16
8,14,2018,16,0,3,"Braga",8,"Rua Costa Gomes",25,40,15,69,43,26
8,14,2018,17,0,3,"Braga",1,"Avenida da Liberdade",25,25,0,124,124,0
8,14,2018,17,0,3,"Braga",2,"Avenida Central",25,25,0,124,124,0
8,14,2018,17,0,3,"Braga",3,"Rua de Caires",37,37,0,36,36,0
8,14,2018,17,0,3,"Braga",4,"N14 Bosch",32,47,15,70,48,22
8,14,2018,17,0,3,"Braga",5,"Avenida João Paulo II",29,39,10,12,9,3
8,14,2018,17,0,3,"Braga",6,"Avenida Padre Júlio Fragata",38,67,29,147,83,64
8,14,2018,17,0,3,"Braga",7,"Rua Nova Santa Cruz",43,43,0,40,40,0
8,14,2018,17,0,3,"Braga",8,"Rua Costa Gomes",40,40,0,43,43,0
8,14,2018,18,0,3,"Braga",1,"Avenida da Liberdade",25,25,0,124,124,0
8,14,2018,18,0,3,"Braga",2,"Avenida Central",25,25,0,124,124,0
8,14,2018,18,0,3,"Braga",3,"Rua de Caires",26,37,11,52,36,16
8,14,2018,18,0,3,"Braga",4,"N14 Bosch",26,47,21,86,48,38
8,14,2018,18,0,3,"Braga",5,"Avenida João Paulo II",27,39,12,13,9,4
8,14,2018,18,0,3,"Braga",6,"Avenida Padre Júlio Fragata",33,67,34,169,83,86
8,14,2018,18,0,3,"Braga",7,"Rua Nova Santa Cruz",43,43,0,40,40,0
8,14,2018,18,0,3,"Braga",8,"Rua Costa Gomes",27,40,13,64,43,21
8,14,2018,19,0,3,"Braga",1,"Avenida da Liberdade",25,25,0,124,124,0
8,14,2018,19,0,3,"Braga",2,"Avenida Central",25,25,0,124,124,0
8,14,2018,19,0,3,"Braga",3,"Rua de Caires",37,37,0,36,36,0
8,14,2018,19,0,3,"Braga",4,"N14 Bosch",47,47,0,48,48,0
8,14,2018,19,0,3,"Braga",5,"Avenida João Paulo II",39,39,0,9,9,0
8,14,2018,19,0,3,"Braga",6,"Avenida Padre Júlio Fragata",67,67,0,83,83,0
8,14,2018,19,0,3,"Braga",7,"Rua Nova Santa Cruz",43,43,0,40,40,0
8,14,2018,19,0,3,"Braga",8,"Rua Costa Gomes",40,40,0,43,43,0
8,14,2018,20,0,3,"Braga",1,"Avenida da Liberdade",25,25,0,124,124,0
8,14,2018,20,0,3,"Braga",2,"Avenida Central",25,25,0,124,124,0
8,14,2018,20,0,3,"Braga",3,"Rua de Caires",37,37,0,36,36,0
8,14,2018,20,0,3,"Braga",4,"N14 Bosch",47,47,0,48,48,0
8,14,2018,20,0,3,"Braga",5,"Avenida João Paulo II",39,39,0,9,9,0
8,14,2018,20,0,3,"Braga",6,"Avenida Padre Júlio Fragata",67,67,0,83,83,0
8,14,2018,20,0,3,"Braga",7,"Rua Nova Santa Cruz",43,43,0,40,40,0
8,14,2018,20,0,3,"Braga",8,"Rua Costa Gomes",40,40,0,43,43,0
8,14,2018,21,0,3,"Braga",1,"Avenida da Liberdade",25,25,0,124,124,0
8,14,2018,21,0,3,"Braga",2,"Avenida Central",25,25,0,124,124,0
8,14,2018,21,0,3,"Braga",3,"Rua de Caires",37,37,0,36,36,0
8,14,2018,21,0,3,"Braga",4,"N14 Bosch",47,47,0,48,48,0
8,14,2018,21,0,3,"Braga",5,"Avenida João Paulo II",39,39,0,9,9,0
8,14,2018,21,0,3,"Braga",6,"Avenida Padre Júlio Fragata",67,67,0,83,83,0
8,14,2018,21,0,3,"Braga",7,"Rua Nova Santa Cruz",43,43,0,40,40,0
8,14,2018,21,0,3,"Braga",8,"Rua Costa Gomes",40,40,0,43,43,0
8,14,2018,22,0,3,"Braga",1,"Avenida da Liberdade",25,25,0,124,124,0
8,14,2018,22,0,3,"Braga",2,"Avenida Central",25,25,0,124,124,0
8,14,2018,22,0,3,"Braga",3,"Rua de Caires",26,37,11,52,36,16
8,14,2018,22,0,3,"Braga",4,"N14 Bosch",47,47,0,48,48,0
8,14,2018,22,0,3,"Braga",5,"Avenida João Paulo II",39,39,0,9,9,0
8,14,2018,22,0,3,"Braga",6,"Avenida Padre Júlio Fragata",67,67,0,83,83,0
8,14,2018,22,0,3,"Braga",7,"Rua Nova Santa Cruz",43,43,0,40,40,0
8,14,2018,22,0,3,"Braga",8,"Rua Costa Gomes",40,40,0,43,43,0
8,14,2018,23,0,3,"Braga",1,"Avenida da Liberdade",25,25,0,124,124,0
8,14,2018,23,0,3,"Braga",2,"Avenida Central",25,25,0,124,124,0
8,14,2018,23,0,3,"Braga",3,"Rua de Caires",37,37,0,36,36,0
8,14,2018,23,0,3,"Braga",4,"N14 Bosch",47,47,0,48,48,0
8,14,2018,23,0,3,"Braga",5,"Avenida João Paulo II",39,39,0,9,9,0
8,14,2018,23,0,3,"Braga",6,"Avenida Padre Júlio Fragata",67,67,0,83,83,0
8,14,2018,23,0,3,"Braga",7,"Rua Nova Santa Cruz",43,43,0,40,40,0
8,14,2018,23,0,3,"Braga",8,"Rua Costa Gomes",40,40,0,43,43,0
8,15,2018,0,0,4,"Braga",1,"Avenida da Liberdade",25,25,0,124,124,0
8,15,2018,0,0,4,"Braga",2,"Avenida Central",25,25,0,124,124,0
8,15,2018,0,0,4,"Braga",3,"Rua de Caires",37,37,0,36,36,0
8,15,2018,0,0,4,"Braga",4,"N14 Bosch",47,47,0,48,48,0
8,15,2018,0,0,4,"Braga",5,"Avenida João Paulo II",39,39,0,9,9,0
8,15,2018,0,0,4,"Braga",6,"Avenida Padre Júlio Fragata",67,67,0,83,83,0
8,15,2018,0,0,4,"Braga",7,"Rua Nova Santa Cruz",43,43,0,40,40,0
8,15,2018,0,0,4,"Braga",8,"Rua Costa Gomes",40,40,0,43,43,0
8,15,2018,1,0,4,"Braga",1,"Avenida da Liberdade",25,25,0,124,124,0
8,15,2018,1,0,4,"Braga",2,"Avenida Central",25,25,0,124,124,0
8,15,2018,1,0,4,"Braga",3,"Rua de Caires",37,37,0,36,36,0
8,15,2018,1,0,4,"Braga",4,"N14 Bosch",47,47,0,48,48,0
8,15,2018,1,0,4,"Braga",5,"Avenida João Paulo II",39,39,0,9,9,0
8,15,2018,1,0,4,"Braga",6,"Avenida Padre Júlio Fragata",67,67,0,83,83,0
8,15,2018,1,0,4,"Braga",7,"Rua Nova Santa Cruz",43,43,0,40,40,0
8,15,2018,1,0,4,"Braga",8,"Rua Costa Gomes",40,40,0,43,43,0
8,15,2018,2,0,4,"Braga",1,"Avenida da Liberdade",25,25,0,124,124,0
8,15,2018,2,0,4,"Braga",2,"Avenida Central",25,25,0,124,124,0
8,15,2018,2,0,4,"Braga",3,"Rua de Caires",37,37,0,36,36,0
8,15,2018,2,0,4,"Braga",4,"N14 Bosch",47,47,0,48,48,0
8,15,2018,2,0,4,"Braga",5,"Avenida João Paulo II",39,39,0,9,9,0
8,15,2018,2,0,4,"Braga",6,"Avenida Padre Júlio Fragata",67,67,0,83,83,0
8,15,2018,2,0,4,"Braga",7,"Rua Nova Santa Cruz",43,43,0,40,40,0
8,15,2018,2,0,4,"Braga",8,"Rua Costa Gomes",40,40,0,43,43,0
8,15,2018,3,0,4,"Braga",1,"Avenida da Liberdade",25,25,0,124,124,0
8,15,2018,3,0,4,"Braga",2,"Avenida Central",25,25,0,124,124,0
8,15,2018,3,0,4,"Braga",3,"Rua de Caires",37,37,0,36,36,0
8,15,2018,3,0,4,"Braga",4,"N14 Bosch",47,47,0,48,48,0
8,15,2018,3,0,4,"Braga",5,"Avenida João Paulo II",39,39,0,9,9,0
8,15,2018,3,0,4,"Braga",6,"Avenida Padre Júlio Fragata",67,67,0,83,83,0
8,15,2018,3,0,4,"Braga",7,"Rua Nova Santa Cruz",43,43,0,40,40,0
8,15,2018,3,0,4,"Braga",8,"Rua Costa Gomes",40,40,0,43,43,0
8,15,2018,4,0,4,"Braga",1,"Avenida da Liberdade",25,25,0,124,124,0
8,15,2018,4,0,4,"Braga",2,"Avenida Central",25,25,0,124,124,0
8,15,2018,4,0,4,"Braga",3,"Rua de Caires",37,37,0,36,36,0
8,15,2018,4,0,4,"Braga",4,"N14 Bosch",47,47,0,48,48,0
8,15,2018,4,0,4,"Braga",5,"Avenida João Paulo II",39,39,0,9,9,0
8,15,2018,4,0,4,"Braga",6,"Avenida Padre Júlio Fragata",67,67,0,83,83,0
8,15,2018,4,0,4,"Braga",7,"Rua Nova Santa Cruz",43,43,0,40,40,0
8,15,2018,4,0,4,"Braga",8,"Rua Costa Gomes",40,40,0,43,43,0
8,15,2018,5,0,4,"Braga",1,"Avenida da Liberdade",25,25,0,124,124,0
8,15,2018,5,0,4,"Braga",2,"Avenida Central",25,25,0,124,124,0
8,15,2018,5,0,4,"Braga",3,"Rua de Caires",37,37,0,36,36,0
8,15,2018,5,0,4,"Braga",4,"N14 Bosch",47,47,0,48,48,0
8,15,2018,5,0,4,"Braga",5,"Avenida João Paulo II",39,39,0,9,9,0
8,15,2018,5,0,4,"Braga",6,"Avenida Padre Júlio Fragata",67,67,0,83,83,0
8,15,2018,5,0,4,"Braga",7,"Rua Nova Santa Cruz",43,43,0,40,40,0
8,15,2018,5,0,4,"Braga",8,"Rua Costa Gomes",40,40,0,43,43,0
8,15,2018,6,0,4,"Braga",1,"Avenida da Liberdade",25,25,0,124,124,0
8,15,2018,6,0,4,"Braga",2,"Avenida Central",25,25,0,124,124,0
8,15,2018,6,0,4,"Braga",3,"Rua de Caires",37,37,0,36,36,0
8,15,2018,6,0,4,"Braga",4,"N14 Bosch",47,47,0,48,48,0
8,15,2018,6,0,4,"Braga",5,"Avenida João Paulo II",39,39,0,9,9,0
8,15,2018,6,0,4,"Braga",6,"Avenida Padre Júlio Fragata",67,67,0,83,83,0
8,15,2018,6,0,4,"Braga",7,"Rua Nova Santa Cruz",43,43,0,40,40,0
8,15,2018,6,0,4,"Braga",8,"Rua Costa Gomes",40,40,0,43,43,0
8,15,2018,7,0,4,"Braga",1,"Avenida da Liberdade",25,25,0,124,124,0
8,15,2018,7,0,4,"Braga",2,"Avenida Central",25,25,0,124,124,0
8,15,2018,7,0,4,"Braga",3,"Rua de Caires",37,37,0,36,36,0
8,15,2018,7,0,4,"Braga",4,"N14 Bosch",47,47,0,48,48,0
8,15,2018,7,0,4,"Braga",5,"Avenida João Paulo II",39,39,0,9,9,0
8,15,2018,7,0,4,"Braga",6,"Avenida Padre Júlio Fragata",67,67,0,83,83,0
8,15,2018,7,0,4,"Braga",7,"Rua Nova Santa Cruz",43,43,0,40,40,0
8,15,2018,7,0,4,"Braga",8,"Rua Costa Gomes",40,40,0,43,43,0
8,15,2018,8,0,4,"Braga",1,"Avenida da Liberdade",25,25,0,124,124,0
8,15,2018,8,0,4,"Braga",2,"Avenida Central",25,25,0,124,124,0
8,15,2018,8,0,4,"Braga",3,"Rua de Caires",37,37,0,36,36,0
8,15,2018,8,0,4,"Braga",4,"N14 Bosch",47,47,0,48,48,0
8,15,2018,8,0,4,"Braga",5,"Avenida João Paulo II",39,39,0,9,9,0
8,15,2018,8,0,4,"Braga",6,"Avenida Padre Júlio Fragata",67,67,0,83,83,0
8,15,2018,8,0,4,"Braga",7,"Rua Nova Santa Cruz",43,43,0,40,40,0
8,15,2018,8,0,4,"Braga",8,"Rua Costa Gomes",40,40,0,43,43,0
8,15,2018,9,0,4,"Braga",1,"Avenida da Liberdade",25,25,0,124,124,0
8,15,2018,9,0,4,"Braga",2,"Avenida Central",25,25,0,124,124,0
8,15,2018,9,0,4,"Braga",3,"Rua de Caires",37,37,0,36,36,0
8,15,2018,9,0,4,"Braga",4,"N14 Bosch",47,47,0,48,48,0
8,15,2018,9,0,4,"Braga",5,"Avenida João Paulo II",39,39,0,9,9,0
8,15,2018,9,0,4,"Braga",6,"Avenida Padre Júlio Fragata",67,67,0,83,83,0
8,15,2018,9,0,4,"Braga",7,"Rua Nova Santa Cruz",43,43,0,40,40,0
8,15,2018,9,0,4,"Braga",8,"Rua Costa Gomes",40,40,0,43,43,0
8,15,2018,10,0,4,"Braga",1,"Avenida da Liberdade",25,25,0,124,124,0
8,15,2018,10,0,4,"Braga",2,"Avenida Central",25,25,0,124,124,0
8,15,2018,10,0,4,"Braga",3,"Rua de Caires",29,37,8,46,36,10
8,15,2018,10,0,4,"Braga",4,"N14 Bosch",47,47,0,48,48,0
8,15,2018,10,0,4,"Braga",5,"Avenida João Paulo II",39,39,0,9,9,0
8,15,2018,10,0,4,"Braga",6,"Avenida Padre Júlio Fragata",67,67,0,83,83,0
8,15,2018,10,0,4,"Braga",7,"Rua Nova Santa Cruz",43,43,0,40,40,0
8,15,2018,10,0,4,"Braga",8,"Rua Costa Gomes",40,40,0,43,43,0
8,15,2018,11,0,4,"Braga",1,"Avenida da Liberdade",25,25,0,124,124,0
8,15,2018,11,0,4,"Braga",2,"Avenida Central",25,25,0,124,124,0
8,15,2018,11,0,4,"Braga",3,"Rua de Caires",37,37,0,36,36,0
8,15,2018,11,0,4,"Braga",4,"N14 Bosch",47,47,0,48,48,0
8,15,2018,11,0,4,"Braga",5,"Avenida João Paulo II",39,39,0,9,9,0
8,15,2018,11,0,4,"Braga",6,"Avenida Padre Júlio Fragata",67,67,0,83,83,0
8,15,2018,11,0,4,"Braga",7,"Rua Nova Santa Cruz",43,43,0,40,40,0
8,15,2018,11,0,4,"Braga",8,"Rua Costa Gomes",40,40,0,43,43,0
8,15,2018,12,0,4,"Braga",1,"Avenida da Liberdade",25,25,0,124,124,0
8,15,2018,12,0,4,"Braga",2,"Avenida Central",25,25,0,124,124,0
8,15,2018,12,0,4,"Braga",3,"Rua de Caires",37,37,0,36,36,0
8,15,2018,12,0,4,"Braga",4,"N14 Bosch",47,47,0,48,48,0
8,15,2018,12,0,4,"Braga",5,"Avenida João Paulo II",30,39,9,12,9,3
8,15,2018,12,0,4,"Braga",6,"Avenida Padre Júlio Fragata",67,67,0,83,83,0
8,15,2018,12,0,4,"Braga",7,"Rua Nova Santa Cruz",43,43,0,40,40,0
8,15,2018,12,0,4,"Braga",8,"Rua Costa Gomes",40,40,0,43,43,0
8,15,2018,13,0,4,"Braga",1,"Avenida da Liberdade",19,25,6,163,124,39
8,15,2018,13,0,4,"Braga",2,"Avenida Central",19,25,6,163,124,39
8,15,2018,13,0,4,"Braga",3,"Rua de Caires",37,37,0,36,36,0
8,15,2018,13,0,4,"Braga",4,"N14 Bosch",47,47,0,48,48,0
8,15,2018,13,0,4,"Braga",5,"Avenida João Paulo II",39,39,0,9,9,0
8,15,2018,13,0,4,"Braga",6,"Avenida Padre Júlio Fragata",67,67,0,83,83,0
8,15,2018,13,0,4,"Braga",7,"Rua Nova Santa Cruz",43,43,0,40,40,0
8,15,2018,13,0,4,"Braga",8,"Rua Costa Gomes",40,40,0,43,43,0
8,15,2018,14,0,4,"Braga",1,"Avenida da Liberdade",25,25,0,124,124,0
8,15,2018,14,0,4,"Braga",2,"Avenida Central",25,25,0,124,124,0
8,15,2018,14,0,4,"Braga",3,"Rua de Caires",28,37,9,48,36,12
8,15,2018,14,0,4,"Braga",4,"N14 Bosch",47,47,0,48,48,0
8,15,2018,14,0,4,"Braga",5,"Avenida João Paulo II",39,39,0,9,9,0
8,15,2018,14,0,4,"Braga",6,"Avenida Padre Júlio Fragata",67,67,0,83,83,0
8,15,2018,14,0,4,"Braga",7,"Rua Nova Santa Cruz",43,43,0,40,40,0
8,15,2018,14,0,4,"Braga",8,"Rua Costa Gomes",40,40,0,43,43,0
8,15,2018,15,0,4,"Braga",1,"Avenida da Liberdade",25,25,0,124,124,0
8,15,2018,15,0,4,"Braga",2,"Avenida Central",25,25,0,124,124,0
8,15,2018,15,0,4,"Braga",3,"Rua de Caires",37,37,0,36,36,0
8,15,2018,15,0,4,"Braga",4,"N14 Bosch",47,47,0,48,48,0
8,15,2018,15,0,4,"Braga",5,"Avenida João Paulo II",39,39,0,9,9,0
8,15,2018,15,0,4,"Braga",6,"Avenida Padre Júlio Fragata",67,67,0,83,83,0
8,15,2018,15,0,4,"Braga",7,"Rua Nova Santa Cruz",43,43,0,40,40,0
8,15,2018,15,0,4,"Braga",8,"Rua Costa Gomes",40,40,0,43,43,0
8,15,2018,16,0,4,"Braga",1,"Avenida da Liberdade",25,25,0,124,124,0
8,15,2018,16,0,4,"Braga",2,"Avenida Central",25,25,0,124,124,0
8,15,2018,16,0,4,"Braga",3,"Rua de Caires",37,37,0,36,36,0
8,15,2018,16,0,4,"Braga",4,"N14 Bosch",47,47,0,48,48,0
8,15,2018,16,0,4,"Braga",5,"Avenida João Paulo II",39,39,0,9,9,0
8,15,2018,16,0,4,"Braga",6,"Avenida Padre Júlio Fragata",67,67,0,83,83,0
8,15,2018,16,0,4,"Braga",7,"Rua Nova Santa Cruz",43,43,0,40,40,0
8,15,2018,16,0,4,"Braga",8,"Rua Costa Gomes",40,40,0,43,43,0
8,15,2018,17,0,4,"Braga",1,"Avenida da Liberdade",18,25,7,172,124,48
8,15,2018,17,0,4,"Braga",2,"Avenida Central",18,25,7,172,124,48
8,15,2018,17,0,4,"Braga",3,"Rua de Caires",37,37,0,36,36,0
8,15,2018,17,0,4,"Braga",4,"N14 Bosch",47,47,0,48,48,0
8,15,2018,17,0,4,"Braga",5,"Avenida João Paulo II",39,39,0,9,9,0
8,15,2018,17,0,4,"Braga",6,"Avenida Padre Júlio Fragata",67,67,0,83,83,0
8,15,2018,17,0,4,"Braga",7,"Rua Nova Santa Cruz",43,43,0,40,40,0
8,15,2018,17,0,4,"Braga",8,"Rua Costa Gomes",40,40,0,43,43,0
8,15,2018,18,0,4,"Braga",1,"Avenida da Liberdade",25,25,0,124,124,0
8,15,2018,18,0,4,"Braga",2,"Avenida Central",25,25,0,124,124,0
8,15,2018,18,0,4,"Braga",3,"Rua de Caires",37,37,0,36,36,0
8,15,2018,18,0,4,"Braga",4,"N14 Bosch",47,47,0,48,48,0
8,15,2018,18,0,4,"Braga",5,"Avenida João Paulo II",27,39,12,13,9,4
8,15,2018,18,0,4,"Braga",6,"Avenida Padre Júlio Fragata",50,67,17,111,83,28
8,15,2018,18,0,4,"Braga",7,"Rua Nova Santa Cruz",43,43,0,40,40,0
8,15,2018,18,0,4,"Braga",8,"Rua Costa Gomes",40,40,0,43,43,0
8,15,2018,19,0,4,"Braga",1,"Avenida da Liberdade",19,25,6,163,124,39
8,15,2018,19,0,4,"Braga",2,"Avenida Central",19,25,6,163,124,39
8,15,2018,19,0,4,"Braga",3,"Rua de Caires",37,37,0,36,36,0
8,15,2018,19,0,4,"Braga",4,"N14 Bosch",47,47,0,48,48,0
8,15,2018,19,0,4,"Braga",5,"Avenida João Paulo II",39,39,0,9,9,0
8,15,2018,19,0,4,"Braga",6,"Avenida Padre Júlio Fragata",67,67,0,83,83,0
8,15,2018,19,0,4,"Braga",7,"Rua Nova Santa Cruz",43,43,0,40,40,0
8,15,2018,19,0,4,"Braga",8,"Rua Costa Gomes",40,40,0,43,43,0
8,15,2018,20,0,4,"Braga",1,"Avenida da Liberdade",19,25,6,163,124,39
8,15,2018,20,0,4,"Braga",2,"Avenida Central",19,25,6,163,124,39
8,15,2018,20,0,4,"Braga",3,"Rua de Caires",29,37,8,46,36,10
8,15,2018,20,0,4,"Braga",4,"N14 Bosch",47,47,0,48,48,0
8,15,2018,20,0,4,"Braga",5,"Avenida João Paulo II",39,39,0,9,9,0
8,15,2018,20,0,4,"Braga",6,"Avenida Padre Júlio Fragata",49,67,18,114,83,31
8,15,2018,20,0,4,"Braga",7,"Rua Nova Santa Cruz",43,43,0,40,40,0
8,15,2018,20,0,4,"Braga",8,"Rua Costa Gomes",40,40,0,43,43,0
8,15,2018,21,0,4,"Braga",1,"Avenida da Liberdade",25,25,0,124,124,0
8,15,2018,21,0,4,"Braga",2,"Avenida Central",25,25,0,124,124,0
8,15,2018,21,0,4,"Braga",3,"Rua de Caires",37,37,0,36,36,0
8,15,2018,21,0,4,"Braga",4,"N14 Bosch",47,47,0,48,48,0
8,15,2018,21,0,4,"Braga",5,"Avenida João Paulo II",39,39,0,9,9,0
8,15,2018,21,0,4,"Braga",6,"Avenida Padre Júlio Fragata",67,67,0,83,83,0
8,15,2018,21,0,4,"Braga",7,"Rua Nova Santa Cruz",33,43,10,52,40,12
8,15,2018,21,0,4,"Braga",8,"Rua Costa Gomes",40,40,0,43,43,0
8,15,2018,22,0,4,"Braga",1,"Avenida da Liberdade",25,25,0,124,124,0
8,15,2018,22,0,4,"Braga",2,"Avenida Central",25,25,0,124,124,0
8,15,2018,22,0,4,"Braga",3,"Rua de Caires",37,37,0,36,36,0
8,15,2018,22,0,4,"Braga",4,"N14 Bosch",35,47,12,64,48,16
8,15,2018,22,0,4,"Braga",5,"Avenida João Paulo II",39,39,0,9,9,0
8,15,2018,22,0,4,"Braga",6,"Avenida Padre Júlio Fragata",67,67,0,83,83,0
8,15,2018,22,0,4,"Braga",7,"Rua Nova Santa Cruz",43,43,0,40,40,0
8,15,2018,22,0,4,"Braga",8,"Rua Costa Gomes",40,40,0,43,43,0
8,15,2018,23,0,4,"Braga",1,"Avenida da Liberdade",25,25,0,124,124,0
8,15,2018,23,0,4,"Braga",2,"Avenida Central",25,25,0,124,124,0
8,15,2018,23,0,4,"Braga",3,"Rua de Caires",37,37,0,36,36,0
8,15,2018,23,0,4,"Braga",4,"N14 Bosch",47,47,0,48,48,0
8,15,2018,23,0,4,"Braga",5,"Avenida João Paulo II",39,39,0,9,9,0
8,15,2018,23,0,4,"Braga",6,"Avenida Padre Júlio Fragata",67,67,0,83,83,0
8,15,2018,23,0,4,"Braga",7,"Rua Nova Santa Cruz",43,43,0,40,40,0
8,15,2018,23,0,4,"Braga",8,"Rua Costa Gomes",40,40,0,43,43,0
8,16,2018,0,0,5,"Braga",1,"Avenida da Liberdade",25,25,0,124,124,0
8,16,2018,0,0,5,"Braga",2,"Avenida Central",25,25,0,124,124,0
8,16,2018,0,0,5,"Braga",3,"Rua de Caires",37,37,0,36,36,0
8,16,2018,0,0,5,"Braga",4,"N14 Bosch",47,47,0,48,48,0
8,16,2018,0,0,5,"Braga",5,"Avenida João Paulo II",39,39,0,9,9,0
8,16,2018,0,0,5,"Braga",6,"Avenida Padre Júlio Fragata",67,67,0,83,83,0
8,16,2018,0,0,5,"Braga",7,"Rua Nova Santa Cruz",43,43,0,40,40,0
8,16,2018,0,0,5,"Braga",8,"Rua Costa Gomes",40,40,0,43,43,0
8,16,2018,1,0,5,"Braga",1,"Avenida da Liberdade",25,25,0,124,124,0
8,16,2018,1,0,5,"Braga",2,"Avenida Central",25,25,0,124,124,0
8,16,2018,1,0,5,"Braga",3,"Rua de Caires",37,37,0,36,36,0
8,16,2018,1,0,5,"Braga",4,"N14 Bosch",47,47,0,48,48,0
8,16,2018,1,0,5,"Braga",5,"Avenida João Paulo II",39,39,0,9,9,0
8,16,2018,1,0,5,"Braga",6,"Avenida Padre Júlio Fragata",67,67,0,83,83,0
8,16,2018,1,0,5,"Braga",7,"Rua Nova Santa Cruz",43,43,0,40,40,0
8,16,2018,1,0,5,"Braga",8,"Rua Costa Gomes",40,40,0,43,43,0
8,16,2018,2,0,5,"Braga",1,"Avenida da Liberdade",25,25,0,124,124,0
8,16,2018,2,0,5,"Braga",2,"Avenida Central",25,25,0,124,124,0
8,16,2018,2,0,5,"Braga",3,"Rua de Caires",37,37,0,36,36,0
8,16,2018,2,0,5,"Braga",4,"N14 Bosch",47,47,0,48,48,0
8,16,2018,2,0,5,"Braga",5,"Avenida João Paulo II",39,39,0,9,9,0
8,16,2018,2,0,5,"Braga",6,"Avenida Padre Júlio Fragata",67,67,0,83,83,0
8,16,2018,2,0,5,"Braga",7,"Rua Nova Santa Cruz",43,43,0,40,40,0
8,16,2018,2,0,5,"Braga",8,"Rua Costa Gomes",40,40,0,43,43,0
8,16,2018,3,0,5,"Braga",1,"Avenida da Liberdade",25,25,0,124,124,0
8,16,2018,3,0,5,"Braga",2,"Avenida Central",25,25,0,124,124,0
8,16,2018,3,0,5,"Braga",3,"Rua de Caires",37,37,0,36,36,0
8,16,2018,3,0,5,"Braga",4,"N14 Bosch",47,47,0,48,48,0
8,16,2018,3,0,5,"Braga",5,"Avenida João Paulo II",39,39,0,9,9,0
8,16,2018,3,0,5,"Braga",6,"Avenida Padre Júlio Fragata",67,67,0,83,83,0
8,16,2018,3,0,5,"Braga",7,"Rua Nova Santa Cruz",43,43,0,40,40,0
8,16,2018,3,0,5,"Braga",8,"Rua Costa Gomes",40,40,0,43,43,0
8,16,2018,4,0,5,"Braga",1,"Avenida da Liberdade",25,25,0,124,124,0
8,16,2018,4,0,5,"Braga",2,"Avenida Central",25,25,0,124,124,0
8,16,2018,4,0,5,"Braga",3,"Rua de Caires",37,37,0,36,36,0
8,16,2018,4,0,5,"Braga",4,"N14 Bosch",47,47,0,48,48,0
8,16,2018,4,0,5,"Braga",5,"Avenida João Paulo II",39,39,0,9,9,0
8,16,2018,4,0,5,"Braga",6,"Avenida Padre Júlio Fragata",67,67,0,83,83,0
8,16,2018,4,0,5,"Braga",7,"Rua Nova Santa Cruz",43,43,0,40,40,0
8,16,2018,4,0,5,"Braga",8,"Rua Costa Gomes",40,40,0,43,43,0
8,16,2018,5,0,5,"Braga",1,"Avenida da Liberdade",25,25,0,124,124,0
8,16,2018,5,0,5,"Braga",2,"Avenida Central",25,25,0,124,124,0
8,16,2018,5,0,5,"Braga",3,"Rua de Caires",37,37,0,36,36,0
8,16,2018,5,0,5,"Braga",4,"N14 Bosch",47,47,0,48,48,0
8,16,2018,5,0,5,"Braga",5,"Avenida João Paulo II",39,39,0,9,9,0
8,16,2018,5,0,5,"Braga",6,"Avenida Padre Júlio Fragata",67,67,0,83,83,0
8,16,2018,5,0,5,"Braga",7,"Rua Nova Santa Cruz",43,43,0,40,40,0
8,16,2018,5,0,5,"Braga",8,"Rua Costa Gomes",40,40,0,43,43,0
8,16,2018,6,0,5,"Braga",1,"Avenida da Liberdade",25,25,0,124,124,0
8,16,2018,6,0,5,"Braga",2,"Avenida Central",25,25,0,124,124,0
8,16,2018,6,0,5,"Braga",3,"Rua de Caires",37,37,0,36,36,0
8,16,2018,6,0,5,"Braga",4,"N14 Bosch",47,47,0,48,48,0
8,16,2018,6,0,5,"Braga",5,"Avenida João Paulo II",39,39,0,9,9,0
8,16,2018,6,0,5,"Braga",6,"Avenida Padre Júlio Fragata",67,67,0,83,83,0
8,16,2018,6,0,5,"Braga",7,"Rua Nova Santa Cruz",43,43,0,40,40,0
8,16,2018,6,0,5,"Braga",8,"Rua Costa Gomes",40,40,0,43,43,0
8,16,2018,7,0,5,"Braga",1,"Avenida da Liberdade",25,25,0,124,124,0
8,16,2018,7,0,5,"Braga",2,"Avenida Central",25,25,0,124,124,0
8,16,2018,7,0,5,"Braga",3,"Rua de Caires",37,37,0,36,36,0
8,16,2018,7,0,5,"Braga",4,"N14 Bosch",47,47,0,48,48,0
8,16,2018,7,0,5,"Braga",5,"Avenida João Paulo II",39,39,0,9,9,0
8,16,2018,7,0,5,"Braga",6,"Avenida Padre Júlio Fragata",67,67,0,83,83,0
8,16,2018,7,0,5,"Braga",7,"Rua Nova Santa Cruz",30,43,13,58,40,18
8,16,2018,7,0,5,"Braga",8,"Rua Costa Gomes",40,40,0,43,43,0
8,16,2018,8,0,5,"Braga",1,"Avenida da Liberdade",25,25,0,124,124,0
8,16,2018,8,0,5,"Braga",2,"Avenida Central",25,25,0,124,124,0
8,16,2018,8,0,5,"Braga",3,"Rua de Caires",21,37,16,64,36,28
8,16,2018,8,0,5,"Braga",4,"N14 Bosch",47,47,0,48,48,0
8,16,2018,8,0,5,"Braga",5,"Avenida João Paulo II",39,39,0,9,9,0
8,16,2018,8,0,5,"Braga",6,"Avenida Padre Júlio Fragata",67,67,0,83,83,0
8,16,2018,8,0,5,"Braga",7,"Rua Nova Santa Cruz",43,43,0,40,40,0
8,16,2018,8,0,5,"Braga",8,"Rua Costa Gomes",40,40,0,43,43,0
8,16,2018,9,0,5,"Braga",1,"Avenida da Liberdade",17,25,8,182,124,58
8,16,2018,9,0,5,"Braga",2,"Avenida Central",17,25,8,182,124,58
8,16,2018,9,0,5,"Braga",3,"Rua de Caires",23,37,14,59,36,23
8,16,2018,9,0,5,"Braga",4,"N14 Bosch",21,47,26,107,48,59
8,16,2018,9,0,5,"Braga",5,"Avenida João Paulo II",39,39,0,9,9,0
8,16,2018,9,0,5,"Braga",6,"Avenida Padre Júlio Fragata",67,67,0,83,83,0
8,16,2018,9,0,5,"Braga",7,"Rua Nova Santa Cruz",43,43,0,40,40,0
8,16,2018,9,0,5,"Braga",8,"Rua Costa Gomes",40,40,0,43,43,0
8,16,2018,10,0,5,"Braga",1,"Avenida da Liberdade",18,25,7,172,124,48
8,16,2018,10,0,5,"Braga",2,"Avenida Central",18,25,7,172,124,48
8,16,2018,10,0,5,"Braga",3,"Rua de Caires",19,36,17,71,37,34
8,16,2018,10,0,5,"Braga",4,"N14 Bosch",25,47,22,90,48,42
8,16,2018,10,0,5,"Braga",5,"Avenida João Paulo II",39,39,0,9,9,0
8,16,2018,10,0,5,"Braga",6,"Avenida Padre Júlio Fragata",67,67,0,83,83,0
8,16,2018,10,0,5,"Braga",7,"Rua Nova Santa Cruz",44,44,0,39,39,0
8,16,2018,10,0,5,"Braga",8,"Rua Costa Gomes",30,41,11,58,42,16
8,16,2018,11,0,5,"Braga",1,"Avenida da Liberdade",17,25,8,182,124,58
8,16,2018,11,0,5,"Braga",2,"Avenida Central",17,25,8,182,124,58
8,16,2018,11,0,5,"Braga",3,"Rua de Caires",36,36,0,37,37,0
8,16,2018,11,0,5,"Braga",4,"N14 Bosch",33,47,14,68,48,20
8,16,2018,11,0,5,"Braga",5,"Avenida João Paulo II",30,39,9,12,9,3
8,16,2018,11,0,5,"Braga",6,"Avenida Padre Júlio Fragata",67,67,0,83,83,0
8,16,2018,11,0,5,"Braga",7,"Rua Nova Santa Cruz",44,44,0,39,39,0
8,16,2018,11,0,5,"Braga",8,"Rua Costa Gomes",30,41,11,58,42,16
8,16,2018,12,0,5,"Braga",1,"Avenida da Liberdade",19,25,6,163,124,39
8,16,2018,12,0,5,"Braga",2,"Avenida Central",19,25,6,163,124,39
8,16,2018,12,0,5,"Braga",3,"Rua de Caires",28,36,8,48,37,11
8,16,2018,12,0,5,"Braga",4,"N14 Bosch",28,47,19,80,48,32
8,16,2018,12,0,5,"Braga",5,"Avenida João Paulo II",39,39,0,9,9,0
8,16,2018,12,0,5,"Braga",6,"Avenida Padre Júlio Fragata",67,67,0,83,83,0
8,16,2018,12,0,5,"Braga",7,"Rua Nova Santa Cruz",44,44,0,39,39,0
8,16,2018,12,0,5,"Braga",8,"Rua Costa Gomes",28,41,13,62,42,20
8,16,2018,13,0,5,"Braga",1,"Avenida da Liberdade",25,25,0,124,124,0
8,16,2018,13,0,5,"Braga",2,"Avenida Central",25,25,0,124,124,0
8,16,2018,13,0,5,"Braga",3,"Rua de Caires",36,36,0,37,37,0
8,16,2018,13,0,5,"Braga",4,"N14 Bosch",21,47,26,107,48,59
8,16,2018,13,0,5,"Braga",5,"Avenida João Paulo II",26,39,13,13,9,4
8,16,2018,13,0,5,"Braga",6,"Avenida Padre Júlio Fragata",67,67,0,83,83,0
8,16,2018,13,0,5,"Braga",7,"Rua Nova Santa Cruz",44,44,0,39,39,0
8,16,2018,13,0,5,"Braga",8,"Rua Costa Gomes",31,41,10,56,42,14
8,16,2018,14,0,5,"Braga",1,"Avenida da Liberdade",25,25,0,124,124,0
8,16,2018,14,0,5,"Braga",2,"Avenida Central",25,25,0,124,124,0
8,16,2018,14,0,5,"Braga",3,"Rua de Caires",19,36,17,71,37,34
8,16,2018,14,0,5,"Braga",4,"N14 Bosch",33,47,14,68,48,20
8,16,2018,14,0,5,"Braga",5,"Avenida João Paulo II",9,39,30,39,9,30
8,16,2018,14,0,5,"Braga",6,"Avenida Padre Júlio Fragata",67,67,0,83,83,0
8,16,2018,14,0,5,"Braga",7,"Rua Nova Santa Cruz",44,44,0,39,39,0
8,16,2018,14,0,5,"Braga",8,"Rua Costa Gomes",26,41,15,67,42,25
8,16,2018,15,0,5,"Braga",1,"Avenida da Liberdade",19,25,6,163,124,39
8,16,2018,15,0,5,"Braga",2,"Avenida Central",19,25,6,163,124,39
8,16,2018,15,0,5,"Braga",3,"Rua de Caires",36,36,0,37,37,0
8,16,2018,15,0,5,"Braga",4,"N14 Bosch",37,47,10,61,48,13
8,16,2018,15,0,5,"Braga",5,"Avenida João Paulo II",9,39,30,39,9,30
8,16,2018,15,0,5,"Braga",6,"Avenida Padre Júlio Fragata",39,67,28,143,83,60
8,16,2018,15,0,5,"Braga",7,"Rua Nova Santa Cruz",44,44,0,39,39,0
8,16,2018,15,0,5,"Braga",8,"Rua Costa Gomes",21,41,20,82,42,40
8,16,2018,16,0,5,"Braga",1,"Avenida da Liberdade",19,25,6,163,124,39
8,16,2018,16,0,5,"Braga",2,"Avenida Central",19,25,6,163,124,39
8,16,2018,16,0,5,"Braga",3,"Rua de Caires",36,36,0,37,37,0
8,16,2018,16,0,5,"Braga",4,"N14 Bosch",35,47,12,64,48,16
8,16,2018,16,0,5,"Braga",5,"Avenida João Paulo II",4,39,35,87,9,78
8,16,2018,16,0,5,"Braga",6,"Avenida Padre Júlio Fragata",10,67,57,557,83,474
8,16,2018,16,0,5,"Braga",7,"Rua Nova Santa Cruz",44,44,0,39,39,0
8,16,2018,16,0,5,"Braga",8,"Rua Costa Gomes",41,41,0,42,42,0
8,16,2018,17,0,5,"Braga",1,"Avenida da Liberdade",15,25,10,207,124,83
8,16,2018,17,0,5,"Braga",2,"Avenida Central",15,25,10,207,124,83
8,16,2018,17,0,5,"Braga",3,"Rua de Caires",19,36,17,71,37,34
8,16,2018,17,0,5,"Braga",4,"N14 Bosch",27,47,20,83,48,35
8,16,2018,17,0,5,"Braga",5,"Avenida João Paulo II",39,39,0,9,9,0
8,16,2018,17,0,5,"Braga",6,"Avenida Padre Júlio Fragata",19,67,48,293,83,210
8,16,2018,17,0,5,"Braga",7,"Rua Nova Santa Cruz",44,44,0,39,39,0
8,16,2018,17,0,5,"Braga",8,"Rua Costa Gomes",16,41,25,108,42,66
8,16,2018,18,0,5,"Braga",1,"Avenida da Liberdade",25,25,0,124,124,0
8,16,2018,18,0,5,"Braga",2,"Avenida Central",25,25,0,124,124,0
8,16,2018,18,0,5,"Braga",3,"Rua de Caires",24,36,12,56,37,19
8,16,2018,18,0,5,"Braga",4,"N14 Bosch",24,47,23,94,48,46
8,16,2018,18,0,5,"Braga",5,"Avenida João Paulo II",13,39,26,27,9,18
8,16,2018,18,0,5,"Braga",6,"Avenida Padre Júlio Fragata",22,67,45,253,83,170
8,16,2018,18,0,5,"Braga",7,"Rua Nova Santa Cruz",44,44,0,39,39,0
8,16,2018,18,0,5,"Braga",8,"Rua Costa Gomes",31,41,10,56,42,14
8,16,2018,19,0,5,"Braga",1,"Avenida da Liberdade",19,25,6,163,124,39
8,16,2018,19,0,5,"Braga",2,"Avenida Central",19,25,6,163,124,39
8,16,2018,19,0,5,"Braga",3,"Rua de Caires",36,36,0,37,37,0
8,16,2018,19,0,5,"Braga",4,"N14 Bosch",47,47,0,48,48,0
8,16,2018,19,0,5,"Braga",5,"Avenida João Paulo II",7,39,32,50,9,41
8,16,2018,19,0,5,"Braga",6,"Avenida Padre Júlio Fragata",18,67,49,310,83,227
8,16,2018,19,0,5,"Braga",7,"Rua Nova Santa Cruz",44,44,0,39,39,0
8,16,2018,19,0,5,"Braga",8,"Rua Costa Gomes",19,41,22,91,42,49
8,16,2018,20,0,5,"Braga",1,"Avenida da Liberdade",25,25,0,124,124,0
8,16,2018,20,0,5,"Braga",2,"Avenida Central",25,25,0,124,124,0
8,16,2018,20,0,5,"Braga",3,"Rua de Caires",36,36,0,37,37,0
8,16,2018,20,0,5,"Braga",4,"N14 Bosch",47,47,0,48,48,0
8,16,2018,20,0,5,"Braga",5,"Avenida João Paulo II",39,39,0,9,9,0
8,16,2018,20,0,5,"Braga",6,"Avenida Padre Júlio Fragata",67,67,0,83,83,0
8,16,2018,20,0,5,"Braga",7,"Rua Nova Santa Cruz",44,44,0,39,39,0
8,16,2018,20,0,5,"Braga",8,"Rua Costa Gomes",41,41,0,42,42,0
8,16,2018,21,0,5,"Braga",1,"Avenida da Liberdade",19,25,6,163,124,39
8,16,2018,21,0,5,"Braga",2,"Avenida Central",19,25,6,163,124,39
8,16,2018,21,0,5,"Braga",3,"Rua de Caires",18,36,18,75,37,38
8,16,2018,21,0,5,"Braga",4,"N14 Bosch",47,47,0,48,48,0
8,16,2018,21,0,5,"Braga",5,"Avenida João Paulo II",39,39,0,9,9,0
8,16,2018,21,0,5,"Braga",6,"Avenida Padre Júlio Fragata",52,67,15,107,83,24
8,16,2018,21,0,5,"Braga",7,"Rua Nova Santa Cruz",44,44,0,39,39,0
8,16,2018,21,0,5,"Braga",8,"Rua Costa Gomes",41,41,0,42,42,0
8,16,2018,22,0,5,"Braga",1,"Avenida da Liberdade",25,25,0,124,124,0
8,16,2018,22,0,5,"Braga",2,"Avenida Central",19,25,6,163,124,39
8,16,2018,22,0,5,"Braga",3,"Rua de Caires",36,36,0,37,37,0
8,16,2018,22,0,5,"Braga",4,"N14 Bosch",47,47,0,48,48,0
8,16,2018,22,0,5,"Braga",5,"Avenida João Paulo II",39,39,0,9,9,0
8,16,2018,22,0,5,"Braga",6,"Avenida Padre Júlio Fragata",67,67,0,83,83,0
8,16,2018,22,0,5,"Braga",7,"Rua Nova Santa Cruz",44,44,0,39,39,0
8,16,2018,22,0,5,"Braga",8,"Rua Costa Gomes",29,41,12,60,42,18
8,16,2018,23,0,5,"Braga",1,"Avenida da Liberdade",25,25,0,124,124,0
8,16,2018,23,0,5,"Braga",2,"Avenida Central",25,25,0,124,124,0
8,16,2018,23,0,5,"Braga",3,"Rua de Caires",36,36,0,37,37,0
8,16,2018,23,0,5,"Braga",4,"N14 Bosch",47,47,0,48,48,0
8,16,2018,23,0,5,"Braga",5,"Avenida João Paulo II",39,39,0,9,9,0
8,16,2018,23,0,5,"Braga",6,"Avenida Padre Júlio Fragata",67,67,0,83,83,0
8,16,2018,23,0,5,"Braga",7,"Rua Nova Santa Cruz",44,44,0,39,39,0
8,16,2018,23,0,5,"Braga",8,"Rua Costa Gomes",41,41,0,42,42,0
8,17,2018,0,0,6,"Braga",1,"Avenida da Liberdade",25,25,0,124,124,0
8,17,2018,0,0,6,"Braga",2,"Avenida Central",25,25,0,124,124,0
8,17,2018,0,0,6,"Braga",3,"Rua de Caires",36,36,0,37,37,0
8,17,2018,0,0,6,"Braga",4,"N14 Bosch",47,47,0,48,48,0
8,17,2018,0,0,6,"Braga",5,"Avenida João Paulo II",39,39,0,9,9,0
8,17,2018,0,0,6,"Braga",6,"Avenida Padre Júlio Fragata",67,67,0,83,83,0
8,17,2018,0,0,6,"Braga",7,"Rua Nova Santa Cruz",44,44,0,39,39,0
8,17,2018,0,0,6,"Braga",8,"Rua Costa Gomes",41,41,0,42,42,0
8,17,2018,1,0,6,"Braga",1,"Avenida da Liberdade",25,25,0,124,124,0
8,17,2018,1,0,6,"Braga",2,"Avenida Central",25,25,0,124,124,0
8,17,2018,1,0,6,"Braga",3,"Rua de Caires",36,36,0,37,37,0
8,17,2018,1,0,6,"Braga",4,"N14 Bosch",47,47,0,48,48,0
8,17,2018,1,0,6,"Braga",5,"Avenida João Paulo II",39,39,0,9,9,0
8,17,2018,1,0,6,"Braga",6,"Avenida Padre Júlio Fragata",67,67,0,83,83,0
8,17,2018,1,0,6,"Braga",7,"Rua Nova Santa Cruz",44,44,0,39,39,0
8,17,2018,1,0,6,"Braga",8,"Rua Costa Gomes",41,41,0,42,42,0
8,17,2018,2,0,6,"Braga",1,"Avenida da Liberdade",25,25,0,124,124,0
8,17,2018,2,0,6,"Braga",2,"Avenida Central",25,25,0,124,124,0
8,17,2018,2,0,6,"Braga",3,"Rua de Caires",36,36,0,37,37,0
8,17,2018,2,0,6,"Braga",4,"N14 Bosch",47,47,0,48,48,0
8,17,2018,2,0,6,"Braga",5,"Avenida João Paulo II",39,39,0,9,9,0
8,17,2018,2,0,6,"Braga",6,"Avenida Padre Júlio Fragata",67,67,0,83,83,0
8,17,2018,2,0,6,"Braga",7,"Rua Nova Santa Cruz",44,44,0,39,39,0
8,17,2018,2,0,6,"Braga",8,"Rua Costa Gomes",41,41,0,42,42,0
8,17,2018,3,0,6,"Braga",1,"Avenida da Liberdade",25,25,0,124,124,0
8,17,2018,3,0,6,"Braga",2,"Avenida Central",25,25,0,124,124,0
8,17,2018,3,0,6,"Braga",3,"Rua de Caires",36,36,0,37,37,0
8,17,2018,3,0,6,"Braga",4,"N14 Bosch",47,47,0,48,48,0
8,17,2018,3,0,6,"Braga",5,"Avenida João Paulo II",39,39,0,9,9,0
8,17,2018,3,0,6,"Braga",6,"Avenida Padre Júlio Fragata",67,67,0,83,83,0
8,17,2018,3,0,6,"Braga",7,"Rua Nova Santa Cruz",44,44,0,39,39,0
8,17,2018,3,0,6,"Braga",8,"Rua Costa Gomes",41,41,0,42,42,0
8,17,2018,4,0,6,"Braga",1,"Avenida da Liberdade",25,25,0,124,124,0
8,17,2018,4,0,6,"Braga",2,"Avenida Central",25,25,0,124,124,0
8,17,2018,4,0,6,"Braga",3,"Rua de Caires",36,36,0,37,37,0
8,17,2018,4,0,6,"Braga",4,"N14 Bosch",47,47,0,48,48,0
8,17,2018,4,0,6,"Braga",5,"Avenida João Paulo II",39,39,0,9,9,0
8,17,2018,4,0,6,"Braga",6,"Avenida Padre Júlio Fragata",67,67,0,83,83,0
8,17,2018,4,0,6,"Braga",7,"Rua Nova Santa Cruz",44,44,0,39,39,0
8,17,2018,4,0,6,"Braga",8,"Rua Costa Gomes",41,41,0,42,42,0
8,17,2018,5,0,6,"Braga",1,"Avenida da Liberdade",25,25,0,124,124,0
8,17,2018,5,0,6,"Braga",2,"Avenida Central",25,25,0,124,124,0
8,17,2018,5,0,6,"Braga",3,"Rua de Caires",36,36,0,37,37,0
8,17,2018,5,0,6,"Braga",4,"N14 Bosch",47,47,0,48,48,0
8,17,2018,5,0,6,"Braga",5,"Avenida João Paulo II",39,39,0,9,9,0
8,17,2018,5,0,6,"Braga",6,"Avenida Padre Júlio Fragata",67,67,0,83,83,0
8,17,2018,5,0,6,"Braga",7,"Rua Nova Santa Cruz",44,44,0,39,39,0
8,17,2018,5,0,6,"Braga",8,"Rua Costa Gomes",41,41,0,42,42,0
8,17,2018,6,0,6,"Braga",1,"Avenida da Liberdade",25,25,0,124,124,0
8,17,2018,6,0,6,"Braga",2,"Avenida Central",25,25,0,124,124,0
8,17,2018,6,0,6,"Braga",3,"Rua de Caires",36,36,0,37,37,0
8,17,2018,6,0,6,"Braga",4,"N14 Bosch",47,47,0,48,48,0
8,17,2018,6,0,6,"Braga",5,"Avenida João Paulo II",39,39,0,9,9,0
8,17,2018,6,0,6,"Braga",6,"Avenida Padre Júlio Fragata",67,67,0,83,83,0
8,17,2018,6,0,6,"Braga",7,"Rua Nova Santa Cruz",44,44,0,39,39,0
8,17,2018,6,0,6,"Braga",8,"Rua Costa Gomes",41,41,0,42,42,0
8,17,2018,7,0,6,"Braga",1,"Avenida da Liberdade",25,25,0,124,124,0
8,17,2018,7,0,6,"Braga",2,"Avenida Central",25,25,0,124,124,0
8,17,2018,7,0,6,"Braga",3,"Rua de Caires",28,36,8,48,37,11
8,17,2018,7,0,6,"Braga",4,"N14 Bosch",47,47,0,48,48,0
8,17,2018,7,0,6,"Braga",5,"Avenida João Paulo II",39,39,0,9,9,0
8,17,2018,7,0,6,"Braga",6,"Avenida Padre Júlio Fragata",67,67,0,83,83,0
8,17,2018,7,0,6,"Braga",7,"Rua Nova Santa Cruz",44,44,0,39,39,0
8,17,2018,7,0,6,"Braga",8,"Rua Costa Gomes",41,41,0,42,42,0
8,17,2018,8,0,6,"Braga",1,"Avenida da Liberdade",25,25,0,124,124,0
8,17,2018,8,0,6,"Braga",2,"Avenida Central",25,25,0,124,124,0
8,17,2018,8,0,6,"Braga",3,"Rua de Caires",18,36,18,75,37,38
8,17,2018,8,0,6,"Braga",4,"N14 Bosch",37,47,10,61,48,13
8,17,2018,8,0,6,"Braga",5,"Avenida João Paulo II",39,39,0,9,9,0
8,17,2018,8,0,6,"Braga",6,"Avenida Padre Júlio Fragata",67,67,0,83,83,0
8,17,2018,8,0,6,"Braga",7,"Rua Nova Santa Cruz",44,44,0,39,39,0
8,17,2018,8,0,6,"Braga",8,"Rua Costa Gomes",32,41,9,54,42,12
8,17,2018,9,0,6,"Braga",1,"Avenida da Liberdade",25,25,0,124,124,0
8,17,2018,9,0,6,"Braga",2,"Avenida Central",25,25,0,124,124,0
8,17,2018,9,0,6,"Braga",3,"Rua de Caires",23,36,13,59,37,22
8,17,2018,9,0,6,"Braga",4,"N14 Bosch",36,47,11,62,48,14
8,17,2018,9,0,6,"Braga",5,"Avenida João Paulo II",39,39,0,9,9,0
8,17,2018,9,0,6,"Braga",6,"Avenida Padre Júlio Fragata",51,67,16,109,83,26
8,17,2018,9,0,6,"Braga",7,"Rua Nova Santa Cruz",44,44,0,39,39,0
8,17,2018,9,0,6,"Braga",8,"Rua Costa Gomes",32,41,9,54,42,12
8,17,2018,10,0,6,"Braga",1,"Avenida da Liberdade",17,25,8,182,124,58
8,17,2018,10,0,6,"Braga",2,"Avenida Central",17,25,8,182,124,58
8,17,2018,10,0,6,"Braga",3,"Rua de Caires",28,36,8,48,37,11
8,17,2018,10,0,6,"Braga",4,"N14 Bosch",26,47,21,86,48,38
8,17,2018,10,0,6,"Braga",5,"Avenida João Paulo II",24,39,15,15,9,6
8,17,2018,10,0,6,"Braga",6,"Avenida Padre Júlio Fragata",67,67,0,83,83,0
8,17,2018,10,0,6,"Braga",7,"Rua Nova Santa Cruz",44,44,0,39,39,0
8,17,2018,10,0,6,"Braga",8,"Rua Costa Gomes",41,41,0,42,42,0
8,17,2018,11,0,6,"Braga",1,"Avenida da Liberdade",25,25,0,124,124,0
8,17,2018,11,0,6,"Braga",2,"Avenida Central",25,25,0,124,124,0
8,17,2018,11,0,6,"Braga",3,"Rua de Caires",25,36,11,54,37,17
8,17,2018,11,0,6,"Braga",4,"N14 Bosch",36,47,11,62,48,14
8,17,2018,11,0,6,"Braga",5,"Avenida João Paulo II",39,39,0,9,9,0
8,17,2018,11,0,6,"Braga",6,"Avenida Padre Júlio Fragata",67,67,0,83,83,0
8,17,2018,11,0,6,"Braga",7,"Rua Nova Santa Cruz",44,44,0,39,39,0
8,17,2018,11,0,6,"Braga",8,"Rua Costa Gomes",27,41,14,64,42,22
8,17,2018,12,0,6,"Braga",1,"Avenida da Liberdade",25,25,0,124,124,0
8,17,2018,12,0,6,"Braga",2,"Avenida Central",25,25,0,124,124,0
8,17,2018,12,0,6,"Braga",3,"Rua de Caires",36,36,0,37,37,0
8,17,2018,12,0,6,"Braga",4,"N14 Bosch",37,47,10,61,48,13
8,17,2018,12,0,6,"Braga",5,"Avenida João Paulo II",39,39,0,9,9,0
8,17,2018,12,0,6,"Braga",6,"Avenida Padre Júlio Fragata",67,67,0,83,83,0
8,17,2018,12,0,6,"Braga",7,"Rua Nova Santa Cruz",44,44,0,39,39,0
8,17,2018,12,0,6,"Braga",8,"Rua Costa Gomes",30,41,11,58,42,16
8,17,2018,13,0,6,"Braga",1,"Avenida da Liberdade",25,25,0,124,124,0
8,17,2018,13,0,6,"Braga",2,"Avenida Central",25,25,0,124,124,0
8,17,2018,13,0,6,"Braga",3,"Rua de Caires",36,36,0,37,37,0
8,17,2018,13,0,6,"Braga",4,"N14 Bosch",47,47,0,48,48,0
8,17,2018,13,0,6,"Braga",5,"Avenida João Paulo II",39,39,0,9,9,0
8,17,2018,13,0,6,"Braga",6,"Avenida Padre Júlio Fragata",67,67,0,83,83,0
8,17,2018,13,0,6,"Braga",7,"Rua Nova Santa Cruz",44,44,0,39,39,0
8,17,2018,13,0,6,"Braga",8,"Rua Costa Gomes",32,41,9,54,42,12
8,17,2018,14,0,6,"Braga",1,"Avenida da Liberdade",25,25,0,124,124,0
8,17,2018,14,0,6,"Braga",2,"Avenida Central",25,25,0,124,124,0
8,17,2018,14,0,6,"Braga",3,"Rua de Caires",25,36,11,54,37,17
8,17,2018,14,0,6,"Braga",4,"N14 Bosch",47,47,0,48,48,0
8,17,2018,14,0,6,"Braga",5,"Avenida João Paulo II",39,39,0,9,9,0
8,17,2018,14,0,6,"Braga",6,"Avenida Padre Júlio Fragata",67,67,0,83,83,0
8,17,2018,14,0,6,"Braga",7,"Rua Nova Santa Cruz",29,44,15,60,39,21
8,17,2018,14,0,6,"Braga",8,"Rua Costa Gomes",25,41,16,69,42,27
8,17,2018,15,0,6,"Braga",1,"Avenida da Liberdade",15,25,10,207,124,83
8,17,2018,15,0,6,"Braga",2,"Avenida Central",15,25,10,207,124,83
8,17,2018,15,0,6,"Braga",3,"Rua de Caires",36,36,0,37,37,0
8,17,2018,15,0,6,"Braga",4,"N14 Bosch",29,47,18,77,48,29
8,17,2018,15,0,6,"Braga",5,"Avenida João Paulo II",16,39,23,22,9,13
8,17,2018,15,0,6,"Braga",6,"Avenida Padre Júlio Fragata",51,67,16,109,83,26
8,17,2018,15,0,6,"Braga",7,"Rua Nova Santa Cruz",20,44,24,86,39,47
8,17,2018,15,0,6,"Braga",8,"Rua Costa Gomes",27,41,14,64,42,22
8,17,2018,16,0,6,"Braga",1,"Avenida da Liberdade",16,25,9,194,124,70
8,17,2018,16,0,6,"Braga",2,"Avenida Central",16,25,9,194,124,70
8,17,2018,16,0,6,"Braga",3,"Rua de Caires",25,36,11,54,37,17
8,17,2018,16,0,6,"Braga",4,"N14 Bosch",33,47,14,68,48,20
8,17,2018,16,0,6,"Braga",5,"Avenida João Paulo II",30,39,9,12,9,3
8,17,2018,16,0,6,"Braga",6,"Avenida Padre Júlio Fragata",50,67,17,111,83,28
8,17,2018,16,0,6,"Braga",7,"Rua Nova Santa Cruz",44,44,0,39,39,0
8,17,2018,16,0,6,"Braga",8,"Rua Costa Gomes",31,41,10,56,42,14
8,17,2018,17,0,6,"Braga",1,"Avenida da Liberdade",25,25,0,124,124,0
8,17,2018,17,0,6,"Braga",2,"Avenida Central",25,25,0,124,124,0
8,17,2018,17,0,6,"Braga",3,"Rua de Caires",14,36,22,96,37,59
8,17,2018,17,0,6,"Braga",4,"N14 Bosch",16,47,31,140,48,92
8,17,2018,17,0,6,"Braga",5,"Avenida João Paulo II",39,39,0,9,9,0
8,17,2018,17,0,6,"Braga",6,"Avenida Padre Júlio Fragata",46,67,21,121,83,38
8,17,2018,17,0,6,"Braga",7,"Rua Nova Santa Cruz",32,44,12,54,39,15
8,17,2018,17,0,6,"Braga",8,"Rua Costa Gomes",17,41,24,102,42,60
8,17,2018,18,0,6,"Braga",1,"Avenida da Liberdade",18,25,7,172,124,48
8,17,2018,18,0,6,"Braga",2,"Avenida Central",18,25,7,172,124,48
8,17,2018,18,0,6,"Braga",3,"Rua de Caires",24,36,12,56,37,19
8,17,2018,18,0,6,"Braga",4,"N14 Bosch",47,47,0,48,48,0
8,17,2018,18,0,6,"Braga",5,"Avenida João Paulo II",5,39,34,70,9,61
8,17,2018,18,0,6,"Braga",6,"Avenida Padre Júlio Fragata",6,67,61,929,83,846
8,17,2018,18,0,6,"Braga",7,"Rua Nova Santa Cruz",44,44,0,39,39,0
8,17,2018,18,0,6,"Braga",8,"Rua Costa Gomes",28,41,13,62,42,20
8,17,2018,19,0,6,"Braga",1,"Avenida da Liberdade",25,25,0,124,124,0
8,17,2018,19,0,6,"Braga",2,"Avenida Central",25,25,0,124,124,0
8,17,2018,19,0,6,"Braga",3,"Rua de Caires",36,36,0,37,37,0
8,17,2018,19,0,6,"Braga",4,"N14 Bosch",29,47,18,77,48,29
8,17,2018,19,0,6,"Braga",5,"Avenida João Paulo II",39,39,0,9,9,0
8,17,2018,19,0,6,"Braga",6,"Avenida Padre Júlio Fragata",25,67,42,223,83,140
8,17,2018,19,0,6,"Braga",7,"Rua Nova Santa Cruz",44,44,0,39,39,0
8,17,2018,19,0,6,"Braga",8,"Rua Costa Gomes",29,41,12,60,42,18
8,17,2018,20,0,6,"Braga",1,"Avenida da Liberdade",25,25,0,124,124,0
8,17,2018,20,0,6,"Braga",2,"Avenida Central",25,25,0,124,124,0
8,17,2018,20,0,6,"Braga",3,"Rua de Caires",26,36,10,52,37,15
8,17,2018,20,0,6,"Braga",4,"N14 Bosch",47,47,0,48,48,0
8,17,2018,20,0,6,"Braga",5,"Avenida João Paulo II",39,39,0,9,9,0
8,17,2018,20,0,6,"Braga",6,"Avenida Padre Júlio Fragata",67,67,0,83,83,0
8,17,2018,20,0,6,"Braga",7,"Rua Nova Santa Cruz",44,44,0,39,39,0
8,17,2018,20,0,6,"Braga",8,"Rua Costa Gomes",41,41,0,42,42,0
8,17,2018,21,0,6,"Braga",1,"Avenida da Liberdade",25,25,0,124,124,0
8,17,2018,21,0,6,"Braga",2,"Avenida Central",25,25,0,124,124,0
8,17,2018,21,0,6,"Braga",3,"Rua de Caires",36,36,0,37,37,0
8,17,2018,21,0,6,"Braga",4,"N14 Bosch",47,47,0,48,48,0
8,17,2018,21,0,6,"Braga",5,"Avenida João Paulo II",39,39,0,9,9,0
8,17,2018,21,0,6,"Braga",6,"Avenida Padre Júlio Fragata",67,67,0,83,83,0
8,17,2018,21,0,6,"Braga",7,"Rua Nova Santa Cruz",44,44,0,39,39,0
8,17,2018,21,0,6,"Braga",8,"Rua Costa Gomes",41,41,0,42,42,0
8,17,2018,22,0,6,"Braga",1,"Avenida da Liberdade",25,25,0,124,124,0
8,17,2018,22,0,6,"Braga",2,"Avenida Central",25,25,0,124,124,0
8,17,2018,22,0,6,"Braga",3,"Rua de Caires",36,36,0,37,37,0
8,17,2018,22,0,6,"Braga",4,"N14 Bosch",47,47,0,48,48,0
8,17,2018,22,0,6,"Braga",5,"Avenida João Paulo II",39,39,0,9,9,0
8,17,2018,22,0,6,"Braga",6,"Avenida Padre Júlio Fragata",67,67,0,83,83,0
8,17,2018,22,0,6,"Braga",7,"Rua Nova Santa Cruz",44,44,0,39,39,0
8,17,2018,22,0,6,"Braga",8,"Rua Costa Gomes",41,41,0,42,42,0
8,17,2018,23,0,6,"Braga",1,"Avenida da Liberdade",25,25,0,124,124,0
8,17,2018,23,0,6,"Braga",2,"Avenida Central",25,25,0,124,124,0
8,17,2018,23,0,6,"Braga",3,"Rua de Caires",36,36,0,37,37,0
8,17,2018,23,0,6,"Braga",4,"N14 Bosch",47,47,0,48,48,0
8,17,2018,23,0,6,"Braga",5,"Avenida João Paulo II",39,39,0,9,9,0
8,17,2018,23,0,6,"Braga",6,"Avenida Padre Júlio Fragata",67,67,0,83,83,0
8,17,2018,23,0,6,"Braga",7,"Rua Nova Santa Cruz",44,44,0,39,39,0
8,17,2018,23,0,6,"Braga",8,"Rua Costa Gomes",41,41,0,42,42,0
8,18,2018,0,0,7,"Braga",1,"Avenida da Liberdade",25,25,0,124,124,0
8,18,2018,0,0,7,"Braga",2,"Avenida Central",25,25,0,124,124,0
8,18,2018,0,0,7,"Braga",3,"Rua de Caires",36,36,0,37,37,0
8,18,2018,0,0,7,"Braga",4,"N14 Bosch",47,47,0,48,48,0
8,18,2018,0,0,7,"Braga",5,"Avenida João Paulo II",39,39,0,9,9,0
8,18,2018,0,0,7,"Braga",6,"Avenida Padre Júlio Fragata",67,67,0,83,83,0
8,18,2018,0,0,7,"Braga",7,"Rua Nova Santa Cruz",44,44,0,39,39,0
8,18,2018,0,0,7,"Braga",8,"Rua Costa Gomes",41,41,0,42,42,0
8,18,2018,1,0,7,"Braga",1,"Avenida da Liberdade",25,25,0,124,124,0
8,18,2018,1,0,7,"Braga",2,"Avenida Central",25,25,0,124,124,0
8,18,2018,1,0,7,"Braga",3,"Rua de Caires",36,36,0,37,37,0
8,18,2018,1,0,7,"Braga",4,"N14 Bosch",47,47,0,48,48,0
8,18,2018,1,0,7,"Braga",5,"Avenida João Paulo II",39,39,0,9,9,0
8,18,2018,1,0,7,"Braga",6,"Avenida Padre Júlio Fragata",67,67,0,83,83,0
8,18,2018,1,0,7,"Braga",7,"Rua Nova Santa Cruz",44,44,0,39,39,0
8,18,2018,1,0,7,"Braga",8,"Rua Costa Gomes",41,41,0,42,42,0
8,18,2018,2,0,7,"Braga",1,"Avenida da Liberdade",25,25,0,124,124,0
8,18,2018,2,0,7,"Braga",2,"Avenida Central",25,25,0,124,124,0
8,18,2018,2,0,7,"Braga",3,"Rua de Caires",36,36,0,37,37,0
8,18,2018,2,0,7,"Braga",4,"N14 Bosch",47,47,0,48,48,0
8,18,2018,2,0,7,"Braga",5,"Avenida João Paulo II",39,39,0,9,9,0
8,18,2018,2,0,7,"Braga",6,"Avenida Padre Júlio Fragata",67,67,0,83,83,0
8,18,2018,2,0,7,"Braga",7,"Rua Nova Santa Cruz",44,44,0,39,39,0
8,18,2018,2,0,7,"Braga",8,"Rua Costa Gomes",41,41,0,42,42,0
8,18,2018,3,0,7,"Braga",1,"Avenida da Liberdade",25,25,0,124,124,0
8,18,2018,3,0,7,"Braga",2,"Avenida Central",25,25,0,124,124,0
8,18,2018,3,0,7,"Braga",3,"Rua de Caires",36,36,0,37,37,0
8,18,2018,3,0,7,"Braga",4,"N14 Bosch",47,47,0,48,48,0
8,18,2018,3,0,7,"Braga",5,"Avenida João Paulo II",39,39,0,9,9,0
8,18,2018,3,0,7,"Braga",6,"Avenida Padre Júlio Fragata",67,67,0,83,83,0
8,18,2018,3,0,7,"Braga",7,"Rua Nova Santa Cruz",44,44,0,39,39,0
8,18,2018,3,0,7,"Braga",8,"Rua Costa Gomes",41,41,0,42,42,0
8,18,2018,4,0,7,"Braga",1,"Avenida da Liberdade",25,25,0,124,124,0
8,18,2018,4,0,7,"Braga",2,"Avenida Central",25,25,0,124,124,0
8,18,2018,4,0,7,"Braga",3,"Rua de Caires",36,36,0,37,37,0
8,18,2018,4,0,7,"Braga",4,"N14 Bosch",47,47,0,48,48,0
8,18,2018,4,0,7,"Braga",5,"Avenida João Paulo II",39,39,0,9,9,0
8,18,2018,4,0,7,"Braga",6,"Avenida Padre Júlio Fragata",67,67,0,83,83,0
8,18,2018,4,0,7,"Braga",7,"Rua Nova Santa Cruz",44,44,0,39,39,0
8,18,2018,4,0,7,"Braga",8,"Rua Costa Gomes",41,41,0,42,42,0
8,18,2018,5,0,7,"Braga",1,"Avenida da Liberdade",25,25,0,124,124,0
8,18,2018,5,0,7,"Braga",2,"Avenida Central",25,25,0,124,124,0
8,18,2018,5,0,7,"Braga",3,"Rua de Caires",36,36,0,37,37,0
8,18,2018,5,0,7,"Braga",4,"N14 Bosch",47,47,0,48,48,0
8,18,2018,5,0,7,"Braga",5,"Avenida João Paulo II",39,39,0,9,9,0
8,18,2018,5,0,7,"Braga",6,"Avenida Padre Júlio Fragata",67,67,0,83,83,0
8,18,2018,5,0,7,"Braga",7,"Rua Nova Santa Cruz",44,44,0,39,39,0
8,18,2018,5,0,7,"Braga",8,"Rua Costa Gomes",41,41,0,42,42,0
8,18,2018,6,0,7,"Braga",1,"Avenida da Liberdade",25,25,0,124,124,0
8,18,2018,6,0,7,"Braga",2,"Avenida Central",25,25,0,124,124,0
8,18,2018,6,0,7,"Braga",3,"Rua de Caires",36,36,0,37,37,0
8,18,2018,6,0,7,"Braga",4,"N14 Bosch",47,47,0,48,48,0
8,18,2018,6,0,7,"Braga",5,"Avenida João Paulo II",39,39,0,9,9,0
8,18,2018,6,0,7,"Braga",6,"Avenida Padre Júlio Fragata",67,67,0,83,83,0
8,18,2018,6,0,7,"Braga",7,"Rua Nova Santa Cruz",44,44,0,39,39,0
8,18,2018,6,0,7,"Braga",8,"Rua Costa Gomes",41,41,0,42,42,0
8,18,2018,7,0,7,"Braga",1,"Avenida da Liberdade",25,25,0,124,124,0
8,18,2018,7,0,7,"Braga",2,"Avenida Central",25,25,0,124,124,0
8,18,2018,7,0,7,"Braga",3,"Rua de Caires",36,36,0,37,37,0
8,18,2018,7,0,7,"Braga",4,"N14 Bosch",47,47,0,48,48,0
8,18,2018,7,0,7,"Braga",5,"Avenida João Paulo II",39,39,0,9,9,0
8,18,2018,7,0,7,"Braga",6,"Avenida Padre Júlio Fragata",67,67,0,83,83,0
8,18,2018,7,0,7,"Braga",7,"Rua Nova Santa Cruz",44,44,0,39,39,0
8,18,2018,7,0,7,"Braga",8,"Rua Costa Gomes",41,41,0,42,42,0
8,18,2018,8,0,7,"Braga",1,"Avenida da Liberdade",25,25,0,124,124,0
8,18,2018,8,0,7,"Braga",2,"Avenida Central",25,25,0,124,124,0
8,18,2018,8,0,7,"Braga",3,"Rua de Caires",36,36,0,37,37,0
8,18,2018,8,0,7,"Braga",4,"N14 Bosch",47,47,0,48,48,0
8,18,2018,8,0,7,"Braga",5,"Avenida João Paulo II",39,39,0,9,9,0
8,18,2018,8,0,7,"Braga",6,"Avenida Padre Júlio Fragata",67,67,0,83,83,0
8,18,2018,8,0,7,"Braga",7,"Rua Nova Santa Cruz",44,44,0,39,39,0
8,18,2018,8,0,7,"Braga",8,"Rua Costa Gomes",41,41,0,42,42,0
8,18,2018,9,0,7,"Braga",1,"Avenida da Liberdade",25,25,0,124,124,0
8,18,2018,9,0,7,"Braga",2,"Avenida Central",25,25,0,124,124,0
8,18,2018,9,0,7,"Braga",3,"Rua de Caires",27,36,9,50,37,13
8,18,2018,9,0,7,"Braga",4,"N14 Bosch",47,47,0,48,48,0
8,18,2018,9,0,7,"Braga",5,"Avenida João Paulo II",39,39,0,9,9,0
8,18,2018,9,0,7,"Braga",6,"Avenida Padre Júlio Fragata",67,67,0,83,83,0
8,18,2018,9,0,7,"Braga",7,"Rua Nova Santa Cruz",44,44,0,39,39,0
8,18,2018,9,0,7,"Braga",8,"Rua Costa Gomes",41,41,0,42,42,0
8,18,2018,10,0,7,"Braga",1,"Avenida da Liberdade",25,25,0,124,124,0
8,18,2018,10,0,7,"Braga",2,"Avenida Central",25,25,0,124,124,0
8,18,2018,10,0,7,"Braga",3,"Rua de Caires",36,36,0,37,37,0
8,18,2018,10,0,7,"Braga",4,"N14 Bosch",30,47,17,75,48,27
8,18,2018,10,0,7,"Braga",5,"Avenida João Paulo II",39,39,0,9,9,0
8,18,2018,10,0,7,"Braga",6,"Avenida Padre Júlio Fragata",67,67,0,83,83,0
8,18,2018,10,0,7,"Braga",7,"Rua Nova Santa Cruz",44,44,0,39,39,0
8,18,2018,10,0,7,"Braga",8,"Rua Costa Gomes",30,41,11,58,42,16
8,18,2018,11,0,7,"Braga",1,"Avenida da Liberdade",25,25,0,124,124,0
8,18,2018,11,0,7,"Braga",2,"Avenida Central",25,25,0,124,124,0
8,18,2018,11,0,7,"Braga",3,"Rua de Caires",17,36,19,79,37,42
8,18,2018,11,0,7,"Braga",4,"N14 Bosch",47,47,0,48,48,0
8,18,2018,11,0,7,"Braga",5,"Avenida João Paulo II",39,39,0,9,9,0
8,18,2018,11,0,7,"Braga",6,"Avenida Padre Júlio Fragata",67,67,0,83,83,0
8,18,2018,11,0,7,"Braga",7,"Rua Nova Santa Cruz",44,44,0,39,39,0
8,18,2018,11,0,7,"Braga",8,"Rua Costa Gomes",41,41,0,42,42,0
8,18,2018,12,0,7,"Braga",1,"Avenida da Liberdade",25,25,0,124,124,0
8,18,2018,12,0,7,"Braga",2,"Avenida Central",25,25,0,124,124,0
8,18,2018,12,0,7,"Braga",3,"Rua de Caires",36,36,0,37,37,0
8,18,2018,12,0,7,"Braga",4,"N14 Bosch",47,47,0,48,48,0
8,18,2018,12,0,7,"Braga",5,"Avenida João Paulo II",39,39,0,9,9,0
8,18,2018,12,0,7,"Braga",6,"Avenida Padre Júlio Fragata",67,67,0,83,83,0
8,18,2018,12,0,7,"Braga",7,"Rua Nova Santa Cruz",44,44,0,39,39,0
8,18,2018,12,0,7,"Braga",8,"Rua Costa Gomes",41,41,0,42,42,0
8,18,2018,13,0,7,"Braga",1,"Avenida da Liberdade",25,25,0,124,124,0
8,18,2018,13,0,7,"Braga",2,"Avenida Central",25,25,0,124,124,0
8,18,2018,13,0,7,"Braga",3,"Rua de Caires",28,36,8,48,37,11
8,18,2018,13,0,7,"Braga",4,"N14 Bosch",47,47,0,48,48,0
8,18,2018,13,0,7,"Braga",5,"Avenida João Paulo II",39,39,0,9,9,0
8,18,2018,13,0,7,"Braga",6,"Avenida Padre Júlio Fragata",67,67,0,83,83,0
8,18,2018,13,0,7,"Braga",7,"Rua Nova Santa Cruz",44,44,0,39,39,0
8,18,2018,13,0,7,"Braga",8,"Rua Costa Gomes",41,41,0,42,42,0
8,18,2018,14,0,7,"Braga",1,"Avenida da Liberdade",25,25,0,124,124,0
8,18,2018,14,0,7,"Braga",2,"Avenida Central",25,25,0,124,124,0
8,18,2018,14,0,7,"Braga",3,"Rua de Caires",36,36,0,37,37,0
8,18,2018,14,0,7,"Braga",4,"N14 Bosch",47,47,0,48,48,0
8,18,2018,14,0,7,"Braga",5,"Avenida João Paulo II",39,39,0,9,9,0
8,18,2018,14,0,7,"Braga",6,"Avenida Padre Júlio Fragata",67,67,0,83,83,0
8,18,2018,14,0,7,"Braga",7,"Rua Nova Santa Cruz",44,44,0,39,39,0
8,18,2018,14,0,7,"Braga",8,"Rua Costa Gomes",28,41,13,62,42,20
8,18,2018,15,0,7,"Braga",1,"Avenida da Liberdade",19,25,6,163,124,39
8,18,2018,15,0,7,"Braga",2,"Avenida Central",19,25,6,163,124,39
8,18,2018,15,0,7,"Braga",3,"Rua de Caires",36,36,0,37,37,0
8,18,2018,15,0,7,"Braga",4,"N14 Bosch",47,47,0,48,48,0
8,18,2018,15,0,7,"Braga",5,"Avenida João Paulo II",39,39,0,9,9,0
8,18,2018,15,0,7,"Braga",6,"Avenida Padre Júlio Fragata",67,67,0,83,83,0
8,18,2018,15,0,7,"Braga",7,"Rua Nova Santa Cruz",44,44,0,39,39,0
8,18,2018,15,0,7,"Braga",8,"Rua Costa Gomes",41,41,0,42,42,0
8,18,2018,16,0,7,"Braga",1,"Avenida da Liberdade",25,25,0,124,124,0
8,18,2018,16,0,7,"Braga",2,"Avenida Central",25,25,0,124,124,0
8,18,2018,16,0,7,"Braga",3,"Rua de Caires",36,36,0,37,37,0
8,18,2018,16,0,7,"Braga",4,"N14 Bosch",47,47,0,48,48,0
8,18,2018,16,0,7,"Braga",5,"Avenida João Paulo II",39,39,0,9,9,0
8,18,2018,16,0,7,"Braga",6,"Avenida Padre Júlio Fragata",67,67,0,83,83,0
8,18,2018,16,0,7,"Braga",7,"Rua Nova Santa Cruz",44,44,0,39,39,0
8,18,2018,16,0,7,"Braga",8,"Rua Costa Gomes",41,41,0,42,42,0
8,18,2018,17,0,7,"Braga",1,"Avenida da Liberdade",25,25,0,124,124,0
8,18,2018,17,0,7,"Braga",2,"Avenida Central",25,25,0,124,124,0
8,18,2018,17,0,7,"Braga",3,"Rua de Caires",36,36,0,37,37,0
8,18,2018,17,0,7,"Braga",4,"N14 Bosch",47,47,0,48,48,0
8,18,2018,17,0,7,"Braga",5,"Avenida João Paulo II",31,39,8,11,9,2
8,18,2018,17,0,7,"Braga",6,"Avenida Padre Júlio Fragata",67,67,0,83,83,0
8,18,2018,17,0,7,"Braga",7,"Rua Nova Santa Cruz",44,44,0,39,39,0
8,18,2018,17,0,7,"Braga",8,"Rua Costa Gomes",32,41,9,54,42,12
8,18,2018,18,0,7,"Braga",1,"Avenida da Liberdade",25,25,0,124,124,0
8,18,2018,18,0,7,"Braga",2,"Avenida Central",25,25,0,124,124,0
8,18,2018,18,0,7,"Braga",3,"Rua de Caires",36,36,0,37,37,0
8,18,2018,18,0,7,"Braga",4,"N14 Bosch",47,47,0,48,48,0
8,18,2018,18,0,7,"Braga",5,"Avenida João Paulo II",39,39,0,9,9,0
8,18,2018,18,0,7,"Braga",6,"Avenida Padre Júlio Fragata",67,67,0,83,83,0
8,18,2018,18,0,7,"Braga",7,"Rua Nova Santa Cruz",44,44,0,39,39,0
8,18,2018,18,0,7,"Braga",8,"Rua Costa Gomes",41,41,0,42,42,0
8,18,2018,19,0,7,"Braga",1,"Avenida da Liberdade",25,25,0,124,124,0
8,18,2018,19,0,7,"Braga",2,"Avenida Central",25,25,0,124,124,0
8,18,2018,19,0,7,"Braga",3,"Rua de Caires",28,36,8,48,37,11
8,18,2018,19,0,7,"Braga",4,"N14 Bosch",47,47,0,48,48,0
8,18,2018,19,0,7,"Braga",5,"Avenida João Paulo II",39,39,0,9,9,0
8,18,2018,19,0,7,"Braga",6,"Avenida Padre Júlio Fragata",67,67,0,83,83,0
8,18,2018,19,0,7,"Braga",7,"Rua Nova Santa Cruz",44,44,0,39,39,0
8,18,2018,19,0,7,"Braga",8,"Rua Costa Gomes",41,41,0,42,42,0
8,18,2018,20,0,7,"Braga",1,"Avenida da Liberdade",25,25,0,124,124,0
8,18,2018,20,0,7,"Braga",2,"Avenida Central",25,25,0,124,124,0
8,18,2018,20,0,7,"Braga",3,"Rua de Caires",36,36,0,37,37,0
8,18,2018,20,0,7,"Braga",4,"N14 Bosch",47,47,0,48,48,0
8,18,2018,20,0,7,"Braga",5,"Avenida João Paulo II",39,39,0,9,9,0
8,18,2018,20,0,7,"Braga",6,"Avenida Padre Júlio Fragata",51,67,16,109,83,26
8,18,2018,20,0,7,"Braga",7,"Rua Nova Santa Cruz",44,44,0,39,39,0
8,18,2018,20,0,7,"Braga",8,"Rua Costa Gomes",41,41,0,42,42,0
8,18,2018,21,0,7,"Braga",1,"Avenida da Liberdade",25,25,0,124,124,0
8,18,2018,21,0,7,"Braga",2,"Avenida Central",25,25,0,124,124,0
8,18,2018,21,0,7,"Braga",3,"Rua de Caires",36,36,0,37,37,0
8,18,2018,21,0,7,"Braga",4,"N14 Bosch",47,47,0,48,48,0
8,18,2018,21,0,7,"Braga",5,"Avenida João Paulo II",39,39,0,9,9,0
8,18,2018,21,0,7,"Braga",6,"Avenida Padre Júlio Fragata",67,67,0,83,83,0
8,18,2018,21,0,7,"Braga",7,"Rua Nova Santa Cruz",44,44,0,39,39,0
8,18,2018,21,0,7,"Braga",8,"Rua Costa Gomes",41,41,0,42,42,0
8,18,2018,22,0,7,"Braga",1,"Avenida da Liberdade",17,25,8,182,124,58
8,18,2018,22,0,7,"Braga",2,"Avenida Central",17,25,8,182,124,58
8,18,2018,22,0,7,"Braga",3,"Rua de Caires",36,36,0,37,37,0
8,18,2018,22,0,7,"Braga",4,"N14 Bosch",47,47,0,48,48,0
8,18,2018,22,0,7,"Braga",5,"Avenida João Paulo II",39,39,0,9,9,0
8,18,2018,22,0,7,"Braga",6,"Avenida Padre Júlio Fragata",50,67,17,111,83,28
8,18,2018,22,0,7,"Braga",7,"Rua Nova Santa Cruz",44,44,0,39,39,0
8,18,2018,22,0,7,"Braga",8,"Rua Costa Gomes",41,41,0,42,42,0
8,18,2018,23,0,7,"Braga",1,"Avenida da Liberdade",25,25,0,124,124,0
8,18,2018,23,0,7,"Braga",2,"Avenida Central",25,25,0,124,124,0
8,18,2018,23,0,7,"Braga",3,"Rua de Caires",24,36,12,56,37,19
8,18,2018,23,0,7,"Braga",4,"N14 Bosch",47,47,0,48,48,0
8,18,2018,23,0,7,"Braga",5,"Avenida João Paulo II",39,39,0,9,9,0
8,18,2018,23,0,7,"Braga",6,"Avenida Padre Júlio Fragata",67,67,0,83,83,0
8,18,2018,23,0,7,"Braga",7,"Rua Nova Santa Cruz",44,44,0,39,39,0
8,18,2018,23,0,7,"Braga",8,"Rua Costa Gomes",41,41,0,42,42,0
8,19,2018,0,0,8,"Braga",1,"Avenida da Liberdade",18,25,7,172,124,48
8,19,2018,0,0,8,"Braga",2,"Avenida Central",18,25,7,172,124,48
8,19,2018,0,0,8,"Braga",3,"Rua de Caires",36,36,0,37,37,0
8,19,2018,0,0,8,"Braga",4,"N14 Bosch",47,47,0,48,48,0
8,19,2018,0,0,8,"Braga",5,"Avenida João Paulo II",39,39,0,9,9,0
8,19,2018,0,0,8,"Braga",6,"Avenida Padre Júlio Fragata",67,67,0,83,83,0
8,19,2018,0,0,8,"Braga",7,"Rua Nova Santa Cruz",44,44,0,39,39,0
8,19,2018,0,0,8,"Braga",8,"Rua Costa Gomes",41,41,0,42,42,0
8,19,2018,1,0,8,"Braga",1,"Avenida da Liberdade",25,25,0,124,124,0
8,19,2018,1,0,8,"Braga",2,"Avenida Central",25,25,0,124,124,0
8,19,2018,1,0,8,"Braga",3,"Rua de Caires",36,36,0,37,37,0
8,19,2018,1,0,8,"Braga",4,"N14 Bosch",47,47,0,48,48,0
8,19,2018,1,0,8,"Braga",5,"Avenida João Paulo II",39,39,0,9,9,0
8,19,2018,1,0,8,"Braga",6,"Avenida Padre Júlio Fragata",67,67,0,83,83,0
8,19,2018,1,0,8,"Braga",7,"Rua Nova Santa Cruz",44,44,0,39,39,0
8,19,2018,1,0,8,"Braga",8,"Rua Costa Gomes",41,41,0,42,42,0
8,19,2018,2,0,8,"Braga",1,"Avenida da Liberdade",25,25,0,124,124,0
8,19,2018,2,0,8,"Braga",2,"Avenida Central",25,25,0,124,124,0
8,19,2018,2,0,8,"Braga",3,"Rua de Caires",36,36,0,37,37,0
8,19,2018,2,0,8,"Braga",4,"N14 Bosch",27,47,20,83,48,35
8,19,2018,2,0,8,"Braga",5,"Avenida João Paulo II",39,39,0,9,9,0
8,19,2018,2,0,8,"Braga",6,"Avenida Padre Júlio Fragata",67,67,0,83,83,0
8,19,2018,2,0,8,"Braga",7,"Rua Nova Santa Cruz",44,44,0,39,39,0
8,19,2018,2,0,8,"Braga",8,"Rua Costa Gomes",41,41,0,42,42,0
8,19,2018,3,0,8,"Braga",1,"Avenida da Liberdade",25,25,0,124,124,0
8,19,2018,3,0,8,"Braga",2,"Avenida Central",25,25,0,124,124,0
8,19,2018,3,0,8,"Braga",3,"Rua de Caires",36,36,0,37,37,0
8,19,2018,3,0,8,"Braga",4,"N14 Bosch",47,47,0,48,48,0
8,19,2018,3,0,8,"Braga",5,"Avenida João Paulo II",39,39,0,9,9,0
8,19,2018,3,0,8,"Braga",6,"Avenida Padre Júlio Fragata",67,67,0,83,83,0
8,19,2018,3,0,8,"Braga",7,"Rua Nova Santa Cruz",44,44,0,39,39,0
8,19,2018,3,0,8,"Braga",8,"Rua Costa Gomes",41,41,0,42,42,0
8,19,2018,4,0,8,"Braga",1,"Avenida da Liberdade",25,25,0,124,124,0
8,19,2018,4,0,8,"Braga",2,"Avenida Central",25,25,0,124,124,0
8,19,2018,4,0,8,"Braga",3,"Rua de Caires",36,36,0,37,37,0
8,19,2018,4,0,8,"Braga",4,"N14 Bosch",47,47,0,48,48,0
8,19,2018,4,0,8,"Braga",5,"Avenida João Paulo II",39,39,0,9,9,0
8,19,2018,4,0,8,"Braga",6,"Avenida Padre Júlio Fragata",67,67,0,83,83,0
8,19,2018,4,0,8,"Braga",7,"Rua Nova Santa Cruz",44,44,0,39,39,0
8,19,2018,4,0,8,"Braga",8,"Rua Costa Gomes",41,41,0,42,42,0
8,19,2018,5,0,8,"Braga",1,"Avenida da Liberdade",25,25,0,124,124,0
8,19,2018,5,0,8,"Braga",2,"Avenida Central",25,25,0,124,124,0
8,19,2018,5,0,8,"Braga",3,"Rua de Caires",36,36,0,37,37,0
8,19,2018,5,0,8,"Braga",4,"N14 Bosch",47,47,0,48,48,0
8,19,2018,5,0,8,"Braga",5,"Avenida João Paulo II",39,39,0,9,9,0
8,19,2018,5,0,8,"Braga",6,"Avenida Padre Júlio Fragata",67,67,0,83,83,0
8,19,2018,5,0,8,"Braga",7,"Rua Nova Santa Cruz",44,44,0,39,39,0
8,19,2018,5,0,8,"Braga",8,"Rua Costa Gomes",41,41,0,42,42,0
8,19,2018,6,0,8,"Braga",1,"Avenida da Liberdade",25,25,0,124,124,0
8,19,2018,6,0,8,"Braga",2,"Avenida Central",25,25,0,124,124,0
8,19,2018,6,0,8,"Braga",3,"Rua de Caires",36,36,0,37,37,0
8,19,2018,6,0,8,"Braga",4,"N14 Bosch",47,47,0,48,48,0
8,19,2018,6,0,8,"Braga",5,"Avenida João Paulo II",39,39,0,9,9,0
8,19,2018,6,0,8,"Braga",6,"Avenida Padre Júlio Fragata",67,67,0,83,83,0
8,19,2018,6,0,8,"Braga",7,"Rua Nova Santa Cruz",44,44,0,39,39,0
8,19,2018,6,0,8,"Braga",8,"Rua Costa Gomes",41,41,0,42,42,0
8,19,2018,7,0,8,"Braga",1,"Avenida da Liberdade",25,25,0,124,124,0
8,19,2018,7,0,8,"Braga",2,"Avenida Central",25,25,0,124,124,0
8,19,2018,7,0,8,"Braga",3,"Rua de Caires",36,36,0,37,37,0
8,19,2018,7,0,8,"Braga",4,"N14 Bosch",47,47,0,48,48,0
8,19,2018,7,0,8,"Braga",5,"Avenida João Paulo II",39,39,0,9,9,0
8,19,2018,7,0,8,"Braga",6,"Avenida Padre Júlio Fragata",67,67,0,83,83,0
8,19,2018,7,0,8,"Braga",7,"Rua Nova Santa Cruz",44,44,0,39,39,0
8,19,2018,7,0,8,"Braga",8,"Rua Costa Gomes",41,41,0,42,42,0
8,19,2018,8,0,8,"Braga",1,"Avenida da Liberdade",25,25,0,124,124,0
8,19,2018,8,0,8,"Braga",2,"Avenida Central",25,25,0,124,124,0
8,19,2018,8,0,8,"Braga",3,"Rua de Caires",36,36,0,37,37,0
8,19,2018,8,0,8,"Braga",4,"N14 Bosch",47,47,0,48,48,0
8,19,2018,8,0,8,"Braga",5,"Avenida João Paulo II",39,39,0,9,9,0
8,19,2018,8,0,8,"Braga",6,"Avenida Padre Júlio Fragata",67,67,0,83,83,0
8,19,2018,8,0,8,"Braga",7,"Rua Nova Santa Cruz",44,44,0,39,39,0
8,19,2018,8,0,8,"Braga",8,"Rua Costa Gomes",41,41,0,42,42,0
8,19,2018,9,0,8,"Braga",1,"Avenida da Liberdade",25,25,0,124,124,0
8,19,2018,9,0,8,"Braga",2,"Avenida Central",25,25,0,124,124,0
8,19,2018,9,0,8,"Braga",3,"Rua de Caires",36,36,0,37,37,0
8,19,2018,9,0,8,"Braga",4,"N14 Bosch",47,47,0,48,48,0
8,19,2018,9,0,8,"Braga",5,"Avenida João Paulo II",39,39,0,9,9,0
8,19,2018,9,0,8,"Braga",6,"Avenida Padre Júlio Fragata",67,67,0,83,83,0
8,19,2018,9,0,8,"Braga",7,"Rua Nova Santa Cruz",44,44,0,39,39,0
8,19,2018,9,0,8,"Braga",8,"Rua Costa Gomes",41,41,0,42,42,0
8,19,2018,10,0,8,"Braga",1,"Avenida da Liberdade",25,25,0,124,124,0
8,19,2018,10,0,8,"Braga",2,"Avenida Central",25,25,0,124,124,0
8,19,2018,10,0,8,"Braga",3,"Rua de Caires",26,36,10,52,37,15
8,19,2018,10,0,8,"Braga",4,"N14 Bosch",47,47,0,48,48,0
8,19,2018,10,0,8,"Braga",5,"Avenida João Paulo II",39,39,0,9,9,0
8,19,2018,10,0,8,"Braga",6,"Avenida Padre Júlio Fragata",67,67,0,83,83,0
8,19,2018,10,0,8,"Braga",7,"Rua Nova Santa Cruz",44,44,0,39,39,0
8,19,2018,10,0,8,"Braga",8,"Rua Costa Gomes",41,41,0,42,42,0
8,19,2018,11,0,8,"Braga",1,"Avenida da Liberdade",10,25,15,310,124,186
8,19,2018,11,0,8,"Braga",2,"Avenida Central",10,25,15,310,124,186
8,19,2018,11,0,8,"Braga",3,"Rua de Caires",25,36,11,54,37,17
8,19,2018,11,0,8,"Braga",4,"N14 Bosch",36,47,11,62,48,14
8,19,2018,11,0,8,"Braga",5,"Avenida João Paulo II",39,39,0,9,9,0
8,19,2018,11,0,8,"Braga",6,"Avenida Padre Júlio Fragata",67,67,0,83,83,0
8,19,2018,11,0,8,"Braga",7,"Rua Nova Santa Cruz",44,44,0,39,39,0
8,19,2018,11,0,8,"Braga",8,"Rua Costa Gomes",41,41,0,42,42,0
8,19,2018,12,0,8,"Braga",1,"Avenida da Liberdade",25,25,0,124,124,0
8,19,2018,12,0,8,"Braga",2,"Avenida Central",25,25,0,124,124,0
8,19,2018,12,0,8,"Braga",3,"Rua de Caires",36,36,0,37,37,0
8,19,2018,12,0,8,"Braga",4,"N14 Bosch",47,47,0,48,48,0
8,19,2018,12,0,8,"Braga",5,"Avenida João Paulo II",39,39,0,9,9,0
8,19,2018,12,0,8,"Braga",6,"Avenida Padre Júlio Fragata",67,67,0,83,83,0
8,19,2018,12,0,8,"Braga",7,"Rua Nova Santa Cruz",44,44,0,39,39,0
8,19,2018,12,0,8,"Braga",8,"Rua Costa Gomes",41,41,0,42,42,0
8,19,2018,13,0,8,"Braga",1,"Avenida da Liberdade",25,25,0,124,124,0
8,19,2018,13,0,8,"Braga",2,"Avenida Central",25,25,0,124,124,0
8,19,2018,13,0,8,"Braga",3,"Rua de Caires",36,36,0,37,37,0
8,19,2018,13,0,8,"Braga",4,"N14 Bosch",47,47,0,48,48,0
8,19,2018,13,0,8,"Braga",5,"Avenida João Paulo II",39,39,0,9,9,0
8,19,2018,13,0,8,"Braga",6,"Avenida Padre Júlio Fragata",67,67,0,83,83,0
8,19,2018,13,0,8,"Braga",7,"Rua Nova Santa Cruz",44,44,0,39,39,0
8,19,2018,13,0,8,"Braga",8,"Rua Costa Gomes",41,41,0,42,42,0
8,19,2018,14,0,8,"Braga",1,"Avenida da Liberdade",25,25,0,124,124,0
8,19,2018,14,0,8,"Braga",2,"Avenida Central",25,25,0,124,124,0
8,19,2018,14,0,8,"Braga",3,"Rua de Caires",36,36,0,37,37,0
8,19,2018,14,0,8,"Braga",4,"N14 Bosch",47,47,0,48,48,0
8,19,2018,14,0,8,"Braga",5,"Avenida João Paulo II",27,39,12,13,9,4
8,19,2018,14,0,8,"Braga",6,"Avenida Padre Júlio Fragata",67,67,0,83,83,0
8,19,2018,14,0,8,"Braga",7,"Rua Nova Santa Cruz",44,44,0,39,39,0
8,19,2018,14,0,8,"Braga",8,"Rua Costa Gomes",41,41,0,42,42,0
8,19,2018,15,0,8,"Braga",1,"Avenida da Liberdade",25,25,0,124,124,0
8,19,2018,15,0,8,"Braga",2,"Avenida Central",25,25,0,124,124,0
8,19,2018,15,0,8,"Braga",3,"Rua de Caires",28,36,8,48,37,11
8,19,2018,15,0,8,"Braga",4,"N14 Bosch",47,47,0,48,48,0
8,19,2018,15,0,8,"Braga",5,"Avenida João Paulo II",27,39,12,13,9,4
8,19,2018,15,0,8,"Braga",6,"Avenida Padre Júlio Fragata",67,67,0,83,83,0
8,19,2018,15,0,8,"Braga",7,"Rua Nova Santa Cruz",44,44,0,39,39,0
8,19,2018,15,0,8,"Braga",8,"Rua Costa Gomes",41,41,0,42,42,0
8,19,2018,16,0,8,"Braga",1,"Avenida da Liberdade",25,25,0,124,124,0
8,19,2018,16,0,8,"Braga",2,"Avenida Central",25,25,0,124,124,0
8,19,2018,16,0,8,"Braga",3,"Rua de Caires",36,36,0,37,37,0
8,19,2018,16,0,8,"Braga",4,"N14 Bosch",47,47,0,48,48,0
8,19,2018,16,0,8,"Braga",5,"Avenida João Paulo II",39,39,0,9,9,0
8,19,2018,16,0,8,"Braga",6,"Avenida Padre Júlio Fragata",67,67,0,83,83,0
8,19,2018,16,0,8,"Braga",7,"Rua Nova Santa Cruz",44,44,0,39,39,0
8,19,2018,16,0,8,"Braga",8,"Rua Costa Gomes",24,41,17,72,42,30
8,19,2018,17,0,8,"Braga",1,"Avenida da Liberdade",25,25,0,124,124,0
8,19,2018,17,0,8,"Braga",2,"Avenida Central",25,25,0,124,124,0
8,19,2018,17,0,8,"Braga",3,"Rua de Caires",36,36,0,37,37,0
8,19,2018,17,0,8,"Braga",4,"N14 Bosch",47,47,0,48,48,0
8,19,2018,17,0,8,"Braga",5,"Avenida João Paulo II",39,39,0,9,9,0
8,19,2018,17,0,8,"Braga",6,"Avenida Padre Júlio Fragata",67,67,0,83,83,0
8,19,2018,17,0,8,"Braga",7,"Rua Nova Santa Cruz",44,44,0,39,39,0
8,19,2018,17,0,8,"Braga",8,"Rua Costa Gomes",41,41,0,42,42,0
8,19,2018,18,0,8,"Braga",1,"Avenida da Liberdade",19,25,6,163,124,39
8,19,2018,18,0,8,"Braga",2,"Avenida Central",19,25,6,163,124,39
8,19,2018,18,0,8,"Braga",3,"Rua de Caires",36,36,0,37,37,0
8,19,2018,18,0,8,"Braga",4,"N14 Bosch",47,47,0,48,48,0
8,19,2018,18,0,8,"Braga",5,"Avenida João Paulo II",39,39,0,9,9,0
8,19,2018,18,0,8,"Braga",6,"Avenida Padre Júlio Fragata",67,67,0,83,83,0
8,19,2018,18,0,8,"Braga",7,"Rua Nova Santa Cruz",44,44,0,39,39,0
8,19,2018,18,0,8,"Braga",8,"Rua Costa Gomes",41,41,0,42,42,0
8,19,2018,19,0,8,"Braga",1,"Avenida da Liberdade",25,25,0,124,124,0
8,19,2018,19,0,8,"Braga",2,"Avenida Central",25,25,0,124,124,0
8,19,2018,19,0,8,"Braga",3,"Rua de Caires",26,36,10,52,37,15
8,19,2018,19,0,8,"Braga",4,"N14 Bosch",47,47,0,48,48,0
8,19,2018,19,0,8,"Braga",5,"Avenida João Paulo II",39,39,0,9,9,0
8,19,2018,19,0,8,"Braga",6,"Avenida Padre Júlio Fragata",67,67,0,83,83,0
8,19,2018,19,0,8,"Braga",7,"Rua Nova Santa Cruz",44,44,0,39,39,0
8,19,2018,19,0,8,"Braga",8,"Rua Costa Gomes",41,41,0,42,42,0
8,19,2018,20,0,8,"Braga",1,"Avenida da Liberdade",25,25,0,124,124,0
8,19,2018,20,0,8,"Braga",2,"Avenida Central",25,25,0,124,124,0
8,19,2018,20,0,8,"Braga",3,"Rua de Caires",36,36,0,37,37,0
8,19,2018,20,0,8,"Braga",4,"N14 Bosch",47,47,0,48,48,0
8,19,2018,20,0,8,"Braga",5,"Avenida João Paulo II",39,39,0,9,9,0
8,19,2018,20,0,8,"Braga",6,"Avenida Padre Júlio Fragata",34,67,33,164,83,81
8,19,2018,20,0,8,"Braga",7,"Rua Nova Santa Cruz",44,44,0,39,39,0
8,19,2018,20,0,8,"Braga",8,"Rua Costa Gomes",41,41,0,42,42,0
8,19,2018,21,0,8,"Braga",1,"Avenida da Liberdade",25,25,0,124,124,0
8,19,2018,21,0,8,"Braga",2,"Avenida Central",25,25,0,124,124,0
8,19,2018,21,0,8,"Braga",3,"Rua de Caires",36,36,0,37,37,0
8,19,2018,21,0,8,"Braga",4,"N14 Bosch",47,47,0,48,48,0
8,19,2018,21,0,8,"Braga",5,"Avenida João Paulo II",39,39,0,9,9,0
8,19,2018,21,0,8,"Braga",6,"Avenida Padre Júlio Fragata",67,67,0,83,83,0
8,19,2018,21,0,8,"Braga",7,"Rua Nova Santa Cruz",44,44,0,39,39,0
8,19,2018,21,0,8,"Braga",8,"Rua Costa Gomes",41,41,0,42,42,0
8,19,2018,22,0,8,"Braga",1,"Avenida da Liberdade",25,25,0,124,124,0
8,19,2018,22,0,8,"Braga",2,"Avenida Central",25,25,0,124,124,0
8,19,2018,22,0,8,"Braga",3,"Rua de Caires",36,36,0,37,37,0
8,19,2018,22,0,8,"Braga",4,"N14 Bosch",47,47,0,48,48,0
8,19,2018,22,0,8,"Braga",5,"Avenida João Paulo II",39,39,0,9,9,0
8,19,2018,22,0,8,"Braga",6,"Avenida Padre Júlio Fragata",67,67,0,83,83,0
8,19,2018,22,0,8,"Braga",7,"Rua Nova Santa Cruz",44,44,0,39,39,0
8,19,2018,22,0,8,"Braga",8,"Rua Costa Gomes",41,41,0,42,42,0
8,19,2018,23,0,8,"Braga",1,"Avenida da Liberdade",25,25,0,124,124,0
8,19,2018,23,0,8,"Braga",2,"Avenida Central",25,25,0,124,124,0
8,19,2018,23,0,8,"Braga",3,"Rua de Caires",36,36,0,37,37,0
8,19,2018,23,0,8,"Braga",4,"N14 Bosch",47,47,0,48,48,0
8,19,2018,23,0,8,"Braga",5,"Avenida João Paulo II",39,39,0,9,9,0
8,19,2018,23,0,8,"Braga",6,"Avenida Padre Júlio Fragata",67,67,0,83,83,0
8,19,2018,23,0,8,"Braga",7,"Rua Nova Santa Cruz",44,44,0,39,39,0
8,19,2018,23,0,8,"Braga",8,"Rua Costa Gomes",41,41,0,42,42,0
8,20,2018,0,0,2,"Braga",1,"Avenida da Liberdade",25,25,0,124,124,0
8,20,2018,0,0,2,"Braga",2,"Avenida Central",25,25,0,124,124,0
8,20,2018,0,0,2,"Braga",3,"Rua de Caires",36,36,0,37,37,0
8,20,2018,0,0,2,"Braga",4,"N14 Bosch",47,47,0,48,48,0
8,20,2018,0,0,2,"Braga",5,"Avenida João Paulo II",39,39,0,9,9,0
8,20,2018,0,0,2,"Braga",6,"Avenida Padre Júlio Fragata",67,67,0,83,83,0
8,20,2018,0,0,2,"Braga",7,"Rua Nova Santa Cruz",44,44,0,39,39,0
8,20,2018,0,0,2,"Braga",8,"Rua Costa Gomes",41,41,0,42,42,0
8,20,2018,1,0,2,"Braga",1,"Avenida da Liberdade",25,25,0,124,124,0
8,20,2018,1,0,2,"Braga",2,"Avenida Central",25,25,0,124,124,0
8,20,2018,1,0,2,"Braga",3,"Rua de Caires",36,36,0,37,37,0
8,20,2018,1,0,2,"Braga",4,"N14 Bosch",47,47,0,48,48,0
8,20,2018,1,0,2,"Braga",5,"Avenida João Paulo II",39,39,0,9,9,0
8,20,2018,1,0,2,"Braga",6,"Avenida Padre Júlio Fragata",67,67,0,83,83,0
8,20,2018,1,0,2,"Braga",7,"Rua Nova Santa Cruz",44,44,0,39,39,0
8,20,2018,1,0,2,"Braga",8,"Rua Costa Gomes",41,41,0,42,42,0
8,20,2018,2,0,2,"Braga",1,"Avenida da Liberdade",25,25,0,124,124,0
8,20,2018,2,0,2,"Braga",2,"Avenida Central",25,25,0,124,124,0
8,20,2018,2,0,2,"Braga",3,"Rua de Caires",36,36,0,37,37,0
8,20,2018,2,0,2,"Braga",4,"N14 Bosch",47,47,0,48,48,0
8,20,2018,2,0,2,"Braga",5,"Avenida João Paulo II",39,39,0,9,9,0
8,20,2018,2,0,2,"Braga",6,"Avenida Padre Júlio Fragata",67,67,0,83,83,0
8,20,2018,2,0,2,"Braga",7,"Rua Nova Santa Cruz",44,44,0,39,39,0
8,20,2018,2,0,2,"Braga",8,"Rua Costa Gomes",41,41,0,42,42,0
8,20,2018,3,0,2,"Braga",1,"Avenida da Liberdade",25,25,0,124,124,0
8,20,2018,3,0,2,"Braga",2,"Avenida Central",25,25,0,124,124,0
8,20,2018,3,0,2,"Braga",3,"Rua de Caires",36,36,0,37,37,0
8,20,2018,3,0,2,"Braga",4,"N14 Bosch",47,47,0,48,48,0
8,20,2018,3,0,2,"Braga",5,"Avenida João Paulo II",39,39,0,9,9,0
8,20,2018,3,0,2,"Braga",6,"Avenida Padre Júlio Fragata",67,67,0,83,83,0
8,20,2018,3,0,2,"Braga",7,"Rua Nova Santa Cruz",44,44,0,39,39,0
8,20,2018,3,0,2,"Braga",8,"Rua Costa Gomes",41,41,0,42,42,0
8,20,2018,4,0,2,"Braga",1,"Avenida da Liberdade",25,25,0,124,124,0
8,20,2018,4,0,2,"Braga",2,"Avenida Central",25,25,0,124,124,0
8,20,2018,4,0,2,"Braga",3,"Rua de Caires",36,36,0,37,37,0
8,20,2018,4,0,2,"Braga",4,"N14 Bosch",47,47,0,48,48,0
8,20,2018,4,0,2,"Braga",5,"Avenida João Paulo II",39,39,0,9,9,0
8,20,2018,4,0,2,"Braga",6,"Avenida Padre Júlio Fragata",67,67,0,83,83,0
8,20,2018,4,0,2,"Braga",7,"Rua Nova Santa Cruz",44,44,0,39,39,0
8,20,2018,4,0,2,"Braga",8,"Rua Costa Gomes",41,41,0,42,42,0
8,20,2018,5,0,2,"Braga",1,"Avenida da Liberdade",25,25,0,124,124,0
8,20,2018,5,0,2,"Braga",2,"Avenida Central",25,25,0,124,124,0
8,20,2018,5,0,2,"Braga",3,"Rua de Caires",36,36,0,37,37,0
8,20,2018,5,0,2,"Braga",4,"N14 Bosch",47,47,0,48,48,0
8,20,2018,5,0,2,"Braga",5,"Avenida João Paulo II",39,39,0,9,9,0
8,20,2018,5,0,2,"Braga",6,"Avenida Padre Júlio Fragata",67,67,0,83,83,0
8,20,2018,5,0,2,"Braga",7,"Rua Nova Santa Cruz",44,44,0,39,39,0
8,20,2018,5,0,2,"Braga",8,"Rua Costa Gomes",41,41,0,42,42,0
8,20,2018,6,0,2,"Braga",1,"Avenida da Liberdade",25,25,0,124,124,0
8,20,2018,6,0,2,"Braga",2,"Avenida Central",25,25,0,124,124,0
8,20,2018,6,0,2,"Braga",3,"Rua de Caires",36,36,0,37,37,0
8,20,2018,6,0,2,"Braga",4,"N14 Bosch",47,47,0,48,48,0
8,20,2018,6,0,2,"Braga",5,"Avenida João Paulo II",39,39,0,9,9,0
8,20,2018,6,0,2,"Braga",6,"Avenida Padre Júlio Fragata",67,67,0,83,83,0
8,20,2018,6,0,2,"Braga",7,"Rua Nova Santa Cruz",44,44,0,39,39,0
8,20,2018,6,0,2,"Braga",8,"Rua Costa Gomes",41,41,0,42,42,0
8,20,2018,7,0,2,"Braga",1,"Avenida da Liberdade",25,25,0,124,124,0
8,20,2018,7,0,2,"Braga",2,"Avenida Central",25,25,0,124,124,0
8,20,2018,7,0,2,"Braga",3,"Rua de Caires",28,36,8,48,37,11
8,20,2018,7,0,2,"Braga",4,"N14 Bosch",47,47,0,48,48,0
8,20,2018,7,0,2,"Braga",5,"Avenida João Paulo II",39,39,0,9,9,0
8,20,2018,7,0,2,"Braga",6,"Avenida Padre Júlio Fragata",67,67,0,83,83,0
8,20,2018,7,0,2,"Braga",7,"Rua Nova Santa Cruz",44,44,0,39,39,0
8,20,2018,7,0,2,"Braga",8,"Rua Costa Gomes",41,41,0,42,42,0
8,20,2018,8,0,2,"Braga",1,"Avenida da Liberdade",25,25,0,124,124,0
8,20,2018,8,0,2,"Braga",2,"Avenida Central",25,25,0,124,124,0
8,20,2018,8,0,2,"Braga",3,"Rua de Caires",27,36,9,50,37,13
8,20,2018,8,0,2,"Braga",4,"N14 Bosch",30,47,17,75,48,27
8,20,2018,8,0,2,"Braga",5,"Avenida João Paulo II",39,39,0,9,9,0
8,20,2018,8,0,2,"Braga",6,"Avenida Padre Júlio Fragata",67,67,0,83,83,0
8,20,2018,8,0,2,"Braga",7,"Rua Nova Santa Cruz",44,44,0,39,39,0
8,20,2018,8,0,2,"Braga",8,"Rua Costa Gomes",41,41,0,42,42,0
8,20,2018,9,0,2,"Braga",1,"Avenida da Liberdade",25,25,0,124,124,0
8,20,2018,9,0,2,"Braga",2,"Avenida Central",25,25,0,124,124,0
8,20,2018,9,0,2,"Braga",3,"Rua de Caires",26,36,10,52,37,15
8,20,2018,9,0,2,"Braga",4,"N14 Bosch",34,47,13,66,48,18
8,20,2018,9,0,2,"Braga",5,"Avenida João Paulo II",39,39,0,9,9,0
8,20,2018,9,0,2,"Braga",6,"Avenida Padre Júlio Fragata",67,67,0,83,83,0
8,20,2018,9,0,2,"Braga",7,"Rua Nova Santa Cruz",44,44,0,39,39,0
8,20,2018,9,0,2,"Braga",8,"Rua Costa Gomes",41,41,0,42,42,0
8,20,2018,10,0,2,"Braga",1,"Avenida da Liberdade",25,25,0,124,124,0
8,20,2018,10,0,2,"Braga",2,"Avenida Central",25,25,0,124,124,0
8,20,2018,10,0,2,"Braga",3,"Rua de Caires",26,36,10,52,37,15
8,20,2018,10,0,2,"Braga",4,"N14 Bosch",36,47,11,62,48,14
8,20,2018,10,0,2,"Braga",5,"Avenida João Paulo II",39,39,0,9,9,0
8,20,2018,10,0,2,"Braga",6,"Avenida Padre Júlio Fragata",67,67,0,83,83,0
8,20,2018,10,0,2,"Braga",7,"Rua Nova Santa Cruz",44,44,0,39,39,0
8,20,2018,10,0,2,"Braga",8,"Rua Costa Gomes",41,41,0,42,42,0
8,20,2018,11,0,2,"Braga",1,"Avenida da Liberdade",19,25,6,163,124,39
8,20,2018,11,0,2,"Braga",2,"Avenida Central",19,25,6,163,124,39
8,20,2018,11,0,2,"Braga",3,"Rua de Caires",36,36,0,37,37,0
8,20,2018,11,0,2,"Braga",4,"N14 Bosch",47,47,0,48,48,0
8,20,2018,11,0,2,"Braga",5,"Avenida João Paulo II",30,39,9,12,9,3
8,20,2018,11,0,2,"Braga",6,"Avenida Padre Júlio Fragata",67,67,0,83,83,0
8,20,2018,11,0,2,"Braga",7,"Rua Nova Santa Cruz",44,44,0,39,39,0
8,20,2018,11,0,2,"Braga",8,"Rua Costa Gomes",31,41,10,56,42,14
8,20,2018,12,0,2,"Braga",1,"Avenida da Liberdade",18,25,7,172,124,48
8,20,2018,12,0,2,"Braga",2,"Avenida Central",18,25,7,172,124,48
8,20,2018,12,0,2,"Braga",3,"Rua de Caires",27,36,9,50,37,13
8,20,2018,12,0,2,"Braga",4,"N14 Bosch",33,47,14,68,48,20
8,20,2018,12,0,2,"Braga",5,"Avenida João Paulo II",39,39,0,9,9,0
8,20,2018,12,0,2,"Braga",6,"Avenida Padre Júlio Fragata",67,67,0,83,83,0
8,20,2018,12,0,2,"Braga",7,"Rua Nova Santa Cruz",44,44,0,39,39,0
8,20,2018,12,0,2,"Braga",8,"Rua Costa Gomes",25,41,16,69,42,27
8,20,2018,13,0,2,"Braga",1,"Avenida da Liberdade",25,25,0,124,124,0
8,20,2018,13,0,2,"Braga",2,"Avenida Central",25,25,0,124,124,0
8,20,2018,13,0,2,"Braga",3,"Rua de Caires",22,36,14,61,37,24
8,20,2018,13,0,2,"Braga",4,"N14 Bosch",27,47,20,83,48,35
8,20,2018,13,0,2,"Braga",5,"Avenida João Paulo II",39,39,0,9,9,0
8,20,2018,13,0,2,"Braga",6,"Avenida Padre Júlio Fragata",67,67,0,83,83,0
8,20,2018,13,0,2,"Braga",7,"Rua Nova Santa Cruz",34,44,10,51,39,12
8,20,2018,13,0,2,"Braga",8,"Rua Costa Gomes",18,41,23,96,42,54
8,20,2018,14,0,2,"Braga",1,"Avenida da Liberdade",25,25,0,124,124,0
8,20,2018,14,0,2,"Braga",2,"Avenida Central",25,25,0,124,124,0
8,20,2018,14,0,2,"Braga",3,"Rua de Caires",36,36,0,37,37,0
8,20,2018,14,0,2,"Braga",4,"N14 Bosch",33,47,14,68,48,20
8,20,2018,14,0,2,"Braga",5,"Avenida João Paulo II",39,39,0,9,9,0
8,20,2018,14,0,2,"Braga",6,"Avenida Padre Júlio Fragata",67,67,0,83,83,0
8,20,2018,14,0,2,"Braga",7,"Rua Nova Santa Cruz",44,44,0,39,39,0
8,20,2018,14,0,2,"Braga",8,"Rua Costa Gomes",27,41,14,64,42,22
8,20,2018,15,0,2,"Braga",1,"Avenida da Liberdade",25,25,0,124,124,0
8,20,2018,15,0,2,"Braga",2,"Avenida Central",25,25,0,124,124,0
8,20,2018,15,0,2,"Braga",3,"Rua de Caires",36,36,0,37,37,0
8,20,2018,15,0,2,"Braga",4,"N14 Bosch",34,47,13,66,48,18
8,20,2018,15,0,2,"Braga",5,"Avenida João Paulo II",39,39,0,9,9,0
8,20,2018,15,0,2,"Braga",6,"Avenida Padre Júlio Fragata",67,67,0,83,83,0
8,20,2018,15,0,2,"Braga",7,"Rua Nova Santa Cruz",32,44,12,54,39,15
8,20,2018,15,0,2,"Braga",8,"Rua Costa Gomes",21,41,20,82,42,40
8,20,2018,16,0,2,"Braga",1,"Avenida da Liberdade",25,25,0,124,124,0
8,20,2018,16,0,2,"Braga",2,"Avenida Central",25,25,0,124,124,0
8,20,2018,16,0,2,"Braga",3,"Rua de Caires",36,36,0,37,37,0
8,20,2018,16,0,2,"Braga",4,"N14 Bosch",47,47,0,48,48,0
8,20,2018,16,0,2,"Braga",5,"Avenida João Paulo II",39,39,0,9,9,0
8,20,2018,16,0,2,"Braga",6,"Avenida Padre Júlio Fragata",53,67,14,105,83,22
8,20,2018,16,0,2,"Braga",7,"Rua Nova Santa Cruz",44,44,0,39,39,0
8,20,2018,16,0,2,"Braga",8,"Rua Costa Gomes",27,41,14,64,42,22
8,20,2018,17,0,2,"Braga",1,"Avenida da Liberdade",25,25,0,124,124,0
8,20,2018,17,0,2,"Braga",2,"Avenida Central",25,25,0,124,124,0
8,20,2018,17,0,2,"Braga",3,"Rua de Caires",36,36,0,37,37,0
8,20,2018,17,0,2,"Braga",4,"N14 Bosch",15,47,32,150,48,102
8,20,2018,17,0,2,"Braga",5,"Avenida João Paulo II",39,39,0,9,9,0
8,20,2018,17,0,2,"Braga",6,"Avenida Padre Júlio Fragata",49,67,18,114,83,31
8,20,2018,17,0,2,"Braga",7,"Rua Nova Santa Cruz",44,44,0,39,39,0
8,20,2018,17,0,2,"Braga",8,"Rua Costa Gomes",30,41,11,58,42,16
8,20,2018,18,0,2,"Braga",1,"Avenida da Liberdade",19,25,6,163,124,39
8,20,2018,18,0,2,"Braga",2,"Avenida Central",19,25,6,163,124,39
8,20,2018,18,0,2,"Braga",3,"Rua de Caires",22,36,14,61,37,24
8,20,2018,18,0,2,"Braga",4,"N14 Bosch",47,47,0,48,48,0
8,20,2018,18,0,2,"Braga",5,"Avenida João Paulo II",39,39,0,9,9,0
8,20,2018,18,0,2,"Braga",6,"Avenida Padre Júlio Fragata",50,67,17,111,83,28
8,20,2018,18,0,2,"Braga",7,"Rua Nova Santa Cruz",44,44,0,39,39,0
8,20,2018,18,0,2,"Braga",8,"Rua Costa Gomes",20,41,21,87,42,45
8,20,2018,19,0,2,"Braga",1,"Avenida da Liberdade",25,25,0,124,124,0
8,20,2018,19,0,2,"Braga",2,"Avenida Central",25,25,0,124,124,0
8,20,2018,19,0,2,"Braga",3,"Rua de Caires",26,36,10,52,37,15
8,20,2018,19,0,2,"Braga",4,"N14 Bosch",47,47,0,48,48,0
8,20,2018,19,0,2,"Braga",5,"Avenida João Paulo II",39,39,0,9,9,0
8,20,2018,19,0,2,"Braga",6,"Avenida Padre Júlio Fragata",67,67,0,83,83,0
8,20,2018,19,0,2,"Braga",7,"Rua Nova Santa Cruz",44,44,0,39,39,0
8,20,2018,19,0,2,"Braga",8,"Rua Costa Gomes",27,41,14,64,42,22
8,20,2018,20,0,2,"Braga",1,"Avenida da Liberdade",25,25,0,124,124,0
8,20,2018,20,0,2,"Braga",2,"Avenida Central",25,25,0,124,124,0
8,20,2018,20,0,2,"Braga",3,"Rua de Caires",36,36,0,37,37,0
8,20,2018,20,0,2,"Braga",4,"N14 Bosch",47,47,0,48,48,0
8,20,2018,20,0,2,"Braga",5,"Avenida João Paulo II",39,39,0,9,9,0
8,20,2018,20,0,2,"Braga",6,"Avenida Padre Júlio Fragata",67,67,0,83,83,0
8,20,2018,20,0,2,"Braga",7,"Rua Nova Santa Cruz",44,44,0,39,39,0
8,20,2018,20,0,2,"Braga",8,"Rua Costa Gomes",41,41,0,42,42,0
8,20,2018,21,0,2,"Braga",1,"Avenida da Liberdade",25,25,0,124,124,0
8,20,2018,21,0,2,"Braga",2,"Avenida Central",25,25,0,124,124,0
8,20,2018,21,0,2,"Braga",3,"Rua de Caires",36,36,0,37,37,0
8,20,2018,21,0,2,"Braga",4,"N14 Bosch",47,47,0,48,48,0
8,20,2018,21,0,2,"Braga",5,"Avenida João Paulo II",30,39,9,12,9,3
8,20,2018,21,0,2,"Braga",6,"Avenida Padre Júlio Fragata",53,67,14,105,83,22
8,20,2018,21,0,2,"Braga",7,"Rua Nova Santa Cruz",44,44,0,39,39,0
8,20,2018,21,0,2,"Braga",8,"Rua Costa Gomes",32,41,9,54,42,12
8,20,2018,22,0,2,"Braga",1,"Avenida da Liberdade",25,25,0,124,124,0
8,20,2018,22,0,2,"Braga",2,"Avenida Central",25,25,0,124,124,0
8,20,2018,22,0,2,"Braga",3,"Rua de Caires",36,36,0,37,37,0
8,20,2018,22,0,2,"Braga",4,"N14 Bosch",47,47,0,48,48,0
8,20,2018,22,0,2,"Braga",5,"Avenida João Paulo II",39,39,0,9,9,0
8,20,2018,22,0,2,"Braga",6,"Avenida Padre Júlio Fragata",67,67,0,83,83,0
8,20,2018,22,0,2,"Braga",7,"Rua Nova Santa Cruz",44,44,0,39,39,0
8,20,2018,22,0,2,"Braga",8,"Rua Costa Gomes",41,41,0,42,42,0
8,20,2018,23,0,2,"Braga",1,"Avenida da Liberdade",25,25,0,124,124,0
8,20,2018,23,0,2,"Braga",2,"Avenida Central",25,25,0,124,124,0
8,20,2018,23,0,2,"Braga",3,"Rua de Caires",36,36,0,37,37,0
8,20,2018,23,0,2,"Braga",4,"N14 Bosch",47,47,0,48,48,0
8,20,2018,23,0,2,"Braga",5,"Avenida João Paulo II",39,39,0,9,9,0
8,20,2018,23,0,2,"Braga",6,"Avenida Padre Júlio Fragata",67,67,0,83,83,0
8,20,2018,23,0,2,"Braga",7,"Rua Nova Santa Cruz",44,44,0,39,39,0
8,20,2018,23,0,2,"Braga",8,"Rua Costa Gomes",41,41,0,42,42,0
8,21,2018,0,0,3,"Braga",1,"Avenida da Liberdade",25,25,0,124,124,0
8,21,2018,0,0,3,"Braga",2,"Avenida Central",25,25,0,124,124,0
8,21,2018,0,0,3,"Braga",3,"Rua de Caires",36,36,0,37,37,0
8,21,2018,0,0,3,"Braga",4,"N14 Bosch",47,47,0,48,48,0
8,21,2018,0,0,3,"Braga",5,"Avenida João Paulo II",39,39,0,9,9,0
8,21,2018,0,0,3,"Braga",6,"Avenida Padre Júlio Fragata",67,67,0,83,83,0
8,21,2018,0,0,3,"Braga",7,"Rua Nova Santa Cruz",44,44,0,39,39,0
8,21,2018,0,0,3,"Braga",8,"Rua Costa Gomes",41,41,0,42,42,0
8,21,2018,1,0,3,"Braga",1,"Avenida da Liberdade",25,25,0,124,124,0
8,21,2018,1,0,3,"Braga",2,"Avenida Central",25,25,0,124,124,0
8,21,2018,1,0,3,"Braga",3,"Rua de Caires",36,36,0,37,37,0
8,21,2018,1,0,3,"Braga",4,"N14 Bosch",47,47,0,48,48,0
8,21,2018,1,0,3,"Braga",5,"Avenida João Paulo II",39,39,0,9,9,0
8,21,2018,1,0,3,"Braga",6,"Avenida Padre Júlio Fragata",67,67,0,83,83,0
8,21,2018,1,0,3,"Braga",7,"Rua Nova Santa Cruz",44,44,0,39,39,0
8,21,2018,1,0,3,"Braga",8,"Rua Costa Gomes",41,41,0,42,42,0
8,21,2018,2,0,3,"Braga",1,"Avenida da Liberdade",25,25,0,124,124,0
8,21,2018,2,0,3,"Braga",2,"Avenida Central",25,25,0,124,124,0
8,21,2018,2,0,3,"Braga",3,"Rua de Caires",36,36,0,37,37,0
8,21,2018,2,0,3,"Braga",4,"N14 Bosch",47,47,0,48,48,0
8,21,2018,2,0,3,"Braga",5,"Avenida João Paulo II",39,39,0,9,9,0
8,21,2018,2,0,3,"Braga",6,"Avenida Padre Júlio Fragata",67,67,0,83,83,0
8,21,2018,2,0,3,"Braga",7,"Rua Nova Santa Cruz",44,44,0,39,39,0
8,21,2018,2,0,3,"Braga",8,"Rua Costa Gomes",41,41,0,42,42,0
8,21,2018,3,0,3,"Braga",1,"Avenida da Liberdade",25,25,0,124,124,0
8,21,2018,3,0,3,"Braga",2,"Avenida Central",25,25,0,124,124,0
8,21,2018,3,0,3,"Braga",3,"Rua de Caires",36,36,0,37,37,0
8,21,2018,3,0,3,"Braga",4,"N14 Bosch",47,47,0,48,48,0
8,21,2018,3,0,3,"Braga",5,"Avenida João Paulo II",39,39,0,9,9,0
8,21,2018,3,0,3,"Braga",6,"Avenida Padre Júlio Fragata",67,67,0,83,83,0
8,21,2018,3,0,3,"Braga",7,"Rua Nova Santa Cruz",44,44,0,39,39,0
8,21,2018,3,0,3,"Braga",8,"Rua Costa Gomes",41,41,0,42,42,0
8,21,2018,4,0,3,"Braga",1,"Avenida da Liberdade",25,25,0,124,124,0
8,21,2018,4,0,3,"Braga",2,"Avenida Central",25,25,0,124,124,0
8,21,2018,4,0,3,"Braga",3,"Rua de Caires",36,36,0,37,37,0
8,21,2018,4,0,3,"Braga",4,"N14 Bosch",47,47,0,48,48,0
8,21,2018,4,0,3,"Braga",5,"Avenida João Paulo II",39,39,0,9,9,0
8,21,2018,4,0,3,"Braga",6,"Avenida Padre Júlio Fragata",67,67,0,83,83,0
8,21,2018,4,0,3,"Braga",7,"Rua Nova Santa Cruz",44,44,0,39,39,0
8,21,2018,4,0,3,"Braga",8,"Rua Costa Gomes",41,41,0,42,42,0
8,21,2018,5,0,3,"Braga",1,"Avenida da Liberdade",25,25,0,124,124,0
8,21,2018,5,0,3,"Braga",2,"Avenida Central",25,25,0,124,124,0
8,21,2018,5,0,3,"Braga",3,"Rua de Caires",36,36,0,37,37,0
8,21,2018,5,0,3,"Braga",4,"N14 Bosch",47,47,0,48,48,0
8,21,2018,5,0,3,"Braga",5,"Avenida João Paulo II",39,39,0,9,9,0
8,21,2018,5,0,3,"Braga",6,"Avenida Padre Júlio Fragata",67,67,0,83,83,0
8,21,2018,5,0,3,"Braga",7,"Rua Nova Santa Cruz",44,44,0,39,39,0
8,21,2018,5,0,3,"Braga",8,"Rua Costa Gomes",41,41,0,42,42,0
8,21,2018,6,0,3,"Braga",1,"Avenida da Liberdade",25,25,0,124,124,0
8,21,2018,6,0,3,"Braga",2,"Avenida Central",25,25,0,124,124,0
8,21,2018,6,0,3,"Braga",3,"Rua de Caires",36,36,0,37,37,0
8,21,2018,6,0,3,"Braga",4,"N14 Bosch",47,47,0,48,48,0
8,21,2018,6,0,3,"Braga",5,"Avenida João Paulo II",39,39,0,9,9,0
8,21,2018,6,0,3,"Braga",6,"Avenida Padre Júlio Fragata",67,67,0,83,83,0
8,21,2018,6,0,3,"Braga",7,"Rua Nova Santa Cruz",44,44,0,39,39,0
8,21,2018,6,0,3,"Braga",8,"Rua Costa Gomes",41,41,0,42,42,0
8,21,2018,7,0,3,"Braga",1,"Avenida da Liberdade",25,25,0,124,124,0
8,21,2018,7,0,3,"Braga",2,"Avenida Central",25,25,0,124,124,0
8,21,2018,7,0,3,"Braga",3,"Rua de Caires",36,36,0,37,37,0
8,21,2018,7,0,3,"Braga",4,"N14 Bosch",47,47,0,48,48,0
8,21,2018,7,0,3,"Braga",5,"Avenida João Paulo II",39,39,0,9,9,0
8,21,2018,7,0,3,"Braga",6,"Avenida Padre Júlio Fragata",67,67,0,83,83,0
8,21,2018,7,0,3,"Braga",7,"Rua Nova Santa Cruz",44,44,0,39,39,0
8,21,2018,7,0,3,"Braga",8,"Rua Costa Gomes",41,41,0,42,42,0
8,21,2018,8,0,3,"Braga",1,"Avenida da Liberdade",25,25,0,124,124,0
8,21,2018,8,0,3,"Braga",2,"Avenida Central",25,25,0,124,124,0
8,21,2018,8,0,3,"Braga",3,"Rua de Caires",24,36,12,56,37,19
8,21,2018,8,0,3,"Braga",4,"N14 Bosch",30,47,17,75,48,27
8,21,2018,8,0,3,"Braga",5,"Avenida João Paulo II",30,39,9,12,9,3
8,21,2018,8,0,3,"Braga",6,"Avenida Padre Júlio Fragata",67,67,0,83,83,0
8,21,2018,8,0,3,"Braga",7,"Rua Nova Santa Cruz",44,44,0,39,39,0
8,21,2018,8,0,3,"Braga",8,"Rua Costa Gomes",41,41,0,42,42,0
8,21,2018,10,0,3,"Braga",1,"Avenida da Liberdade",25,25,0,124,124,0
8,21,2018,10,0,3,"Braga",2,"Avenida Central",25,25,0,124,124,0
8,21,2018,10,0,3,"Braga",3,"Rua de Caires",28,36,8,48,37,11
8,21,2018,10,0,3,"Braga",4,"N14 Bosch",32,47,15,70,48,22
8,21,2018,10,0,3,"Braga",5,"Avenida João Paulo II",30,39,9,12,9,3
8,21,2018,10,0,3,"Braga",6,"Avenida Padre Júlio Fragata",49,67,18,114,83,31
8,21,2018,10,0,3,"Braga",7,"Rua Nova Santa Cruz",44,44,0,39,39,0
8,21,2018,10,0,3,"Braga",8,"Rua Costa Gomes",30,41,11,58,42,16
8,21,2018,11,0,3,"Braga",1,"Avenida da Liberdade",25,25,0,124,124,0
8,21,2018,11,0,3,"Braga",2,"Avenida Central",25,25,0,124,124,0
8,21,2018,11,0,3,"Braga",3,"Rua de Caires",26,36,10,52,37,15
8,21,2018,11,0,3,"Braga",4,"N14 Bosch",32,47,15,70,48,22
8,21,2018,11,0,3,"Braga",5,"Avenida João Paulo II",39,39,0,9,9,0
8,21,2018,11,0,3,"Braga",6,"Avenida Padre Júlio Fragata",67,67,0,83,83,0
8,21,2018,11,0,3,"Braga",7,"Rua Nova Santa Cruz",44,44,0,39,39,0
8,21,2018,11,0,3,"Braga",8,"Rua Costa Gomes",41,41,0,42,42,0
8,21,2018,12,0,3,"Braga",1,"Avenida da Liberdade",18,25,7,172,124,48
8,21,2018,12,0,3,"Braga",2,"Avenida Central",18,25,7,172,124,48
8,21,2018,12,0,3,"Braga",3,"Rua de Caires",17,36,19,79,37,42
8,21,2018,12,0,3,"Braga",4,"N14 Bosch",47,47,0,48,48,0
8,21,2018,12,0,3,"Braga",5,"Avenida João Paulo II",39,39,0,9,9,0
8,21,2018,12,0,3,"Braga",6,"Avenida Padre Júlio Fragata",67,67,0,83,83,0
8,21,2018,12,0,3,"Braga",7,"Rua Nova Santa Cruz",44,44,0,39,39,0
8,21,2018,12,0,3,"Braga",8,"Rua Costa Gomes",27,41,14,64,42,22
8,21,2018,13,0,3,"Braga",1,"Avenida da Liberdade",25,25,0,124,124,0
8,21,2018,13,0,3,"Braga",2,"Avenida Central",25,25,0,124,124,0
8,21,2018,13,0,3,"Braga",3,"Rua de Caires",28,36,8,48,37,11
8,21,2018,13,0,3,"Braga",4,"N14 Bosch",15,47,32,150,48,102
8,21,2018,13,0,3,"Braga",5,"Avenida João Paulo II",39,39,0,9,9,0
8,21,2018,13,0,3,"Braga",6,"Avenida Padre Júlio Fragata",67,67,0,83,83,0
8,21,2018,13,0,3,"Braga",7,"Rua Nova Santa Cruz",44,44,0,39,39,0
8,21,2018,13,0,3,"Braga",8,"Rua Costa Gomes",41,41,0,42,42,0
8,21,2018,14,0,3,"Braga",1,"Avenida da Liberdade",25,25,0,124,124,0
8,21,2018,14,0,3,"Braga",2,"Avenida Central",25,25,0,124,124,0
8,21,2018,14,0,3,"Braga",3,"Rua de Caires",36,36,0,37,37,0
8,21,2018,14,0,3,"Braga",4,"N14 Bosch",47,47,0,48,48,0
8,21,2018,14,0,3,"Braga",5,"Avenida João Paulo II",39,39,0,9,9,0
8,21,2018,14,0,3,"Braga",6,"Avenida Padre Júlio Fragata",67,67,0,83,83,0
8,21,2018,14,0,3,"Braga",7,"Rua Nova Santa Cruz",44,44,0,39,39,0
8,21,2018,14,0,3,"Braga",8,"Rua Costa Gomes",31,41,10,56,42,14
8,21,2018,15,0,3,"Braga",1,"Avenida da Liberdade",25,25,0,124,124,0
8,21,2018,15,0,3,"Braga",2,"Avenida Central",25,25,0,124,124,0
8,21,2018,15,0,3,"Braga",3,"Rua de Caires",36,36,0,37,37,0
8,21,2018,15,0,3,"Braga",4,"N14 Bosch",47,47,0,48,48,0
8,21,2018,15,0,3,"Braga",5,"Avenida João Paulo II",39,39,0,9,9,0
8,21,2018,15,0,3,"Braga",6,"Avenida Padre Júlio Fragata",67,67,0,83,83,0
8,21,2018,15,0,3,"Braga",7,"Rua Nova Santa Cruz",44,44,0,39,39,0
8,21,2018,15,0,3,"Braga",8,"Rua Costa Gomes",25,41,16,69,42,27
8,21,2018,16,0,3,"Braga",1,"Avenida da Liberdade",18,25,7,172,124,48
8,21,2018,16,0,3,"Braga",2,"Avenida Central",18,25,7,172,124,48
8,21,2018,16,0,3,"Braga",3,"Rua de Caires",36,36,0,37,37,0
8,21,2018,16,0,3,"Braga",4,"N14 Bosch",34,47,13,66,48,18
8,21,2018,16,0,3,"Braga",5,"Avenida João Paulo II",39,39,0,9,9,0
8,21,2018,16,0,3,"Braga",6,"Avenida Padre Júlio Fragata",67,67,0,83,83,0
8,21,2018,16,0,3,"Braga",7,"Rua Nova Santa Cruz",44,44,0,39,39,0
8,21,2018,16,0,3,"Braga",8,"Rua Costa Gomes",32,41,9,54,42,12
8,21,2018,17,0,3,"Braga",1,"Avenida da Liberdade",19,25,6,163,124,39
8,21,2018,17,0,3,"Braga",2,"Avenida Central",19,25,6,163,124,39
8,21,2018,17,0,3,"Braga",3,"Rua de Caires",28,36,8,48,37,11
8,21,2018,17,0,3,"Braga",4,"N14 Bosch",33,47,14,68,48,20
8,21,2018,17,0,3,"Braga",5,"Avenida João Paulo II",39,39,0,9,9,0
8,21,2018,17,0,3,"Braga",6,"Avenida Padre Júlio Fragata",67,67,0,83,83,0
8,21,2018,17,0,3,"Braga",7,"Rua Nova Santa Cruz",44,44,0,39,39,0
8,21,2018,17,0,3,"Braga",8,"Rua Costa Gomes",20,41,21,87,42,45
8,21,2018,18,0,3,"Braga",1,"Avenida da Liberdade",19,25,6,163,124,39
8,21,2018,18,0,3,"Braga",2,"Avenida Central",19,25,6,163,124,39
8,21,2018,18,0,3,"Braga",3,"Rua de Caires",36,36,0,37,37,0
8,21,2018,18,0,3,"Braga",4,"N14 Bosch",47,47,0,48,48,0
8,21,2018,18,0,3,"Braga",5,"Avenida João Paulo II",39,39,0,9,9,0
8,21,2018,18,0,3,"Braga",6,"Avenida Padre Júlio Fragata",40,67,27,139,83,56
8,21,2018,18,0,3,"Braga",7,"Rua Nova Santa Cruz",44,44,0,39,39,0
8,21,2018,18,0,3,"Braga",8,"Rua Costa Gomes",19,41,22,91,42,49
8,21,2018,19,0,3,"Braga",1,"Avenida da Liberdade",25,25,0,124,124,0
8,21,2018,19,0,3,"Braga",2,"Avenida Central",25,25,0,124,124,0
8,21,2018,19,0,3,"Braga",3,"Rua de Caires",36,36,0,37,37,0
8,21,2018,19,0,3,"Braga",4,"N14 Bosch",47,47,0,48,48,0
8,21,2018,19,0,3,"Braga",5,"Avenida João Paulo II",39,39,0,9,9,0
8,21,2018,19,0,3,"Braga",6,"Avenida Padre Júlio Fragata",67,67,0,83,83,0
8,21,2018,19,0,3,"Braga",7,"Rua Nova Santa Cruz",30,44,14,58,39,19
8,21,2018,19,0,3,"Braga",8,"Rua Costa Gomes",31,41,10,56,42,14
8,21,2018,20,0,3,"Braga",1,"Avenida da Liberdade",25,25,0,124,124,0
8,21,2018,20,0,3,"Braga",2,"Avenida Central",25,25,0,124,124,0
8,21,2018,20,0,3,"Braga",3,"Rua de Caires",36,36,0,37,37,0
8,21,2018,20,0,3,"Braga",4,"N14 Bosch",47,47,0,48,48,0
8,21,2018,20,0,3,"Braga",5,"Avenida João Paulo II",39,39,0,9,9,0
8,21,2018,20,0,3,"Braga",6,"Avenida Padre Júlio Fragata",67,67,0,83,83,0
8,21,2018,20,0,3,"Braga",7,"Rua Nova Santa Cruz",44,44,0,39,39,0
8,21,2018,20,0,3,"Braga",8,"Rua Costa Gomes",41,41,0,42,42,0
8,21,2018,21,0,3,"Braga",1,"Avenida da Liberdade",25,25,0,124,124,0
8,21,2018,21,0,3,"Braga",2,"Avenida Central",25,25,0,124,124,0
8,21,2018,21,0,3,"Braga",3,"Rua de Caires",36,36,0,37,37,0
8,21,2018,21,0,3,"Braga",4,"N14 Bosch",47,47,0,48,48,0
8,21,2018,21,0,3,"Braga",5,"Avenida João Paulo II",39,39,0,9,9,0
8,21,2018,21,0,3,"Braga",6,"Avenida Padre Júlio Fragata",67,67,0,83,83,0
8,21,2018,21,0,3,"Braga",7,"Rua Nova Santa Cruz",44,44,0,39,39,0
8,21,2018,21,0,3,"Braga",8,"Rua Costa Gomes",32,41,9,54,42,12
8,21,2018,22,0,3,"Braga",1,"Avenida da Liberdade",25,25,0,124,124,0
8,21,2018,22,0,3,"Braga",2,"Avenida Central",25,25,0,124,124,0
8,21,2018,22,0,3,"Braga",3,"Rua de Caires",36,36,0,37,37,0
8,21,2018,22,0,3,"Braga",4,"N14 Bosch",47,47,0,48,48,0
8,21,2018,22,0,3,"Braga",5,"Avenida João Paulo II",39,39,0,9,9,0
8,21,2018,22,0,3,"Braga",6,"Avenida Padre Júlio Fragata",67,67,0,83,83,0
8,21,2018,22,0,3,"Braga",7,"Rua Nova Santa Cruz",44,44,0,39,39,0
8,21,2018,22,0,3,"Braga",8,"Rua Costa Gomes",41,41,0,42,42,0
8,21,2018,23,0,3,"Braga",1,"Avenida da Liberdade",25,25,0,124,124,0
8,21,2018,23,0,3,"Braga",2,"Avenida Central",25,25,0,124,124,0
8,21,2018,23,0,3,"Braga",3,"Rua de Caires",36,36,0,37,37,0
8,21,2018,23,0,3,"Braga",4,"N14 Bosch",47,47,0,48,48,0
8,21,2018,23,0,3,"Braga",5,"Avenida João Paulo II",39,39,0,9,9,0
8,21,2018,23,0,3,"Braga",6,"Avenida Padre Júlio Fragata",67,67,0,83,83,0
8,21,2018,23,0,3,"Braga",7,"Rua Nova Santa Cruz",44,44,0,39,39,0
8,21,2018,23,0,3,"Braga",8,"Rua Costa Gomes",41,41,0,42,42,0
8,22,2018,0,0,4,"Braga",1,"Avenida da Liberdade",25,25,0,124,124,0
8,22,2018,0,0,4,"Braga",2,"Avenida Central",25,25,0,124,124,0
8,22,2018,0,0,4,"Braga",3,"Rua de Caires",36,36,0,37,37,0
8,22,2018,0,0,4,"Braga",4,"N14 Bosch",47,47,0,48,48,0
8,22,2018,0,0,4,"Braga",5,"Avenida João Paulo II",39,39,0,9,9,0
8,22,2018,0,0,4,"Braga",6,"Avenida Padre Júlio Fragata",67,67,0,83,83,0
8,22,2018,0,0,4,"Braga",7,"Rua Nova Santa Cruz",44,44,0,39,39,0
8,22,2018,0,0,4,"Braga",8,"Rua Costa Gomes",41,41,0,42,42,0
8,22,2018,1,0,4,"Braga",1,"Avenida da Liberdade",25,25,0,124,124,0
8,22,2018,1,0,4,"Braga",2,"Avenida Central",25,25,0,124,124,0
8,22,2018,1,0,4,"Braga",3,"Rua de Caires",36,36,0,37,37,0
8,22,2018,1,0,4,"Braga",4,"N14 Bosch",47,47,0,48,48,0
8,22,2018,1,0,4,"Braga",5,"Avenida João Paulo II",39,39,0,9,9,0
8,22,2018,1,0,4,"Braga",6,"Avenida Padre Júlio Fragata",67,67,0,83,83,0
8,22,2018,1,0,4,"Braga",7,"Rua Nova Santa Cruz",44,44,0,39,39,0
8,22,2018,1,0,4,"Braga",8,"Rua Costa Gomes",41,41,0,42,42,0
8,22,2018,2,0,4,"Braga",1,"Avenida da Liberdade",25,25,0,124,124,0
8,22,2018,2,0,4,"Braga",2,"Avenida Central",25,25,0,124,124,0
8,22,2018,2,0,4,"Braga",3,"Rua de Caires",36,36,0,37,37,0
8,22,2018,2,0,4,"Braga",4,"N14 Bosch",47,47,0,48,48,0
8,22,2018,2,0,4,"Braga",5,"Avenida João Paulo II",39,39,0,9,9,0
8,22,2018,2,0,4,"Braga",6,"Avenida Padre Júlio Fragata",67,67,0,83,83,0
8,22,2018,2,0,4,"Braga",7,"Rua Nova Santa Cruz",44,44,0,39,39,0
8,22,2018,2,0,4,"Braga",8,"Rua Costa Gomes",41,41,0,42,42,0
8,22,2018,3,0,4,"Braga",1,"Avenida da Liberdade",25,25,0,124,124,0
8,22,2018,3,0,4,"Braga",2,"Avenida Central",25,25,0,124,124,0
8,22,2018,3,0,4,"Braga",3,"Rua de Caires",36,36,0,37,37,0
8,22,2018,3,0,4,"Braga",4,"N14 Bosch",47,47,0,48,48,0
8,22,2018,3,0,4,"Braga",5,"Avenida João Paulo II",30,39,9,12,9,3
8,22,2018,3,0,4,"Braga",6,"Avenida Padre Júlio Fragata",67,67,0,83,83,0
8,22,2018,3,0,4,"Braga",7,"Rua Nova Santa Cruz",44,44,0,39,39,0
8,22,2018,3,0,4,"Braga",8,"Rua Costa Gomes",41,41,0,42,42,0
8,22,2018,4,0,4,"Braga",1,"Avenida da Liberdade",25,25,0,124,124,0
8,22,2018,4,0,4,"Braga",2,"Avenida Central",25,25,0,124,124,0
8,22,2018,4,0,4,"Braga",3,"Rua de Caires",36,36,0,37,37,0
8,22,2018,4,0,4,"Braga",4,"N14 Bosch",47,47,0,48,48,0
8,22,2018,4,0,4,"Braga",5,"Avenida João Paulo II",39,39,0,9,9,0
8,22,2018,4,0,4,"Braga",6,"Avenida Padre Júlio Fragata",67,67,0,83,83,0
8,22,2018,4,0,4,"Braga",7,"Rua Nova Santa Cruz",44,44,0,39,39,0
8,22,2018,4,0,4,"Braga",8,"Rua Costa Gomes",41,41,0,42,42,0
8,22,2018,5,0,4,"Braga",1,"Avenida da Liberdade",25,25,0,124,124,0
8,22,2018,5,0,4,"Braga",2,"Avenida Central",25,25,0,124,124,0
8,22,2018,5,0,4,"Braga",3,"Rua de Caires",36,36,0,37,37,0
8,22,2018,5,0,4,"Braga",4,"N14 Bosch",47,47,0,48,48,0
8,22,2018,5,0,4,"Braga",5,"Avenida João Paulo II",39,39,0,9,9,0
8,22,2018,5,0,4,"Braga",6,"Avenida Padre Júlio Fragata",67,67,0,83,83,0
8,22,2018,5,0,4,"Braga",7,"Rua Nova Santa Cruz",44,44,0,39,39,0
8,22,2018,5,0,4,"Braga",8,"Rua Costa Gomes",41,41,0,42,42,0
8,22,2018,6,0,4,"Braga",1,"Avenida da Liberdade",25,25,0,124,124,0
8,22,2018,6,0,4,"Braga",2,"Avenida Central",25,25,0,124,124,0
8,22,2018,6,0,4,"Braga",3,"Rua de Caires",36,36,0,37,37,0
8,22,2018,6,0,4,"Braga",4,"N14 Bosch",47,47,0,48,48,0
8,22,2018,6,0,4,"Braga",5,"Avenida João Paulo II",39,39,0,9,9,0
8,22,2018,6,0,4,"Braga",6,"Avenida Padre Júlio Fragata",67,67,0,83,83,0
8,22,2018,6,0,4,"Braga",7,"Rua Nova Santa Cruz",44,44,0,39,39,0
8,22,2018,6,0,4,"Braga",8,"Rua Costa Gomes",41,41,0,42,42,0
8,22,2018,7,0,4,"Braga",1,"Avenida da Liberdade",25,25,0,124,124,0
8,22,2018,7,0,4,"Braga",2,"Avenida Central",25,25,0,124,124,0
8,22,2018,7,0,4,"Braga",3,"Rua de Caires",36,36,0,37,37,0
8,22,2018,7,0,4,"Braga",4,"N14 Bosch",47,47,0,48,48,0
8,22,2018,7,0,4,"Braga",5,"Avenida João Paulo II",39,39,0,9,9,0
8,22,2018,7,0,4,"Braga",6,"Avenida Padre Júlio Fragata",67,67,0,83,83,0
8,22,2018,7,0,4,"Braga",7,"Rua Nova Santa Cruz",44,44,0,39,39,0
8,22,2018,7,0,4,"Braga",8,"Rua Costa Gomes",41,41,0,42,42,0
8,22,2018,8,0,4,"Braga",1,"Avenida da Liberdade",25,25,0,124,124,0
8,22,2018,8,0,4,"Braga",2,"Avenida Central",25,25,0,124,124,0
8,22,2018,8,0,4,"Braga",3,"Rua de Caires",25,36,11,54,37,17
8,22,2018,8,0,4,"Braga",4,"N14 Bosch",47,47,0,48,48,0
8,22,2018,8,0,4,"Braga",5,"Avenida João Paulo II",39,39,0,9,9,0
8,22,2018,8,0,4,"Braga",6,"Avenida Padre Júlio Fragata",67,67,0,83,83,0
8,22,2018,8,0,4,"Braga",7,"Rua Nova Santa Cruz",44,44,0,39,39,0
8,22,2018,8,0,4,"Braga",8,"Rua Costa Gomes",32,41,9,54,42,12
8,22,2018,9,0,4,"Braga",1,"Avenida da Liberdade",25,25,0,124,124,0
8,22,2018,9,0,4,"Braga",2,"Avenida Central",25,25,0,124,124,0
8,22,2018,9,0,4,"Braga",3,"Rua de Caires",23,36,13,59,37,22
8,22,2018,9,0,4,"Braga",4,"N14 Bosch",24,47,23,94,48,46
8,22,2018,9,0,4,"Braga",5,"Avenida João Paulo II",39,39,0,9,9,0
8,22,2018,9,0,4,"Braga",6,"Avenida Padre Júlio Fragata",67,67,0,83,83,0
8,22,2018,9,0,4,"Braga",7,"Rua Nova Santa Cruz",44,44,0,39,39,0
8,22,2018,9,0,4,"Braga",8,"Rua Costa Gomes",32,41,9,54,42,12
8,22,2018,10,0,4,"Braga",1,"Avenida da Liberdade",25,25,0,124,124,0
8,22,2018,10,0,4,"Braga",2,"Avenida Central",25,25,0,124,124,0
8,22,2018,10,0,4,"Braga",3,"Rua de Caires",24,36,12,56,37,19
8,22,2018,10,0,4,"Braga",4,"N14 Bosch",37,47,10,61,48,13
8,22,2018,10,0,4,"Braga",5,"Avenida João Paulo II",39,39,0,9,9,0
8,22,2018,10,0,4,"Braga",6,"Avenida Padre Júlio Fragata",67,67,0,83,83,0
8,22,2018,10,0,4,"Braga",7,"Rua Nova Santa Cruz",44,44,0,39,39,0
8,22,2018,10,0,4,"Braga",8,"Rua Costa Gomes",29,41,12,60,42,18
8,22,2018,11,0,4,"Braga",1,"Avenida da Liberdade",25,25,0,124,124,0
8,22,2018,11,0,4,"Braga",2,"Avenida Central",25,25,0,124,124,0
8,22,2018,11,0,4,"Braga",3,"Rua de Caires",36,36,0,37,37,0
8,22,2018,11,0,4,"Braga",4,"N14 Bosch",36,47,11,62,48,14
8,22,2018,11,0,4,"Braga",5,"Avenida João Paulo II",39,39,0,9,9,0
8,22,2018,11,0,4,"Braga",6,"Avenida Padre Júlio Fragata",67,67,0,83,83,0
8,22,2018,11,0,4,"Braga",7,"Rua Nova Santa Cruz",31,44,13,56,39,17
8,22,2018,11,0,4,"Braga",8,"Rua Costa Gomes",30,41,11,58,42,16
8,22,2018,12,0,4,"Braga",1,"Avenida da Liberdade",17,25,8,182,124,58
8,22,2018,12,0,4,"Braga",2,"Avenida Central",17,25,8,182,124,58
8,22,2018,12,0,4,"Braga",3,"Rua de Caires",36,36,0,37,37,0
8,22,2018,12,0,4,"Braga",4,"N14 Bosch",47,47,0,48,48,0
8,22,2018,12,0,4,"Braga",5,"Avenida João Paulo II",39,39,0,9,9,0
8,22,2018,12,0,4,"Braga",6,"Avenida Padre Júlio Fragata",67,67,0,83,83,0
8,22,2018,12,0,4,"Braga",7,"Rua Nova Santa Cruz",44,44,0,39,39,0
8,22,2018,12,0,4,"Braga",8,"Rua Costa Gomes",31,41,10,56,42,14
8,22,2018,13,0,4,"Braga",1,"Avenida da Liberdade",25,25,0,124,124,0
8,22,2018,13,0,4,"Braga",2,"Avenida Central",12,25,13,258,124,134
8,22,2018,13,0,4,"Braga",3,"Rua de Caires",36,36,0,37,37,0
8,22,2018,13,0,4,"Braga",4,"N14 Bosch",24,47,23,94,48,46
8,22,2018,13,0,4,"Braga",5,"Avenida João Paulo II",39,39,0,9,9,0
8,22,2018,13,0,4,"Braga",6,"Avenida Padre Júlio Fragata",67,67,0,83,83,0
8,22,2018,13,0,4,"Braga",7,"Rua Nova Santa Cruz",44,44,0,39,39,0
8,22,2018,13,0,4,"Braga",8,"Rua Costa Gomes",41,41,0,42,42,0
8,22,2018,14,0,4,"Braga",1,"Avenida da Liberdade",25,25,0,124,124,0
8,22,2018,14,0,4,"Braga",2,"Avenida Central",25,25,0,124,124,0
8,22,2018,14,0,4,"Braga",3,"Rua de Caires",36,36,0,37,37,0
8,22,2018,14,0,4,"Braga",4,"N14 Bosch",37,47,10,61,48,13
8,22,2018,14,0,4,"Braga",5,"Avenida João Paulo II",39,39,0,9,9,0
8,22,2018,14,0,4,"Braga",6,"Avenida Padre Júlio Fragata",67,67,0,83,83,0
8,22,2018,14,0,4,"Braga",7,"Rua Nova Santa Cruz",44,44,0,39,39,0
8,22,2018,14,0,4,"Braga",8,"Rua Costa Gomes",28,41,13,62,42,20
8,22,2018,15,0,4,"Braga",1,"Avenida da Liberdade",25,25,0,124,124,0
8,22,2018,15,0,4,"Braga",2,"Avenida Central",25,25,0,124,124,0
8,22,2018,15,0,4,"Braga",3,"Rua de Caires",36,36,0,37,37,0
8,22,2018,15,0,4,"Braga",4,"N14 Bosch",36,47,11,62,48,14
8,22,2018,15,0,4,"Braga",5,"Avenida João Paulo II",7,39,32,50,9,41
8,22,2018,15,0,4,"Braga",6,"Avenida Padre Júlio Fragata",51,67,16,109,83,26
8,22,2018,15,0,4,"Braga",7,"Rua Nova Santa Cruz",44,44,0,39,39,0
8,22,2018,15,0,4,"Braga",8,"Rua Costa Gomes",28,41,13,62,42,20
8,22,2018,16,0,4,"Braga",1,"Avenida da Liberdade",19,25,6,163,124,39
8,22,2018,16,0,4,"Braga",2,"Avenida Central",18,25,7,172,124,48
8,22,2018,16,0,4,"Braga",3,"Rua de Caires",26,36,10,52,37,15
8,22,2018,16,0,4,"Braga",4,"N14 Bosch",47,47,0,48,48,0
8,22,2018,16,0,4,"Braga",5,"Avenida João Paulo II",39,39,0,9,9,0
8,22,2018,16,0,4,"Braga",6,"Avenida Padre Júlio Fragata",67,67,0,83,83,0
8,22,2018,16,0,4,"Braga",7,"Rua Nova Santa Cruz",44,44,0,39,39,0
8,22,2018,16,0,4,"Braga",8,"Rua Costa Gomes",26,41,15,67,42,25
8,22,2018,17,0,4,"Braga",1,"Avenida da Liberdade",15,25,10,207,124,83
8,22,2018,17,0,4,"Braga",2,"Avenida Central",15,25,10,207,124,83
8,22,2018,17,0,4,"Braga",3,"Rua de Caires",36,36,0,37,37,0
8,22,2018,17,0,4,"Braga",4,"N14 Bosch",47,47,0,48,48,0
8,22,2018,17,0,4,"Braga",5,"Avenida João Paulo II",39,39,0,9,9,0
8,22,2018,17,0,4,"Braga",6,"Avenida Padre Júlio Fragata",52,67,15,107,83,24
8,22,2018,17,0,4,"Braga",7,"Rua Nova Santa Cruz",44,44,0,39,39,0
8,22,2018,17,0,4,"Braga",8,"Rua Costa Gomes",18,41,23,96,42,54
8,22,2018,18,0,4,"Braga",1,"Avenida da Liberdade",18,25,7,172,124,48
8,22,2018,18,0,4,"Braga",2,"Avenida Central",17,25,8,182,124,58
8,22,2018,18,0,4,"Braga",3,"Rua de Caires",28,36,8,48,37,11
8,22,2018,18,0,4,"Braga",4,"N14 Bosch",20,47,27,112,48,64
8,22,2018,18,0,4,"Braga",5,"Avenida João Paulo II",39,39,0,9,9,0
8,22,2018,18,0,4,"Braga",6,"Avenida Padre Júlio Fragata",46,67,21,121,83,38
8,22,2018,18,0,4,"Braga",7,"Rua Nova Santa Cruz",44,44,0,39,39,0
8,22,2018,18,0,4,"Braga",8,"Rua Costa Gomes",17,41,24,102,42,60
8,22,2018,19,0,4,"Braga",1,"Avenida da Liberdade",25,25,0,124,124,0
8,22,2018,19,0,4,"Braga",2,"Avenida Central",25,25,0,124,124,0
8,22,2018,19,0,4,"Braga",3,"Rua de Caires",36,36,0,37,37,0
8,22,2018,19,0,4,"Braga",4,"N14 Bosch",47,47,0,48,48,0
8,22,2018,19,0,4,"Braga",5,"Avenida João Paulo II",39,39,0,9,9,0
8,22,2018,19,0,4,"Braga",6,"Avenida Padre Júlio Fragata",67,67,0,83,83,0
8,22,2018,19,0,4,"Braga",7,"Rua Nova Santa Cruz",33,44,11,52,39,13
8,22,2018,19,0,4,"Braga",8,"Rua Costa Gomes",25,41,16,69,42,27
8,22,2018,20,0,4,"Braga",1,"Avenida da Liberdade",25,25,0,124,124,0
8,22,2018,20,0,4,"Braga",2,"Avenida Central",25,25,0,124,124,0
8,22,2018,20,0,4,"Braga",3,"Rua de Caires",36,36,0,37,37,0
8,22,2018,20,0,4,"Braga",4,"N14 Bosch",47,47,0,48,48,0
8,22,2018,20,0,4,"Braga",5,"Avenida João Paulo II",39,39,0,9,9,0
8,22,2018,20,0,4,"Braga",6,"Avenida Padre Júlio Fragata",67,67,0,83,83,0
8,22,2018,20,0,4,"Braga",7,"Rua Nova Santa Cruz",44,44,0,39,39,0
8,22,2018,20,0,4,"Braga",8,"Rua Costa Gomes",41,41,0,42,42,0
8,22,2018,21,0,4,"Braga",1,"Avenida da Liberdade",25,25,0,124,124,0
8,22,2018,21,0,4,"Braga",2,"Avenida Central",25,25,0,124,124,0
8,22,2018,21,0,4,"Braga",3,"Rua de Caires",36,36,0,37,37,0
8,22,2018,21,0,4,"Braga",4,"N14 Bosch",47,47,0,48,48,0
8,22,2018,21,0,4,"Braga",5,"Avenida João Paulo II",39,39,0,9,9,0
8,22,2018,21,0,4,"Braga",6,"Avenida Padre Júlio Fragata",67,67,0,83,83,0
8,22,2018,21,0,4,"Braga",7,"Rua Nova Santa Cruz",44,44,0,39,39,0
8,22,2018,21,0,4,"Braga",8,"Rua Costa Gomes",41,41,0,42,42,0
8,22,2018,22,0,4,"Braga",1,"Avenida da Liberdade",25,25,0,124,124,0
8,22,2018,22,0,4,"Braga",2,"Avenida Central",25,25,0,124,124,0
8,22,2018,22,0,4,"Braga",3,"Rua de Caires",36,36,0,37,37,0
8,22,2018,22,0,4,"Braga",4,"N14 Bosch",47,47,0,48,48,0
8,22,2018,22,0,4,"Braga",5,"Avenida João Paulo II",39,39,0,9,9,0
8,22,2018,22,0,4,"Braga",6,"Avenida Padre Júlio Fragata",67,67,0,83,83,0
8,22,2018,22,0,4,"Braga",7,"Rua Nova Santa Cruz",44,44,0,39,39,0
8,22,2018,22,0,4,"Braga",8,"Rua Costa Gomes",41,41,0,42,42,0
8,22,2018,23,0,4,"Braga",1,"Avenida da Liberdade",25,25,0,124,124,0
8,22,2018,23,0,4,"Braga",2,"Avenida Central",25,25,0,124,124,0
8,22,2018,23,0,4,"Braga",3,"Rua de Caires",27,36,9,50,37,13
8,22,2018,23,0,4,"Braga",4,"N14 Bosch",47,47,0,48,48,0
8,22,2018,23,0,4,"Braga",5,"Avenida João Paulo II",39,39,0,9,9,0
8,22,2018,23,0,4,"Braga",6,"Avenida Padre Júlio Fragata",67,67,0,83,83,0
8,22,2018,23,0,4,"Braga",7,"Rua Nova Santa Cruz",44,44,0,39,39,0
8,22,2018,23,0,4,"Braga",8,"Rua Costa Gomes",41,41,0,42,42,0
8,23,2018,0,0,5,"Braga",1,"Avenida da Liberdade",25,25,0,124,124,0
8,23,2018,0,0,5,"Braga",2,"Avenida Central",25,25,0,124,124,0
8,23,2018,0,0,5,"Braga",3,"Rua de Caires",36,36,0,37,37,0
8,23,2018,0,0,5,"Braga",4,"N14 Bosch",47,47,0,48,48,0
8,23,2018,0,0,5,"Braga",5,"Avenida João Paulo II",39,39,0,9,9,0
8,23,2018,0,0,5,"Braga",6,"Avenida Padre Júlio Fragata",67,67,0,83,83,0
8,23,2018,0,0,5,"Braga",7,"Rua Nova Santa Cruz",44,44,0,39,39,0
8,23,2018,0,0,5,"Braga",8,"Rua Costa Gomes",41,41,0,42,42,0
8,23,2018,1,0,5,"Braga",1,"Avenida da Liberdade",25,25,0,124,124,0
8,23,2018,1,0,5,"Braga",2,"Avenida Central",25,25,0,124,124,0
8,23,2018,1,0,5,"Braga",3,"Rua de Caires",36,36,0,37,37,0
8,23,2018,1,0,5,"Braga",4,"N14 Bosch",47,47,0,48,48,0
8,23,2018,1,0,5,"Braga",5,"Avenida João Paulo II",39,39,0,9,9,0
8,23,2018,1,0,5,"Braga",6,"Avenida Padre Júlio Fragata",67,67,0,83,83,0
8,23,2018,1,0,5,"Braga",7,"Rua Nova Santa Cruz",44,44,0,39,39,0
8,23,2018,1,0,5,"Braga",8,"Rua Costa Gomes",41,41,0,42,42,0
8,23,2018,2,0,5,"Braga",1,"Avenida da Liberdade",25,25,0,124,124,0
8,23,2018,2,0,5,"Braga",2,"Avenida Central",25,25,0,124,124,0
8,23,2018,2,0,5,"Braga",3,"Rua de Caires",36,36,0,37,37,0
8,23,2018,2,0,5,"Braga",4,"N14 Bosch",47,47,0,48,48,0
8,23,2018,2,0,5,"Braga",5,"Avenida João Paulo II",39,39,0,9,9,0
8,23,2018,2,0,5,"Braga",6,"Avenida Padre Júlio Fragata",67,67,0,83,83,0
8,23,2018,2,0,5,"Braga",7,"Rua Nova Santa Cruz",44,44,0,39,39,0
8,23,2018,2,0,5,"Braga",8,"Rua Costa Gomes",41,41,0,42,42,0
8,23,2018,3,0,5,"Braga",1,"Avenida da Liberdade",25,25,0,124,124,0
8,23,2018,3,0,5,"Braga",2,"Avenida Central",25,25,0,124,124,0
8,23,2018,3,0,5,"Braga",3,"Rua de Caires",36,36,0,37,37,0
8,23,2018,3,0,5,"Braga",4,"N14 Bosch",47,47,0,48,48,0
8,23,2018,3,0,5,"Braga",5,"Avenida João Paulo II",39,39,0,9,9,0
8,23,2018,3,0,5,"Braga",6,"Avenida Padre Júlio Fragata",67,67,0,83,83,0
8,23,2018,3,0,5,"Braga",7,"Rua Nova Santa Cruz",44,44,0,39,39,0
8,23,2018,3,0,5,"Braga",8,"Rua Costa Gomes",41,41,0,42,42,0
8,23,2018,4,0,5,"Braga",1,"Avenida da Liberdade",25,25,0,124,124,0
8,23,2018,4,0,5,"Braga",2,"Avenida Central",25,25,0,124,124,0
8,23,2018,4,0,5,"Braga",3,"Rua de Caires",36,36,0,37,37,0
8,23,2018,4,0,5,"Braga",4,"N14 Bosch",47,47,0,48,48,0
8,23,2018,4,0,5,"Braga",5,"Avenida João Paulo II",39,39,0,9,9,0
8,23,2018,4,0,5,"Braga",6,"Avenida Padre Júlio Fragata",67,67,0,83,83,0
8,23,2018,4,0,5,"Braga",7,"Rua Nova Santa Cruz",44,44,0,39,39,0
8,23,2018,4,0,5,"Braga",8,"Rua Costa Gomes",41,41,0,42,42,0
8,23,2018,5,0,5,"Braga",1,"Avenida da Liberdade",25,25,0,124,124,0
8,23,2018,5,0,5,"Braga",2,"Avenida Central",25,25,0,124,124,0
8,23,2018,5,0,5,"Braga",3,"Rua de Caires",36,36,0,37,37,0
8,23,2018,5,0,5,"Braga",4,"N14 Bosch",47,47,0,48,48,0
8,23,2018,5,0,5,"Braga",5,"Avenida João Paulo II",39,39,0,9,9,0
8,23,2018,5,0,5,"Braga",6,"Avenida Padre Júlio Fragata",67,67,0,83,83,0
8,23,2018,5,0,5,"Braga",7,"Rua Nova Santa Cruz",44,44,0,39,39,0
8,23,2018,5,0,5,"Braga",8,"Rua Costa Gomes",41,41,0,42,42,0
8,23,2018,6,0,5,"Braga",1,"Avenida da Liberdade",25,25,0,124,124,0
8,23,2018,6,0,5,"Braga",2,"Avenida Central",25,25,0,124,124,0
8,23,2018,6,0,5,"Braga",3,"Rua de Caires",36,36,0,37,37,0
8,23,2018,6,0,5,"Braga",4,"N14 Bosch",47,47,0,48,48,0
8,23,2018,6,0,5,"Braga",5,"Avenida João Paulo II",39,39,0,9,9,0
8,23,2018,6,0,5,"Braga",6,"Avenida Padre Júlio Fragata",67,67,0,83,83,0
8,23,2018,6,0,5,"Braga",7,"Rua Nova Santa Cruz",44,44,0,39,39,0
8,23,2018,6,0,5,"Braga",8,"Rua Costa Gomes",41,41,0,42,42,0
8,23,2018,7,0,5,"Braga",1,"Avenida da Liberdade",25,25,0,124,124,0
8,23,2018,7,0,5,"Braga",2,"Avenida Central",25,25,0,124,124,0
8,23,2018,7,0,5,"Braga",3,"Rua de Caires",36,36,0,37,37,0
8,23,2018,7,0,5,"Braga",4,"N14 Bosch",47,47,0,48,48,0
8,23,2018,7,0,5,"Braga",5,"Avenida João Paulo II",39,39,0,9,9,0
8,23,2018,7,0,5,"Braga",6,"Avenida Padre Júlio Fragata",67,67,0,83,83,0
8,23,2018,7,0,5,"Braga",7,"Rua Nova Santa Cruz",44,44,0,39,39,0
8,23,2018,7,0,5,"Braga",8,"Rua Costa Gomes",41,41,0,42,42,0
8,23,2018,8,0,5,"Braga",1,"Avenida da Liberdade",25,25,0,124,124,0
8,23,2018,8,0,5,"Braga",2,"Avenida Central",25,25,0,124,124,0
8,23,2018,8,0,5,"Braga",3,"Rua de Caires",36,36,0,37,37,0
8,23,2018,8,0,5,"Braga",4,"N14 Bosch",47,47,0,48,48,0
8,23,2018,8,0,5,"Braga",5,"Avenida João Paulo II",39,39,0,9,9,0
8,23,2018,8,0,5,"Braga",6,"Avenida Padre Júlio Fragata",67,67,0,83,83,0
8,23,2018,8,0,5,"Braga",7,"Rua Nova Santa Cruz",28,44,16,62,39,23
8,23,2018,8,0,5,"Braga",8,"Rua Costa Gomes",32,41,9,54,42,12
8,23,2018,9,0,5,"Braga",1,"Avenida da Liberdade",25,25,0,124,124,0
8,23,2018,9,0,5,"Braga",2,"Avenida Central",25,25,0,124,124,0
8,23,2018,9,0,5,"Braga",3,"Rua de Caires",22,36,14,61,37,24
8,23,2018,9,0,5,"Braga",4,"N14 Bosch",36,47,11,62,48,14
8,23,2018,9,0,5,"Braga",5,"Avenida João Paulo II",39,39,0,9,9,0
8,23,2018,9,0,5,"Braga",6,"Avenida Padre Júlio Fragata",67,67,0,83,83,0
8,23,2018,9,0,5,"Braga",7,"Rua Nova Santa Cruz",44,44,0,39,39,0
8,23,2018,9,0,5,"Braga",8,"Rua Costa Gomes",41,41,0,42,42,0
8,23,2018,10,0,5,"Braga",1,"Avenida da Liberdade",25,25,0,124,124,0
8,23,2018,10,0,5,"Braga",2,"Avenida Central",25,25,0,124,124,0
8,23,2018,10,0,5,"Braga",3,"Rua de Caires",28,36,8,48,37,11
8,23,2018,10,0,5,"Braga",4,"N14 Bosch",33,47,14,68,48,20
8,23,2018,10,0,5,"Braga",5,"Avenida João Paulo II",29,39,10,12,9,3
8,23,2018,10,0,5,"Braga",6,"Avenida Padre Júlio Fragata",67,67,0,83,83,0
8,23,2018,10,0,5,"Braga",7,"Rua Nova Santa Cruz",44,44,0,39,39,0
8,23,2018,10,0,5,"Braga",8,"Rua Costa Gomes",41,41,0,42,42,0
8,23,2018,11,0,5,"Braga",1,"Avenida da Liberdade",18,25,7,172,124,48
8,23,2018,11,0,5,"Braga",2,"Avenida Central",18,25,7,172,124,48
8,23,2018,11,0,5,"Braga",3,"Rua de Caires",36,36,0,37,37,0
8,23,2018,11,0,5,"Braga",4,"N14 Bosch",26,47,21,86,48,38
8,23,2018,11,0,5,"Braga",5,"Avenida João Paulo II",39,39,0,9,9,0
8,23,2018,11,0,5,"Braga",6,"Avenida Padre Júlio Fragata",67,67,0,83,83,0
8,23,2018,11,0,5,"Braga",7,"Rua Nova Santa Cruz",44,44,0,39,39,0
8,23,2018,11,0,5,"Braga",8,"Rua Costa Gomes",30,41,11,58,42,16
8,23,2018,12,0,5,"Braga",1,"Avenida da Liberdade",25,25,0,124,124,0
8,23,2018,12,0,5,"Braga",2,"Avenida Central",25,25,0,124,124,0
8,23,2018,12,0,5,"Braga",3,"Rua de Caires",36,36,0,37,37,0
8,23,2018,12,0,5,"Braga",4,"N14 Bosch",35,47,12,64,48,16
8,23,2018,12,0,5,"Braga",5,"Avenida João Paulo II",25,39,14,14,9,5
8,23,2018,12,0,5,"Braga",6,"Avenida Padre Júlio Fragata",51,67,16,109,83,26
8,23,2018,12,0,5,"Braga",7,"Rua Nova Santa Cruz",44,44,0,39,39,0
8,23,2018,12,0,5,"Braga",8,"Rua Costa Gomes",31,41,10,56,42,14
8,23,2018,13,0,5,"Braga",1,"Avenida da Liberdade",25,25,0,124,124,0
8,23,2018,13,0,5,"Braga",2,"Avenida Central",25,25,0,124,124,0
8,23,2018,13,0,5,"Braga",3,"Rua de Caires",36,36,0,37,37,0
8,23,2018,13,0,5,"Braga",4,"N14 Bosch",28,47,19,80,48,32
8,23,2018,13,0,5,"Braga",5,"Avenida João Paulo II",39,39,0,9,9,0
8,23,2018,13,0,5,"Braga",6,"Avenida Padre Júlio Fragata",67,67,0,83,83,0
8,23,2018,13,0,5,"Braga",7,"Rua Nova Santa Cruz",44,44,0,39,39,0
8,23,2018,13,0,5,"Braga",8,"Rua Costa Gomes",32,41,9,54,42,12
8,23,2018,14,0,5,"Braga",1,"Avenida da Liberdade",25,25,0,124,124,0
8,23,2018,14,0,5,"Braga",2,"Avenida Central",25,25,0,124,124,0
8,23,2018,14,0,5,"Braga",3,"Rua de Caires",26,36,10,52,37,15
8,23,2018,14,0,5,"Braga",4,"N14 Bosch",47,47,0,48,48,0
8,23,2018,14,0,5,"Braga",5,"Avenida João Paulo II",26,39,13,13,9,4
8,23,2018,14,0,5,"Braga",6,"Avenida Padre Júlio Fragata",41,67,26,136,83,53
8,23,2018,14,0,5,"Braga",7,"Rua Nova Santa Cruz",44,44,0,39,39,0
8,23,2018,14,0,5,"Braga",8,"Rua Costa Gomes",41,41,0,42,42,0
8,23,2018,15,0,5,"Braga",1,"Avenida da Liberdade",20,25,5,155,124,31
8,23,2018,15,0,5,"Braga",2,"Avenida Central",20,25,5,155,124,31
8,23,2018,15,0,5,"Braga",3,"Rua de Caires",36,36,0,37,37,0
8,23,2018,15,0,5,"Braga",4,"N14 Bosch",31,47,16,72,48,24
8,23,2018,15,0,5,"Braga",5,"Avenida João Paulo II",30,39,9,12,9,3
8,23,2018,15,0,5,"Braga",6,"Avenida Padre Júlio Fragata",67,67,0,83,83,0
8,23,2018,15,0,5,"Braga",7,"Rua Nova Santa Cruz",31,44,13,56,39,17
8,23,2018,15,0,5,"Braga",8,"Rua Costa Gomes",27,41,14,64,42,22
8,23,2018,16,0,5,"Braga",1,"Avenida da Liberdade",19,25,6,163,124,39
8,23,2018,16,0,5,"Braga",2,"Avenida Central",19,25,6,163,124,39
8,23,2018,16,0,5,"Braga",3,"Rua de Caires",36,36,0,37,37,0
8,23,2018,16,0,5,"Braga",4,"N14 Bosch",36,47,11,62,48,14
8,23,2018,16,0,5,"Braga",5,"Avenida João Paulo II",39,39,0,9,9,0
8,23,2018,16,0,5,"Braga",6,"Avenida Padre Júlio Fragata",67,67,0,83,83,0
8,23,2018,16,0,5,"Braga",7,"Rua Nova Santa Cruz",44,44,0,39,39,0
8,23,2018,16,0,5,"Braga",8,"Rua Costa Gomes",30,41,11,58,42,16
8,23,2018,17,0,5,"Braga",1,"Avenida da Liberdade",18,25,7,172,124,48
8,23,2018,17,0,5,"Braga",2,"Avenida Central",18,25,7,172,124,48
8,23,2018,17,0,5,"Braga",3,"Rua de Caires",25,36,11,54,37,17
8,23,2018,17,0,5,"Braga",4,"N14 Bosch",26,47,21,86,48,38
8,23,2018,17,0,5,"Braga",5,"Avenida João Paulo II",39,39,0,9,9,0
8,23,2018,17,0,5,"Braga",6,"Avenida Padre Júlio Fragata",47,67,20,119,83,36
8,23,2018,17,0,5,"Braga",7,"Rua Nova Santa Cruz",28,44,16,62,39,23
8,23,2018,17,0,5,"Braga",8,"Rua Costa Gomes",17,41,24,102,42,60
8,23,2018,18,0,5,"Braga",1,"Avenida da Liberdade",19,25,6,163,124,39
8,23,2018,18,0,5,"Braga",2,"Avenida Central",19,25,6,163,124,39
8,23,2018,18,0,5,"Braga",3,"Rua de Caires",26,36,10,52,37,15
8,23,2018,18,0,5,"Braga",4,"N14 Bosch",31,47,16,72,48,24
8,23,2018,18,0,5,"Braga",5,"Avenida João Paulo II",23,39,16,15,9,6
8,23,2018,18,0,5,"Braga",6,"Avenida Padre Júlio Fragata",37,67,30,151,83,68
8,23,2018,18,0,5,"Braga",7,"Rua Nova Santa Cruz",44,44,0,39,39,0
8,23,2018,18,0,5,"Braga",8,"Rua Costa Gomes",18,41,23,96,42,54
8,23,2018,19,0,5,"Braga",1,"Avenida da Liberdade",25,25,0,124,124,0
8,23,2018,19,0,5,"Braga",2,"Avenida Central",25,25,0,124,124,0
8,23,2018,19,0,5,"Braga",3,"Rua de Caires",36,36,0,37,37,0
8,23,2018,19,0,5,"Braga",4,"N14 Bosch",36,47,11,62,48,14
8,23,2018,19,0,5,"Braga",5,"Avenida João Paulo II",39,39,0,9,9,0
8,23,2018,19,0,5,"Braga",6,"Avenida Padre Júlio Fragata",32,67,35,174,83,91
8,23,2018,19,0,5,"Braga",7,"Rua Nova Santa Cruz",44,44,0,39,39,0
8,23,2018,19,0,5,"Braga",8,"Rua Costa Gomes",26,41,15,67,42,25
8,23,2018,20,0,5,"Braga",1,"Avenida da Liberdade",25,25,0,124,124,0
8,23,2018,20,0,5,"Braga",2,"Avenida Central",25,25,0,124,124,0
8,23,2018,20,0,5,"Braga",3,"Rua de Caires",28,36,8,48,37,11
8,23,2018,20,0,5,"Braga",4,"N14 Bosch",47,47,0,48,48,0
8,23,2018,20,0,5,"Braga",5,"Avenida João Paulo II",39,39,0,9,9,0
8,23,2018,20,0,5,"Braga",6,"Avenida Padre Júlio Fragata",67,67,0,83,83,0
8,23,2018,20,0,5,"Braga",7,"Rua Nova Santa Cruz",44,44,0,39,39,0
8,23,2018,20,0,5,"Braga",8,"Rua Costa Gomes",25,41,16,69,42,27
8,23,2018,21,0,5,"Braga",1,"Avenida da Liberdade",25,25,0,124,124,0
8,23,2018,21,0,5,"Braga",2,"Avenida Central",25,25,0,124,124,0
8,23,2018,21,0,5,"Braga",3,"Rua de Caires",36,36,0,37,37,0
8,23,2018,21,0,5,"Braga",4,"N14 Bosch",47,47,0,48,48,0
8,23,2018,21,0,5,"Braga",5,"Avenida João Paulo II",39,39,0,9,9,0
8,23,2018,21,0,5,"Braga",6,"Avenida Padre Júlio Fragata",53,67,14,105,83,22
8,23,2018,21,0,5,"Braga",7,"Rua Nova Santa Cruz",44,44,0,39,39,0
8,23,2018,21,0,5,"Braga",8,"Rua Costa Gomes",41,41,0,42,42,0
8,23,2018,22,0,5,"Braga",1,"Avenida da Liberdade",15,25,10,207,124,83
8,23,2018,22,0,5,"Braga",2,"Avenida Central",15,25,10,207,124,83
8,23,2018,22,0,5,"Braga",3,"Rua de Caires",36,36,0,37,37,0
8,23,2018,22,0,5,"Braga",4,"N14 Bosch",47,47,0,48,48,0
8,23,2018,22,0,5,"Braga",5,"Avenida João Paulo II",39,39,0,9,9,0
8,23,2018,22,0,5,"Braga",6,"Avenida Padre Júlio Fragata",67,67,0,83,83,0
8,23,2018,22,0,5,"Braga",7,"Rua Nova Santa Cruz",44,44,0,39,39,0
8,23,2018,22,0,5,"Braga",8,"Rua Costa Gomes",41,41,0,42,42,0
8,23,2018,23,0,5,"Braga",1,"Avenida da Liberdade",25,25,0,124,124,0
8,23,2018,23,0,5,"Braga",2,"Avenida Central",25,25,0,124,124,0
8,23,2018,23,0,5,"Braga",3,"Rua de Caires",36,36,0,37,37,0
8,23,2018,23,0,5,"Braga",4,"N14 Bosch",47,47,0,48,48,0
8,23,2018,23,0,5,"Braga",5,"Avenida João Paulo II",39,39,0,9,9,0
8,23,2018,23,0,5,"Braga",6,"Avenida Padre Júlio Fragata",67,67,0,83,83,0
8,23,2018,23,0,5,"Braga",7,"Rua Nova Santa Cruz",44,44,0,39,39,0
8,23,2018,23,0,5,"Braga",8,"Rua Costa Gomes",41,41,0,42,42,0
8,24,2018,0,0,6,"Braga",1,"Avenida da Liberdade",25,25,0,124,124,0
8,24,2018,0,0,6,"Braga",2,"Avenida Central",25,25,0,124,124,0
8,24,2018,0,0,6,"Braga",3,"Rua de Caires",36,36,0,37,37,0
8,24,2018,0,0,6,"Braga",4,"N14 Bosch",47,47,0,48,48,0
8,24,2018,0,0,6,"Braga",5,"Avenida João Paulo II",39,39,0,9,9,0
8,24,2018,0,0,6,"Braga",6,"Avenida Padre Júlio Fragata",67,67,0,83,83,0
8,24,2018,0,0,6,"Braga",7,"Rua Nova Santa Cruz",44,44,0,39,39,0
8,24,2018,0,0,6,"Braga",8,"Rua Costa Gomes",41,41,0,42,42,0
8,24,2018,1,0,6,"Braga",1,"Avenida da Liberdade",25,25,0,124,124,0
8,24,2018,1,0,6,"Braga",2,"Avenida Central",25,25,0,124,124,0
8,24,2018,1,0,6,"Braga",3,"Rua de Caires",36,36,0,37,37,0
8,24,2018,1,0,6,"Braga",4,"N14 Bosch",47,47,0,48,48,0
8,24,2018,1,0,6,"Braga",5,"Avenida João Paulo II",39,39,0,9,9,0
8,24,2018,1,0,6,"Braga",6,"Avenida Padre Júlio Fragata",67,67,0,83,83,0
8,24,2018,1,0,6,"Braga",7,"Rua Nova Santa Cruz",44,44,0,39,39,0
8,24,2018,1,0,6,"Braga",8,"Rua Costa Gomes",41,41,0,42,42,0
8,24,2018,2,0,6,"Braga",1,"Avenida da Liberdade",25,25,0,124,124,0
8,24,2018,2,0,6,"Braga",2,"Avenida Central",25,25,0,124,124,0
8,24,2018,2,0,6,"Braga",3,"Rua de Caires",36,36,0,37,37,0
8,24,2018,2,0,6,"Braga",4,"N14 Bosch",47,47,0,48,48,0
8,24,2018,2,0,6,"Braga",5,"Avenida João Paulo II",39,39,0,9,9,0
8,24,2018,2,0,6,"Braga",6,"Avenida Padre Júlio Fragata",67,67,0,83,83,0
8,24,2018,2,0,6,"Braga",7,"Rua Nova Santa Cruz",44,44,0,39,39,0
8,24,2018,2,0,6,"Braga",8,"Rua Costa Gomes",41,41,0,42,42,0
8,24,2018,3,0,6,"Braga",1,"Avenida da Liberdade",25,25,0,124,124,0
8,24,2018,3,0,6,"Braga",2,"Avenida Central",25,25,0,124,124,0
8,24,2018,3,0,6,"Braga",3,"Rua de Caires",36,36,0,37,37,0
8,24,2018,3,0,6,"Braga",4,"N14 Bosch",47,47,0,48,48,0
8,24,2018,3,0,6,"Braga",5,"Avenida João Paulo II",39,39,0,9,9,0
8,24,2018,3,0,6,"Braga",6,"Avenida Padre Júlio Fragata",67,67,0,83,83,0
8,24,2018,3,0,6,"Braga",7,"Rua Nova Santa Cruz",44,44,0,39,39,0
8,24,2018,3,0,6,"Braga",8,"Rua Costa Gomes",41,41,0,42,42,0
8,24,2018,4,0,6,"Braga",1,"Avenida da Liberdade",25,25,0,124,124,0
8,24,2018,4,0,6,"Braga",2,"Avenida Central",25,25,0,124,124,0
8,24,2018,4,0,6,"Braga",3,"Rua de Caires",36,36,0,37,37,0
8,24,2018,4,0,6,"Braga",4,"N14 Bosch",47,47,0,48,48,0
8,24,2018,4,0,6,"Braga",5,"Avenida João Paulo II",39,39,0,9,9,0
8,24,2018,4,0,6,"Braga",6,"Avenida Padre Júlio Fragata",67,67,0,83,83,0
8,24,2018,4,0,6,"Braga",7,"Rua Nova Santa Cruz",44,44,0,39,39,0
8,24,2018,4,0,6,"Braga",8,"Rua Costa Gomes",41,41,0,42,42,0
8,24,2018,5,0,6,"Braga",1,"Avenida da Liberdade",25,25,0,124,124,0
8,24,2018,5,0,6,"Braga",2,"Avenida Central",25,25,0,124,124,0
8,24,2018,5,0,6,"Braga",3,"Rua de Caires",36,36,0,37,37,0
8,24,2018,5,0,6,"Braga",4,"N14 Bosch",47,47,0,48,48,0
8,24,2018,5,0,6,"Braga",5,"Avenida João Paulo II",39,39,0,9,9,0
8,24,2018,5,0,6,"Braga",6,"Avenida Padre Júlio Fragata",67,67,0,83,83,0
8,24,2018,5,0,6,"Braga",7,"Rua Nova Santa Cruz",44,44,0,39,39,0
8,24,2018,5,0,6,"Braga",8,"Rua Costa Gomes",41,41,0,42,42,0
8,24,2018,6,0,6,"Braga",1,"Avenida da Liberdade",25,25,0,124,124,0
8,24,2018,6,0,6,"Braga",2,"Avenida Central",25,25,0,124,124,0
8,24,2018,6,0,6,"Braga",3,"Rua de Caires",36,36,0,37,37,0
8,24,2018,6,0,6,"Braga",4,"N14 Bosch",47,47,0,48,48,0
8,24,2018,6,0,6,"Braga",5,"Avenida João Paulo II",39,39,0,9,9,0
8,24,2018,6,0,6,"Braga",6,"Avenida Padre Júlio Fragata",67,67,0,83,83,0
8,24,2018,6,0,6,"Braga",7,"Rua Nova Santa Cruz",44,44,0,39,39,0
8,24,2018,6,0,6,"Braga",8,"Rua Costa Gomes",41,41,0,42,42,0
8,24,2018,7,0,6,"Braga",1,"Avenida da Liberdade",25,25,0,124,124,0
8,24,2018,7,0,6,"Braga",2,"Avenida Central",25,25,0,124,124,0
8,24,2018,7,0,6,"Braga",3,"Rua de Caires",36,36,0,37,37,0
8,24,2018,7,0,6,"Braga",4,"N14 Bosch",47,47,0,48,48,0
8,24,2018,7,0,6,"Braga",5,"Avenida João Paulo II",39,39,0,9,9,0
8,24,2018,7,0,6,"Braga",6,"Avenida Padre Júlio Fragata",67,67,0,83,83,0
8,24,2018,7,0,6,"Braga",7,"Rua Nova Santa Cruz",30,44,14,58,39,19
8,24,2018,7,0,6,"Braga",8,"Rua Costa Gomes",41,41,0,42,42,0
8,24,2018,8,0,6,"Braga",1,"Avenida da Liberdade",25,25,0,124,124,0
8,24,2018,8,0,6,"Braga",2,"Avenida Central",25,25,0,124,124,0
8,24,2018,8,0,6,"Braga",3,"Rua de Caires",28,36,8,48,37,11
8,24,2018,8,0,6,"Braga",4,"N14 Bosch",35,47,12,64,48,16
8,24,2018,8,0,6,"Braga",5,"Avenida João Paulo II",39,39,0,9,9,0
8,24,2018,8,0,6,"Braga",6,"Avenida Padre Júlio Fragata",67,67,0,83,83,0
8,24,2018,8,0,6,"Braga",7,"Rua Nova Santa Cruz",44,44,0,39,39,0
8,24,2018,8,0,6,"Braga",8,"Rua Costa Gomes",41,41,0,42,42,0
8,24,2018,9,0,6,"Braga",1,"Avenida da Liberdade",25,25,0,124,124,0
8,24,2018,9,0,6,"Braga",2,"Avenida Central",25,25,0,124,124,0
8,24,2018,9,0,6,"Braga",3,"Rua de Caires",25,36,11,54,37,17
8,24,2018,9,0,6,"Braga",4,"N14 Bosch",47,47,0,48,48,0
8,24,2018,9,0,6,"Braga",5,"Avenida João Paulo II",39,39,0,9,9,0
8,24,2018,9,0,6,"Braga",6,"Avenida Padre Júlio Fragata",67,67,0,83,83,0
8,24,2018,9,0,6,"Braga",7,"Rua Nova Santa Cruz",44,44,0,39,39,0
8,24,2018,9,0,6,"Braga",8,"Rua Costa Gomes",29,41,12,60,42,18
8,24,2018,10,0,6,"Braga",1,"Avenida da Liberdade",19,25,6,163,124,39
8,24,2018,10,0,6,"Braga",2,"Avenida Central",19,25,6,163,124,39
8,24,2018,10,0,6,"Braga",3,"Rua de Caires",27,36,9,50,37,13
8,24,2018,10,0,6,"Braga",4,"N14 Bosch",25,47,22,90,48,42
8,24,2018,10,0,6,"Braga",5,"Avenida João Paulo II",39,39,0,9,9,0
8,24,2018,10,0,6,"Braga",6,"Avenida Padre Júlio Fragata",67,67,0,83,83,0
8,24,2018,10,0,6,"Braga",7,"Rua Nova Santa Cruz",44,44,0,39,39,0
8,24,2018,10,0,6,"Braga",8,"Rua Costa Gomes",41,41,0,42,42,0
8,24,2018,11,0,6,"Braga",1,"Avenida da Liberdade",25,25,0,124,124,0
8,24,2018,11,0,6,"Braga",2,"Avenida Central",25,25,0,124,124,0
8,24,2018,11,0,6,"Braga",3,"Rua de Caires",24,36,12,56,37,19
8,24,2018,11,0,6,"Braga",4,"N14 Bosch",31,47,16,72,48,24
8,24,2018,11,0,6,"Braga",5,"Avenida João Paulo II",39,39,0,9,9,0
8,24,2018,11,0,6,"Braga",6,"Avenida Padre Júlio Fragata",67,67,0,83,83,0
8,24,2018,11,0,6,"Braga",7,"Rua Nova Santa Cruz",44,44,0,39,39,0
8,24,2018,11,0,6,"Braga",8,"Rua Costa Gomes",32,41,9,54,42,12
8,24,2018,12,0,6,"Braga",1,"Avenida da Liberdade",25,25,0,124,124,0
8,24,2018,12,0,6,"Braga",2,"Avenida Central",25,25,0,124,124,0
8,24,2018,12,0,6,"Braga",3,"Rua de Caires",36,36,0,37,37,0
8,24,2018,12,0,6,"Braga",4,"N14 Bosch",47,47,0,48,48,0
8,24,2018,12,0,6,"Braga",5,"Avenida João Paulo II",39,39,0,9,9,0
8,24,2018,12,0,6,"Braga",6,"Avenida Padre Júlio Fragata",67,67,0,83,83,0
8,24,2018,12,0,6,"Braga",7,"Rua Nova Santa Cruz",44,44,0,39,39,0
8,24,2018,12,0,6,"Braga",8,"Rua Costa Gomes",32,41,9,54,42,12
8,24,2018,13,0,6,"Braga",1,"Avenida da Liberdade",25,25,0,124,124,0
8,24,2018,13,0,6,"Braga",2,"Avenida Central",25,25,0,124,124,0
8,24,2018,13,0,6,"Braga",3,"Rua de Caires",26,36,10,52,37,15
8,24,2018,13,0,6,"Braga",4,"N14 Bosch",34,47,13,66,48,18
8,24,2018,13,0,6,"Braga",5,"Avenida João Paulo II",39,39,0,9,9,0
8,24,2018,13,0,6,"Braga",6,"Avenida Padre Júlio Fragata",67,67,0,83,83,0
8,24,2018,13,0,6,"Braga",7,"Rua Nova Santa Cruz",44,44,0,39,39,0
8,24,2018,13,0,6,"Braga",8,"Rua Costa Gomes",41,41,0,42,42,0
8,24,2018,14,0,6,"Braga",1,"Avenida da Liberdade",12,25,13,258,124,134
8,24,2018,14,0,6,"Braga",2,"Avenida Central",12,25,13,258,124,134
8,24,2018,14,0,6,"Braga",3,"Rua de Caires",36,36,0,37,37,0
8,24,2018,14,0,6,"Braga",4,"N14 Bosch",28,47,19,80,48,32
8,24,2018,14,0,6,"Braga",5,"Avenida João Paulo II",29,39,10,12,9,3
8,24,2018,14,0,6,"Braga",6,"Avenida Padre Júlio Fragata",51,67,16,109,83,26
8,24,2018,14,0,6,"Braga",7,"Rua Nova Santa Cruz",44,44,0,39,39,0
8,24,2018,14,0,6,"Braga",8,"Rua Costa Gomes",41,41,0,42,42,0
8,24,2018,15,0,6,"Braga",1,"Avenida da Liberdade",25,25,0,124,124,0
8,24,2018,15,0,6,"Braga",2,"Avenida Central",25,25,0,124,124,0
8,24,2018,15,0,6,"Braga",3,"Rua de Caires",36,36,0,37,37,0
8,24,2018,15,0,6,"Braga",4,"N14 Bosch",33,47,14,68,48,20
8,24,2018,15,0,6,"Braga",5,"Avenida João Paulo II",39,39,0,9,9,0
8,24,2018,15,0,6,"Braga",6,"Avenida Padre Júlio Fragata",49,67,18,114,83,31
8,24,2018,15,0,6,"Braga",7,"Rua Nova Santa Cruz",44,44,0,39,39,0
8,24,2018,15,0,6,"Braga",8,"Rua Costa Gomes",29,41,12,60,42,18
8,24,2018,16,0,6,"Braga",1,"Avenida da Liberdade",14,25,11,221,124,97
8,24,2018,16,0,6,"Braga",2,"Avenida Central",14,25,11,221,124,97
8,24,2018,16,0,6,"Braga",3,"Rua de Caires",27,36,9,50,37,13
8,24,2018,16,0,6,"Braga",4,"N14 Bosch",28,47,19,80,48,32
8,24,2018,16,0,6,"Braga",5,"Avenida João Paulo II",27,39,12,13,9,4
8,24,2018,16,0,6,"Braga",6,"Avenida Padre Júlio Fragata",67,67,0,83,83,0
8,24,2018,16,0,6,"Braga",7,"Rua Nova Santa Cruz",23,44,21,75,39,36
8,24,2018,16,0,6,"Braga",8,"Rua Costa Gomes",24,41,17,72,42,30
8,24,2018,17,0,6,"Braga",1,"Avenida da Liberdade",19,25,6,163,124,39
8,24,2018,17,0,6,"Braga",2,"Avenida Central",19,25,6,163,124,39
8,24,2018,17,0,6,"Braga",3,"Rua de Caires",27,36,9,50,37,13
8,24,2018,17,0,6,"Braga",4,"N14 Bosch",28,47,19,80,48,32
8,24,2018,17,0,6,"Braga",5,"Avenida João Paulo II",21,39,18,17,9,8
8,24,2018,17,0,6,"Braga",6,"Avenida Padre Júlio Fragata",67,67,0,83,83,0
8,24,2018,17,0,6,"Braga",7,"Rua Nova Santa Cruz",44,44,0,39,39,0
8,24,2018,17,0,6,"Braga",8,"Rua Costa Gomes",20,41,21,87,42,45
8,24,2018,18,0,6,"Braga",1,"Avenida da Liberdade",25,25,0,124,124,0
8,24,2018,18,0,6,"Braga",2,"Avenida Central",25,25,0,124,124,0
8,24,2018,18,0,6,"Braga",3,"Rua de Caires",36,36,0,37,37,0
8,24,2018,18,0,6,"Braga",4,"N14 Bosch",35,47,12,64,48,16
8,24,2018,18,0,6,"Braga",5,"Avenida João Paulo II",39,39,0,9,9,0
8,24,2018,18,0,6,"Braga",6,"Avenida Padre Júlio Fragata",45,67,22,124,83,41
8,24,2018,18,0,6,"Braga",7,"Rua Nova Santa Cruz",44,44,0,39,39,0
8,24,2018,18,0,6,"Braga",8,"Rua Costa Gomes",19,41,22,91,42,49
8,24,2018,19,0,6,"Braga",1,"Avenida da Liberdade",18,25,7,172,124,48
8,24,2018,19,0,6,"Braga",2,"Avenida Central",18,25,7,172,124,48
8,24,2018,19,0,6,"Braga",3,"Rua de Caires",36,36,0,37,37,0
8,24,2018,19,0,6,"Braga",4,"N14 Bosch",47,47,0,48,48,0
8,24,2018,19,0,6,"Braga",5,"Avenida João Paulo II",39,39,0,9,9,0
8,24,2018,19,0,6,"Braga",6,"Avenida Padre Júlio Fragata",46,67,21,121,83,38
8,24,2018,19,0,6,"Braga",7,"Rua Nova Santa Cruz",44,44,0,39,39,0
8,24,2018,19,0,6,"Braga",8,"Rua Costa Gomes",0,41,41,-1,42,-43
8,24,2018,20,0,6,"Braga",1,"Avenida da Liberdade",25,25,0,124,124,0
8,24,2018,20,0,6,"Braga",2,"Avenida Central",25,25,0,124,124,0
8,24,2018,20,0,6,"Braga",3,"Rua de Caires",36,36,0,37,37,0
8,24,2018,20,0,6,"Braga",4,"N14 Bosch",33,47,14,68,48,20
8,24,2018,20,0,6,"Braga",5,"Avenida João Paulo II",39,39,0,9,9,0
8,24,2018,20,0,6,"Braga",6,"Avenida Padre Júlio Fragata",67,67,0,83,83,0
8,24,2018,20,0,6,"Braga",7,"Rua Nova Santa Cruz",44,44,0,39,39,0
8,24,2018,20,0,6,"Braga",8,"Rua Costa Gomes",0,41,41,-1,42,-43
8,24,2018,21,0,6,"Braga",1,"Avenida da Liberdade",15,25,10,207,124,83
8,24,2018,21,0,6,"Braga",2,"Avenida Central",15,25,10,207,124,83
8,24,2018,21,0,6,"Braga",3,"Rua de Caires",27,36,9,50,37,13
8,24,2018,21,0,6,"Braga",4,"N14 Bosch",47,47,0,48,48,0
8,24,2018,21,0,6,"Braga",5,"Avenida João Paulo II",39,39,0,9,9,0
8,24,2018,21,0,6,"Braga",6,"Avenida Padre Júlio Fragata",67,67,0,83,83,0
8,24,2018,21,0,6,"Braga",7,"Rua Nova Santa Cruz",44,44,0,39,39,0
8,24,2018,21,0,6,"Braga",8,"Rua Costa Gomes",0,41,41,-1,42,-43
8,24,2018,22,0,6,"Braga",1,"Avenida da Liberdade",25,25,0,124,124,0
8,24,2018,22,0,6,"Braga",2,"Avenida Central",25,25,0,124,124,0
8,24,2018,22,0,6,"Braga",3,"Rua de Caires",36,36,0,37,37,0
8,24,2018,22,0,6,"Braga",4,"N14 Bosch",47,47,0,48,48,0
8,24,2018,22,0,6,"Braga",5,"Avenida João Paulo II",39,39,0,9,9,0
8,24,2018,22,0,6,"Braga",6,"Avenida Padre Júlio Fragata",67,67,0,83,83,0
8,24,2018,22,0,6,"Braga",7,"Rua Nova Santa Cruz",44,44,0,39,39,0
8,24,2018,22,0,6,"Braga",8,"Rua Costa Gomes",0,41,41,-1,42,-43
8,24,2018,23,0,6,"Braga",1,"Avenida da Liberdade",19,25,6,163,124,39
8,24,2018,23,0,6,"Braga",2,"Avenida Central",19,25,6,163,124,39
8,24,2018,23,0,6,"Braga",3,"Rua de Caires",28,36,8,48,37,11
8,24,2018,23,0,6,"Braga",4,"N14 Bosch",47,47,0,48,48,0
8,24,2018,23,0,6,"Braga",5,"Avenida João Paulo II",39,39,0,9,9,0
8,24,2018,23,0,6,"Braga",6,"Avenida Padre Júlio Fragata",67,67,0,83,83,0
8,24,2018,23,0,6,"Braga",7,"Rua Nova Santa Cruz",44,44,0,39,39,0
8,24,2018,23,0,6,"Braga",8,"Rua Costa Gomes",0,41,41,-1,42,-43
8,25,2018,0,0,7,"Braga",1,"Avenida da Liberdade",25,25,0,124,124,0
8,25,2018,0,0,7,"Braga",2,"Avenida Central",25,25,0,124,124,0
8,25,2018,0,0,7,"Braga",3,"Rua de Caires",36,36,0,37,37,0
8,25,2018,0,0,7,"Braga",4,"N14 Bosch",47,47,0,48,48,0
8,25,2018,0,0,7,"Braga",5,"Avenida João Paulo II",39,39,0,9,9,0
8,25,2018,0,0,7,"Braga",6,"Avenida Padre Júlio Fragata",67,67,0,83,83,0
8,25,2018,0,0,7,"Braga",7,"Rua Nova Santa Cruz",44,44,0,39,39,0
8,25,2018,0,0,7,"Braga",8,"Rua Costa Gomes",0,41,41,-1,42,-43
8,25,2018,1,0,7,"Braga",1,"Avenida da Liberdade",25,25,0,124,124,0
8,25,2018,1,0,7,"Braga",2,"Avenida Central",25,25,0,124,124,0
8,25,2018,1,0,7,"Braga",3,"Rua de Caires",36,36,0,37,37,0
8,25,2018,1,0,7,"Braga",4,"N14 Bosch",47,47,0,48,48,0
8,25,2018,1,0,7,"Braga",5,"Avenida João Paulo II",39,39,0,9,9,0
8,25,2018,1,0,7,"Braga",6,"Avenida Padre Júlio Fragata",67,67,0,83,83,0
8,25,2018,1,0,7,"Braga",7,"Rua Nova Santa Cruz",44,44,0,39,39,0
8,25,2018,1,0,7,"Braga",8,"Rua Costa Gomes",0,41,41,-1,42,-43
8,25,2018,2,0,7,"Braga",1,"Avenida da Liberdade",25,25,0,124,124,0
8,25,2018,2,0,7,"Braga",2,"Avenida Central",25,25,0,124,124,0
8,25,2018,2,0,7,"Braga",3,"Rua de Caires",36,36,0,37,37,0
8,25,2018,2,0,7,"Braga",4,"N14 Bosch",47,47,0,48,48,0
8,25,2018,2,0,7,"Braga",5,"Avenida João Paulo II",39,39,0,9,9,0
8,25,2018,2,0,7,"Braga",6,"Avenida Padre Júlio Fragata",67,67,0,83,83,0
8,25,2018,2,0,7,"Braga",7,"Rua Nova Santa Cruz",44,44,0,39,39,0
8,25,2018,2,0,7,"Braga",8,"Rua Costa Gomes",0,41,41,-1,42,-43
8,25,2018,3,0,7,"Braga",1,"Avenida da Liberdade",25,25,0,124,124,0
8,25,2018,3,0,7,"Braga",2,"Avenida Central",25,25,0,124,124,0
8,25,2018,3,0,7,"Braga",3,"Rua de Caires",36,36,0,37,37,0
8,25,2018,3,0,7,"Braga",4,"N14 Bosch",47,47,0,48,48,0
8,25,2018,3,0,7,"Braga",5,"Avenida João Paulo II",39,39,0,9,9,0
8,25,2018,3,0,7,"Braga",6,"Avenida Padre Júlio Fragata",67,67,0,83,83,0
8,25,2018,3,0,7,"Braga",7,"Rua Nova Santa Cruz",44,44,0,39,39,0
8,25,2018,3,0,7,"Braga",8,"Rua Costa Gomes",0,41,41,-1,42,-43
8,25,2018,4,0,7,"Braga",1,"Avenida da Liberdade",25,25,0,124,124,0
8,25,2018,4,0,7,"Braga",2,"Avenida Central",25,25,0,124,124,0
8,25,2018,4,0,7,"Braga",3,"Rua de Caires",36,36,0,37,37,0
8,25,2018,4,0,7,"Braga",4,"N14 Bosch",47,47,0,48,48,0
8,25,2018,4,0,7,"Braga",5,"Avenida João Paulo II",39,39,0,9,9,0
8,25,2018,4,0,7,"Braga",6,"Avenida Padre Júlio Fragata",67,67,0,83,83,0
8,25,2018,4,0,7,"Braga",7,"Rua Nova Santa Cruz",44,44,0,39,39,0
8,25,2018,4,0,7,"Braga",8,"Rua Costa Gomes",0,41,41,-1,42,-43
8,25,2018,5,0,7,"Braga",1,"Avenida da Liberdade",25,25,0,124,124,0
8,25,2018,5,0,7,"Braga",2,"Avenida Central",25,25,0,124,124,0
8,25,2018,5,0,7,"Braga",3,"Rua de Caires",36,36,0,37,37,0
8,25,2018,5,0,7,"Braga",4,"N14 Bosch",47,47,0,48,48,0
8,25,2018,5,0,7,"Braga",5,"Avenida João Paulo II",39,39,0,9,9,0
8,25,2018,5,0,7,"Braga",6,"Avenida Padre Júlio Fragata",67,67,0,83,83,0
8,25,2018,5,0,7,"Braga",7,"Rua Nova Santa Cruz",44,44,0,39,39,0
8,25,2018,5,0,7,"Braga",8,"Rua Costa Gomes",0,41,41,-1,42,-43
8,25,2018,6,0,7,"Braga",1,"Avenida da Liberdade",25,25,0,124,124,0
8,25,2018,6,0,7,"Braga",2,"Avenida Central",25,25,0,124,124,0
8,25,2018,6,0,7,"Braga",3,"Rua de Caires",36,36,0,37,37,0
8,25,2018,6,0,7,"Braga",4,"N14 Bosch",47,47,0,48,48,0
8,25,2018,6,0,7,"Braga",5,"Avenida João Paulo II",39,39,0,9,9,0
8,25,2018,6,0,7,"Braga",6,"Avenida Padre Júlio Fragata",67,67,0,83,83,0
8,25,2018,6,0,7,"Braga",7,"Rua Nova Santa Cruz",44,44,0,39,39,0
8,25,2018,6,0,7,"Braga",8,"Rua Costa Gomes",0,41,41,-1,42,-43
8,25,2018,7,0,7,"Braga",1,"Avenida da Liberdade",25,25,0,124,124,0
8,25,2018,7,0,7,"Braga",2,"Avenida Central",25,25,0,124,124,0
8,25,2018,7,0,7,"Braga",3,"Rua de Caires",36,36,0,37,37,0
8,25,2018,7,0,7,"Braga",4,"N14 Bosch",47,47,0,48,48,0
8,25,2018,7,0,7,"Braga",5,"Avenida João Paulo II",39,39,0,9,9,0
8,25,2018,7,0,7,"Braga",6,"Avenida Padre Júlio Fragata",67,67,0,83,83,0
8,25,2018,7,0,7,"Braga",7,"Rua Nova Santa Cruz",44,44,0,39,39,0
8,25,2018,7,0,7,"Braga",8,"Rua Costa Gomes",0,41,41,-1,42,-43
8,25,2018,8,0,7,"Braga",1,"Avenida da Liberdade",25,25,0,124,124,0
8,25,2018,8,0,7,"Braga",2,"Avenida Central",25,25,0,124,124,0
8,25,2018,8,0,7,"Braga",3,"Rua de Caires",36,36,0,37,37,0
8,25,2018,8,0,7,"Braga",4,"N14 Bosch",47,47,0,48,48,0
8,25,2018,8,0,7,"Braga",5,"Avenida João Paulo II",39,39,0,9,9,0
8,25,2018,8,0,7,"Braga",6,"Avenida Padre Júlio Fragata",67,67,0,83,83,0
8,25,2018,8,0,7,"Braga",7,"Rua Nova Santa Cruz",44,44,0,39,39,0
8,25,2018,8,0,7,"Braga",8,"Rua Costa Gomes",0,41,41,-1,42,-43
8,25,2018,11,0,7,"Braga",1,"Avenida da Liberdade",25,25,0,124,124,0
8,25,2018,11,0,7,"Braga",2,"Avenida Central",25,25,0,124,124,0
8,25,2018,11,0,7,"Braga",3,"Rua de Caires",20,36,16,67,37,30
8,25,2018,11,0,7,"Braga",4,"N14 Bosch",47,47,0,48,48,0
8,25,2018,11,0,7,"Braga",5,"Avenida João Paulo II",31,39,8,11,9,2
8,25,2018,11,0,7,"Braga",6,"Avenida Padre Júlio Fragata",67,67,0,83,83,0
8,25,2018,11,0,7,"Braga",7,"Rua Nova Santa Cruz",44,44,0,39,39,0
8,25,2018,11,0,7,"Braga",8,"Rua Costa Gomes",0,41,41,-1,42,-43
8,25,2018,12,0,7,"Braga",1,"Avenida da Liberdade",25,25,0,124,124,0
8,25,2018,12,0,7,"Braga",2,"Avenida Central",25,25,0,124,124,0
8,25,2018,12,0,7,"Braga",3,"Rua de Caires",27,36,9,50,37,13
8,25,2018,12,0,7,"Braga",4,"N14 Bosch",29,47,18,77,48,29
8,25,2018,12,0,7,"Braga",5,"Avenida João Paulo II",39,39,0,9,9,0
8,25,2018,12,0,7,"Braga",6,"Avenida Padre Júlio Fragata",67,67,0,83,83,0
8,25,2018,12,0,7,"Braga",7,"Rua Nova Santa Cruz",44,44,0,39,39,0
8,25,2018,12,0,7,"Braga",8,"Rua Costa Gomes",0,41,41,-1,42,-43
8,25,2018,13,0,7,"Braga",1,"Avenida da Liberdade",25,25,0,124,124,0
8,25,2018,13,0,7,"Braga",2,"Avenida Central",25,25,0,124,124,0
8,25,2018,13,0,7,"Braga",3,"Rua de Caires",36,36,0,37,37,0
8,25,2018,13,0,7,"Braga",4,"N14 Bosch",47,47,0,48,48,0
8,25,2018,13,0,7,"Braga",5,"Avenida João Paulo II",39,39,0,9,9,0
8,25,2018,13,0,7,"Braga",6,"Avenida Padre Júlio Fragata",67,67,0,83,83,0
8,25,2018,13,0,7,"Braga",7,"Rua Nova Santa Cruz",44,44,0,39,39,0
8,25,2018,13,0,7,"Braga",8,"Rua Costa Gomes",0,41,41,-1,42,-43
8,25,2018,14,0,7,"Braga",1,"Avenida da Liberdade",25,25,0,124,124,0
8,25,2018,14,0,7,"Braga",2,"Avenida Central",25,25,0,124,124,0
8,25,2018,14,0,7,"Braga",3,"Rua de Caires",27,36,9,50,37,13
8,25,2018,14,0,7,"Braga",4,"N14 Bosch",24,47,23,94,48,46
8,25,2018,14,0,7,"Braga",5,"Avenida João Paulo II",39,39,0,9,9,0
8,25,2018,14,0,7,"Braga",6,"Avenida Padre Júlio Fragata",67,67,0,83,83,0
8,25,2018,14,0,7,"Braga",7,"Rua Nova Santa Cruz",44,44,0,39,39,0
8,25,2018,14,0,7,"Braga",8,"Rua Costa Gomes",0,41,41,-1,42,-43
8,25,2018,15,0,7,"Braga",1,"Avenida da Liberdade",19,25,6,163,124,39
8,25,2018,15,0,7,"Braga",2,"Avenida Central",19,25,6,163,124,39
8,25,2018,15,0,7,"Braga",3,"Rua de Caires",17,36,19,79,37,42
8,25,2018,15,0,7,"Braga",4,"N14 Bosch",47,47,0,48,48,0
8,25,2018,15,0,7,"Braga",5,"Avenida João Paulo II",30,39,9,12,9,3
8,25,2018,15,0,7,"Braga",6,"Avenida Padre Júlio Fragata",67,67,0,83,83,0
8,25,2018,15,0,7,"Braga",7,"Rua Nova Santa Cruz",44,44,0,39,39,0
8,25,2018,15,0,7,"Braga",8,"Rua Costa Gomes",0,41,41,-1,42,-43
8,25,2018,16,0,7,"Braga",1,"Avenida da Liberdade",16,25,9,194,124,70
8,25,2018,16,0,7,"Braga",2,"Avenida Central",16,25,9,194,124,70
8,25,2018,16,0,7,"Braga",3,"Rua de Caires",36,36,0,37,37,0
8,25,2018,16,0,7,"Braga",4,"N14 Bosch",47,47,0,48,48,0
8,25,2018,16,0,7,"Braga",5,"Avenida João Paulo II",31,39,8,11,9,2
8,25,2018,16,0,7,"Braga",6,"Avenida Padre Júlio Fragata",67,67,0,83,83,0
8,25,2018,16,0,7,"Braga",7,"Rua Nova Santa Cruz",44,44,0,39,39,0
8,25,2018,16,0,7,"Braga",8,"Rua Costa Gomes",0,41,41,-1,42,-43
8,25,2018,17,0,7,"Braga",1,"Avenida da Liberdade",25,25,0,124,124,0
8,25,2018,17,0,7,"Braga",2,"Avenida Central",25,25,0,124,124,0
8,25,2018,17,0,7,"Braga",3,"Rua de Caires",36,36,0,37,37,0
8,25,2018,17,0,7,"Braga",4,"N14 Bosch",47,47,0,48,48,0
8,25,2018,17,0,7,"Braga",5,"Avenida João Paulo II",39,39,0,9,9,0
8,25,2018,17,0,7,"Braga",6,"Avenida Padre Júlio Fragata",67,67,0,83,83,0
8,25,2018,17,0,7,"Braga",7,"Rua Nova Santa Cruz",44,44,0,39,39,0
8,25,2018,17,0,7,"Braga",8,"Rua Costa Gomes",0,41,41,-1,42,-43
8,25,2018,18,0,7,"Braga",1,"Avenida da Liberdade",25,25,0,124,124,0
8,25,2018,18,0,7,"Braga",2,"Avenida Central",25,25,0,124,124,0
8,25,2018,18,0,7,"Braga",3,"Rua de Caires",36,36,0,37,37,0
8,25,2018,18,0,7,"Braga",4,"N14 Bosch",47,47,0,48,48,0
8,25,2018,18,0,7,"Braga",5,"Avenida João Paulo II",39,39,0,9,9,0
8,25,2018,18,0,7,"Braga",6,"Avenida Padre Júlio Fragata",67,67,0,83,83,0
8,25,2018,18,0,7,"Braga",7,"Rua Nova Santa Cruz",44,44,0,39,39,0
8,25,2018,18,0,7,"Braga",8,"Rua Costa Gomes",0,41,41,-1,42,-43
8,25,2018,19,0,7,"Braga",1,"Avenida da Liberdade",25,25,0,124,124,0
8,25,2018,19,0,7,"Braga",2,"Avenida Central",25,25,0,124,124,0
8,25,2018,19,0,7,"Braga",3,"Rua de Caires",36,36,0,37,37,0
8,25,2018,19,0,7,"Braga",4,"N14 Bosch",47,47,0,48,48,0
8,25,2018,19,0,7,"Braga",5,"Avenida João Paulo II",39,39,0,9,9,0
8,25,2018,19,0,7,"Braga",6,"Avenida Padre Júlio Fragata",67,67,0,83,83,0
8,25,2018,19,0,7,"Braga",7,"Rua Nova Santa Cruz",44,44,0,39,39,0
8,25,2018,19,0,7,"Braga",8,"Rua Costa Gomes",0,41,41,-1,42,-43
8,25,2018,20,0,7,"Braga",1,"Avenida da Liberdade",25,25,0,124,124,0
8,25,2018,20,0,7,"Braga",2,"Avenida Central",25,25,0,124,124,0
8,25,2018,20,0,7,"Braga",3,"Rua de Caires",36,36,0,37,37,0
8,25,2018,20,0,7,"Braga",4,"N14 Bosch",47,47,0,48,48,0
8,25,2018,20,0,7,"Braga",5,"Avenida João Paulo II",39,39,0,9,9,0
8,25,2018,20,0,7,"Braga",6,"Avenida Padre Júlio Fragata",67,67,0,83,83,0
8,25,2018,20,0,7,"Braga",7,"Rua Nova Santa Cruz",44,44,0,39,39,0
8,25,2018,20,0,7,"Braga",8,"Rua Costa Gomes",0,41,41,-1,42,-43
8,25,2018,21,0,7,"Braga",1,"Avenida da Liberdade",25,25,0,124,124,0
8,25,2018,21,0,7,"Braga",2,"Avenida Central",25,25,0,124,124,0
8,25,2018,21,0,7,"Braga",3,"Rua de Caires",36,36,0,37,37,0
8,25,2018,21,0,7,"Braga",4,"N14 Bosch",47,47,0,48,48,0
8,25,2018,21,0,7,"Braga",5,"Avenida João Paulo II",39,39,0,9,9,0
8,25,2018,21,0,7,"Braga",6,"Avenida Padre Júlio Fragata",67,67,0,83,83,0
8,25,2018,21,0,7,"Braga",7,"Rua Nova Santa Cruz",44,44,0,39,39,0
8,25,2018,21,0,7,"Braga",8,"Rua Costa Gomes",0,41,41,-1,42,-43
8,25,2018,22,0,7,"Braga",1,"Avenida da Liberdade",25,25,0,124,124,0
8,25,2018,22,0,7,"Braga",2,"Avenida Central",25,25,0,124,124,0
8,25,2018,22,0,7,"Braga",3,"Rua de Caires",36,36,0,37,37,0
8,25,2018,22,0,7,"Braga",4,"N14 Bosch",47,47,0,48,48,0
8,25,2018,22,0,7,"Braga",5,"Avenida João Paulo II",39,39,0,9,9,0
8,25,2018,22,0,7,"Braga",6,"Avenida Padre Júlio Fragata",67,67,0,83,83,0
8,25,2018,22,0,7,"Braga",7,"Rua Nova Santa Cruz",44,44,0,39,39,0
8,25,2018,22,0,7,"Braga",8,"Rua Costa Gomes",0,41,41,-1,42,-43
8,25,2018,23,0,7,"Braga",1,"Avenida da Liberdade",25,25,0,124,124,0
8,25,2018,23,0,7,"Braga",2,"Avenida Central",25,25,0,124,124,0
8,25,2018,23,0,7,"Braga",3,"Rua de Caires",36,36,0,37,37,0
8,25,2018,23,0,7,"Braga",4,"N14 Bosch",47,47,0,48,48,0
8,25,2018,23,0,7,"Braga",5,"Avenida João Paulo II",39,39,0,9,9,0
8,25,2018,23,0,7,"Braga",6,"Avenida Padre Júlio Fragata",67,67,0,83,83,0
8,25,2018,23,0,7,"Braga",7,"Rua Nova Santa Cruz",44,44,0,39,39,0
8,25,2018,23,0,7,"Braga",8,"Rua Costa Gomes",0,41,41,-1,42,-43
8,26,2018,0,0,8,"Braga",1,"Avenida da Liberdade",25,25,0,124,124,0
8,26,2018,0,0,8,"Braga",2,"Avenida Central",25,25,0,124,124,0
8,26,2018,0,0,8,"Braga",3,"Rua de Caires",36,36,0,37,37,0
8,26,2018,0,0,8,"Braga",4,"N14 Bosch",47,47,0,48,48,0
8,26,2018,0,0,8,"Braga",5,"Avenida João Paulo II",39,39,0,9,9,0
8,26,2018,0,0,8,"Braga",6,"Avenida Padre Júlio Fragata",67,67,0,83,83,0
8,26,2018,0,0,8,"Braga",7,"Rua Nova Santa Cruz",35,44,9,49,39,10
8,26,2018,0,0,8,"Braga",8,"Rua Costa Gomes",0,41,41,-1,42,-43
8,26,2018,1,0,8,"Braga",1,"Avenida da Liberdade",25,25,0,124,124,0
8,26,2018,1,0,8,"Braga",2,"Avenida Central",25,25,0,124,124,0
8,26,2018,1,0,8,"Braga",3,"Rua de Caires",36,36,0,37,37,0
8,26,2018,1,0,8,"Braga",4,"N14 Bosch",47,47,0,48,48,0
8,26,2018,1,0,8,"Braga",5,"Avenida João Paulo II",39,39,0,9,9,0
8,26,2018,1,0,8,"Braga",6,"Avenida Padre Júlio Fragata",67,67,0,83,83,0
8,26,2018,1,0,8,"Braga",7,"Rua Nova Santa Cruz",44,44,0,39,39,0
8,26,2018,1,0,8,"Braga",8,"Rua Costa Gomes",0,41,41,-1,42,-43
8,26,2018,2,0,8,"Braga",1,"Avenida da Liberdade",25,25,0,124,124,0
8,26,2018,2,0,8,"Braga",2,"Avenida Central",25,25,0,124,124,0
8,26,2018,2,0,8,"Braga",3,"Rua de Caires",36,36,0,37,37,0
8,26,2018,2,0,8,"Braga",4,"N14 Bosch",47,47,0,48,48,0
8,26,2018,2,0,8,"Braga",5,"Avenida João Paulo II",39,39,0,9,9,0
8,26,2018,2,0,8,"Braga",6,"Avenida Padre Júlio Fragata",67,67,0,83,83,0
8,26,2018,2,0,8,"Braga",7,"Rua Nova Santa Cruz",44,44,0,39,39,0
8,26,2018,2,0,8,"Braga",8,"Rua Costa Gomes",0,41,41,-1,42,-43
8,26,2018,3,0,8,"Braga",1,"Avenida da Liberdade",25,25,0,124,124,0
8,26,2018,3,0,8,"Braga",2,"Avenida Central",25,25,0,124,124,0
8,26,2018,3,0,8,"Braga",3,"Rua de Caires",36,36,0,37,37,0
8,26,2018,3,0,8,"Braga",4,"N14 Bosch",47,47,0,48,48,0
8,26,2018,3,0,8,"Braga",5,"Avenida João Paulo II",39,39,0,9,9,0
8,26,2018,3,0,8,"Braga",6,"Avenida Padre Júlio Fragata",67,67,0,83,83,0
8,26,2018,3,0,8,"Braga",7,"Rua Nova Santa Cruz",44,44,0,39,39,0
8,26,2018,3,0,8,"Braga",8,"Rua Costa Gomes",0,41,41,-1,42,-43
8,26,2018,4,0,8,"Braga",1,"Avenida da Liberdade",25,25,0,124,124,0
8,26,2018,4,0,8,"Braga",2,"Avenida Central",25,25,0,124,124,0
8,26,2018,4,0,8,"Braga",3,"Rua de Caires",36,36,0,37,37,0
8,26,2018,4,0,8,"Braga",4,"N14 Bosch",47,47,0,48,48,0
8,26,2018,4,0,8,"Braga",5,"Avenida João Paulo II",39,39,0,9,9,0
8,26,2018,4,0,8,"Braga",6,"Avenida Padre Júlio Fragata",67,67,0,83,83,0
8,26,2018,4,0,8,"Braga",7,"Rua Nova Santa Cruz",44,44,0,39,39,0
8,26,2018,4,0,8,"Braga",8,"Rua Costa Gomes",0,41,41,-1,42,-43
8,26,2018,5,0,8,"Braga",1,"Avenida da Liberdade",25,25,0,124,124,0
8,26,2018,5,0,8,"Braga",2,"Avenida Central",25,25,0,124,124,0
8,26,2018,5,0,8,"Braga",3,"Rua de Caires",36,36,0,37,37,0
8,26,2018,5,0,8,"Braga",4,"N14 Bosch",47,47,0,48,48,0
8,26,2018,5,0,8,"Braga",5,"Avenida João Paulo II",39,39,0,9,9,0
8,26,2018,5,0,8,"Braga",6,"Avenida Padre Júlio Fragata",67,67,0,83,83,0
8,26,2018,5,0,8,"Braga",7,"Rua Nova Santa Cruz",44,44,0,39,39,0
8,26,2018,5,0,8,"Braga",8,"Rua Costa Gomes",0,41,41,-1,42,-43
8,26,2018,6,0,8,"Braga",1,"Avenida da Liberdade",25,25,0,124,124,0
8,26,2018,6,0,8,"Braga",2,"Avenida Central",25,25,0,124,124,0
8,26,2018,6,0,8,"Braga",3,"Rua de Caires",36,36,0,37,37,0
8,26,2018,6,0,8,"Braga",4,"N14 Bosch",47,47,0,48,48,0
8,26,2018,6,0,8,"Braga",5,"Avenida João Paulo II",39,39,0,9,9,0
8,26,2018,6,0,8,"Braga",6,"Avenida Padre Júlio Fragata",67,67,0,83,83,0
8,26,2018,6,0,8,"Braga",7,"Rua Nova Santa Cruz",44,44,0,39,39,0
8,26,2018,6,0,8,"Braga",8,"Rua Costa Gomes",0,41,41,-1,42,-43
8,26,2018,7,0,8,"Braga",1,"Avenida da Liberdade",25,25,0,124,124,0
8,26,2018,7,0,8,"Braga",2,"Avenida Central",25,25,0,124,124,0
8,26,2018,7,0,8,"Braga",3,"Rua de Caires",36,36,0,37,37,0
8,26,2018,7,0,8,"Braga",4,"N14 Bosch",47,47,0,48,48,0
8,26,2018,7,0,8,"Braga",5,"Avenida João Paulo II",39,39,0,9,9,0
8,26,2018,7,0,8,"Braga",6,"Avenida Padre Júlio Fragata",67,67,0,83,83,0
8,26,2018,7,0,8,"Braga",7,"Rua Nova Santa Cruz",44,44,0,39,39,0
8,26,2018,7,0,8,"Braga",8,"Rua Costa Gomes",0,41,41,-1,42,-43
8,26,2018,8,0,8,"Braga",1,"Avenida da Liberdade",25,25,0,124,124,0
8,26,2018,8,0,8,"Braga",2,"Avenida Central",25,25,0,124,124,0
8,26,2018,8,0,8,"Braga",3,"Rua de Caires",36,36,0,37,37,0
8,26,2018,8,0,8,"Braga",4,"N14 Bosch",47,47,0,48,48,0
8,26,2018,8,0,8,"Braga",5,"Avenida João Paulo II",39,39,0,9,9,0
8,26,2018,8,0,8,"Braga",6,"Avenida Padre Júlio Fragata",67,67,0,83,83,0
8,26,2018,8,0,8,"Braga",7,"Rua Nova Santa Cruz",44,44,0,39,39,0
8,26,2018,8,0,8,"Braga",8,"Rua Costa Gomes",0,41,41,-1,42,-43
8,26,2018,9,0,8,"Braga",1,"Avenida da Liberdade",25,25,0,124,124,0
8,26,2018,9,0,8,"Braga",2,"Avenida Central",25,25,0,124,124,0
8,26,2018,9,0,8,"Braga",3,"Rua de Caires",36,36,0,37,37,0
8,26,2018,9,0,8,"Braga",4,"N14 Bosch",47,47,0,48,48,0
8,26,2018,9,0,8,"Braga",5,"Avenida João Paulo II",39,39,0,9,9,0
8,26,2018,9,0,8,"Braga",6,"Avenida Padre Júlio Fragata",67,67,0,83,83,0
8,26,2018,9,0,8,"Braga",7,"Rua Nova Santa Cruz",44,44,0,39,39,0
8,26,2018,9,0,8,"Braga",8,"Rua Costa Gomes",0,41,41,-1,42,-43
8,26,2018,10,0,8,"Braga",1,"Avenida da Liberdade",25,25,0,124,124,0
8,26,2018,10,0,8,"Braga",2,"Avenida Central",25,25,0,124,124,0
8,26,2018,10,0,8,"Braga",3,"Rua de Caires",36,36,0,37,37,0
8,26,2018,10,0,8,"Braga",4,"N14 Bosch",47,47,0,48,48,0
8,26,2018,10,0,8,"Braga",5,"Avenida João Paulo II",39,39,0,9,9,0
8,26,2018,10,0,8,"Braga",6,"Avenida Padre Júlio Fragata",67,67,0,83,83,0
8,26,2018,10,0,8,"Braga",7,"Rua Nova Santa Cruz",44,44,0,39,39,0
8,26,2018,10,0,8,"Braga",8,"Rua Costa Gomes",0,41,41,-1,42,-43
8,26,2018,11,0,8,"Braga",1,"Avenida da Liberdade",25,25,0,124,124,0
8,26,2018,11,0,8,"Braga",2,"Avenida Central",25,25,0,124,124,0
8,26,2018,11,0,8,"Braga",3,"Rua de Caires",26,36,10,52,37,15
8,26,2018,11,0,8,"Braga",4,"N14 Bosch",47,47,0,48,48,0
8,26,2018,11,0,8,"Braga",5,"Avenida João Paulo II",25,39,14,14,9,5
8,26,2018,11,0,8,"Braga",6,"Avenida Padre Júlio Fragata",67,67,0,83,83,0
8,26,2018,11,0,8,"Braga",7,"Rua Nova Santa Cruz",44,44,0,39,39,0
8,26,2018,11,0,8,"Braga",8,"Rua Costa Gomes",0,41,41,-1,42,-43
8,26,2018,12,0,8,"Braga",1,"Avenida da Liberdade",25,25,0,124,124,0
8,26,2018,12,0,8,"Braga",2,"Avenida Central",25,25,0,124,124,0
8,26,2018,12,0,8,"Braga",3,"Rua de Caires",36,36,0,37,37,0
8,26,2018,12,0,8,"Braga",4,"N14 Bosch",47,47,0,48,48,0
8,26,2018,12,0,8,"Braga",5,"Avenida João Paulo II",39,39,0,9,9,0
8,26,2018,12,0,8,"Braga",6,"Avenida Padre Júlio Fragata",67,67,0,83,83,0
8,26,2018,12,0,8,"Braga",7,"Rua Nova Santa Cruz",44,44,0,39,39,0
8,26,2018,12,0,8,"Braga",8,"Rua Costa Gomes",0,41,41,-1,42,-43
8,26,2018,13,0,8,"Braga",1,"Avenida da Liberdade",25,25,0,124,124,0
8,26,2018,13,0,8,"Braga",2,"Avenida Central",25,25,0,124,124,0
8,26,2018,13,0,8,"Braga",3,"Rua de Caires",36,36,0,37,37,0
8,26,2018,13,0,8,"Braga",4,"N14 Bosch",47,47,0,48,48,0
8,26,2018,13,0,8,"Braga",5,"Avenida João Paulo II",39,39,0,9,9,0
8,26,2018,13,0,8,"Braga",6,"Avenida Padre Júlio Fragata",67,67,0,83,83,0
8,26,2018,13,0,8,"Braga",7,"Rua Nova Santa Cruz",44,44,0,39,39,0
8,26,2018,13,0,8,"Braga",8,"Rua Costa Gomes",0,41,41,-1,42,-43
8,26,2018,14,0,8,"Braga",1,"Avenida da Liberdade",25,25,0,124,124,0
8,26,2018,14,0,8,"Braga",2,"Avenida Central",25,25,0,124,124,0
8,26,2018,14,0,8,"Braga",3,"Rua de Caires",36,36,0,37,37,0
8,26,2018,14,0,8,"Braga",4,"N14 Bosch",47,47,0,48,48,0
8,26,2018,14,0,8,"Braga",5,"Avenida João Paulo II",39,39,0,9,9,0
8,26,2018,14,0,8,"Braga",6,"Avenida Padre Júlio Fragata",67,67,0,83,83,0
8,26,2018,14,0,8,"Braga",7,"Rua Nova Santa Cruz",44,44,0,39,39,0
8,26,2018,14,0,8,"Braga",8,"Rua Costa Gomes",0,41,41,-1,42,-43
8,26,2018,15,0,8,"Braga",1,"Avenida da Liberdade",25,25,0,124,124,0
8,26,2018,15,0,8,"Braga",2,"Avenida Central",25,25,0,124,124,0
8,26,2018,15,0,8,"Braga",3,"Rua de Caires",36,36,0,37,37,0
8,26,2018,15,0,8,"Braga",4,"N14 Bosch",47,47,0,48,48,0
8,26,2018,15,0,8,"Braga",5,"Avenida João Paulo II",39,39,0,9,9,0
8,26,2018,15,0,8,"Braga",6,"Avenida Padre Júlio Fragata",67,67,0,83,83,0
8,26,2018,15,0,8,"Braga",7,"Rua Nova Santa Cruz",44,44,0,39,39,0
8,26,2018,15,0,8,"Braga",8,"Rua Costa Gomes",0,41,41,-1,42,-43
8,26,2018,16,0,8,"Braga",1,"Avenida da Liberdade",25,25,0,124,124,0
8,26,2018,16,0,8,"Braga",2,"Avenida Central",25,25,0,124,124,0
8,26,2018,16,0,8,"Braga",3,"Rua de Caires",36,36,0,37,37,0
8,26,2018,16,0,8,"Braga",4,"N14 Bosch",47,47,0,48,48,0
8,26,2018,16,0,8,"Braga",5,"Avenida João Paulo II",39,39,0,9,9,0
8,26,2018,16,0,8,"Braga",6,"Avenida Padre Júlio Fragata",67,67,0,83,83,0
8,26,2018,16,0,8,"Braga",7,"Rua Nova Santa Cruz",44,44,0,39,39,0
8,26,2018,16,0,8,"Braga",8,"Rua Costa Gomes",0,41,41,-1,42,-43
8,26,2018,17,0,8,"Braga",1,"Avenida da Liberdade",25,25,0,124,124,0
8,26,2018,17,0,8,"Braga",2,"Avenida Central",25,25,0,124,124,0
8,26,2018,17,0,8,"Braga",3,"Rua de Caires",36,36,0,37,37,0
8,26,2018,17,0,8,"Braga",4,"N14 Bosch",47,47,0,48,48,0
8,26,2018,17,0,8,"Braga",5,"Avenida João Paulo II",39,39,0,9,9,0
8,26,2018,17,0,8,"Braga",6,"Avenida Padre Júlio Fragata",67,67,0,83,83,0
8,26,2018,17,0,8,"Braga",7,"Rua Nova Santa Cruz",44,44,0,39,39,0
8,26,2018,17,0,8,"Braga",8,"Rua Costa Gomes",0,41,41,-1,42,-43
8,26,2018,18,0,8,"Braga",1,"Avenida da Liberdade",25,25,0,124,124,0
8,26,2018,18,0,8,"Braga",2,"Avenida Central",25,25,0,124,124,0
8,26,2018,18,0,8,"Braga",3,"Rua de Caires",36,36,0,37,37,0
8,26,2018,18,0,8,"Braga",4,"N14 Bosch",47,47,0,48,48,0
8,26,2018,18,0,8,"Braga",5,"Avenida João Paulo II",25,39,14,14,9,5
8,26,2018,18,0,8,"Braga",6,"Avenida Padre Júlio Fragata",67,67,0,83,83,0
8,26,2018,18,0,8,"Braga",7,"Rua Nova Santa Cruz",44,44,0,39,39,0
8,26,2018,18,0,8,"Braga",8,"Rua Costa Gomes",0,41,41,-1,42,-43
8,26,2018,19,0,8,"Braga",1,"Avenida da Liberdade",25,25,0,124,124,0
8,26,2018,19,0,8,"Braga",2,"Avenida Central",25,25,0,124,124,0
8,26,2018,19,0,8,"Braga",3,"Rua de Caires",25,36,11,54,37,17
8,26,2018,19,0,8,"Braga",4,"N14 Bosch",47,47,0,48,48,0
8,26,2018,19,0,8,"Braga",5,"Avenida João Paulo II",39,39,0,9,9,0
8,26,2018,19,0,8,"Braga",6,"Avenida Padre Júlio Fragata",48,67,19,116,83,33
8,26,2018,19,0,8,"Braga",7,"Rua Nova Santa Cruz",44,44,0,39,39,0
8,26,2018,19,0,8,"Braga",8,"Rua Costa Gomes",0,41,41,-1,42,-43
8,26,2018,20,0,8,"Braga",1,"Avenida da Liberdade",25,25,0,124,124,0
8,26,2018,20,0,8,"Braga",2,"Avenida Central",25,25,0,124,124,0
8,26,2018,20,0,8,"Braga",3,"Rua de Caires",28,36,8,48,37,11
8,26,2018,20,0,8,"Braga",4,"N14 Bosch",47,47,0,48,48,0
8,26,2018,20,0,8,"Braga",5,"Avenida João Paulo II",21,39,18,17,9,8
8,26,2018,20,0,8,"Braga",6,"Avenida Padre Júlio Fragata",67,67,0,83,83,0
8,26,2018,20,0,8,"Braga",7,"Rua Nova Santa Cruz",44,44,0,39,39,0
8,26,2018,20,0,8,"Braga",8,"Rua Costa Gomes",0,41,41,-1,42,-43
8,26,2018,21,0,8,"Braga",1,"Avenida da Liberdade",25,25,0,124,124,0
8,26,2018,21,0,8,"Braga",2,"Avenida Central",25,25,0,124,124,0
8,26,2018,21,0,8,"Braga",3,"Rua de Caires",27,36,9,50,37,13
8,26,2018,21,0,8,"Braga",4,"N14 Bosch",47,47,0,48,48,0
8,26,2018,21,0,8,"Braga",5,"Avenida João Paulo II",39,39,0,9,9,0
8,26,2018,21,0,8,"Braga",6,"Avenida Padre Júlio Fragata",67,67,0,83,83,0
8,26,2018,21,0,8,"Braga",7,"Rua Nova Santa Cruz",44,44,0,39,39,0
8,26,2018,21,0,8,"Braga",8,"Rua Costa Gomes",0,41,41,-1,42,-43
8,26,2018,22,0,8,"Braga",1,"Avenida da Liberdade",25,25,0,124,124,0
8,26,2018,22,0,8,"Braga",2,"Avenida Central",25,25,0,124,124,0
8,26,2018,22,0,8,"Braga",3,"Rua de Caires",36,36,0,37,37,0
8,26,2018,22,0,8,"Braga",4,"N14 Bosch",47,47,0,48,48,0
8,26,2018,22,0,8,"Braga",5,"Avenida João Paulo II",39,39,0,9,9,0
8,26,2018,22,0,8,"Braga",6,"Avenida Padre Júlio Fragata",67,67,0,83,83,0
8,26,2018,22,0,8,"Braga",7,"Rua Nova Santa Cruz",44,44,0,39,39,0
8,26,2018,22,0,8,"Braga",8,"Rua Costa Gomes",0,41,41,-1,42,-43
8,26,2018,23,0,8,"Braga",1,"Avenida da Liberdade",25,25,0,124,124,0
8,26,2018,23,0,8,"Braga",2,"Avenida Central",25,25,0,124,124,0
8,26,2018,23,0,8,"Braga",3,"Rua de Caires",36,36,0,37,37,0
8,26,2018,23,0,8,"Braga",4,"N14 Bosch",47,47,0,48,48,0
8,26,2018,23,0,8,"Braga",5,"Avenida João Paulo II",39,39,0,9,9,0
8,26,2018,23,0,8,"Braga",6,"Avenida Padre Júlio Fragata",67,67,0,83,83,0
8,26,2018,23,0,8,"Braga",7,"Rua Nova Santa Cruz",44,44,0,39,39,0
8,26,2018,23,0,8,"Braga",8,"Rua Costa Gomes",0,41,41,-1,42,-43
8,27,2018,0,0,2,"Braga",1,"Avenida da Liberdade",19,25,6,163,124,39
8,27,2018,0,0,2,"Braga",2,"Avenida Central",25,25,0,124,124,0
8,27,2018,0,0,2,"Braga",3,"Rua de Caires",36,36,0,37,37,0
8,27,2018,0,0,2,"Braga",4,"N14 Bosch",47,47,0,48,48,0
8,27,2018,0,0,2,"Braga",5,"Avenida João Paulo II",39,39,0,9,9,0
8,27,2018,0,0,2,"Braga",6,"Avenida Padre Júlio Fragata",67,67,0,83,83,0
8,27,2018,0,0,2,"Braga",7,"Rua Nova Santa Cruz",44,44,0,39,39,0
8,27,2018,0,0,2,"Braga",8,"Rua Costa Gomes",0,41,41,-1,42,-43
8,27,2018,1,0,2,"Braga",1,"Avenida da Liberdade",25,25,0,124,124,0
8,27,2018,1,0,2,"Braga",2,"Avenida Central",25,25,0,124,124,0
8,27,2018,1,0,2,"Braga",3,"Rua de Caires",36,36,0,37,37,0
8,27,2018,1,0,2,"Braga",4,"N14 Bosch",47,47,0,48,48,0
8,27,2018,1,0,2,"Braga",5,"Avenida João Paulo II",39,39,0,9,9,0
8,27,2018,1,0,2,"Braga",6,"Avenida Padre Júlio Fragata",67,67,0,83,83,0
8,27,2018,1,0,2,"Braga",7,"Rua Nova Santa Cruz",44,44,0,39,39,0
8,27,2018,1,0,2,"Braga",8,"Rua Costa Gomes",0,41,41,-1,42,-43
8,27,2018,2,0,2,"Braga",1,"Avenida da Liberdade",25,25,0,124,124,0
8,27,2018,2,0,2,"Braga",2,"Avenida Central",25,25,0,124,124,0
8,27,2018,2,0,2,"Braga",3,"Rua de Caires",36,36,0,37,37,0
8,27,2018,2,0,2,"Braga",4,"N14 Bosch",47,47,0,48,48,0
8,27,2018,2,0,2,"Braga",5,"Avenida João Paulo II",39,39,0,9,9,0
8,27,2018,2,0,2,"Braga",6,"Avenida Padre Júlio Fragata",67,67,0,83,83,0
8,27,2018,2,0,2,"Braga",7,"Rua Nova Santa Cruz",44,44,0,39,39,0
8,27,2018,2,0,2,"Braga",8,"Rua Costa Gomes",0,41,41,-1,42,-43
8,27,2018,3,0,2,"Braga",1,"Avenida da Liberdade",25,25,0,124,124,0
8,27,2018,3,0,2,"Braga",2,"Avenida Central",25,25,0,124,124,0
8,27,2018,3,0,2,"Braga",3,"Rua de Caires",36,36,0,37,37,0
8,27,2018,3,0,2,"Braga",4,"N14 Bosch",47,47,0,48,48,0
8,27,2018,3,0,2,"Braga",5,"Avenida João Paulo II",39,39,0,9,9,0
8,27,2018,3,0,2,"Braga",6,"Avenida Padre Júlio Fragata",67,67,0,83,83,0
8,27,2018,3,0,2,"Braga",7,"Rua Nova Santa Cruz",44,44,0,39,39,0
8,27,2018,3,0,2,"Braga",8,"Rua Costa Gomes",0,41,41,-1,42,-43
8,27,2018,4,0,2,"Braga",1,"Avenida da Liberdade",25,25,0,124,124,0
8,27,2018,4,0,2,"Braga",2,"Avenida Central",25,25,0,124,124,0
8,27,2018,4,0,2,"Braga",3,"Rua de Caires",36,36,0,37,37,0
8,27,2018,4,0,2,"Braga",4,"N14 Bosch",47,47,0,48,48,0
8,27,2018,4,0,2,"Braga",5,"Avenida João Paulo II",39,39,0,9,9,0
8,27,2018,4,0,2,"Braga",6,"Avenida Padre Júlio Fragata",67,67,0,83,83,0
8,27,2018,4,0,2,"Braga",7,"Rua Nova Santa Cruz",44,44,0,39,39,0
8,27,2018,4,0,2,"Braga",8,"Rua Costa Gomes",0,41,41,-1,42,-43
8,27,2018,5,0,2,"Braga",1,"Avenida da Liberdade",25,25,0,124,124,0
8,27,2018,5,0,2,"Braga",2,"Avenida Central",25,25,0,124,124,0
8,27,2018,5,0,2,"Braga",3,"Rua de Caires",36,36,0,37,37,0
8,27,2018,5,0,2,"Braga",4,"N14 Bosch",47,47,0,48,48,0
8,27,2018,5,0,2,"Braga",5,"Avenida João Paulo II",39,39,0,9,9,0
8,27,2018,5,0,2,"Braga",6,"Avenida Padre Júlio Fragata",67,67,0,83,83,0
8,27,2018,5,0,2,"Braga",7,"Rua Nova Santa Cruz",44,44,0,39,39,0
8,27,2018,5,0,2,"Braga",8,"Rua Costa Gomes",0,41,41,-1,42,-43
8,27,2018,6,0,2,"Braga",1,"Avenida da Liberdade",25,25,0,124,124,0
8,27,2018,6,0,2,"Braga",2,"Avenida Central",25,25,0,124,124,0
8,27,2018,6,0,2,"Braga",3,"Rua de Caires",36,36,0,37,37,0
8,27,2018,6,0,2,"Braga",4,"N14 Bosch",47,47,0,48,48,0
8,27,2018,6,0,2,"Braga",5,"Avenida João Paulo II",39,39,0,9,9,0
8,27,2018,6,0,2,"Braga",6,"Avenida Padre Júlio Fragata",67,67,0,83,83,0
8,27,2018,6,0,2,"Braga",7,"Rua Nova Santa Cruz",44,44,0,39,39,0
8,27,2018,6,0,2,"Braga",8,"Rua Costa Gomes",0,41,41,-1,42,-43
8,27,2018,7,0,2,"Braga",1,"Avenida da Liberdade",25,25,0,124,124,0
8,27,2018,7,0,2,"Braga",2,"Avenida Central",25,25,0,124,124,0
8,27,2018,7,0,2,"Braga",3,"Rua de Caires",36,36,0,37,37,0
8,27,2018,7,0,2,"Braga",4,"N14 Bosch",47,47,0,48,48,0
8,27,2018,7,0,2,"Braga",5,"Avenida João Paulo II",39,39,0,9,9,0
8,27,2018,7,0,2,"Braga",6,"Avenida Padre Júlio Fragata",67,67,0,83,83,0
8,27,2018,7,0,2,"Braga",7,"Rua Nova Santa Cruz",31,44,13,56,39,17
8,27,2018,7,0,2,"Braga",8,"Rua Costa Gomes",0,41,41,-1,42,-43
8,27,2018,8,0,2,"Braga",1,"Avenida da Liberdade",25,25,0,124,124,0
8,27,2018,8,0,2,"Braga",2,"Avenida Central",25,25,0,124,124,0
8,27,2018,8,0,2,"Braga",3,"Rua de Caires",26,36,10,52,37,15
8,27,2018,8,0,2,"Braga",4,"N14 Bosch",47,47,0,48,48,0
8,27,2018,8,0,2,"Braga",5,"Avenida João Paulo II",39,39,0,9,9,0
8,27,2018,8,0,2,"Braga",6,"Avenida Padre Júlio Fragata",67,67,0,83,83,0
8,27,2018,8,0,2,"Braga",7,"Rua Nova Santa Cruz",44,44,0,39,39,0
8,27,2018,8,0,2,"Braga",8,"Rua Costa Gomes",0,41,41,-1,42,-43
8,27,2018,9,0,2,"Braga",1,"Avenida da Liberdade",18,25,7,172,124,48
8,27,2018,9,0,2,"Braga",2,"Avenida Central",18,25,7,172,124,48
8,27,2018,9,0,2,"Braga",3,"Rua de Caires",36,36,0,37,37,0
8,27,2018,9,0,2,"Braga",4,"N14 Bosch",23,47,24,98,48,50
8,27,2018,9,0,2,"Braga",5,"Avenida João Paulo II",39,39,0,9,9,0
8,27,2018,9,0,2,"Braga",6,"Avenida Padre Júlio Fragata",67,67,0,83,83,0
8,27,2018,9,0,2,"Braga",7,"Rua Nova Santa Cruz",44,44,0,39,39,0
8,27,2018,9,0,2,"Braga",8,"Rua Costa Gomes",0,41,41,-1,42,-43
8,27,2018,10,0,2,"Braga",1,"Avenida da Liberdade",25,25,0,124,124,0
8,27,2018,10,0,2,"Braga",2,"Avenida Central",25,25,0,124,124,0
8,27,2018,10,0,2,"Braga",3,"Rua de Caires",28,36,8,48,37,11
8,27,2018,10,0,2,"Braga",4,"N14 Bosch",32,47,15,70,48,22
8,27,2018,10,0,2,"Braga",5,"Avenida João Paulo II",39,39,0,9,9,0
8,27,2018,10,0,2,"Braga",6,"Avenida Padre Júlio Fragata",67,67,0,83,83,0
8,27,2018,10,0,2,"Braga",7,"Rua Nova Santa Cruz",44,44,0,39,39,0
8,27,2018,10,0,2,"Braga",8,"Rua Costa Gomes",0,41,41,-1,42,-43
8,27,2018,11,0,2,"Braga",1,"Avenida da Liberdade",25,25,0,124,124,0
8,27,2018,11,0,2,"Braga",2,"Avenida Central",25,25,0,124,124,0
8,27,2018,11,0,2,"Braga",3,"Rua de Caires",36,36,0,37,37,0
8,27,2018,11,0,2,"Braga",4,"N14 Bosch",33,47,14,68,48,20
8,27,2018,11,0,2,"Braga",5,"Avenida João Paulo II",39,39,0,9,9,0
8,27,2018,11,0,2,"Braga",6,"Avenida Padre Júlio Fragata",67,67,0,83,83,0
8,27,2018,11,0,2,"Braga",7,"Rua Nova Santa Cruz",44,44,0,39,39,0
8,27,2018,11,0,2,"Braga",8,"Rua Costa Gomes",0,41,41,-1,42,-43
8,27,2018,12,0,2,"Braga",1,"Avenida da Liberdade",25,25,0,124,124,0
8,27,2018,12,0,2,"Braga",2,"Avenida Central",25,25,0,124,124,0
8,27,2018,12,0,2,"Braga",3,"Rua de Caires",28,36,8,48,37,11
8,27,2018,12,0,2,"Braga",4,"N14 Bosch",26,47,21,86,48,38
8,27,2018,12,0,2,"Braga",5,"Avenida João Paulo II",39,39,0,9,9,0
8,27,2018,12,0,2,"Braga",6,"Avenida Padre Júlio Fragata",67,67,0,83,83,0
8,27,2018,12,0,2,"Braga",7,"Rua Nova Santa Cruz",44,44,0,39,39,0
8,27,2018,12,0,2,"Braga",8,"Rua Costa Gomes",0,41,41,-1,42,-43
8,27,2018,13,0,2,"Braga",1,"Avenida da Liberdade",25,25,0,124,124,0
8,27,2018,13,0,2,"Braga",2,"Avenida Central",25,25,0,124,124,0
8,27,2018,13,0,2,"Braga",3,"Rua de Caires",28,36,8,48,37,11
8,27,2018,13,0,2,"Braga",4,"N14 Bosch",22,47,25,102,48,54
8,27,2018,13,0,2,"Braga",5,"Avenida João Paulo II",39,39,0,9,9,0
8,27,2018,13,0,2,"Braga",6,"Avenida Padre Júlio Fragata",67,67,0,83,83,0
8,27,2018,13,0,2,"Braga",7,"Rua Nova Santa Cruz",44,44,0,39,39,0
8,27,2018,13,0,2,"Braga",8,"Rua Costa Gomes",0,41,41,-1,42,-43
8,27,2018,14,0,2,"Braga",1,"Avenida da Liberdade",25,25,0,124,124,0
8,27,2018,14,0,2,"Braga",2,"Avenida Central",25,25,0,124,124,0
8,27,2018,14,0,2,"Braga",3,"Rua de Caires",36,36,0,37,37,0
8,27,2018,14,0,2,"Braga",4,"N14 Bosch",20,47,27,112,48,64
8,27,2018,14,0,2,"Braga",5,"Avenida João Paulo II",28,39,11,12,9,3
8,27,2018,14,0,2,"Braga",6,"Avenida Padre Júlio Fragata",67,67,0,83,83,0
8,27,2018,14,0,2,"Braga",7,"Rua Nova Santa Cruz",31,44,13,56,39,17
8,27,2018,14,0,2,"Braga",8,"Rua Costa Gomes",0,41,41,-1,42,-43
8,27,2018,15,0,2,"Braga",1,"Avenida da Liberdade",25,25,0,124,124,0
8,27,2018,15,0,2,"Braga",2,"Avenida Central",25,25,0,124,124,0
8,27,2018,15,0,2,"Braga",3,"Rua de Caires",36,36,0,37,37,0
8,27,2018,15,0,2,"Braga",4,"N14 Bosch",47,47,0,48,48,0
8,27,2018,15,0,2,"Braga",5,"Avenida João Paulo II",39,39,0,9,9,0
8,27,2018,15,0,2,"Braga",6,"Avenida Padre Júlio Fragata",67,67,0,83,83,0
8,27,2018,15,0,2,"Braga",7,"Rua Nova Santa Cruz",44,44,0,39,39,0
8,27,2018,15,0,2,"Braga",8,"Rua Costa Gomes",0,41,41,-1,42,-43
8,27,2018,16,0,2,"Braga",1,"Avenida da Liberdade",19,25,6,163,124,39
8,27,2018,16,0,2,"Braga",2,"Avenida Central",19,25,6,163,124,39
8,27,2018,16,0,2,"Braga",3,"Rua de Caires",28,36,8,48,37,11
8,27,2018,16,0,2,"Braga",4,"N14 Bosch",25,47,22,90,48,42
8,27,2018,16,0,2,"Braga",5,"Avenida João Paulo II",23,39,16,15,9,6
8,27,2018,16,0,2,"Braga",6,"Avenida Padre Júlio Fragata",67,67,0,83,83,0
8,27,2018,16,0,2,"Braga",7,"Rua Nova Santa Cruz",44,44,0,39,39,0
8,27,2018,16,0,2,"Braga",8,"Rua Costa Gomes",0,41,41,-1,42,-43
8,27,2018,17,0,2,"Braga",1,"Avenida da Liberdade",25,25,0,124,124,0
8,27,2018,17,0,2,"Braga",2,"Avenida Central",25,25,0,124,124,0
8,27,2018,17,0,2,"Braga",3,"Rua de Caires",23,36,13,59,37,22
8,27,2018,17,0,2,"Braga",4,"N14 Bosch",33,47,14,68,48,20
8,27,2018,17,0,2,"Braga",5,"Avenida João Paulo II",39,39,0,9,9,0
8,27,2018,17,0,2,"Braga",6,"Avenida Padre Júlio Fragata",49,67,18,114,83,31
8,27,2018,17,0,2,"Braga",7,"Rua Nova Santa Cruz",44,44,0,39,39,0
8,27,2018,17,0,2,"Braga",8,"Rua Costa Gomes",0,41,41,-1,42,-43
8,27,2018,18,0,2,"Braga",1,"Avenida da Liberdade",19,25,6,163,124,39
8,27,2018,18,0,2,"Braga",2,"Avenida Central",19,25,6,163,124,39
8,27,2018,18,0,2,"Braga",3,"Rua de Caires",36,36,0,37,37,0
8,27,2018,18,0,2,"Braga",4,"N14 Bosch",20,47,27,112,48,64
8,27,2018,18,0,2,"Braga",5,"Avenida João Paulo II",39,39,0,9,9,0
8,27,2018,18,0,2,"Braga",6,"Avenida Padre Júlio Fragata",44,67,23,127,83,44
8,27,2018,18,0,2,"Braga",7,"Rua Nova Santa Cruz",32,44,12,54,39,15
8,27,2018,18,0,2,"Braga",8,"Rua Costa Gomes",0,41,41,-1,42,-43
8,27,2018,19,0,2,"Braga",1,"Avenida da Liberdade",25,25,0,124,124,0
8,27,2018,19,0,2,"Braga",2,"Avenida Central",25,25,0,124,124,0
8,27,2018,19,0,2,"Braga",3,"Rua de Caires",36,36,0,37,37,0
8,27,2018,19,0,2,"Braga",4,"N14 Bosch",47,47,0,48,48,0
8,27,2018,19,0,2,"Braga",5,"Avenida João Paulo II",25,39,14,14,9,5
8,27,2018,19,0,2,"Braga",6,"Avenida Padre Júlio Fragata",67,67,0,83,83,0
8,27,2018,19,0,2,"Braga",7,"Rua Nova Santa Cruz",44,44,0,39,39,0
8,27,2018,19,0,2,"Braga",8,"Rua Costa Gomes",0,41,41,-1,42,-43
8,27,2018,20,0,2,"Braga",1,"Avenida da Liberdade",25,25,0,124,124,0
8,27,2018,20,0,2,"Braga",2,"Avenida Central",25,25,0,124,124,0
8,27,2018,20,0,2,"Braga",3,"Rua de Caires",36,36,0,37,37,0
8,27,2018,20,0,2,"Braga",4,"N14 Bosch",47,47,0,48,48,0
8,27,2018,20,0,2,"Braga",5,"Avenida João Paulo II",39,39,0,9,9,0
8,27,2018,20,0,2,"Braga",6,"Avenida Padre Júlio Fragata",67,67,0,83,83,0
8,27,2018,20,0,2,"Braga",7,"Rua Nova Santa Cruz",44,44,0,39,39,0
8,27,2018,20,0,2,"Braga",8,"Rua Costa Gomes",0,41,41,-1,42,-43
8,27,2018,21,0,2,"Braga",1,"Avenida da Liberdade",25,25,0,124,124,0
8,27,2018,21,0,2,"Braga",2,"Avenida Central",25,25,0,124,124,0
8,27,2018,21,0,2,"Braga",3,"Rua de Caires",36,36,0,37,37,0
8,27,2018,21,0,2,"Braga",4,"N14 Bosch",47,47,0,48,48,0
8,27,2018,21,0,2,"Braga",5,"Avenida João Paulo II",39,39,0,9,9,0
8,27,2018,21,0,2,"Braga",6,"Avenida Padre Júlio Fragata",67,67,0,83,83,0
8,27,2018,21,0,2,"Braga",7,"Rua Nova Santa Cruz",44,44,0,39,39,0
8,27,2018,21,0,2,"Braga",8,"Rua Costa Gomes",0,41,41,-1,42,-43
8,27,2018,22,0,2,"Braga",1,"Avenida da Liberdade",25,25,0,124,124,0
8,27,2018,22,0,2,"Braga",2,"Avenida Central",25,25,0,124,124,0
8,27,2018,22,0,2,"Braga",3,"Rua de Caires",36,36,0,37,37,0
8,27,2018,22,0,2,"Braga",4,"N14 Bosch",47,47,0,48,48,0
8,27,2018,22,0,2,"Braga",5,"Avenida João Paulo II",39,39,0,9,9,0
8,27,2018,22,0,2,"Braga",6,"Avenida Padre Júlio Fragata",67,67,0,83,83,0
8,27,2018,22,0,2,"Braga",7,"Rua Nova Santa Cruz",44,44,0,39,39,0
8,27,2018,22,0,2,"Braga",8,"Rua Costa Gomes",0,41,41,-1,42,-43
8,27,2018,23,0,2,"Braga",1,"Avenida da Liberdade",25,25,0,124,124,0
8,27,2018,23,0,2,"Braga",2,"Avenida Central",25,25,0,124,124,0
8,27,2018,23,0,2,"Braga",3,"Rua de Caires",36,36,0,37,37,0
8,27,2018,23,0,2,"Braga",4,"N14 Bosch",47,47,0,48,48,0
8,27,2018,23,0,2,"Braga",5,"Avenida João Paulo II",39,39,0,9,9,0
8,27,2018,23,0,2,"Braga",6,"Avenida Padre Júlio Fragata",67,67,0,83,83,0
8,27,2018,23,0,2,"Braga",7,"Rua Nova Santa Cruz",44,44,0,39,39,0
8,27,2018,23,0,2,"Braga",8,"Rua Costa Gomes",0,41,41,-1,42,-43
8,28,2018,0,0,3,"Braga",1,"Avenida da Liberdade",25,25,0,124,124,0
8,28,2018,0,0,3,"Braga",2,"Avenida Central",25,25,0,124,124,0
8,28,2018,0,0,3,"Braga",3,"Rua de Caires",36,36,0,37,37,0
8,28,2018,0,0,3,"Braga",4,"N14 Bosch",47,47,0,48,48,0
8,28,2018,0,0,3,"Braga",5,"Avenida João Paulo II",39,39,0,9,9,0
8,28,2018,0,0,3,"Braga",6,"Avenida Padre Júlio Fragata",67,67,0,83,83,0
8,28,2018,0,0,3,"Braga",7,"Rua Nova Santa Cruz",44,44,0,39,39,0
8,28,2018,0,0,3,"Braga",8,"Rua Costa Gomes",0,41,41,-1,42,-43
8,28,2018,1,0,3,"Braga",1,"Avenida da Liberdade",25,25,0,124,124,0
8,28,2018,1,0,3,"Braga",2,"Avenida Central",25,25,0,124,124,0
8,28,2018,1,0,3,"Braga",3,"Rua de Caires",36,36,0,37,37,0
8,28,2018,1,0,3,"Braga",4,"N14 Bosch",47,47,0,48,48,0
8,28,2018,1,0,3,"Braga",5,"Avenida João Paulo II",39,39,0,9,9,0
8,28,2018,1,0,3,"Braga",6,"Avenida Padre Júlio Fragata",67,67,0,83,83,0
8,28,2018,1,0,3,"Braga",7,"Rua Nova Santa Cruz",44,44,0,39,39,0
8,28,2018,1,0,3,"Braga",8,"Rua Costa Gomes",0,41,41,-1,42,-43
8,28,2018,2,0,3,"Braga",1,"Avenida da Liberdade",25,25,0,124,124,0
8,28,2018,2,0,3,"Braga",2,"Avenida Central",25,25,0,124,124,0
8,28,2018,2,0,3,"Braga",3,"Rua de Caires",36,36,0,37,37,0
8,28,2018,2,0,3,"Braga",4,"N14 Bosch",47,47,0,48,48,0
8,28,2018,2,0,3,"Braga",5,"Avenida João Paulo II",39,39,0,9,9,0
8,28,2018,2,0,3,"Braga",6,"Avenida Padre Júlio Fragata",67,67,0,83,83,0
8,28,2018,2,0,3,"Braga",7,"Rua Nova Santa Cruz",44,44,0,39,39,0
8,28,2018,2,0,3,"Braga",8,"Rua Costa Gomes",0,41,41,-1,42,-43
8,28,2018,3,0,3,"Braga",1,"Avenida da Liberdade",25,25,0,124,124,0
8,28,2018,3,0,3,"Braga",2,"Avenida Central",25,25,0,124,124,0
8,28,2018,3,0,3,"Braga",3,"Rua de Caires",36,36,0,37,37,0
8,28,2018,3,0,3,"Braga",4,"N14 Bosch",47,47,0,48,48,0
8,28,2018,3,0,3,"Braga",5,"Avenida João Paulo II",39,39,0,9,9,0
8,28,2018,3,0,3,"Braga",6,"Avenida Padre Júlio Fragata",67,67,0,83,83,0
8,28,2018,3,0,3,"Braga",7,"Rua Nova Santa Cruz",44,44,0,39,39,0
8,28,2018,3,0,3,"Braga",8,"Rua Costa Gomes",0,41,41,-1,42,-43
8,28,2018,4,0,3,"Braga",1,"Avenida da Liberdade",25,25,0,124,124,0
8,28,2018,4,0,3,"Braga",2,"Avenida Central",25,25,0,124,124,0
8,28,2018,4,0,3,"Braga",3,"Rua de Caires",36,36,0,37,37,0
8,28,2018,4,0,3,"Braga",4,"N14 Bosch",47,47,0,48,48,0
8,28,2018,4,0,3,"Braga",5,"Avenida João Paulo II",39,39,0,9,9,0
8,28,2018,4,0,3,"Braga",6,"Avenida Padre Júlio Fragata",67,67,0,83,83,0
8,28,2018,4,0,3,"Braga",7,"Rua Nova Santa Cruz",44,44,0,39,39,0
8,28,2018,4,0,3,"Braga",8,"Rua Costa Gomes",0,41,41,-1,42,-43
8,28,2018,5,0,3,"Braga",1,"Avenida da Liberdade",25,25,0,124,124,0
8,28,2018,5,0,3,"Braga",2,"Avenida Central",25,25,0,124,124,0
8,28,2018,5,0,3,"Braga",3,"Rua de Caires",36,36,0,37,37,0
8,28,2018,5,0,3,"Braga",4,"N14 Bosch",47,47,0,48,48,0
8,28,2018,5,0,3,"Braga",5,"Avenida João Paulo II",39,39,0,9,9,0
8,28,2018,5,0,3,"Braga",6,"Avenida Padre Júlio Fragata",67,67,0,83,83,0
8,28,2018,5,0,3,"Braga",7,"Rua Nova Santa Cruz",44,44,0,39,39,0
8,28,2018,5,0,3,"Braga",8,"Rua Costa Gomes",0,41,41,-1,42,-43
8,28,2018,6,0,3,"Braga",1,"Avenida da Liberdade",25,25,0,124,124,0
8,28,2018,6,0,3,"Braga",2,"Avenida Central",25,25,0,124,124,0
8,28,2018,6,0,3,"Braga",3,"Rua de Caires",36,36,0,37,37,0
8,28,2018,6,0,3,"Braga",4,"N14 Bosch",47,47,0,48,48,0
8,28,2018,6,0,3,"Braga",5,"Avenida João Paulo II",39,39,0,9,9,0
8,28,2018,6,0,3,"Braga",6,"Avenida Padre Júlio Fragata",67,67,0,83,83,0
8,28,2018,6,0,3,"Braga",7,"Rua Nova Santa Cruz",44,44,0,39,39,0
8,28,2018,6,0,3,"Braga",8,"Rua Costa Gomes",0,41,41,-1,42,-43
8,28,2018,7,0,3,"Braga",1,"Avenida da Liberdade",25,25,0,124,124,0
8,28,2018,7,0,3,"Braga",2,"Avenida Central",25,25,0,124,124,0
8,28,2018,7,0,3,"Braga",3,"Rua de Caires",28,36,8,48,37,11
8,28,2018,7,0,3,"Braga",4,"N14 Bosch",33,47,14,68,48,20
8,28,2018,7,0,3,"Braga",5,"Avenida João Paulo II",39,39,0,9,9,0
8,28,2018,7,0,3,"Braga",6,"Avenida Padre Júlio Fragata",67,67,0,83,83,0
8,28,2018,7,0,3,"Braga",7,"Rua Nova Santa Cruz",22,44,22,79,39,40
8,28,2018,7,0,3,"Braga",8,"Rua Costa Gomes",0,41,41,-1,42,-43
8,28,2018,8,0,3,"Braga",1,"Avenida da Liberdade",25,25,0,124,124,0
8,28,2018,8,0,3,"Braga",2,"Avenida Central",25,25,0,124,124,0
8,28,2018,8,0,3,"Braga",3,"Rua de Caires",36,36,0,37,37,0
8,28,2018,8,0,3,"Braga",4,"N14 Bosch",47,47,0,48,48,0
8,28,2018,8,0,3,"Braga",5,"Avenida João Paulo II",23,39,16,15,9,6
8,28,2018,8,0,3,"Braga",6,"Avenida Padre Júlio Fragata",67,67,0,83,83,0
8,28,2018,8,0,3,"Braga",7,"Rua Nova Santa Cruz",44,44,0,39,39,0
8,28,2018,8,0,3,"Braga",8,"Rua Costa Gomes",0,41,41,-1,42,-43
8,28,2018,9,0,3,"Braga",1,"Avenida da Liberdade",25,25,0,124,124,0
8,28,2018,9,0,3,"Braga",2,"Avenida Central",25,25,0,124,124,0
8,28,2018,9,0,3,"Braga",3,"Rua de Caires",26,36,10,52,37,15
8,28,2018,9,0,3,"Braga",4,"N14 Bosch",34,47,13,66,48,18
8,28,2018,9,0,3,"Braga",5,"Avenida João Paulo II",39,39,0,9,9,0
8,28,2018,9,0,3,"Braga",6,"Avenida Padre Júlio Fragata",67,67,0,83,83,0
8,28,2018,9,0,3,"Braga",7,"Rua Nova Santa Cruz",44,44,0,39,39,0
8,28,2018,9,0,3,"Braga",8,"Rua Costa Gomes",0,41,41,-1,42,-43
8,28,2018,10,0,3,"Braga",1,"Avenida da Liberdade",25,25,0,124,124,0
8,28,2018,10,0,3,"Braga",2,"Avenida Central",25,25,0,124,124,0
8,28,2018,10,0,3,"Braga",3,"Rua de Caires",28,36,8,48,37,11
8,28,2018,10,0,3,"Braga",4,"N14 Bosch",37,47,10,61,48,13
8,28,2018,10,0,3,"Braga",5,"Avenida João Paulo II",39,39,0,9,9,0
8,28,2018,10,0,3,"Braga",6,"Avenida Padre Júlio Fragata",67,67,0,83,83,0
8,28,2018,10,0,3,"Braga",7,"Rua Nova Santa Cruz",44,44,0,39,39,0
8,28,2018,10,0,3,"Braga",8,"Rua Costa Gomes",0,41,41,-1,42,-43
8,28,2018,11,0,3,"Braga",1,"Avenida da Liberdade",17,25,8,182,124,58
8,28,2018,11,0,3,"Braga",2,"Avenida Central",17,25,8,182,124,58
8,28,2018,11,0,3,"Braga",3,"Rua de Caires",14,36,22,96,37,59
8,28,2018,11,0,3,"Braga",4,"N14 Bosch",28,47,19,80,48,32
8,28,2018,11,0,3,"Braga",5,"Avenida João Paulo II",30,39,9,12,9,3
8,28,2018,11,0,3,"Braga",6,"Avenida Padre Júlio Fragata",67,67,0,83,83,0
8,28,2018,11,0,3,"Braga",7,"Rua Nova Santa Cruz",44,44,0,39,39,0
8,28,2018,11,0,3,"Braga",8,"Rua Costa Gomes",0,41,41,-1,42,-43
8,28,2018,12,0,3,"Braga",1,"Avenida da Liberdade",25,25,0,124,124,0
8,28,2018,12,0,3,"Braga",2,"Avenida Central",25,25,0,124,124,0
8,28,2018,12,0,3,"Braga",3,"Rua de Caires",27,36,9,50,37,13
8,28,2018,12,0,3,"Braga",4,"N14 Bosch",31,47,16,72,48,24
8,28,2018,12,0,3,"Braga",5,"Avenida João Paulo II",39,39,0,9,9,0
8,28,2018,12,0,3,"Braga",6,"Avenida Padre Júlio Fragata",67,67,0,83,83,0
8,28,2018,12,0,3,"Braga",7,"Rua Nova Santa Cruz",44,44,0,39,39,0
8,28,2018,12,0,3,"Braga",8,"Rua Costa Gomes",0,41,41,-1,42,-43
8,28,2018,13,0,3,"Braga",1,"Avenida da Liberdade",25,25,0,124,124,0
8,28,2018,13,0,3,"Braga",2,"Avenida Central",25,25,0,124,124,0
8,28,2018,13,0,3,"Braga",3,"Rua de Caires",36,36,0,37,37,0
8,28,2018,13,0,3,"Braga",4,"N14 Bosch",34,47,13,66,48,18
8,28,2018,13,0,3,"Braga",5,"Avenida João Paulo II",39,39,0,9,9,0
8,28,2018,13,0,3,"Braga",6,"Avenida Padre Júlio Fragata",67,67,0,83,83,0
8,28,2018,13,0,3,"Braga",7,"Rua Nova Santa Cruz",31,44,13,56,39,17
8,28,2018,13,0,3,"Braga",8,"Rua Costa Gomes",0,41,41,-1,42,-43
8,28,2018,14,0,3,"Braga",1,"Avenida da Liberdade",25,25,0,124,124,0
8,28,2018,14,0,3,"Braga",2,"Avenida Central",25,25,0,124,124,0
8,28,2018,14,0,3,"Braga",3,"Rua de Caires",36,36,0,37,37,0
8,28,2018,14,0,3,"Braga",4,"N14 Bosch",25,47,22,90,48,42
8,28,2018,14,0,3,"Braga",5,"Avenida João Paulo II",25,39,14,14,9,5
8,28,2018,14,0,3,"Braga",6,"Avenida Padre Júlio Fragata",67,67,0,83,83,0
8,28,2018,14,0,3,"Braga",7,"Rua Nova Santa Cruz",44,44,0,39,39,0
8,28,2018,14,0,3,"Braga",8,"Rua Costa Gomes",0,41,41,-1,42,-43
8,28,2018,15,0,3,"Braga",1,"Avenida da Liberdade",19,25,6,163,124,39
8,28,2018,15,0,3,"Braga",2,"Avenida Central",19,25,6,163,124,39
8,28,2018,15,0,3,"Braga",3,"Rua de Caires",21,36,15,64,37,27
8,28,2018,15,0,3,"Braga",4,"N14 Bosch",27,47,20,83,48,35
8,28,2018,15,0,3,"Braga",5,"Avenida João Paulo II",39,39,0,9,9,0
8,28,2018,15,0,3,"Braga",6,"Avenida Padre Júlio Fragata",51,67,16,109,83,26
8,28,2018,15,0,3,"Braga",7,"Rua Nova Santa Cruz",44,44,0,39,39,0
8,28,2018,15,0,3,"Braga",8,"Rua Costa Gomes",0,41,41,-1,42,-43
8,28,2018,16,0,3,"Braga",1,"Avenida da Liberdade",10,25,15,310,124,186
8,28,2018,16,0,3,"Braga",2,"Avenida Central",10,25,15,310,124,186
8,28,2018,16,0,3,"Braga",3,"Rua de Caires",24,36,12,56,37,19
8,28,2018,16,0,3,"Braga",4,"N14 Bosch",26,47,21,86,48,38
8,28,2018,16,0,3,"Braga",5,"Avenida João Paulo II",14,39,25,25,9,16
8,28,2018,16,0,3,"Braga",6,"Avenida Padre Júlio Fragata",67,67,0,83,83,0
8,28,2018,16,0,3,"Braga",7,"Rua Nova Santa Cruz",44,44,0,39,39,0
8,28,2018,16,0,3,"Braga",8,"Rua Costa Gomes",0,41,41,-1,42,-43
8,28,2018,17,0,3,"Braga",1,"Avenida da Liberdade",15,25,10,207,124,83
8,28,2018,17,0,3,"Braga",2,"Avenida Central",15,25,10,207,124,83
8,28,2018,17,0,3,"Braga",3,"Rua de Caires",36,36,0,37,37,0
8,28,2018,17,0,3,"Braga",4,"N14 Bosch",20,47,27,112,48,64
8,28,2018,17,0,3,"Braga",5,"Avenida João Paulo II",27,39,12,13,9,4
8,28,2018,17,0,3,"Braga",6,"Avenida Padre Júlio Fragata",43,67,24,130,83,47
8,28,2018,17,0,3,"Braga",7,"Rua Nova Santa Cruz",44,44,0,39,39,0
8,28,2018,17,0,3,"Braga",8,"Rua Costa Gomes",0,41,41,-1,42,-43
8,28,2018,18,0,3,"Braga",1,"Avenida da Liberdade",18,25,7,172,124,48
8,28,2018,18,0,3,"Braga",2,"Avenida Central",18,25,7,172,124,48
8,28,2018,18,0,3,"Braga",3,"Rua de Caires",36,36,0,37,37,0
8,28,2018,18,0,3,"Braga",4,"N14 Bosch",19,47,28,118,48,70
8,28,2018,18,0,3,"Braga",5,"Avenida João Paulo II",39,39,0,9,9,0
8,28,2018,18,0,3,"Braga",6,"Avenida Padre Júlio Fragata",38,67,29,147,83,64
8,28,2018,18,0,3,"Braga",7,"Rua Nova Santa Cruz",44,44,0,39,39,0
8,28,2018,18,0,3,"Braga",8,"Rua Costa Gomes",0,41,41,-1,42,-43
8,28,2018,19,0,3,"Braga",1,"Avenida da Liberdade",19,25,6,163,124,39
8,28,2018,19,0,3,"Braga",2,"Avenida Central",25,25,0,124,124,0
8,28,2018,19,0,3,"Braga",3,"Rua de Caires",36,36,0,37,37,0
8,28,2018,19,0,3,"Braga",4,"N14 Bosch",47,47,0,48,48,0
8,28,2018,19,0,3,"Braga",5,"Avenida João Paulo II",39,39,0,9,9,0
8,28,2018,19,0,3,"Braga",6,"Avenida Padre Júlio Fragata",67,67,0,83,83,0
8,28,2018,19,0,3,"Braga",7,"Rua Nova Santa Cruz",44,44,0,39,39,0
8,28,2018,19,0,3,"Braga",8,"Rua Costa Gomes",0,41,41,-1,42,-43
8,28,2018,20,0,3,"Braga",1,"Avenida da Liberdade",25,25,0,124,124,0
8,28,2018,20,0,3,"Braga",2,"Avenida Central",25,25,0,124,124,0
8,28,2018,20,0,3,"Braga",3,"Rua de Caires",28,36,8,48,37,11
8,28,2018,20,0,3,"Braga",4,"N14 Bosch",47,47,0,48,48,0
8,28,2018,20,0,3,"Braga",5,"Avenida João Paulo II",39,39,0,9,9,0
8,28,2018,20,0,3,"Braga",6,"Avenida Padre Júlio Fragata",67,67,0,83,83,0
8,28,2018,20,0,3,"Braga",7,"Rua Nova Santa Cruz",44,44,0,39,39,0
8,28,2018,20,0,3,"Braga",8,"Rua Costa Gomes",0,41,41,-1,42,-43
8,28,2018,21,0,3,"Braga",1,"Avenida da Liberdade",25,25,0,124,124,0
8,28,2018,21,0,3,"Braga",2,"Avenida Central",25,25,0,124,124,0
8,28,2018,21,0,3,"Braga",3,"Rua de Caires",36,36,0,37,37,0
8,28,2018,21,0,3,"Braga",4,"N14 Bosch",47,47,0,48,48,0
8,28,2018,21,0,3,"Braga",5,"Avenida João Paulo II",39,39,0,9,9,0
8,28,2018,21,0,3,"Braga",6,"Avenida Padre Júlio Fragata",67,67,0,83,83,0
8,28,2018,21,0,3,"Braga",7,"Rua Nova Santa Cruz",44,44,0,39,39,0
8,28,2018,21,0,3,"Braga",8,"Rua Costa Gomes",0,41,41,-1,42,-43
8,28,2018,22,0,3,"Braga",1,"Avenida da Liberdade",25,25,0,124,124,0
8,28,2018,22,0,3,"Braga",2,"Avenida Central",25,25,0,124,124,0
8,28,2018,22,0,3,"Braga",3,"Rua de Caires",36,36,0,37,37,0
8,28,2018,22,0,3,"Braga",4,"N14 Bosch",47,47,0,48,48,0
8,28,2018,22,0,3,"Braga",5,"Avenida João Paulo II",39,39,0,9,9,0
8,28,2018,22,0,3,"Braga",6,"Avenida Padre Júlio Fragata",67,67,0,83,83,0
8,28,2018,22,0,3,"Braga",7,"Rua Nova Santa Cruz",44,44,0,39,39,0
8,28,2018,22,0,3,"Braga",8,"Rua Costa Gomes",0,41,41,-1,42,-43
8,28,2018,23,0,3,"Braga",1,"Avenida da Liberdade",25,25,0,124,124,0
8,28,2018,23,0,3,"Braga",2,"Avenida Central",25,25,0,124,124,0
8,28,2018,23,0,3,"Braga",3,"Rua de Caires",36,36,0,37,37,0
8,28,2018,23,0,3,"Braga",4,"N14 Bosch",47,47,0,48,48,0
8,28,2018,23,0,3,"Braga",5,"Avenida João Paulo II",39,39,0,9,9,0
8,28,2018,23,0,3,"Braga",6,"Avenida Padre Júlio Fragata",52,67,15,107,83,24
8,28,2018,23,0,3,"Braga",7,"Rua Nova Santa Cruz",44,44,0,39,39,0
8,28,2018,23,0,3,"Braga",8,"Rua Costa Gomes",0,41,41,-1,42,-43
8,29,2018,0,0,4,"Braga",1,"Avenida da Liberdade",25,25,0,124,124,0
8,29,2018,0,0,4,"Braga",2,"Avenida Central",25,25,0,124,124,0
8,29,2018,0,0,4,"Braga",3,"Rua de Caires",36,36,0,37,37,0
8,29,2018,0,0,4,"Braga",4,"N14 Bosch",47,47,0,48,48,0
8,29,2018,0,0,4,"Braga",5,"Avenida João Paulo II",39,39,0,9,9,0
8,29,2018,0,0,4,"Braga",6,"Avenida Padre Júlio Fragata",67,67,0,83,83,0
8,29,2018,0,0,4,"Braga",7,"Rua Nova Santa Cruz",44,44,0,39,39,0
8,29,2018,0,0,4,"Braga",8,"Rua Costa Gomes",0,41,41,-1,42,-43
8,29,2018,1,0,4,"Braga",1,"Avenida da Liberdade",25,25,0,124,124,0
8,29,2018,1,0,4,"Braga",2,"Avenida Central",25,25,0,124,124,0
8,29,2018,1,0,4,"Braga",3,"Rua de Caires",36,36,0,37,37,0
8,29,2018,1,0,4,"Braga",4,"N14 Bosch",47,47,0,48,48,0
8,29,2018,1,0,4,"Braga",5,"Avenida João Paulo II",39,39,0,9,9,0
8,29,2018,1,0,4,"Braga",6,"Avenida Padre Júlio Fragata",67,67,0,83,83,0
8,29,2018,1,0,4,"Braga",7,"Rua Nova Santa Cruz",44,44,0,39,39,0
8,29,2018,1,0,4,"Braga",8,"Rua Costa Gomes",0,41,41,-1,42,-43
8,29,2018,2,0,4,"Braga",1,"Avenida da Liberdade",25,25,0,124,124,0
8,29,2018,2,0,4,"Braga",2,"Avenida Central",25,25,0,124,124,0
8,29,2018,2,0,4,"Braga",3,"Rua de Caires",36,36,0,37,37,0
8,29,2018,2,0,4,"Braga",4,"N14 Bosch",47,47,0,48,48,0
8,29,2018,2,0,4,"Braga",5,"Avenida João Paulo II",39,39,0,9,9,0
8,29,2018,2,0,4,"Braga",6,"Avenida Padre Júlio Fragata",67,67,0,83,83,0
8,29,2018,2,0,4,"Braga",7,"Rua Nova Santa Cruz",44,44,0,39,39,0
8,29,2018,2,0,4,"Braga",8,"Rua Costa Gomes",0,41,41,-1,42,-43
8,29,2018,3,0,4,"Braga",1,"Avenida da Liberdade",25,25,0,124,124,0
8,29,2018,3,0,4,"Braga",2,"Avenida Central",25,25,0,124,124,0
8,29,2018,3,0,4,"Braga",3,"Rua de Caires",36,36,0,37,37,0
8,29,2018,3,0,4,"Braga",4,"N14 Bosch",47,47,0,48,48,0
8,29,2018,3,0,4,"Braga",5,"Avenida João Paulo II",39,39,0,9,9,0
8,29,2018,3,0,4,"Braga",6,"Avenida Padre Júlio Fragata",67,67,0,83,83,0
8,29,2018,3,0,4,"Braga",7,"Rua Nova Santa Cruz",44,44,0,39,39,0
8,29,2018,3,0,4,"Braga",8,"Rua Costa Gomes",0,41,41,-1,42,-43
8,29,2018,4,0,4,"Braga",1,"Avenida da Liberdade",25,25,0,124,124,0
8,29,2018,4,0,4,"Braga",2,"Avenida Central",25,25,0,124,124,0
8,29,2018,4,0,4,"Braga",3,"Rua de Caires",36,36,0,37,37,0
8,29,2018,4,0,4,"Braga",4,"N14 Bosch",47,47,0,48,48,0
8,29,2018,4,0,4,"Braga",5,"Avenida João Paulo II",39,39,0,9,9,0
8,29,2018,4,0,4,"Braga",6,"Avenida Padre Júlio Fragata",67,67,0,83,83,0
8,29,2018,4,0,4,"Braga",7,"Rua Nova Santa Cruz",44,44,0,39,39,0
8,29,2018,4,0,4,"Braga",8,"Rua Costa Gomes",0,41,41,-1,42,-43
8,29,2018,5,0,4,"Braga",1,"Avenida da Liberdade",25,25,0,124,124,0
8,29,2018,5,0,4,"Braga",2,"Avenida Central",25,25,0,124,124,0
8,29,2018,5,0,4,"Braga",3,"Rua de Caires",36,36,0,37,37,0
8,29,2018,5,0,4,"Braga",4,"N14 Bosch",47,47,0,48,48,0
8,29,2018,5,0,4,"Braga",5,"Avenida João Paulo II",39,39,0,9,9,0
8,29,2018,5,0,4,"Braga",6,"Avenida Padre Júlio Fragata",67,67,0,83,83,0
8,29,2018,5,0,4,"Braga",7,"Rua Nova Santa Cruz",44,44,0,39,39,0
8,29,2018,5,0,4,"Braga",8,"Rua Costa Gomes",0,41,41,-1,42,-43
8,29,2018,6,0,4,"Braga",1,"Avenida da Liberdade",25,25,0,124,124,0
8,29,2018,6,0,4,"Braga",2,"Avenida Central",25,25,0,124,124,0
8,29,2018,6,0,4,"Braga",3,"Rua de Caires",36,36,0,37,37,0
8,29,2018,6,0,4,"Braga",4,"N14 Bosch",47,47,0,48,48,0
8,29,2018,6,0,4,"Braga",5,"Avenida João Paulo II",39,39,0,9,9,0
8,29,2018,6,0,4,"Braga",6,"Avenida Padre Júlio Fragata",67,67,0,83,83,0
8,29,2018,6,0,4,"Braga",7,"Rua Nova Santa Cruz",44,44,0,39,39,0
8,29,2018,6,0,4,"Braga",8,"Rua Costa Gomes",0,41,41,-1,42,-43
8,29,2018,7,0,4,"Braga",1,"Avenida da Liberdade",25,25,0,124,124,0
8,29,2018,7,0,4,"Braga",2,"Avenida Central",25,25,0,124,124,0
8,29,2018,7,0,4,"Braga",3,"Rua de Caires",36,36,0,37,37,0
8,29,2018,7,0,4,"Braga",4,"N14 Bosch",47,47,0,48,48,0
8,29,2018,7,0,4,"Braga",5,"Avenida João Paulo II",39,39,0,9,9,0
8,29,2018,7,0,4,"Braga",6,"Avenida Padre Júlio Fragata",67,67,0,83,83,0
8,29,2018,7,0,4,"Braga",7,"Rua Nova Santa Cruz",44,44,0,39,39,0
8,29,2018,7,0,4,"Braga",8,"Rua Costa Gomes",0,41,41,-1,42,-43
8,29,2018,8,0,4,"Braga",1,"Avenida da Liberdade",25,25,0,124,124,0
8,29,2018,8,0,4,"Braga",2,"Avenida Central",25,25,0,124,124,0
8,29,2018,8,0,4,"Braga",3,"Rua de Caires",36,36,0,37,37,0
8,29,2018,8,0,4,"Braga",4,"N14 Bosch",47,47,0,48,48,0
8,29,2018,8,0,4,"Braga",5,"Avenida João Paulo II",39,39,0,9,9,0
8,29,2018,8,0,4,"Braga",6,"Avenida Padre Júlio Fragata",67,67,0,83,83,0
8,29,2018,8,0,4,"Braga",7,"Rua Nova Santa Cruz",29,44,15,60,39,21
8,29,2018,8,0,4,"Braga",8,"Rua Costa Gomes",0,41,41,-1,42,-43
8,29,2018,9,0,4,"Braga",1,"Avenida da Liberdade",25,25,0,124,124,0
8,29,2018,9,0,4,"Braga",2,"Avenida Central",25,25,0,124,124,0
8,29,2018,9,0,4,"Braga",3,"Rua de Caires",36,36,0,37,37,0
8,29,2018,9,0,4,"Braga",4,"N14 Bosch",37,47,10,61,48,13
8,29,2018,9,0,4,"Braga",5,"Avenida João Paulo II",39,39,0,9,9,0
8,29,2018,9,0,4,"Braga",6,"Avenida Padre Júlio Fragata",67,67,0,83,83,0
8,29,2018,9,0,4,"Braga",7,"Rua Nova Santa Cruz",44,44,0,39,39,0
8,29,2018,9,0,4,"Braga",8,"Rua Costa Gomes",0,41,41,-1,42,-43
8,29,2018,10,0,4,"Braga",1,"Avenida da Liberdade",25,25,0,124,124,0
8,29,2018,10,0,4,"Braga",2,"Avenida Central",25,25,0,124,124,0
8,29,2018,10,0,4,"Braga",3,"Rua de Caires",11,36,25,122,37,85
8,29,2018,10,0,4,"Braga",4,"N14 Bosch",47,47,0,48,48,0
8,29,2018,10,0,4,"Braga",5,"Avenida João Paulo II",39,39,0,9,9,0
8,29,2018,10,0,4,"Braga",6,"Avenida Padre Júlio Fragata",67,67,0,83,83,0
8,29,2018,10,0,4,"Braga",7,"Rua Nova Santa Cruz",44,44,0,39,39,0
8,29,2018,10,0,4,"Braga",8,"Rua Costa Gomes",0,41,41,-1,42,-43
8,29,2018,11,0,4,"Braga",1,"Avenida da Liberdade",8,25,17,387,124,263
8,29,2018,11,0,4,"Braga",2,"Avenida Central",8,25,17,387,124,263
8,29,2018,11,0,4,"Braga",3,"Rua de Caires",27,36,9,50,37,13
8,29,2018,11,0,4,"Braga",4,"N14 Bosch",31,47,16,72,48,24
8,29,2018,11,0,4,"Braga",5,"Avenida João Paulo II",27,39,12,13,9,4
8,29,2018,11,0,4,"Braga",6,"Avenida Padre Júlio Fragata",67,67,0,83,83,0
8,29,2018,11,0,4,"Braga",7,"Rua Nova Santa Cruz",44,44,0,39,39,0
8,29,2018,11,0,4,"Braga",8,"Rua Costa Gomes",0,41,41,-1,42,-43
8,29,2018,12,0,4,"Braga",1,"Avenida da Liberdade",25,25,0,124,124,0
8,29,2018,12,0,4,"Braga",2,"Avenida Central",25,25,0,124,124,0
8,29,2018,12,0,4,"Braga",3,"Rua de Caires",36,36,0,37,37,0
8,29,2018,12,0,4,"Braga",4,"N14 Bosch",37,47,10,61,48,13
8,29,2018,12,0,4,"Braga",5,"Avenida João Paulo II",39,39,0,9,9,0
8,29,2018,12,0,4,"Braga",6,"Avenida Padre Júlio Fragata",67,67,0,83,83,0
8,29,2018,12,0,4,"Braga",7,"Rua Nova Santa Cruz",44,44,0,39,39,0
8,29,2018,12,0,4,"Braga",8,"Rua Costa Gomes",0,41,41,-1,42,-43
8,29,2018,13,0,4,"Braga",1,"Avenida da Liberdade",25,25,0,124,124,0
8,29,2018,13,0,4,"Braga",2,"Avenida Central",25,25,0,124,124,0
8,29,2018,13,0,4,"Braga",3,"Rua de Caires",25,36,11,54,37,17
8,29,2018,13,0,4,"Braga",4,"N14 Bosch",25,47,22,90,48,42
8,29,2018,13,0,4,"Braga",5,"Avenida João Paulo II",39,39,0,9,9,0
8,29,2018,13,0,4,"Braga",6,"Avenida Padre Júlio Fragata",67,67,0,83,83,0
8,29,2018,13,0,4,"Braga",7,"Rua Nova Santa Cruz",35,44,9,49,39,10
8,29,2018,13,0,4,"Braga",8,"Rua Costa Gomes",0,41,41,-1,42,-43
8,29,2018,14,0,4,"Braga",1,"Avenida da Liberdade",17,25,8,182,124,58
8,29,2018,14,0,4,"Braga",2,"Avenida Central",17,25,8,182,124,58
8,29,2018,14,0,4,"Braga",3,"Rua de Caires",26,36,10,52,37,15
8,29,2018,14,0,4,"Braga",4,"N14 Bosch",47,47,0,48,48,0
8,29,2018,14,0,4,"Braga",5,"Avenida João Paulo II",39,39,0,9,9,0
8,29,2018,14,0,4,"Braga",6,"Avenida Padre Júlio Fragata",67,67,0,83,83,0
8,29,2018,14,0,4,"Braga",7,"Rua Nova Santa Cruz",44,44,0,39,39,0
8,29,2018,14,0,4,"Braga",8,"Rua Costa Gomes",0,41,41,-1,42,-43
8,29,2018,15,0,4,"Braga",1,"Avenida da Liberdade",18,25,7,172,124,48
8,29,2018,15,0,4,"Braga",2,"Avenida Central",18,25,7,172,124,48
8,29,2018,15,0,4,"Braga",3,"Rua de Caires",27,36,9,50,37,13
8,29,2018,15,0,4,"Braga",4,"N14 Bosch",35,47,12,64,48,16
8,29,2018,15,0,4,"Braga",5,"Avenida João Paulo II",39,39,0,9,9,0
8,29,2018,15,0,4,"Braga",6,"Avenida Padre Júlio Fragata",67,67,0,83,83,0
8,29,2018,15,0,4,"Braga",7,"Rua Nova Santa Cruz",44,44,0,39,39,0
8,29,2018,15,0,4,"Braga",8,"Rua Costa Gomes",0,41,41,-1,42,-43
8,29,2018,16,0,4,"Braga",1,"Avenida da Liberdade",18,25,7,172,124,48
8,29,2018,16,0,4,"Braga",2,"Avenida Central",18,25,7,172,124,48
8,29,2018,16,0,4,"Braga",3,"Rua de Caires",24,36,12,56,37,19
8,29,2018,16,0,4,"Braga",4,"N14 Bosch",33,47,14,68,48,20
8,29,2018,16,0,4,"Braga",5,"Avenida João Paulo II",39,39,0,9,9,0
8,29,2018,16,0,4,"Braga",6,"Avenida Padre Júlio Fragata",67,67,0,83,83,0
8,29,2018,16,0,4,"Braga",7,"Rua Nova Santa Cruz",44,44,0,39,39,0
8,29,2018,16,0,4,"Braga",8,"Rua Costa Gomes",0,41,41,-1,42,-43
8,29,2018,17,0,4,"Braga",1,"Avenida da Liberdade",13,25,12,238,124,114
8,29,2018,17,0,4,"Braga",2,"Avenida Central",13,25,12,238,124,114
8,29,2018,17,0,4,"Braga",3,"Rua de Caires",36,36,0,37,37,0
8,29,2018,17,0,4,"Braga",4,"N14 Bosch",23,47,24,98,48,50
8,29,2018,17,0,4,"Braga",5,"Avenida João Paulo II",22,39,17,16,9,7
8,29,2018,17,0,4,"Braga",6,"Avenida Padre Júlio Fragata",47,67,20,119,83,36
8,29,2018,17,0,4,"Braga",7,"Rua Nova Santa Cruz",44,44,0,39,39,0
8,29,2018,17,0,4,"Braga",8,"Rua Costa Gomes",0,41,41,-1,42,-43
8,29,2018,18,0,4,"Braga",1,"Avenida da Liberdade",19,25,6,163,124,39
8,29,2018,18,0,4,"Braga",2,"Avenida Central",19,25,6,163,124,39
8,29,2018,18,0,4,"Braga",3,"Rua de Caires",24,36,12,56,37,19
8,29,2018,18,0,4,"Braga",4,"N14 Bosch",19,47,28,118,48,70
8,29,2018,18,0,4,"Braga",5,"Avenida João Paulo II",30,39,9,12,9,3
8,29,2018,18,0,4,"Braga",6,"Avenida Padre Júlio Fragata",36,67,31,155,83,72
8,29,2018,18,0,4,"Braga",7,"Rua Nova Santa Cruz",44,44,0,39,39,0
8,29,2018,18,0,4,"Braga",8,"Rua Costa Gomes",0,41,41,-1,42,-43
8,29,2018,19,0,4,"Braga",1,"Avenida da Liberdade",25,25,0,124,124,0
8,29,2018,19,0,4,"Braga",2,"Avenida Central",25,25,0,124,124,0
8,29,2018,19,0,4,"Braga",3,"Rua de Caires",36,36,0,37,37,0
8,29,2018,19,0,4,"Braga",4,"N14 Bosch",47,47,0,48,48,0
8,29,2018,19,0,4,"Braga",5,"Avenida João Paulo II",39,39,0,9,9,0
8,29,2018,19,0,4,"Braga",6,"Avenida Padre Júlio Fragata",67,67,0,83,83,0
8,29,2018,19,0,4,"Braga",7,"Rua Nova Santa Cruz",44,44,0,39,39,0
8,29,2018,19,0,4,"Braga",8,"Rua Costa Gomes",0,41,41,-1,42,-43
8,29,2018,20,0,4,"Braga",1,"Avenida da Liberdade",25,25,0,124,124,0
8,29,2018,20,0,4,"Braga",2,"Avenida Central",25,25,0,124,124,0
8,29,2018,20,0,4,"Braga",3,"Rua de Caires",36,36,0,37,37,0
8,29,2018,20,0,4,"Braga",4,"N14 Bosch",47,47,0,48,48,0
8,29,2018,20,0,4,"Braga",5,"Avenida João Paulo II",39,39,0,9,9,0
8,29,2018,20,0,4,"Braga",6,"Avenida Padre Júlio Fragata",67,67,0,83,83,0
8,29,2018,20,0,4,"Braga",7,"Rua Nova Santa Cruz",44,44,0,39,39,0
8,29,2018,20,0,4,"Braga",8,"Rua Costa Gomes",0,41,41,-1,42,-43
8,29,2018,21,0,4,"Braga",1,"Avenida da Liberdade",25,25,0,124,124,0
8,29,2018,21,0,4,"Braga",2,"Avenida Central",25,25,0,124,124,0
8,29,2018,21,0,4,"Braga",3,"Rua de Caires",36,36,0,37,37,0
8,29,2018,21,0,4,"Braga",4,"N14 Bosch",47,47,0,48,48,0
8,29,2018,21,0,4,"Braga",5,"Avenida João Paulo II",28,39,11,12,9,3
8,29,2018,21,0,4,"Braga",6,"Avenida Padre Júlio Fragata",67,67,0,83,83,0
8,29,2018,21,0,4,"Braga",7,"Rua Nova Santa Cruz",44,44,0,39,39,0
8,29,2018,21,0,4,"Braga",8,"Rua Costa Gomes",0,41,41,-1,42,-43
8,29,2018,22,0,4,"Braga",1,"Avenida da Liberdade",25,25,0,124,124,0
8,29,2018,22,0,4,"Braga",2,"Avenida Central",25,25,0,124,124,0
8,29,2018,22,0,4,"Braga",3,"Rua de Caires",36,36,0,37,37,0
8,29,2018,22,0,4,"Braga",4,"N14 Bosch",47,47,0,48,48,0
8,29,2018,22,0,4,"Braga",5,"Avenida João Paulo II",39,39,0,9,9,0
8,29,2018,22,0,4,"Braga",6,"Avenida Padre Júlio Fragata",67,67,0,83,83,0
8,29,2018,22,0,4,"Braga",7,"Rua Nova Santa Cruz",44,44,0,39,39,0
8,29,2018,22,0,4,"Braga",8,"Rua Costa Gomes",0,41,41,-1,42,-43
8,29,2018,23,0,4,"Braga",1,"Avenida da Liberdade",25,25,0,124,124,0
8,29,2018,23,0,4,"Braga",2,"Avenida Central",25,25,0,124,124,0
8,29,2018,23,0,4,"Braga",3,"Rua de Caires",36,36,0,37,37,0
8,29,2018,23,0,4,"Braga",4,"N14 Bosch",47,47,0,48,48,0
8,29,2018,23,0,4,"Braga",5,"Avenida João Paulo II",39,39,0,9,9,0
8,29,2018,23,0,4,"Braga",6,"Avenida Padre Júlio Fragata",67,67,0,83,83,0
8,29,2018,23,0,4,"Braga",7,"Rua Nova Santa Cruz",44,44,0,39,39,0
8,29,2018,23,0,4,"Braga",8,"Rua Costa Gomes",0,41,41,-1,42,-43
8,30,2018,0,0,5,"Braga",1,"Avenida da Liberdade",25,25,0,124,124,0
8,30,2018,0,0,5,"Braga",2,"Avenida Central",25,25,0,124,124,0
8,30,2018,0,0,5,"Braga",3,"Rua de Caires",36,36,0,37,37,0
8,30,2018,0,0,5,"Braga",4,"N14 Bosch",47,47,0,48,48,0
8,30,2018,0,0,5,"Braga",5,"Avenida João Paulo II",39,39,0,9,9,0
8,30,2018,0,0,5,"Braga",6,"Avenida Padre Júlio Fragata",67,67,0,83,83,0
8,30,2018,0,0,5,"Braga",7,"Rua Nova Santa Cruz",44,44,0,39,39,0
8,30,2018,0,0,5,"Braga",8,"Rua Costa Gomes",0,41,41,-1,42,-43
8,30,2018,1,0,5,"Braga",1,"Avenida da Liberdade",25,25,0,124,124,0
8,30,2018,1,0,5,"Braga",2,"Avenida Central",25,25,0,124,124,0
8,30,2018,1,0,5,"Braga",3,"Rua de Caires",36,36,0,37,37,0
8,30,2018,1,0,5,"Braga",4,"N14 Bosch",47,47,0,48,48,0
8,30,2018,1,0,5,"Braga",5,"Avenida João Paulo II",39,39,0,9,9,0
8,30,2018,1,0,5,"Braga",6,"Avenida Padre Júlio Fragata",67,67,0,83,83,0
8,30,2018,1,0,5,"Braga",7,"Rua Nova Santa Cruz",44,44,0,39,39,0
8,30,2018,1,0,5,"Braga",8,"Rua Costa Gomes",0,41,41,-1,42,-43
8,30,2018,2,0,5,"Braga",1,"Avenida da Liberdade",25,25,0,124,124,0
8,30,2018,2,0,5,"Braga",2,"Avenida Central",25,25,0,124,124,0
8,30,2018,2,0,5,"Braga",3,"Rua de Caires",36,36,0,37,37,0
8,30,2018,2,0,5,"Braga",4,"N14 Bosch",47,47,0,48,48,0
8,30,2018,2,0,5,"Braga",5,"Avenida João Paulo II",39,39,0,9,9,0
8,30,2018,2,0,5,"Braga",6,"Avenida Padre Júlio Fragata",67,67,0,83,83,0
8,30,2018,2,0,5,"Braga",7,"Rua Nova Santa Cruz",44,44,0,39,39,0
8,30,2018,2,0,5,"Braga",8,"Rua Costa Gomes",0,41,41,-1,42,-43
8,30,2018,3,0,5,"Braga",1,"Avenida da Liberdade",25,25,0,124,124,0
8,30,2018,3,0,5,"Braga",2,"Avenida Central",25,25,0,124,124,0
8,30,2018,3,0,5,"Braga",3,"Rua de Caires",36,36,0,37,37,0
8,30,2018,3,0,5,"Braga",4,"N14 Bosch",47,47,0,48,48,0
8,30,2018,3,0,5,"Braga",5,"Avenida João Paulo II",39,39,0,9,9,0
8,30,2018,3,0,5,"Braga",6,"Avenida Padre Júlio Fragata",67,67,0,83,83,0
8,30,2018,3,0,5,"Braga",7,"Rua Nova Santa Cruz",44,44,0,39,39,0
8,30,2018,3,0,5,"Braga",8,"Rua Costa Gomes",0,41,41,-1,42,-43
8,30,2018,4,0,5,"Braga",1,"Avenida da Liberdade",25,25,0,124,124,0
8,30,2018,4,0,5,"Braga",2,"Avenida Central",25,25,0,124,124,0
8,30,2018,4,0,5,"Braga",3,"Rua de Caires",36,36,0,37,37,0
8,30,2018,4,0,5,"Braga",4,"N14 Bosch",47,47,0,48,48,0
8,30,2018,4,0,5,"Braga",5,"Avenida João Paulo II",39,39,0,9,9,0
8,30,2018,4,0,5,"Braga",6,"Avenida Padre Júlio Fragata",67,67,0,83,83,0
8,30,2018,4,0,5,"Braga",7,"Rua Nova Santa Cruz",44,44,0,39,39,0
8,30,2018,4,0,5,"Braga",8,"Rua Costa Gomes",0,41,41,-1,42,-43
8,30,2018,5,0,5,"Braga",1,"Avenida da Liberdade",25,25,0,124,124,0
8,30,2018,5,0,5,"Braga",2,"Avenida Central",25,25,0,124,124,0
8,30,2018,5,0,5,"Braga",3,"Rua de Caires",36,36,0,37,37,0
8,30,2018,5,0,5,"Braga",4,"N14 Bosch",47,47,0,48,48,0
8,30,2018,5,0,5,"Braga",5,"Avenida João Paulo II",39,39,0,9,9,0
8,30,2018,5,0,5,"Braga",6,"Avenida Padre Júlio Fragata",67,67,0,83,83,0
8,30,2018,5,0,5,"Braga",7,"Rua Nova Santa Cruz",44,44,0,39,39,0
8,30,2018,5,0,5,"Braga",8,"Rua Costa Gomes",0,41,41,-1,42,-43
8,30,2018,6,0,5,"Braga",1,"Avenida da Liberdade",25,25,0,124,124,0
8,30,2018,6,0,5,"Braga",2,"Avenida Central",25,25,0,124,124,0
8,30,2018,6,0,5,"Braga",3,"Rua de Caires",36,36,0,37,37,0
8,30,2018,6,0,5,"Braga",4,"N14 Bosch",47,47,0,48,48,0
8,30,2018,6,0,5,"Braga",5,"Avenida João Paulo II",30,39,9,12,9,3
8,30,2018,6,0,5,"Braga",6,"Avenida Padre Júlio Fragata",67,67,0,83,83,0
8,30,2018,6,0,5,"Braga",7,"Rua Nova Santa Cruz",44,44,0,39,39,0
8,30,2018,6,0,5,"Braga",8,"Rua Costa Gomes",0,41,41,-1,42,-43
8,30,2018,7,0,5,"Braga",1,"Avenida da Liberdade",25,25,0,124,124,0
8,30,2018,7,0,5,"Braga",2,"Avenida Central",25,25,0,124,124,0
8,30,2018,7,0,5,"Braga",3,"Rua de Caires",36,36,0,37,37,0
8,30,2018,7,0,5,"Braga",4,"N14 Bosch",47,47,0,48,48,0
8,30,2018,7,0,5,"Braga",5,"Avenida João Paulo II",39,39,0,9,9,0
8,30,2018,7,0,5,"Braga",6,"Avenida Padre Júlio Fragata",67,67,0,83,83,0
8,30,2018,7,0,5,"Braga",7,"Rua Nova Santa Cruz",33,44,11,52,39,13
8,30,2018,7,0,5,"Braga",8,"Rua Costa Gomes",0,41,41,-1,42,-43
8,30,2018,8,0,5,"Braga",1,"Avenida da Liberdade",25,25,0,124,124,0
8,30,2018,8,0,5,"Braga",2,"Avenida Central",25,25,0,124,124,0
8,30,2018,8,0,5,"Braga",3,"Rua de Caires",26,36,10,52,37,15
8,30,2018,8,0,5,"Braga",4,"N14 Bosch",28,47,19,80,48,32
8,30,2018,8,0,5,"Braga",5,"Avenida João Paulo II",39,39,0,9,9,0
8,30,2018,8,0,5,"Braga",6,"Avenida Padre Júlio Fragata",67,67,0,83,83,0
8,30,2018,8,0,5,"Braga",7,"Rua Nova Santa Cruz",33,44,11,52,39,13
8,30,2018,8,0,5,"Braga",8,"Rua Costa Gomes",0,41,41,-1,42,-43
8,30,2018,9,0,5,"Braga",1,"Avenida da Liberdade",25,25,0,124,124,0
8,30,2018,9,0,5,"Braga",2,"Avenida Central",25,25,0,124,124,0
8,30,2018,9,0,5,"Braga",3,"Rua de Caires",27,36,9,50,37,13
8,30,2018,9,0,5,"Braga",4,"N14 Bosch",47,47,0,48,48,0
8,30,2018,9,0,5,"Braga",5,"Avenida João Paulo II",39,39,0,9,9,0
8,30,2018,9,0,5,"Braga",6,"Avenida Padre Júlio Fragata",67,67,0,83,83,0
8,30,2018,9,0,5,"Braga",7,"Rua Nova Santa Cruz",44,44,0,39,39,0
8,30,2018,9,0,5,"Braga",8,"Rua Costa Gomes",0,41,41,-1,42,-43
8,30,2018,10,0,5,"Braga",1,"Avenida da Liberdade",25,25,0,124,124,0
8,30,2018,10,0,5,"Braga",2,"Avenida Central",25,25,0,124,124,0
8,30,2018,10,0,5,"Braga",3,"Rua de Caires",28,36,8,48,37,11
8,30,2018,10,0,5,"Braga",4,"N14 Bosch",28,47,19,80,48,32
8,30,2018,10,0,5,"Braga",5,"Avenida João Paulo II",39,39,0,9,9,0
8,30,2018,10,0,5,"Braga",6,"Avenida Padre Júlio Fragata",67,67,0,83,83,0
8,30,2018,10,0,5,"Braga",7,"Rua Nova Santa Cruz",44,44,0,39,39,0
8,30,2018,10,0,5,"Braga",8,"Rua Costa Gomes",0,41,41,-1,42,-43
8,30,2018,11,0,5,"Braga",1,"Avenida da Liberdade",25,25,0,124,124,0
8,30,2018,11,0,5,"Braga",2,"Avenida Central",25,25,0,124,124,0
8,30,2018,11,0,5,"Braga",3,"Rua de Caires",25,36,11,54,37,17
8,30,2018,11,0,5,"Braga",4,"N14 Bosch",47,47,0,48,48,0
8,30,2018,11,0,5,"Braga",5,"Avenida João Paulo II",39,39,0,9,9,0
8,30,2018,11,0,5,"Braga",6,"Avenida Padre Júlio Fragata",67,67,0,83,83,0
8,30,2018,11,0,5,"Braga",7,"Rua Nova Santa Cruz",44,44,0,39,39,0
8,30,2018,11,0,5,"Braga",8,"Rua Costa Gomes",0,41,41,-1,42,-43
8,30,2018,12,0,5,"Braga",1,"Avenida da Liberdade",25,25,0,124,124,0
8,30,2018,12,0,5,"Braga",2,"Avenida Central",25,25,0,124,124,0
8,30,2018,12,0,5,"Braga",3,"Rua de Caires",25,36,11,54,37,17
8,30,2018,12,0,5,"Braga",4,"N14 Bosch",36,47,11,62,48,14
8,30,2018,12,0,5,"Braga",5,"Avenida João Paulo II",39,39,0,9,9,0
8,30,2018,12,0,5,"Braga",6,"Avenida Padre Júlio Fragata",67,67,0,83,83,0
8,30,2018,12,0,5,"Braga",7,"Rua Nova Santa Cruz",44,44,0,39,39,0
8,30,2018,12,0,5,"Braga",8,"Rua Costa Gomes",0,41,41,-1,42,-43
8,30,2018,13,0,5,"Braga",1,"Avenida da Liberdade",25,25,0,124,124,0
8,30,2018,13,0,5,"Braga",2,"Avenida Central",25,25,0,124,124,0
8,30,2018,13,0,5,"Braga",3,"Rua de Caires",36,36,0,37,37,0
8,30,2018,13,0,5,"Braga",4,"N14 Bosch",27,47,20,83,48,35
8,30,2018,13,0,5,"Braga",5,"Avenida João Paulo II",39,39,0,9,9,0
8,30,2018,13,0,5,"Braga",6,"Avenida Padre Júlio Fragata",67,67,0,83,83,0
8,30,2018,13,0,5,"Braga",7,"Rua Nova Santa Cruz",34,44,10,51,39,12
8,30,2018,13,0,5,"Braga",8,"Rua Costa Gomes",0,41,41,-1,42,-43
8,30,2018,14,0,5,"Braga",1,"Avenida da Liberdade",25,25,0,124,124,0
8,30,2018,14,0,5,"Braga",2,"Avenida Central",25,25,0,124,124,0
8,30,2018,14,0,5,"Braga",3,"Rua de Caires",36,36,0,37,37,0
8,30,2018,14,0,5,"Braga",4,"N14 Bosch",17,47,30,132,48,84
8,30,2018,14,0,5,"Braga",5,"Avenida João Paulo II",39,39,0,9,9,0
8,30,2018,14,0,5,"Braga",6,"Avenida Padre Júlio Fragata",67,67,0,83,83,0
8,30,2018,14,0,5,"Braga",7,"Rua Nova Santa Cruz",44,44,0,39,39,0
8,30,2018,14,0,5,"Braga",8,"Rua Costa Gomes",0,41,41,-1,42,-43
8,30,2018,15,0,5,"Braga",1,"Avenida da Liberdade",25,25,0,124,124,0
8,30,2018,15,0,5,"Braga",2,"Avenida Central",25,25,0,124,124,0
8,30,2018,15,0,5,"Braga",3,"Rua de Caires",36,36,0,37,37,0
8,30,2018,15,0,5,"Braga",4,"N14 Bosch",30,47,17,75,48,27
8,30,2018,15,0,5,"Braga",5,"Avenida João Paulo II",39,39,0,9,9,0
8,30,2018,15,0,5,"Braga",6,"Avenida Padre Júlio Fragata",67,67,0,83,83,0
8,30,2018,15,0,5,"Braga",7,"Rua Nova Santa Cruz",44,44,0,39,39,0
8,30,2018,15,0,5,"Braga",8,"Rua Costa Gomes",0,41,41,-1,42,-43
8,30,2018,16,0,5,"Braga",1,"Avenida da Liberdade",25,25,0,124,124,0
8,30,2018,16,0,5,"Braga",2,"Avenida Central",25,25,0,124,124,0
8,30,2018,16,0,5,"Braga",3,"Rua de Caires",36,36,0,37,37,0
8,30,2018,16,0,5,"Braga",4,"N14 Bosch",47,47,0,48,48,0
8,30,2018,16,0,5,"Braga",5,"Avenida João Paulo II",30,39,9,12,9,3
8,30,2018,16,0,5,"Braga",6,"Avenida Padre Júlio Fragata",67,67,0,83,83,0
8,30,2018,16,0,5,"Braga",7,"Rua Nova Santa Cruz",44,44,0,39,39,0
8,30,2018,16,0,5,"Braga",8,"Rua Costa Gomes",0,41,41,-1,42,-43
8,30,2018,17,0,5,"Braga",1,"Avenida da Liberdade",17,25,8,182,124,58
8,30,2018,17,0,5,"Braga",2,"Avenida Central",17,25,8,182,124,58
8,30,2018,17,0,5,"Braga",3,"Rua de Caires",23,36,13,59,37,22
8,30,2018,17,0,5,"Braga",4,"N14 Bosch",30,47,17,75,48,27
8,30,2018,17,0,5,"Braga",5,"Avenida João Paulo II",22,39,17,16,9,7
8,30,2018,17,0,5,"Braga",6,"Avenida Padre Júlio Fragata",50,67,17,111,83,28
8,30,2018,17,0,5,"Braga",7,"Rua Nova Santa Cruz",44,44,0,39,39,0
8,30,2018,17,0,5,"Braga",8,"Rua Costa Gomes",0,41,41,-1,42,-43
8,30,2018,18,0,5,"Braga",1,"Avenida da Liberdade",25,25,0,124,124,0
8,30,2018,18,0,5,"Braga",2,"Avenida Central",25,25,0,124,124,0
8,30,2018,18,0,5,"Braga",3,"Rua de Caires",24,36,12,56,37,19
8,30,2018,18,0,5,"Braga",4,"N14 Bosch",47,47,0,48,48,0
8,30,2018,18,0,5,"Braga",5,"Avenida João Paulo II",39,39,0,9,9,0
8,30,2018,18,0,5,"Braga",6,"Avenida Padre Júlio Fragata",40,67,27,139,83,56
8,30,2018,18,0,5,"Braga",7,"Rua Nova Santa Cruz",44,44,0,39,39,0
8,30,2018,18,0,5,"Braga",8,"Rua Costa Gomes",0,41,41,-1,42,-43
8,30,2018,19,0,5,"Braga",1,"Avenida da Liberdade",25,25,0,124,124,0
8,30,2018,19,0,5,"Braga",2,"Avenida Central",25,25,0,124,124,0
8,30,2018,19,0,5,"Braga",3,"Rua de Caires",24,36,12,56,37,19
8,30,2018,19,0,5,"Braga",4,"N14 Bosch",47,47,0,48,48,0
8,30,2018,19,0,5,"Braga",5,"Avenida João Paulo II",39,39,0,9,9,0
8,30,2018,19,0,5,"Braga",6,"Avenida Padre Júlio Fragata",53,67,14,105,83,22
8,30,2018,19,0,5,"Braga",7,"Rua Nova Santa Cruz",44,44,0,39,39,0
8,30,2018,19,0,5,"Braga",8,"Rua Costa Gomes",0,41,41,-1,42,-43
8,30,2018,20,0,5,"Braga",1,"Avenida da Liberdade",25,25,0,124,124,0
8,30,2018,20,0,5,"Braga",2,"Avenida Central",25,25,0,124,124,0
8,30,2018,20,0,5,"Braga",3,"Rua de Caires",36,36,0,37,37,0
8,30,2018,20,0,5,"Braga",4,"N14 Bosch",47,47,0,48,48,0
8,30,2018,20,0,5,"Braga",5,"Avenida João Paulo II",39,39,0,9,9,0
8,30,2018,20,0,5,"Braga",6,"Avenida Padre Júlio Fragata",67,67,0,83,83,0
8,30,2018,20,0,5,"Braga",7,"Rua Nova Santa Cruz",44,44,0,39,39,0
8,30,2018,20,0,5,"Braga",8,"Rua Costa Gomes",0,41,41,-1,42,-43
8,30,2018,21,0,5,"Braga",1,"Avenida da Liberdade",25,25,0,124,124,0
8,30,2018,21,0,5,"Braga",2,"Avenida Central",25,25,0,124,124,0
8,30,2018,21,0,5,"Braga",3,"Rua de Caires",26,36,10,52,37,15
8,30,2018,21,0,5,"Braga",4,"N14 Bosch",37,47,10,61,48,13
8,30,2018,21,0,5,"Braga",5,"Avenida João Paulo II",39,39,0,9,9,0
8,30,2018,21,0,5,"Braga",6,"Avenida Padre Júlio Fragata",51,67,16,109,83,26
8,30,2018,21,0,5,"Braga",7,"Rua Nova Santa Cruz",44,44,0,39,39,0
8,30,2018,21,0,5,"Braga",8,"Rua Costa Gomes",0,41,41,-1,42,-43
8,30,2018,22,0,5,"Braga",1,"Avenida da Liberdade",25,25,0,124,124,0
8,30,2018,22,0,5,"Braga",2,"Avenida Central",25,25,0,124,124,0
8,30,2018,22,0,5,"Braga",3,"Rua de Caires",28,36,8,48,37,11
8,30,2018,22,0,5,"Braga",4,"N14 Bosch",47,47,0,48,48,0
8,30,2018,22,0,5,"Braga",5,"Avenida João Paulo II",39,39,0,9,9,0
8,30,2018,22,0,5,"Braga",6,"Avenida Padre Júlio Fragata",67,67,0,83,83,0
8,30,2018,22,0,5,"Braga",7,"Rua Nova Santa Cruz",44,44,0,39,39,0
8,30,2018,22,0,5,"Braga",8,"Rua Costa Gomes",0,41,41,-1,42,-43
8,30,2018,23,0,5,"Braga",1,"Avenida da Liberdade",25,25,0,124,124,0
8,30,2018,23,0,5,"Braga",2,"Avenida Central",25,25,0,124,124,0
8,30,2018,23,0,5,"Braga",3,"Rua de Caires",36,36,0,37,37,0
8,30,2018,23,0,5,"Braga",4,"N14 Bosch",47,47,0,48,48,0
8,30,2018,23,0,5,"Braga",5,"Avenida João Paulo II",39,39,0,9,9,0
8,30,2018,23,0,5,"Braga",6,"Avenida Padre Júlio Fragata",67,67,0,83,83,0
8,30,2018,23,0,5,"Braga",7,"Rua Nova Santa Cruz",44,44,0,39,39,0
8,30,2018,23,0,5,"Braga",8,"Rua Costa Gomes",0,41,41,-1,42,-43
8,31,2018,0,0,6,"Braga",1,"Avenida da Liberdade",25,25,0,124,124,0
8,31,2018,0,0,6,"Braga",2,"Avenida Central",25,25,0,124,124,0
8,31,2018,0,0,6,"Braga",3,"Rua de Caires",36,36,0,37,37,0
8,31,2018,0,0,6,"Braga",4,"N14 Bosch",47,47,0,48,48,0
8,31,2018,0,0,6,"Braga",5,"Avenida João Paulo II",39,39,0,9,9,0
8,31,2018,0,0,6,"Braga",6,"Avenida Padre Júlio Fragata",67,67,0,83,83,0
8,31,2018,0,0,6,"Braga",7,"Rua Nova Santa Cruz",44,44,0,39,39,0
8,31,2018,0,0,6,"Braga",8,"Rua Costa Gomes",0,41,41,-1,42,-43
8,31,2018,1,0,6,"Braga",1,"Avenida da Liberdade",25,25,0,124,124,0
8,31,2018,1,0,6,"Braga",2,"Avenida Central",25,25,0,124,124,0
8,31,2018,1,0,6,"Braga",3,"Rua de Caires",36,36,0,37,37,0
8,31,2018,1,0,6,"Braga",4,"N14 Bosch",47,47,0,48,48,0
8,31,2018,1,0,6,"Braga",5,"Avenida João Paulo II",39,39,0,9,9,0
8,31,2018,1,0,6,"Braga",6,"Avenida Padre Júlio Fragata",67,67,0,83,83,0
8,31,2018,1,0,6,"Braga",7,"Rua Nova Santa Cruz",44,44,0,39,39,0
8,31,2018,1,0,6,"Braga",8,"Rua Costa Gomes",0,41,41,-1,42,-43
8,31,2018,2,0,6,"Braga",1,"Avenida da Liberdade",25,25,0,124,124,0
8,31,2018,2,0,6,"Braga",2,"Avenida Central",25,25,0,124,124,0
8,31,2018,2,0,6,"Braga",3,"Rua de Caires",36,36,0,37,37,0
8,31,2018,2,0,6,"Braga",4,"N14 Bosch",47,47,0,48,48,0
8,31,2018,2,0,6,"Braga",5,"Avenida João Paulo II",39,39,0,9,9,0
8,31,2018,2,0,6,"Braga",6,"Avenida Padre Júlio Fragata",67,67,0,83,83,0
8,31,2018,2,0,6,"Braga",7,"Rua Nova Santa Cruz",44,44,0,39,39,0
8,31,2018,2,0,6,"Braga",8,"Rua Costa Gomes",0,41,41,-1,42,-43
8,31,2018,3,0,6,"Braga",1,"Avenida da Liberdade",25,25,0,124,124,0
8,31,2018,3,0,6,"Braga",2,"Avenida Central",25,25,0,124,124,0
8,31,2018,3,0,6,"Braga",3,"Rua de Caires",36,36,0,37,37,0
8,31,2018,3,0,6,"Braga",4,"N14 Bosch",47,47,0,48,48,0
8,31,2018,3,0,6,"Braga",5,"Avenida João Paulo II",39,39,0,9,9,0
8,31,2018,3,0,6,"Braga",6,"Avenida Padre Júlio Fragata",67,67,0,83,83,0
8,31,2018,3,0,6,"Braga",7,"Rua Nova Santa Cruz",44,44,0,39,39,0
8,31,2018,3,0,6,"Braga",8,"Rua Costa Gomes",0,41,41,-1,42,-43
8,31,2018,4,0,6,"Braga",1,"Avenida da Liberdade",25,25,0,124,124,0
8,31,2018,4,0,6,"Braga",2,"Avenida Central",25,25,0,124,124,0
8,31,2018,4,0,6,"Braga",3,"Rua de Caires",36,36,0,37,37,0
8,31,2018,4,0,6,"Braga",4,"N14 Bosch",47,47,0,48,48,0
8,31,2018,4,0,6,"Braga",5,"Avenida João Paulo II",39,39,0,9,9,0
8,31,2018,4,0,6,"Braga",6,"Avenida Padre Júlio Fragata",67,67,0,83,83,0
8,31,2018,4,0,6,"Braga",7,"Rua Nova Santa Cruz",44,44,0,39,39,0
8,31,2018,4,0,6,"Braga",8,"Rua Costa Gomes",0,41,41,-1,42,-43
8,31,2018,5,0,6,"Braga",1,"Avenida da Liberdade",25,25,0,124,124,0
8,31,2018,5,0,6,"Braga",2,"Avenida Central",25,25,0,124,124,0
8,31,2018,5,0,6,"Braga",3,"Rua de Caires",36,36,0,37,37,0
8,31,2018,5,0,6,"Braga",4,"N14 Bosch",47,47,0,48,48,0
8,31,2018,5,0,6,"Braga",5,"Avenida João Paulo II",39,39,0,9,9,0
8,31,2018,5,0,6,"Braga",6,"Avenida Padre Júlio Fragata",67,67,0,83,83,0
8,31,2018,5,0,6,"Braga",7,"Rua Nova Santa Cruz",44,44,0,39,39,0
8,31,2018,5,0,6,"Braga",8,"Rua Costa Gomes",0,41,41,-1,42,-43
8,31,2018,6,0,6,"Braga",1,"Avenida da Liberdade",25,25,0,124,124,0
8,31,2018,6,0,6,"Braga",2,"Avenida Central",25,25,0,124,124,0
8,31,2018,6,0,6,"Braga",3,"Rua de Caires",36,36,0,37,37,0
8,31,2018,6,0,6,"Braga",4,"N14 Bosch",47,47,0,48,48,0
8,31,2018,6,0,6,"Braga",5,"Avenida João Paulo II",39,39,0,9,9,0
8,31,2018,6,0,6,"Braga",6,"Avenida Padre Júlio Fragata",67,67,0,83,83,0
8,31,2018,6,0,6,"Braga",7,"Rua Nova Santa Cruz",44,44,0,39,39,0
8,31,2018,6,0,6,"Braga",8,"Rua Costa Gomes",0,41,41,-1,42,-43
8,31,2018,7,0,6,"Braga",1,"Avenida da Liberdade",25,25,0,124,124,0
8,31,2018,7,0,6,"Braga",2,"Avenida Central",25,25,0,124,124,0
8,31,2018,7,0,6,"Braga",3,"Rua de Caires",36,36,0,37,37,0
8,31,2018,7,0,6,"Braga",4,"N14 Bosch",47,47,0,48,48,0
8,31,2018,7,0,6,"Braga",5,"Avenida João Paulo II",39,39,0,9,9,0
8,31,2018,7,0,6,"Braga",6,"Avenida Padre Júlio Fragata",67,67,0,83,83,0
8,31,2018,7,0,6,"Braga",7,"Rua Nova Santa Cruz",34,44,10,51,39,12
8,31,2018,7,0,6,"Braga",8,"Rua Costa Gomes",0,41,41,-1,42,-43
8,31,2018,8,0,6,"Braga",1,"Avenida da Liberdade",25,25,0,124,124,0
8,31,2018,8,0,6,"Braga",2,"Avenida Central",25,25,0,124,124,0
8,31,2018,8,0,6,"Braga",3,"Rua de Caires",23,36,13,59,37,22
8,31,2018,8,0,6,"Braga",4,"N14 Bosch",14,47,33,160,48,112
8,31,2018,8,0,6,"Braga",5,"Avenida João Paulo II",39,39,0,9,9,0
8,31,2018,8,0,6,"Braga",6,"Avenida Padre Júlio Fragata",67,67,0,83,83,0
8,31,2018,8,0,6,"Braga",7,"Rua Nova Santa Cruz",44,44,0,39,39,0
8,31,2018,8,0,6,"Braga",8,"Rua Costa Gomes",0,41,41,-1,42,-43
8,31,2018,9,0,6,"Braga",1,"Avenida da Liberdade",25,25,0,124,124,0
8,31,2018,9,0,6,"Braga",2,"Avenida Central",25,25,0,124,124,0
8,31,2018,9,0,6,"Braga",3,"Rua de Caires",21,36,15,64,37,27
8,31,2018,9,0,6,"Braga",4,"N14 Bosch",32,47,15,70,48,22
8,31,2018,9,0,6,"Braga",5,"Avenida João Paulo II",39,39,0,9,9,0
8,31,2018,9,0,6,"Braga",6,"Avenida Padre Júlio Fragata",67,67,0,83,83,0
8,31,2018,9,0,6,"Braga",7,"Rua Nova Santa Cruz",44,44,0,39,39,0
8,31,2018,9,0,6,"Braga",8,"Rua Costa Gomes",0,41,41,-1,42,-43
8,31,2018,10,0,6,"Braga",1,"Avenida da Liberdade",25,25,0,124,124,0
8,31,2018,10,0,6,"Braga",2,"Avenida Central",25,25,0,124,124,0
8,31,2018,10,0,6,"Braga",3,"Rua de Caires",16,36,20,84,37,47
8,31,2018,10,0,6,"Braga",4,"N14 Bosch",37,47,10,61,48,13
8,31,2018,10,0,6,"Braga",5,"Avenida João Paulo II",39,39,0,9,9,0
8,31,2018,10,0,6,"Braga",6,"Avenida Padre Júlio Fragata",67,67,0,83,83,0
8,31,2018,10,0,6,"Braga",7,"Rua Nova Santa Cruz",44,44,0,39,39,0
8,31,2018,10,0,6,"Braga",8,"Rua Costa Gomes",0,41,41,-1,42,-43
8,31,2018,11,0,6,"Braga",1,"Avenida da Liberdade",16,25,9,194,124,70
8,31,2018,11,0,6,"Braga",2,"Avenida Central",16,25,9,194,124,70
8,31,2018,11,0,6,"Braga",3,"Rua de Caires",27,36,9,50,37,13
8,31,2018,11,0,6,"Braga",4,"N14 Bosch",26,47,21,86,48,38
8,31,2018,11,0,6,"Braga",5,"Avenida João Paulo II",39,39,0,9,9,0
8,31,2018,11,0,6,"Braga",6,"Avenida Padre Júlio Fragata",67,67,0,83,83,0
8,31,2018,11,0,6,"Braga",7,"Rua Nova Santa Cruz",44,44,0,39,39,0
8,31,2018,11,0,6,"Braga",8,"Rua Costa Gomes",0,41,41,-1,42,-43
8,31,2018,12,0,6,"Braga",1,"Avenida da Liberdade",17,25,8,182,124,58
8,31,2018,12,0,6,"Braga",2,"Avenida Central",17,25,8,182,124,58
8,31,2018,12,0,6,"Braga",3,"Rua de Caires",36,36,0,37,37,0
8,31,2018,12,0,6,"Braga",4,"N14 Bosch",47,47,0,48,48,0
8,31,2018,12,0,6,"Braga",5,"Avenida João Paulo II",39,39,0,9,9,0
8,31,2018,12,0,6,"Braga",6,"Avenida Padre Júlio Fragata",67,67,0,83,83,0
8,31,2018,12,0,6,"Braga",7,"Rua Nova Santa Cruz",44,44,0,39,39,0
8,31,2018,12,0,6,"Braga",8,"Rua Costa Gomes",0,41,41,-1,42,-43
8,31,2018,13,0,6,"Braga",1,"Avenida da Liberdade",25,25,0,124,124,0
8,31,2018,13,0,6,"Braga",2,"Avenida Central",25,25,0,124,124,0
8,31,2018,13,0,6,"Braga",3,"Rua de Caires",26,36,10,52,37,15
8,31,2018,13,0,6,"Braga",4,"N14 Bosch",32,47,15,70,48,22
8,31,2018,13,0,6,"Braga",5,"Avenida João Paulo II",39,39,0,9,9,0
8,31,2018,13,0,6,"Braga",6,"Avenida Padre Júlio Fragata",67,67,0,83,83,0
8,31,2018,13,0,6,"Braga",7,"Rua Nova Santa Cruz",33,44,11,52,39,13
8,31,2018,13,0,6,"Braga",8,"Rua Costa Gomes",0,41,41,-1,42,-43
8,31,2018,14,0,6,"Braga",1,"Avenida da Liberdade",25,25,0,124,124,0
8,31,2018,14,0,6,"Braga",2,"Avenida Central",25,25,0,124,124,0
8,31,2018,14,0,6,"Braga",3,"Rua de Caires",28,36,8,48,37,11
8,31,2018,14,0,6,"Braga",4,"N14 Bosch",35,47,12,64,48,16
8,31,2018,14,0,6,"Braga",5,"Avenida João Paulo II",25,39,14,14,9,5
8,31,2018,14,0,6,"Braga",6,"Avenida Padre Júlio Fragata",67,67,0,83,83,0
8,31,2018,14,0,6,"Braga",7,"Rua Nova Santa Cruz",44,44,0,39,39,0
8,31,2018,14,0,6,"Braga",8,"Rua Costa Gomes",0,41,41,-1,42,-43
8,31,2018,15,0,6,"Braga",1,"Avenida da Liberdade",19,25,6,163,124,39
8,31,2018,15,0,6,"Braga",2,"Avenida Central",19,25,6,163,124,39
8,31,2018,15,0,6,"Braga",3,"Rua de Caires",36,36,0,37,37,0
8,31,2018,15,0,6,"Braga",4,"N14 Bosch",47,47,0,48,48,0
8,31,2018,15,0,6,"Braga",5,"Avenida João Paulo II",39,39,0,9,9,0
8,31,2018,15,0,6,"Braga",6,"Avenida Padre Júlio Fragata",20,67,47,279,83,196
8,31,2018,15,0,6,"Braga",7,"Rua Nova Santa Cruz",44,44,0,39,39,0
8,31,2018,15,0,6,"Braga",8,"Rua Costa Gomes",0,41,41,-1,42,-43
8,31,2018,16,0,6,"Braga",1,"Avenida da Liberdade",17,25,8,182,124,58
8,31,2018,16,0,6,"Braga",2,"Avenida Central",17,25,8,182,124,58
8,31,2018,16,0,6,"Braga",3,"Rua de Caires",22,36,14,61,37,24
8,31,2018,16,0,6,"Braga",4,"N14 Bosch",16,47,31,140,48,92
8,31,2018,16,0,6,"Braga",5,"Avenida João Paulo II",39,39,0,9,9,0
8,31,2018,16,0,6,"Braga",6,"Avenida Padre Júlio Fragata",31,67,36,180,83,97
8,31,2018,16,0,6,"Braga",7,"Rua Nova Santa Cruz",44,44,0,39,39,0
8,31,2018,16,0,6,"Braga",8,"Rua Costa Gomes",0,41,41,-1,42,-43
8,31,2018,17,0,6,"Braga",1,"Avenida da Liberdade",15,25,10,207,124,83
8,31,2018,17,0,6,"Braga",2,"Avenida Central",15,25,10,207,124,83
8,31,2018,17,0,6,"Braga",3,"Rua de Caires",6,36,30,224,37,187
8,31,2018,17,0,6,"Braga",4,"N14 Bosch",19,47,28,118,48,70
8,31,2018,17,0,6,"Braga",5,"Avenida João Paulo II",29,39,10,12,9,3
8,31,2018,17,0,6,"Braga",6,"Avenida Padre Júlio Fragata",67,67,0,83,83,0
8,31,2018,17,0,6,"Braga",7,"Rua Nova Santa Cruz",44,44,0,39,39,0
8,31,2018,17,0,6,"Braga",8,"Rua Costa Gomes",0,41,41,-1,42,-43
8,31,2018,18,0,6,"Braga",1,"Avenida da Liberdade",18,25,7,172,124,48
8,31,2018,18,0,6,"Braga",2,"Avenida Central",18,25,7,172,124,48
8,31,2018,18,0,6,"Braga",3,"Rua de Caires",25,36,11,54,37,17
8,31,2018,18,0,6,"Braga",4,"N14 Bosch",31,47,16,72,48,24
8,31,2018,18,0,6,"Braga",5,"Avenida João Paulo II",39,39,0,9,9,0
8,31,2018,18,0,6,"Braga",6,"Avenida Padre Júlio Fragata",67,67,0,83,83,0
8,31,2018,18,0,6,"Braga",7,"Rua Nova Santa Cruz",44,44,0,39,39,0
8,31,2018,18,0,6,"Braga",8,"Rua Costa Gomes",0,41,41,-1,42,-43
8,31,2018,19,0,6,"Braga",1,"Avenida da Liberdade",25,25,0,124,124,0
8,31,2018,19,0,6,"Braga",2,"Avenida Central",25,25,0,124,124,0
8,31,2018,19,0,6,"Braga",3,"Rua de Caires",36,36,0,37,37,0
8,31,2018,19,0,6,"Braga",4,"N14 Bosch",47,47,0,48,48,0
8,31,2018,19,0,6,"Braga",5,"Avenida João Paulo II",28,39,11,12,9,3
8,31,2018,19,0,6,"Braga",6,"Avenida Padre Júlio Fragata",13,67,54,429,83,346
8,31,2018,19,0,6,"Braga",7,"Rua Nova Santa Cruz",44,44,0,39,39,0
8,31,2018,19,0,6,"Braga",8,"Rua Costa Gomes",0,41,41,-1,42,-43
8,31,2018,20,0,6,"Braga",1,"Avenida da Liberdade",25,25,0,124,124,0
8,31,2018,20,0,6,"Braga",2,"Avenida Central",25,25,0,124,124,0
8,31,2018,20,0,6,"Braga",3,"Rua de Caires",36,36,0,37,37,0
8,31,2018,20,0,6,"Braga",4,"N14 Bosch",47,47,0,48,48,0
8,31,2018,20,0,6,"Braga",5,"Avenida João Paulo II",20,39,19,17,9,8
8,31,2018,20,0,6,"Braga",6,"Avenida Padre Júlio Fragata",67,67,0,83,83,0
8,31,2018,20,0,6,"Braga",7,"Rua Nova Santa Cruz",44,44,0,39,39,0
8,31,2018,20,0,6,"Braga",8,"Rua Costa Gomes",0,41,41,-1,42,-43
8,31,2018,21,0,6,"Braga",1,"Avenida da Liberdade",25,25,0,124,124,0
8,31,2018,21,0,6,"Braga",2,"Avenida Central",25,25,0,124,124,0
8,31,2018,21,0,6,"Braga",3,"Rua de Caires",25,36,11,54,37,17
8,31,2018,21,0,6,"Braga",4,"N14 Bosch",47,47,0,48,48,0
8,31,2018,21,0,6,"Braga",5,"Avenida João Paulo II",39,39,0,9,9,0
8,31,2018,21,0,6,"Braga",6,"Avenida Padre Júlio Fragata",67,67,0,83,83,0
8,31,2018,21,0,6,"Braga",7,"Rua Nova Santa Cruz",44,44,0,39,39,0
8,31,2018,21,0,6,"Braga",8,"Rua Costa Gomes",0,41,41,-1,42,-43
8,31,2018,22,0,6,"Braga",1,"Avenida da Liberdade",25,25,0,124,124,0
8,31,2018,22,0,6,"Braga",2,"Avenida Central",25,25,0,124,124,0
8,31,2018,22,0,6,"Braga",3,"Rua de Caires",16,36,20,84,37,47
8,31,2018,22,0,6,"Braga",4,"N14 Bosch",47,47,0,48,48,0
8,31,2018,22,0,6,"Braga",5,"Avenida João Paulo II",39,39,0,9,9,0
8,31,2018,22,0,6,"Braga",6,"Avenida Padre Júlio Fragata",67,67,0,83,83,0
8,31,2018,22,0,6,"Braga",7,"Rua Nova Santa Cruz",44,44,0,39,39,0
8,31,2018,22,0,6,"Braga",8,"Rua Costa Gomes",0,41,41,-1,42,-43
8,31,2018,23,0,6,"Braga",1,"Avenida da Liberdade",25,25,0,124,124,0
8,31,2018,23,0,6,"Braga",2,"Avenida Central",25,25,0,124,124,0
8,31,2018,23,0,6,"Braga",3,"Rua de Caires",36,36,0,37,37,0
8,31,2018,23,0,6,"Braga",4,"N14 Bosch",47,47,0,48,48,0
8,31,2018,23,0,6,"Braga",5,"Avenida João Paulo II",39,39,0,9,9,0
8,31,2018,23,0,6,"Braga",6,"Avenida Padre Júlio Fragata",67,67,0,83,83,0
8,31,2018,23,0,6,"Braga",7,"Rua Nova Santa Cruz",26,44,18,66,39,27
8,31,2018,23,0,6,"Braga",8,"Rua Costa Gomes",0,41,41,-1,42,-43
9,1,2018,0,0,7,"Braga",1,"Avenida da Liberdade",25,25,0,124,124,0
9,1,2018,0,0,7,"Braga",2,"Avenida Central",25,25,0,124,124,0
9,1,2018,0,0,7,"Braga",3,"Rua de Caires",26,36,10,52,37,15
9,1,2018,0,0,7,"Braga",4,"N14 Bosch",47,47,0,48,48,0
9,1,2018,0,0,7,"Braga",5,"Avenida João Paulo II",39,39,0,9,9,0
9,1,2018,0,0,7,"Braga",6,"Avenida Padre Júlio Fragata",67,67,0,83,83,0
9,1,2018,0,0,7,"Braga",7,"Rua Nova Santa Cruz",44,44,0,39,39,0
9,1,2018,0,0,7,"Braga",8,"Rua Costa Gomes",0,41,41,-1,42,-43
9,1,2018,1,0,7,"Braga",1,"Avenida da Liberdade",25,25,0,124,124,0
9,1,2018,1,0,7,"Braga",2,"Avenida Central",25,25,0,124,124,0
9,1,2018,1,0,7,"Braga",3,"Rua de Caires",36,36,0,37,37,0
9,1,2018,1,0,7,"Braga",4,"N14 Bosch",47,47,0,48,48,0
9,1,2018,1,0,7,"Braga",5,"Avenida João Paulo II",39,39,0,9,9,0
9,1,2018,1,0,7,"Braga",6,"Avenida Padre Júlio Fragata",67,67,0,83,83,0
9,1,2018,1,0,7,"Braga",7,"Rua Nova Santa Cruz",44,44,0,39,39,0
9,1,2018,1,0,7,"Braga",8,"Rua Costa Gomes",0,41,41,-1,42,-43
9,1,2018,2,0,7,"Braga",1,"Avenida da Liberdade",25,25,0,124,124,0
9,1,2018,2,0,7,"Braga",2,"Avenida Central",25,25,0,124,124,0
9,1,2018,2,0,7,"Braga",3,"Rua de Caires",36,36,0,37,37,0
9,1,2018,2,0,7,"Braga",4,"N14 Bosch",47,47,0,48,48,0
9,1,2018,2,0,7,"Braga",5,"Avenida João Paulo II",39,39,0,9,9,0
9,1,2018,2,0,7,"Braga",6,"Avenida Padre Júlio Fragata",67,67,0,83,83,0
9,1,2018,2,0,7,"Braga",7,"Rua Nova Santa Cruz",44,44,0,39,39,0
9,1,2018,2,0,7,"Braga",8,"Rua Costa Gomes",0,41,41,-1,42,-43
9,1,2018,3,0,7,"Braga",1,"Avenida da Liberdade",19,25,6,163,124,39
9,1,2018,3,0,7,"Braga",2,"Avenida Central",19,25,6,163,124,39
9,1,2018,3,0,7,"Braga",3,"Rua de Caires",36,36,0,37,37,0
9,1,2018,3,0,7,"Braga",4,"N14 Bosch",47,47,0,48,48,0
9,1,2018,3,0,7,"Braga",5,"Avenida João Paulo II",39,39,0,9,9,0
9,1,2018,3,0,7,"Braga",6,"Avenida Padre Júlio Fragata",67,67,0,83,83,0
9,1,2018,3,0,7,"Braga",7,"Rua Nova Santa Cruz",44,44,0,39,39,0
9,1,2018,3,0,7,"Braga",8,"Rua Costa Gomes",0,41,41,-1,42,-43
9,1,2018,4,0,7,"Braga",1,"Avenida da Liberdade",25,25,0,124,124,0
9,1,2018,4,0,7,"Braga",2,"Avenida Central",25,25,0,124,124,0
9,1,2018,4,0,7,"Braga",3,"Rua de Caires",36,36,0,37,37,0
9,1,2018,4,0,7,"Braga",4,"N14 Bosch",47,47,0,48,48,0
9,1,2018,4,0,7,"Braga",5,"Avenida João Paulo II",39,39,0,9,9,0
9,1,2018,4,0,7,"Braga",6,"Avenida Padre Júlio Fragata",67,67,0,83,83,0
9,1,2018,4,0,7,"Braga",7,"Rua Nova Santa Cruz",44,44,0,39,39,0
9,1,2018,4,0,7,"Braga",8,"Rua Costa Gomes",0,41,41,-1,42,-43
9,1,2018,5,0,7,"Braga",1,"Avenida da Liberdade",25,25,0,124,124,0
9,1,2018,5,0,7,"Braga",2,"Avenida Central",25,25,0,124,124,0
9,1,2018,5,0,7,"Braga",3,"Rua de Caires",36,36,0,37,37,0
9,1,2018,5,0,7,"Braga",4,"N14 Bosch",47,47,0,48,48,0
9,1,2018,5,0,7,"Braga",5,"Avenida João Paulo II",39,39,0,9,9,0
9,1,2018,5,0,7,"Braga",6,"Avenida Padre Júlio Fragata",67,67,0,83,83,0
9,1,2018,5,0,7,"Braga",7,"Rua Nova Santa Cruz",44,44,0,39,39,0
9,1,2018,5,0,7,"Braga",8,"Rua Costa Gomes",0,41,41,-1,42,-43
9,1,2018,6,0,7,"Braga",1,"Avenida da Liberdade",25,25,0,124,124,0
9,1,2018,6,0,7,"Braga",2,"Avenida Central",25,25,0,124,124,0
9,1,2018,6,0,7,"Braga",3,"Rua de Caires",36,36,0,37,37,0
9,1,2018,6,0,7,"Braga",4,"N14 Bosch",47,47,0,48,48,0
9,1,2018,6,0,7,"Braga",5,"Avenida João Paulo II",39,39,0,9,9,0
9,1,2018,6,0,7,"Braga",6,"Avenida Padre Júlio Fragata",67,67,0,83,83,0
9,1,2018,6,0,7,"Braga",7,"Rua Nova Santa Cruz",44,44,0,39,39,0
9,1,2018,6,0,7,"Braga",8,"Rua Costa Gomes",0,41,41,-1,42,-43
9,1,2018,7,0,7,"Braga",1,"Avenida da Liberdade",25,25,0,124,124,0
9,1,2018,7,0,7,"Braga",2,"Avenida Central",25,25,0,124,124,0
9,1,2018,7,0,7,"Braga",3,"Rua de Caires",36,36,0,37,37,0
9,1,2018,7,0,7,"Braga",4,"N14 Bosch",47,47,0,48,48,0
9,1,2018,7,0,7,"Braga",5,"Avenida João Paulo II",39,39,0,9,9,0
9,1,2018,7,0,7,"Braga",6,"Avenida Padre Júlio Fragata",67,67,0,83,83,0
9,1,2018,7,0,7,"Braga",7,"Rua Nova Santa Cruz",44,44,0,39,39,0
9,1,2018,7,0,7,"Braga",8,"Rua Costa Gomes",0,41,41,-1,42,-43
9,1,2018,8,0,7,"Braga",1,"Avenida da Liberdade",19,25,6,163,124,39
9,1,2018,8,0,7,"Braga",2,"Avenida Central",19,25,6,163,124,39
9,1,2018,8,0,7,"Braga",3,"Rua de Caires",36,36,0,37,37,0
9,1,2018,8,0,7,"Braga",4,"N14 Bosch",47,47,0,48,48,0
9,1,2018,8,0,7,"Braga",5,"Avenida João Paulo II",39,39,0,9,9,0
9,1,2018,8,0,7,"Braga",6,"Avenida Padre Júlio Fragata",67,67,0,83,83,0
9,1,2018,8,0,7,"Braga",7,"Rua Nova Santa Cruz",44,44,0,39,39,0
9,1,2018,8,0,7,"Braga",8,"Rua Costa Gomes",0,41,41,-1,42,-43
9,1,2018,9,0,7,"Braga",1,"Avenida da Liberdade",25,25,0,124,124,0
9,1,2018,9,0,7,"Braga",2,"Avenida Central",25,25,0,124,124,0
9,1,2018,9,0,7,"Braga",3,"Rua de Caires",36,36,0,37,37,0
9,1,2018,9,0,7,"Braga",4,"N14 Bosch",47,47,0,48,48,0
9,1,2018,9,0,7,"Braga",5,"Avenida João Paulo II",39,39,0,9,9,0
9,1,2018,9,0,7,"Braga",6,"Avenida Padre Júlio Fragata",28,67,39,199,83,116
9,1,2018,9,0,7,"Braga",7,"Rua Nova Santa Cruz",44,44,0,39,39,0
9,1,2018,9,0,7,"Braga",8,"Rua Costa Gomes",0,41,41,-1,42,-43
9,1,2018,10,0,7,"Braga",1,"Avenida da Liberdade",25,25,0,124,124,0
9,1,2018,10,0,7,"Braga",2,"Avenida Central",25,25,0,124,124,0
9,1,2018,10,0,7,"Braga",3,"Rua de Caires",27,36,9,50,37,13
9,1,2018,10,0,7,"Braga",4,"N14 Bosch",47,47,0,48,48,0
9,1,2018,10,0,7,"Braga",5,"Avenida João Paulo II",30,39,9,12,9,3
9,1,2018,10,0,7,"Braga",6,"Avenida Padre Júlio Fragata",67,67,0,83,83,0
9,1,2018,10,0,7,"Braga",7,"Rua Nova Santa Cruz",44,44,0,39,39,0
9,1,2018,10,0,7,"Braga",8,"Rua Costa Gomes",0,41,41,-1,42,-43
9,1,2018,12,0,7,"Braga",1,"Avenida da Liberdade",19,25,6,163,124,39
9,1,2018,12,0,7,"Braga",2,"Avenida Central",19,25,6,163,124,39
9,1,2018,12,0,7,"Braga",3,"Rua de Caires",36,36,0,37,37,0
9,1,2018,12,0,7,"Braga",4,"N14 Bosch",37,47,10,61,48,13
9,1,2018,12,0,7,"Braga",5,"Avenida João Paulo II",39,39,0,9,9,0
9,1,2018,12,0,7,"Braga",6,"Avenida Padre Júlio Fragata",67,67,0,83,83,0
9,1,2018,12,0,7,"Braga",7,"Rua Nova Santa Cruz",44,44,0,39,39,0
9,1,2018,12,0,7,"Braga",8,"Rua Costa Gomes",0,41,41,-1,42,-43
9,1,2018,15,0,7,"Braga",1,"Avenida da Liberdade",25,25,0,124,124,0
9,1,2018,15,0,7,"Braga",2,"Avenida Central",25,25,0,124,124,0
9,1,2018,15,0,7,"Braga",3,"Rua de Caires",36,36,0,37,37,0
9,1,2018,15,0,7,"Braga",4,"N14 Bosch",47,47,0,48,48,0
9,1,2018,15,0,7,"Braga",5,"Avenida João Paulo II",39,39,0,9,9,0
9,1,2018,15,0,7,"Braga",6,"Avenida Padre Júlio Fragata",67,67,0,83,83,0
9,1,2018,15,0,7,"Braga",7,"Rua Nova Santa Cruz",44,44,0,39,39,0
9,1,2018,15,0,7,"Braga",8,"Rua Costa Gomes",0,41,41,-1,42,-43
9,1,2018,16,0,7,"Braga",1,"Avenida da Liberdade",25,25,0,124,124,0
9,1,2018,16,0,7,"Braga",2,"Avenida Central",25,25,0,124,124,0
9,1,2018,16,0,7,"Braga",3,"Rua de Caires",36,36,0,37,37,0
9,1,2018,16,0,7,"Braga",4,"N14 Bosch",47,47,0,48,48,0
9,1,2018,16,0,7,"Braga",5,"Avenida João Paulo II",39,39,0,9,9,0
9,1,2018,16,0,7,"Braga",6,"Avenida Padre Júlio Fragata",67,67,0,83,83,0
9,1,2018,16,0,7,"Braga",7,"Rua Nova Santa Cruz",44,44,0,39,39,0
9,1,2018,16,0,7,"Braga",8,"Rua Costa Gomes",0,41,41,-1,42,-43
9,1,2018,17,0,7,"Braga",1,"Avenida da Liberdade",16,25,9,194,124,70
9,1,2018,17,0,7,"Braga",2,"Avenida Central",16,25,9,194,124,70
9,1,2018,17,0,7,"Braga",3,"Rua de Caires",27,36,9,50,37,13
9,1,2018,17,0,7,"Braga",4,"N14 Bosch",47,47,0,48,48,0
9,1,2018,17,0,7,"Braga",5,"Avenida João Paulo II",39,39,0,9,9,0
9,1,2018,17,0,7,"Braga",6,"Avenida Padre Júlio Fragata",67,67,0,83,83,0
9,1,2018,17,0,7,"Braga",7,"Rua Nova Santa Cruz",44,44,0,39,39,0
9,1,2018,17,0,7,"Braga",8,"Rua Costa Gomes",0,41,41,-1,42,-43
9,1,2018,18,0,7,"Braga",1,"Avenida da Liberdade",25,25,0,124,124,0
9,1,2018,18,0,7,"Braga",2,"Avenida Central",25,25,0,124,124,0
9,1,2018,18,0,7,"Braga",3,"Rua de Caires",36,36,0,37,37,0
9,1,2018,18,0,7,"Braga",4,"N14 Bosch",47,47,0,48,48,0
9,1,2018,18,0,7,"Braga",5,"Avenida João Paulo II",31,39,8,11,9,2
9,1,2018,18,0,7,"Braga",6,"Avenida Padre Júlio Fragata",67,67,0,83,83,0
9,1,2018,18,0,7,"Braga",7,"Rua Nova Santa Cruz",44,44,0,39,39,0
9,1,2018,18,0,7,"Braga",8,"Rua Costa Gomes",0,41,41,-1,42,-43
9,1,2018,19,0,7,"Braga",1,"Avenida da Liberdade",19,25,6,163,124,39
9,1,2018,19,0,7,"Braga",2,"Avenida Central",19,25,6,163,124,39
9,1,2018,19,0,7,"Braga",3,"Rua de Caires",36,36,0,37,37,0
9,1,2018,19,0,7,"Braga",4,"N14 Bosch",47,47,0,48,48,0
9,1,2018,19,0,7,"Braga",5,"Avenida João Paulo II",39,39,0,9,9,0
9,1,2018,19,0,7,"Braga",6,"Avenida Padre Júlio Fragata",67,67,0,83,83,0
9,1,2018,19,0,7,"Braga",7,"Rua Nova Santa Cruz",44,44,0,39,39,0
9,1,2018,19,0,7,"Braga",8,"Rua Costa Gomes",0,41,41,-1,42,-43
9,1,2018,20,0,7,"Braga",1,"Avenida da Liberdade",25,25,0,124,124,0
9,1,2018,20,0,7,"Braga",2,"Avenida Central",25,25,0,124,124,0
9,1,2018,20,0,7,"Braga",3,"Rua de Caires",28,36,8,48,37,11
9,1,2018,20,0,7,"Braga",4,"N14 Bosch",36,47,11,62,48,14
9,1,2018,20,0,7,"Braga",5,"Avenida João Paulo II",39,39,0,9,9,0
9,1,2018,20,0,7,"Braga",6,"Avenida Padre Júlio Fragata",67,67,0,83,83,0
9,1,2018,20,0,7,"Braga",7,"Rua Nova Santa Cruz",44,44,0,39,39,0
9,1,2018,20,0,7,"Braga",8,"Rua Costa Gomes",0,41,41,-1,42,-43
9,1,2018,21,0,7,"Braga",1,"Avenida da Liberdade",25,25,0,124,124,0
9,1,2018,21,0,7,"Braga",2,"Avenida Central",25,25,0,124,124,0
9,1,2018,21,0,7,"Braga",3,"Rua de Caires",36,36,0,37,37,0
9,1,2018,21,0,7,"Braga",4,"N14 Bosch",37,47,10,61,48,13
9,1,2018,21,0,7,"Braga",5,"Avenida João Paulo II",39,39,0,9,9,0
9,1,2018,21,0,7,"Braga",6,"Avenida Padre Júlio Fragata",67,67,0,83,83,0
9,1,2018,21,0,7,"Braga",7,"Rua Nova Santa Cruz",44,44,0,39,39,0
9,1,2018,21,0,7,"Braga",8,"Rua Costa Gomes",0,41,41,-1,42,-43
9,1,2018,22,0,7,"Braga",1,"Avenida da Liberdade",16,25,9,194,124,70
9,1,2018,22,0,7,"Braga",2,"Avenida Central",16,25,9,194,124,70
9,1,2018,22,0,7,"Braga",3,"Rua de Caires",13,36,23,104,37,67
9,1,2018,22,0,7,"Braga",4,"N14 Bosch",28,47,19,80,48,32
9,1,2018,22,0,7,"Braga",5,"Avenida João Paulo II",39,39,0,9,9,0
9,1,2018,22,0,7,"Braga",6,"Avenida Padre Júlio Fragata",67,67,0,83,83,0
9,1,2018,22,0,7,"Braga",7,"Rua Nova Santa Cruz",44,44,0,39,39,0
9,1,2018,22,0,7,"Braga",8,"Rua Costa Gomes",0,41,41,-1,42,-43
9,1,2018,23,0,7,"Braga",1,"Avenida da Liberdade",13,25,12,238,124,114
9,1,2018,23,0,7,"Braga",2,"Avenida Central",13,25,12,238,124,114
9,1,2018,23,0,7,"Braga",3,"Rua de Caires",25,36,11,54,37,17
9,1,2018,23,0,7,"Braga",4,"N14 Bosch",47,47,0,48,48,0
9,1,2018,23,0,7,"Braga",5,"Avenida João Paulo II",39,39,0,9,9,0
9,1,2018,23,0,7,"Braga",6,"Avenida Padre Júlio Fragata",67,67,0,83,83,0
9,1,2018,23,0,7,"Braga",7,"Rua Nova Santa Cruz",44,44,0,39,39,0
9,1,2018,23,0,7,"Braga",8,"Rua Costa Gomes",0,41,41,-1,42,-43
9,2,2018,0,0,8,"Braga",1,"Avenida da Liberdade",18,25,7,172,124,48
9,2,2018,0,0,8,"Braga",2,"Avenida Central",18,25,7,172,124,48
9,2,2018,0,0,8,"Braga",3,"Rua de Caires",25,36,11,54,37,17
9,2,2018,0,0,8,"Braga",4,"N14 Bosch",47,47,0,48,48,0
9,2,2018,0,0,8,"Braga",5,"Avenida João Paulo II",39,39,0,9,9,0
9,2,2018,0,0,8,"Braga",6,"Avenida Padre Júlio Fragata",67,67,0,83,83,0
9,2,2018,0,0,8,"Braga",7,"Rua Nova Santa Cruz",44,44,0,39,39,0
9,2,2018,0,0,8,"Braga",8,"Rua Costa Gomes",0,41,41,-1,42,-43
9,2,2018,1,0,8,"Braga",1,"Avenida da Liberdade",19,25,6,163,124,39
9,2,2018,1,0,8,"Braga",2,"Avenida Central",19,25,6,163,124,39
9,2,2018,1,0,8,"Braga",3,"Rua de Caires",36,36,0,37,37,0
9,2,2018,1,0,8,"Braga",4,"N14 Bosch",47,47,0,48,48,0
9,2,2018,1,0,8,"Braga",5,"Avenida João Paulo II",39,39,0,9,9,0
9,2,2018,1,0,8,"Braga",6,"Avenida Padre Júlio Fragata",67,67,0,83,83,0
9,2,2018,1,0,8,"Braga",7,"Rua Nova Santa Cruz",44,44,0,39,39,0
9,2,2018,1,0,8,"Braga",8,"Rua Costa Gomes",0,41,41,-1,42,-43
9,2,2018,2,0,8,"Braga",1,"Avenida da Liberdade",25,25,0,124,124,0
9,2,2018,2,0,8,"Braga",2,"Avenida Central",25,25,0,124,124,0
9,2,2018,2,0,8,"Braga",3,"Rua de Caires",28,36,8,48,37,11
9,2,2018,2,0,8,"Braga",4,"N14 Bosch",47,47,0,48,48,0
9,2,2018,2,0,8,"Braga",5,"Avenida João Paulo II",39,39,0,9,9,0
9,2,2018,2,0,8,"Braga",6,"Avenida Padre Júlio Fragata",67,67,0,83,83,0
9,2,2018,2,0,8,"Braga",7,"Rua Nova Santa Cruz",44,44,0,39,39,0
9,2,2018,2,0,8,"Braga",8,"Rua Costa Gomes",0,41,41,-1,42,-43
9,2,2018,3,0,8,"Braga",1,"Avenida da Liberdade",16,25,9,194,124,70
9,2,2018,3,0,8,"Braga",2,"Avenida Central",16,25,9,194,124,70
9,2,2018,3,0,8,"Braga",3,"Rua de Caires",36,36,0,37,37,0
9,2,2018,3,0,8,"Braga",4,"N14 Bosch",47,47,0,48,48,0
9,2,2018,3,0,8,"Braga",5,"Avenida João Paulo II",39,39,0,9,9,0
9,2,2018,3,0,8,"Braga",6,"Avenida Padre Júlio Fragata",67,67,0,83,83,0
9,2,2018,3,0,8,"Braga",7,"Rua Nova Santa Cruz",44,44,0,39,39,0
9,2,2018,3,0,8,"Braga",8,"Rua Costa Gomes",0,41,41,-1,42,-43
9,2,2018,4,0,8,"Braga",1,"Avenida da Liberdade",25,25,0,124,124,0
9,2,2018,4,0,8,"Braga",2,"Avenida Central",25,25,0,124,124,0
9,2,2018,4,0,8,"Braga",3,"Rua de Caires",36,36,0,37,37,0
9,2,2018,4,0,8,"Braga",4,"N14 Bosch",47,47,0,48,48,0
9,2,2018,4,0,8,"Braga",5,"Avenida João Paulo II",39,39,0,9,9,0
9,2,2018,4,0,8,"Braga",6,"Avenida Padre Júlio Fragata",67,67,0,83,83,0
9,2,2018,4,0,8,"Braga",7,"Rua Nova Santa Cruz",44,44,0,39,39,0
9,2,2018,4,0,8,"Braga",8,"Rua Costa Gomes",0,41,41,-1,42,-43
9,2,2018,5,0,8,"Braga",1,"Avenida da Liberdade",25,25,0,124,124,0
9,2,2018,5,0,8,"Braga",2,"Avenida Central",25,25,0,124,124,0
9,2,2018,5,0,8,"Braga",3,"Rua de Caires",36,36,0,37,37,0
9,2,2018,5,0,8,"Braga",4,"N14 Bosch",47,47,0,48,48,0
9,2,2018,5,0,8,"Braga",5,"Avenida João Paulo II",39,39,0,9,9,0
9,2,2018,5,0,8,"Braga",6,"Avenida Padre Júlio Fragata",67,67,0,83,83,0
9,2,2018,5,0,8,"Braga",7,"Rua Nova Santa Cruz",44,44,0,39,39,0
9,2,2018,5,0,8,"Braga",8,"Rua Costa Gomes",0,41,41,-1,42,-43
9,2,2018,6,0,8,"Braga",1,"Avenida da Liberdade",25,25,0,124,124,0
9,2,2018,6,0,8,"Braga",2,"Avenida Central",25,25,0,124,124,0
9,2,2018,6,0,8,"Braga",3,"Rua de Caires",36,36,0,37,37,0
9,2,2018,6,0,8,"Braga",4,"N14 Bosch",47,47,0,48,48,0
9,2,2018,6,0,8,"Braga",5,"Avenida João Paulo II",39,39,0,9,9,0
9,2,2018,6,0,8,"Braga",6,"Avenida Padre Júlio Fragata",67,67,0,83,83,0
9,2,2018,6,0,8,"Braga",7,"Rua Nova Santa Cruz",44,44,0,39,39,0
9,2,2018,6,0,8,"Braga",8,"Rua Costa Gomes",0,41,41,-1,42,-43
9,2,2018,7,0,8,"Braga",1,"Avenida da Liberdade",25,25,0,124,124,0
9,2,2018,7,0,8,"Braga",2,"Avenida Central",25,25,0,124,124,0
9,2,2018,7,0,8,"Braga",3,"Rua de Caires",36,36,0,37,37,0
9,2,2018,7,0,8,"Braga",4,"N14 Bosch",47,47,0,48,48,0
9,2,2018,7,0,8,"Braga",5,"Avenida João Paulo II",39,39,0,9,9,0
9,2,2018,7,0,8,"Braga",6,"Avenida Padre Júlio Fragata",67,67,0,83,83,0
9,2,2018,7,0,8,"Braga",7,"Rua Nova Santa Cruz",44,44,0,39,39,0
9,2,2018,7,0,8,"Braga",8,"Rua Costa Gomes",0,41,41,-1,42,-43
9,2,2018,9,0,8,"Braga",1,"Avenida da Liberdade",25,25,0,124,124,0
9,2,2018,9,0,8,"Braga",2,"Avenida Central",25,25,0,124,124,0
9,2,2018,9,0,8,"Braga",3,"Rua de Caires",36,36,0,37,37,0
9,2,2018,9,0,8,"Braga",4,"N14 Bosch",47,47,0,48,48,0
9,2,2018,9,0,8,"Braga",5,"Avenida João Paulo II",39,39,0,9,9,0
9,2,2018,9,0,8,"Braga",6,"Avenida Padre Júlio Fragata",67,67,0,83,83,0
9,2,2018,9,0,8,"Braga",7,"Rua Nova Santa Cruz",44,44,0,39,39,0
9,2,2018,9,0,8,"Braga",8,"Rua Costa Gomes",0,41,41,-1,42,-43
9,2,2018,10,0,8,"Braga",1,"Avenida da Liberdade",25,25,0,124,124,0
9,2,2018,10,0,8,"Braga",2,"Avenida Central",25,25,0,124,124,0
9,2,2018,10,0,8,"Braga",3,"Rua de Caires",25,36,11,54,37,17
9,2,2018,10,0,8,"Braga",4,"N14 Bosch",47,47,0,48,48,0
9,2,2018,10,0,8,"Braga",5,"Avenida João Paulo II",39,39,0,9,9,0
9,2,2018,10,0,8,"Braga",6,"Avenida Padre Júlio Fragata",67,67,0,83,83,0
9,2,2018,10,0,8,"Braga",7,"Rua Nova Santa Cruz",44,44,0,39,39,0
9,2,2018,10,0,8,"Braga",8,"Rua Costa Gomes",0,41,41,-1,42,-43
9,2,2018,12,0,8,"Braga",1,"Avenida da Liberdade",25,25,0,124,124,0
9,2,2018,12,0,8,"Braga",2,"Avenida Central",25,25,0,124,124,0
9,2,2018,12,0,8,"Braga",3,"Rua de Caires",36,36,0,37,37,0
9,2,2018,12,0,8,"Braga",4,"N14 Bosch",47,47,0,48,48,0
9,2,2018,12,0,8,"Braga",5,"Avenida João Paulo II",39,39,0,9,9,0
9,2,2018,12,0,8,"Braga",6,"Avenida Padre Júlio Fragata",67,67,0,83,83,0
9,2,2018,12,0,8,"Braga",7,"Rua Nova Santa Cruz",44,44,0,39,39,0
9,2,2018,12,0,8,"Braga",8,"Rua Costa Gomes",0,41,41,-1,42,-43
9,2,2018,13,0,8,"Braga",1,"Avenida da Liberdade",19,25,6,163,124,39
9,2,2018,13,0,8,"Braga",2,"Avenida Central",19,25,6,163,124,39
9,2,2018,13,0,8,"Braga",3,"Rua de Caires",36,36,0,37,37,0
9,2,2018,13,0,8,"Braga",4,"N14 Bosch",47,47,0,48,48,0
9,2,2018,13,0,8,"Braga",5,"Avenida João Paulo II",39,39,0,9,9,0
9,2,2018,13,0,8,"Braga",6,"Avenida Padre Júlio Fragata",67,67,0,83,83,0
9,2,2018,13,0,8,"Braga",7,"Rua Nova Santa Cruz",44,44,0,39,39,0
9,2,2018,13,0,8,"Braga",8,"Rua Costa Gomes",0,41,41,-1,42,-43
9,2,2018,14,0,8,"Braga",1,"Avenida da Liberdade",13,25,12,238,124,114
9,2,2018,14,0,8,"Braga",2,"Avenida Central",13,25,12,238,124,114
9,2,2018,14,0,8,"Braga",3,"Rua de Caires",36,36,0,37,37,0
9,2,2018,14,0,8,"Braga",4,"N14 Bosch",47,47,0,48,48,0
9,2,2018,14,0,8,"Braga",5,"Avenida João Paulo II",39,39,0,9,9,0
9,2,2018,14,0,8,"Braga",6,"Avenida Padre Júlio Fragata",67,67,0,83,83,0
9,2,2018,14,0,8,"Braga",7,"Rua Nova Santa Cruz",44,44,0,39,39,0
9,2,2018,14,0,8,"Braga",8,"Rua Costa Gomes",0,41,41,-1,42,-43
9,2,2018,17,0,8,"Braga",1,"Avenida da Liberdade",25,25,0,124,124,0
9,2,2018,17,0,8,"Braga",2,"Avenida Central",25,25,0,124,124,0
9,2,2018,17,0,8,"Braga",3,"Rua de Caires",36,36,0,37,37,0
9,2,2018,17,0,8,"Braga",4,"N14 Bosch",47,47,0,48,48,0
9,2,2018,17,0,8,"Braga",5,"Avenida João Paulo II",31,39,8,11,9,2
9,2,2018,17,0,8,"Braga",6,"Avenida Padre Júlio Fragata",67,67,0,83,83,0
9,2,2018,17,0,8,"Braga",7,"Rua Nova Santa Cruz",44,44,0,39,39,0
9,2,2018,17,0,8,"Braga",8,"Rua Costa Gomes",0,41,41,-1,42,-43
9,2,2018,19,0,8,"Braga",1,"Avenida da Liberdade",25,25,0,124,124,0
9,2,2018,19,0,8,"Braga",2,"Avenida Central",25,25,0,124,124,0
9,2,2018,19,0,8,"Braga",3,"Rua de Caires",28,36,8,48,37,11
9,2,2018,19,0,8,"Braga",4,"N14 Bosch",47,47,0,48,48,0
9,2,2018,19,0,8,"Braga",5,"Avenida João Paulo II",39,39,0,9,9,0
9,2,2018,19,0,8,"Braga",6,"Avenida Padre Júlio Fragata",67,67,0,83,83,0
9,2,2018,19,0,8,"Braga",7,"Rua Nova Santa Cruz",44,44,0,39,39,0
9,2,2018,19,0,8,"Braga",8,"Rua Costa Gomes",0,41,41,-1,42,-43
9,2,2018,20,0,8,"Braga",1,"Avenida da Liberdade",25,25,0,124,124,0
9,2,2018,20,0,8,"Braga",2,"Avenida Central",25,25,0,124,124,0
9,2,2018,20,0,8,"Braga",3,"Rua de Caires",36,36,0,37,37,0
9,2,2018,20,0,8,"Braga",4,"N14 Bosch",47,47,0,48,48,0
9,2,2018,20,0,8,"Braga",5,"Avenida João Paulo II",39,39,0,9,9,0
9,2,2018,20,0,8,"Braga",6,"Avenida Padre Júlio Fragata",67,67,0,83,83,0
9,2,2018,20,0,8,"Braga",7,"Rua Nova Santa Cruz",44,44,0,39,39,0
9,2,2018,20,0,8,"Braga",8,"Rua Costa Gomes",0,41,41,-1,42,-43
9,2,2018,21,0,8,"Braga",1,"Avenida da Liberdade",25,25,0,124,124,0
9,2,2018,21,0,8,"Braga",2,"Avenida Central",25,25,0,124,124,0
9,2,2018,21,0,8,"Braga",3,"Rua de Caires",36,36,0,37,37,0
9,2,2018,21,0,8,"Braga",4,"N14 Bosch",28,47,19,80,48,32
9,2,2018,21,0,8,"Braga",5,"Avenida João Paulo II",39,39,0,9,9,0
9,2,2018,21,0,8,"Braga",6,"Avenida Padre Júlio Fragata",67,67,0,83,83,0
9,2,2018,21,0,8,"Braga",7,"Rua Nova Santa Cruz",44,44,0,39,39,0
9,2,2018,21,0,8,"Braga",8,"Rua Costa Gomes",0,41,41,-1,42,-43
9,2,2018,22,0,8,"Braga",1,"Avenida da Liberdade",25,25,0,124,124,0
9,2,2018,22,0,8,"Braga",2,"Avenida Central",25,25,0,124,124,0
9,2,2018,22,0,8,"Braga",3,"Rua de Caires",36,36,0,37,37,0
9,2,2018,22,0,8,"Braga",4,"N14 Bosch",47,47,0,48,48,0
9,2,2018,22,0,8,"Braga",5,"Avenida João Paulo II",39,39,0,9,9,0
9,2,2018,22,0,8,"Braga",6,"Avenida Padre Júlio Fragata",67,67,0,83,83,0
9,2,2018,22,0,8,"Braga",7,"Rua Nova Santa Cruz",44,44,0,39,39,0
9,2,2018,22,0,8,"Braga",8,"Rua Costa Gomes",0,41,41,-1,42,-43
9,2,2018,23,0,8,"Braga",1,"Avenida da Liberdade",25,25,0,124,124,0
9,2,2018,23,0,8,"Braga",2,"Avenida Central",25,25,0,124,124,0
9,2,2018,23,0,8,"Braga",3,"Rua de Caires",36,36,0,37,37,0
9,2,2018,23,0,8,"Braga",4,"N14 Bosch",47,47,0,48,48,0
9,2,2018,23,0,8,"Braga",5,"Avenida João Paulo II",39,39,0,9,9,0
9,2,2018,23,0,8,"Braga",6,"Avenida Padre Júlio Fragata",67,67,0,83,83,0
9,2,2018,23,0,8,"Braga",7,"Rua Nova Santa Cruz",44,44,0,39,39,0
9,2,2018,23,0,8,"Braga",8,"Rua Costa Gomes",0,41,41,-1,42,-43
9,3,2018,0,0,2,"Braga",1,"Avenida da Liberdade",25,25,0,124,124,0
9,3,2018,0,0,2,"Braga",2,"Avenida Central",25,25,0,124,124,0
9,3,2018,0,0,2,"Braga",3,"Rua de Caires",36,36,0,37,37,0
9,3,2018,0,0,2,"Braga",4,"N14 Bosch",47,47,0,48,48,0
9,3,2018,0,0,2,"Braga",5,"Avenida João Paulo II",39,39,0,9,9,0
9,3,2018,0,0,2,"Braga",6,"Avenida Padre Júlio Fragata",67,67,0,83,83,0
9,3,2018,0,0,2,"Braga",7,"Rua Nova Santa Cruz",44,44,0,39,39,0
9,3,2018,0,0,2,"Braga",8,"Rua Costa Gomes",0,41,41,-1,42,-43
9,3,2018,1,0,2,"Braga",1,"Avenida da Liberdade",25,25,0,124,124,0
9,3,2018,1,0,2,"Braga",2,"Avenida Central",25,25,0,124,124,0
9,3,2018,1,0,2,"Braga",3,"Rua de Caires",36,36,0,37,37,0
9,3,2018,1,0,2,"Braga",4,"N14 Bosch",47,47,0,48,48,0
9,3,2018,1,0,2,"Braga",5,"Avenida João Paulo II",39,39,0,9,9,0
9,3,2018,1,0,2,"Braga",6,"Avenida Padre Júlio Fragata",67,67,0,83,83,0
9,3,2018,1,0,2,"Braga",7,"Rua Nova Santa Cruz",44,44,0,39,39,0
9,3,2018,1,0,2,"Braga",8,"Rua Costa Gomes",0,41,41,-1,42,-43
9,3,2018,2,0,2,"Braga",1,"Avenida da Liberdade",25,25,0,124,124,0
9,3,2018,2,0,2,"Braga",2,"Avenida Central",25,25,0,124,124,0
9,3,2018,2,0,2,"Braga",3,"Rua de Caires",36,36,0,37,37,0
9,3,2018,2,0,2,"Braga",4,"N14 Bosch",47,47,0,48,48,0
9,3,2018,2,0,2,"Braga",5,"Avenida João Paulo II",39,39,0,9,9,0
9,3,2018,2,0,2,"Braga",6,"Avenida Padre Júlio Fragata",67,67,0,83,83,0
9,3,2018,2,0,2,"Braga",7,"Rua Nova Santa Cruz",44,44,0,39,39,0
9,3,2018,2,0,2,"Braga",8,"Rua Costa Gomes",0,41,41,-1,42,-43
9,3,2018,3,0,2,"Braga",1,"Avenida da Liberdade",25,25,0,124,124,0
9,3,2018,3,0,2,"Braga",2,"Avenida Central",25,25,0,124,124,0
9,3,2018,3,0,2,"Braga",3,"Rua de Caires",36,36,0,37,37,0
9,3,2018,3,0,2,"Braga",4,"N14 Bosch",47,47,0,48,48,0
9,3,2018,3,0,2,"Braga",5,"Avenida João Paulo II",39,39,0,9,9,0
9,3,2018,3,0,2,"Braga",6,"Avenida Padre Júlio Fragata",67,67,0,83,83,0
9,3,2018,3,0,2,"Braga",7,"Rua Nova Santa Cruz",44,44,0,39,39,0
9,3,2018,3,0,2,"Braga",8,"Rua Costa Gomes",0,41,41,-1,42,-43
9,3,2018,4,0,2,"Braga",1,"Avenida da Liberdade",25,25,0,124,124,0
9,3,2018,4,0,2,"Braga",2,"Avenida Central",25,25,0,124,124,0
9,3,2018,4,0,2,"Braga",3,"Rua de Caires",36,36,0,37,37,0
9,3,2018,4,0,2,"Braga",4,"N14 Bosch",47,47,0,48,48,0
9,3,2018,4,0,2,"Braga",5,"Avenida João Paulo II",39,39,0,9,9,0
9,3,2018,4,0,2,"Braga",6,"Avenida Padre Júlio Fragata",67,67,0,83,83,0
9,3,2018,4,0,2,"Braga",7,"Rua Nova Santa Cruz",44,44,0,39,39,0
9,3,2018,4,0,2,"Braga",8,"Rua Costa Gomes",0,41,41,-1,42,-43
9,3,2018,5,0,2,"Braga",1,"Avenida da Liberdade",25,25,0,124,124,0
9,3,2018,5,0,2,"Braga",2,"Avenida Central",25,25,0,124,124,0
9,3,2018,5,0,2,"Braga",3,"Rua de Caires",36,36,0,37,37,0
9,3,2018,5,0,2,"Braga",4,"N14 Bosch",47,47,0,48,48,0
9,3,2018,5,0,2,"Braga",5,"Avenida João Paulo II",39,39,0,9,9,0
9,3,2018,5,0,2,"Braga",6,"Avenida Padre Júlio Fragata",67,67,0,83,83,0
9,3,2018,5,0,2,"Braga",7,"Rua Nova Santa Cruz",44,44,0,39,39,0
9,3,2018,5,0,2,"Braga",8,"Rua Costa Gomes",0,41,41,-1,42,-43
9,3,2018,6,0,2,"Braga",1,"Avenida da Liberdade",25,25,0,124,124,0
9,3,2018,6,0,2,"Braga",2,"Avenida Central",25,25,0,124,124,0
9,3,2018,6,0,2,"Braga",3,"Rua de Caires",36,36,0,37,37,0
9,3,2018,6,0,2,"Braga",4,"N14 Bosch",47,47,0,48,48,0
9,3,2018,6,0,2,"Braga",5,"Avenida João Paulo II",39,39,0,9,9,0
9,3,2018,6,0,2,"Braga",6,"Avenida Padre Júlio Fragata",67,67,0,83,83,0
9,3,2018,6,0,2,"Braga",7,"Rua Nova Santa Cruz",44,44,0,39,39,0
9,3,2018,6,0,2,"Braga",8,"Rua Costa Gomes",0,41,41,-1,42,-43
9,3,2018,7,0,2,"Braga",1,"Avenida da Liberdade",25,25,0,124,124,0
9,3,2018,7,0,2,"Braga",2,"Avenida Central",25,25,0,124,124,0
9,3,2018,7,0,2,"Braga",3,"Rua de Caires",36,36,0,37,37,0
9,3,2018,7,0,2,"Braga",4,"N14 Bosch",35,47,12,64,48,16
9,3,2018,7,0,2,"Braga",5,"Avenida João Paulo II",39,39,0,9,9,0
9,3,2018,7,0,2,"Braga",6,"Avenida Padre Júlio Fragata",67,67,0,83,83,0
9,3,2018,7,0,2,"Braga",7,"Rua Nova Santa Cruz",33,44,11,52,39,13
9,3,2018,7,0,2,"Braga",8,"Rua Costa Gomes",0,41,41,-1,42,-43
9,3,2018,8,0,2,"Braga",1,"Avenida da Liberdade",25,25,0,124,124,0
9,3,2018,8,0,2,"Braga",2,"Avenida Central",25,25,0,124,124,0
9,3,2018,8,0,2,"Braga",3,"Rua de Caires",36,36,0,37,37,0
9,3,2018,8,0,2,"Braga",4,"N14 Bosch",27,47,20,83,48,35
9,3,2018,8,0,2,"Braga",5,"Avenida João Paulo II",39,39,0,9,9,0
9,3,2018,8,0,2,"Braga",6,"Avenida Padre Júlio Fragata",67,67,0,83,83,0
9,3,2018,8,0,2,"Braga",7,"Rua Nova Santa Cruz",44,44,0,39,39,0
9,3,2018,8,0,2,"Braga",8,"Rua Costa Gomes",0,41,41,-1,42,-43
9,3,2018,9,0,2,"Braga",1,"Avenida da Liberdade",25,25,0,124,124,0
9,3,2018,9,0,2,"Braga",2,"Avenida Central",25,25,0,124,124,0
9,3,2018,9,0,2,"Braga",3,"Rua de Caires",28,36,8,48,37,11
9,3,2018,9,0,2,"Braga",4,"N14 Bosch",35,47,12,64,48,16
9,3,2018,9,0,2,"Braga",5,"Avenida João Paulo II",28,39,11,12,9,3
9,3,2018,9,0,2,"Braga",6,"Avenida Padre Júlio Fragata",67,67,0,83,83,0
9,3,2018,9,0,2,"Braga",7,"Rua Nova Santa Cruz",44,44,0,39,39,0
9,3,2018,9,0,2,"Braga",8,"Rua Costa Gomes",0,41,41,-1,42,-43
9,3,2018,10,0,2,"Braga",1,"Avenida da Liberdade",19,25,6,163,124,39
9,3,2018,10,0,2,"Braga",2,"Avenida Central",19,25,6,163,124,39
9,3,2018,10,0,2,"Braga",3,"Rua de Caires",36,36,0,37,37,0
9,3,2018,10,0,2,"Braga",4,"N14 Bosch",18,47,29,125,48,77
9,3,2018,10,0,2,"Braga",5,"Avenida João Paulo II",39,39,0,9,9,0
9,3,2018,10,0,2,"Braga",6,"Avenida Padre Júlio Fragata",67,67,0,83,83,0
9,3,2018,10,0,2,"Braga",7,"Rua Nova Santa Cruz",44,44,0,39,39,0
9,3,2018,10,0,2,"Braga",8,"Rua Costa Gomes",0,41,41,-1,42,-43
9,3,2018,11,0,2,"Braga",1,"Avenida da Liberdade",25,25,0,124,124,0
9,3,2018,11,0,2,"Braga",2,"Avenida Central",25,25,0,124,124,0
9,3,2018,11,0,2,"Braga",3,"Rua de Caires",28,36,8,48,37,11
9,3,2018,11,0,2,"Braga",4,"N14 Bosch",15,47,32,150,48,102
9,3,2018,11,0,2,"Braga",5,"Avenida João Paulo II",29,39,10,12,9,3
9,3,2018,11,0,2,"Braga",6,"Avenida Padre Júlio Fragata",67,67,0,83,83,0
9,3,2018,11,0,2,"Braga",7,"Rua Nova Santa Cruz",30,44,14,58,39,19
9,3,2018,11,0,2,"Braga",8,"Rua Costa Gomes",0,41,41,-1,42,-43
9,3,2018,12,0,2,"Braga",1,"Avenida da Liberdade",25,25,0,124,124,0
9,3,2018,12,0,2,"Braga",2,"Avenida Central",25,25,0,124,124,0
9,3,2018,12,0,2,"Braga",3,"Rua de Caires",27,36,9,50,37,13
9,3,2018,12,0,2,"Braga",4,"N14 Bosch",17,47,30,132,48,84
9,3,2018,12,0,2,"Braga",5,"Avenida João Paulo II",39,39,0,9,9,0
9,3,2018,12,0,2,"Braga",6,"Avenida Padre Júlio Fragata",67,67,0,83,83,0
9,3,2018,12,0,2,"Braga",7,"Rua Nova Santa Cruz",44,44,0,39,39,0
9,3,2018,12,0,2,"Braga",8,"Rua Costa Gomes",0,41,41,-1,42,-43
9,3,2018,13,0,2,"Braga",1,"Avenida da Liberdade",25,25,0,124,124,0
9,3,2018,13,0,2,"Braga",2,"Avenida Central",25,25,0,124,124,0
9,3,2018,13,0,2,"Braga",3,"Rua de Caires",28,36,8,48,37,11
9,3,2018,13,0,2,"Braga",4,"N14 Bosch",47,47,0,48,48,0
9,3,2018,13,0,2,"Braga",5,"Avenida João Paulo II",39,39,0,9,9,0
9,3,2018,13,0,2,"Braga",6,"Avenida Padre Júlio Fragata",67,67,0,83,83,0
9,3,2018,13,0,2,"Braga",7,"Rua Nova Santa Cruz",30,44,14,58,39,19
9,3,2018,13,0,2,"Braga",8,"Rua Costa Gomes",0,41,41,-1,42,-43
9,3,2018,14,0,2,"Braga",1,"Avenida da Liberdade",14,25,11,221,124,97
9,3,2018,14,0,2,"Braga",2,"Avenida Central",14,25,11,221,124,97
9,3,2018,14,0,2,"Braga",3,"Rua de Caires",24,36,12,56,37,19
9,3,2018,14,0,2,"Braga",4,"N14 Bosch",25,47,22,90,48,42
9,3,2018,14,0,2,"Braga",5,"Avenida João Paulo II",39,39,0,9,9,0
9,3,2018,14,0,2,"Braga",6,"Avenida Padre Júlio Fragata",67,67,0,83,83,0
9,3,2018,14,0,2,"Braga",7,"Rua Nova Santa Cruz",33,44,11,52,39,13
9,3,2018,14,0,2,"Braga",8,"Rua Costa Gomes",0,41,41,-1,42,-43
9,3,2018,15,0,2,"Braga",1,"Avenida da Liberdade",19,25,6,163,124,39
9,3,2018,15,0,2,"Braga",2,"Avenida Central",20,25,5,155,124,31
9,3,2018,15,0,2,"Braga",3,"Rua de Caires",26,36,10,52,37,15
9,3,2018,15,0,2,"Braga",4,"N14 Bosch",32,47,15,70,48,22
9,3,2018,15,0,2,"Braga",5,"Avenida João Paulo II",39,39,0,9,9,0
9,3,2018,15,0,2,"Braga",6,"Avenida Padre Júlio Fragata",67,67,0,83,83,0
9,3,2018,15,0,2,"Braga",7,"Rua Nova Santa Cruz",44,44,0,39,39,0
9,3,2018,15,0,2,"Braga",8,"Rua Costa Gomes",0,41,41,-1,42,-43
9,3,2018,16,0,2,"Braga",1,"Avenida da Liberdade",18,25,7,172,124,48
9,3,2018,16,0,2,"Braga",2,"Avenida Central",18,25,7,172,124,48
9,3,2018,16,0,2,"Braga",3,"Rua de Caires",25,36,11,54,37,17
9,3,2018,16,0,2,"Braga",4,"N14 Bosch",14,47,33,160,48,112
9,3,2018,16,0,2,"Braga",5,"Avenida João Paulo II",28,39,11,12,9,3
9,3,2018,16,0,2,"Braga",6,"Avenida Padre Júlio Fragata",44,67,23,127,83,44
9,3,2018,16,0,2,"Braga",7,"Rua Nova Santa Cruz",44,44,0,39,39,0
9,3,2018,16,0,2,"Braga",8,"Rua Costa Gomes",0,41,41,-1,42,-43
9,3,2018,17,0,2,"Braga",1,"Avenida da Liberdade",16,25,9,194,124,70
9,3,2018,17,0,2,"Braga",2,"Avenida Central",16,25,9,194,124,70
9,3,2018,17,0,2,"Braga",3,"Rua de Caires",22,36,14,61,37,24
9,3,2018,17,0,2,"Braga",4,"N14 Bosch",16,47,31,140,48,92
9,3,2018,17,0,2,"Braga",5,"Avenida João Paulo II",39,39,0,9,9,0
9,3,2018,17,0,2,"Braga",6,"Avenida Padre Júlio Fragata",31,67,36,180,83,97
9,3,2018,17,0,2,"Braga",7,"Rua Nova Santa Cruz",32,44,12,54,39,15
9,3,2018,17,0,2,"Braga",8,"Rua Costa Gomes",0,41,41,-1,42,-43
9,3,2018,18,0,2,"Braga",1,"Avenida da Liberdade",25,25,0,124,124,0
9,3,2018,18,0,2,"Braga",2,"Avenida Central",25,25,0,124,124,0
9,3,2018,18,0,2,"Braga",3,"Rua de Caires",26,36,10,52,37,15
9,3,2018,18,0,2,"Braga",4,"N14 Bosch",33,47,14,68,48,20
9,3,2018,18,0,2,"Braga",5,"Avenida João Paulo II",5,39,34,70,9,61
9,3,2018,18,0,2,"Braga",6,"Avenida Padre Júlio Fragata",17,67,50,328,83,245
9,3,2018,18,0,2,"Braga",7,"Rua Nova Santa Cruz",44,44,0,39,39,0
9,3,2018,18,0,2,"Braga",8,"Rua Costa Gomes",0,41,41,-1,42,-43
9,3,2018,19,0,2,"Braga",1,"Avenida da Liberdade",25,25,0,124,124,0
9,3,2018,19,0,2,"Braga",2,"Avenida Central",25,25,0,124,124,0
9,3,2018,19,0,2,"Braga",3,"Rua de Caires",36,36,0,37,37,0
9,3,2018,19,0,2,"Braga",4,"N14 Bosch",47,47,0,48,48,0
9,3,2018,19,0,2,"Braga",5,"Avenida João Paulo II",39,39,0,9,9,0
9,3,2018,19,0,2,"Braga",6,"Avenida Padre Júlio Fragata",67,67,0,83,83,0
9,3,2018,19,0,2,"Braga",7,"Rua Nova Santa Cruz",44,44,0,39,39,0
9,3,2018,19,0,2,"Braga",8,"Rua Costa Gomes",0,41,41,-1,42,-43
9,3,2018,20,0,2,"Braga",1,"Avenida da Liberdade",25,25,0,124,124,0
9,3,2018,20,0,2,"Braga",2,"Avenida Central",25,25,0,124,124,0
9,3,2018,20,0,2,"Braga",3,"Rua de Caires",36,36,0,37,37,0
9,3,2018,20,0,2,"Braga",4,"N14 Bosch",47,47,0,48,48,0
9,3,2018,20,0,2,"Braga",5,"Avenida João Paulo II",39,39,0,9,9,0
9,3,2018,20,0,2,"Braga",6,"Avenida Padre Júlio Fragata",67,67,0,83,83,0
9,3,2018,20,0,2,"Braga",7,"Rua Nova Santa Cruz",30,44,14,58,39,19
9,3,2018,20,0,2,"Braga",8,"Rua Costa Gomes",0,41,41,-1,42,-43
9,3,2018,21,0,2,"Braga",1,"Avenida da Liberdade",25,25,0,124,124,0
9,3,2018,21,0,2,"Braga",2,"Avenida Central",25,25,0,124,124,0
9,3,2018,21,0,2,"Braga",3,"Rua de Caires",36,36,0,37,37,0
9,3,2018,21,0,2,"Braga",4,"N14 Bosch",47,47,0,48,48,0
9,3,2018,21,0,2,"Braga",5,"Avenida João Paulo II",39,39,0,9,9,0
9,3,2018,21,0,2,"Braga",6,"Avenida Padre Júlio Fragata",67,67,0,83,83,0
9,3,2018,21,0,2,"Braga",7,"Rua Nova Santa Cruz",44,44,0,39,39,0
9,3,2018,21,0,2,"Braga",8,"Rua Costa Gomes",0,41,41,-1,42,-43
9,3,2018,22,0,2,"Braga",1,"Avenida da Liberdade",25,25,0,124,124,0
9,3,2018,22,0,2,"Braga",2,"Avenida Central",25,25,0,124,124,0
9,3,2018,22,0,2,"Braga",3,"Rua de Caires",36,36,0,37,37,0
9,3,2018,22,0,2,"Braga",4,"N14 Bosch",47,47,0,48,48,0
9,3,2018,22,0,2,"Braga",5,"Avenida João Paulo II",39,39,0,9,9,0
9,3,2018,22,0,2,"Braga",6,"Avenida Padre Júlio Fragata",52,67,15,107,83,24
9,3,2018,22,0,2,"Braga",7,"Rua Nova Santa Cruz",44,44,0,39,39,0
9,3,2018,22,0,2,"Braga",8,"Rua Costa Gomes",0,41,41,-1,42,-43
9,3,2018,23,0,2,"Braga",1,"Avenida da Liberdade",25,25,0,124,124,0
9,3,2018,23,0,2,"Braga",2,"Avenida Central",25,25,0,124,124,0
9,3,2018,23,0,2,"Braga",3,"Rua de Caires",36,36,0,37,37,0
9,3,2018,23,0,2,"Braga",4,"N14 Bosch",47,47,0,48,48,0
9,3,2018,23,0,2,"Braga",5,"Avenida João Paulo II",39,39,0,9,9,0
9,3,2018,23,0,2,"Braga",6,"Avenida Padre Júlio Fragata",67,67,0,83,83,0
9,3,2018,23,0,2,"Braga",7,"Rua Nova Santa Cruz",44,44,0,39,39,0
9,3,2018,23,0,2,"Braga",8,"Rua Costa Gomes",0,41,41,-1,42,-43
9,4,2018,0,0,3,"Braga",1,"Avenida da Liberdade",25,25,0,124,124,0
9,4,2018,0,0,3,"Braga",2,"Avenida Central",25,25,0,124,124,0
9,4,2018,0,0,3,"Braga",3,"Rua de Caires",36,36,0,37,37,0
9,4,2018,0,0,3,"Braga",4,"N14 Bosch",47,47,0,48,48,0
9,4,2018,0,0,3,"Braga",5,"Avenida João Paulo II",39,39,0,9,9,0
9,4,2018,0,0,3,"Braga",6,"Avenida Padre Júlio Fragata",67,67,0,83,83,0
9,4,2018,0,0,3,"Braga",7,"Rua Nova Santa Cruz",44,44,0,39,39,0
9,4,2018,0,0,3,"Braga",8,"Rua Costa Gomes",0,41,41,-1,42,-43
9,4,2018,1,0,3,"Braga",1,"Avenida da Liberdade",25,25,0,124,124,0
9,4,2018,1,0,3,"Braga",2,"Avenida Central",25,25,0,124,124,0
9,4,2018,1,0,3,"Braga",3,"Rua de Caires",36,36,0,37,37,0
9,4,2018,1,0,3,"Braga",4,"N14 Bosch",47,47,0,48,48,0
9,4,2018,1,0,3,"Braga",5,"Avenida João Paulo II",39,39,0,9,9,0
9,4,2018,1,0,3,"Braga",6,"Avenida Padre Júlio Fragata",67,67,0,83,83,0
9,4,2018,1,0,3,"Braga",7,"Rua Nova Santa Cruz",44,44,0,39,39,0
9,4,2018,1,0,3,"Braga",8,"Rua Costa Gomes",0,41,41,-1,42,-43
9,4,2018,2,0,3,"Braga",1,"Avenida da Liberdade",25,25,0,124,124,0
9,4,2018,2,0,3,"Braga",2,"Avenida Central",25,25,0,124,124,0
9,4,2018,2,0,3,"Braga",3,"Rua de Caires",36,36,0,37,37,0
9,4,2018,2,0,3,"Braga",4,"N14 Bosch",47,47,0,48,48,0
9,4,2018,2,0,3,"Braga",5,"Avenida João Paulo II",39,39,0,9,9,0
9,4,2018,2,0,3,"Braga",6,"Avenida Padre Júlio Fragata",67,67,0,83,83,0
9,4,2018,2,0,3,"Braga",7,"Rua Nova Santa Cruz",44,44,0,39,39,0
9,4,2018,2,0,3,"Braga",8,"Rua Costa Gomes",0,41,41,-1,42,-43
9,4,2018,3,0,3,"Braga",1,"Avenida da Liberdade",25,25,0,124,124,0
9,4,2018,3,0,3,"Braga",2,"Avenida Central",25,25,0,124,124,0
9,4,2018,3,0,3,"Braga",3,"Rua de Caires",36,36,0,37,37,0
9,4,2018,3,0,3,"Braga",4,"N14 Bosch",47,47,0,48,48,0
9,4,2018,3,0,3,"Braga",5,"Avenida João Paulo II",39,39,0,9,9,0
9,4,2018,3,0,3,"Braga",6,"Avenida Padre Júlio Fragata",67,67,0,83,83,0
9,4,2018,3,0,3,"Braga",7,"Rua Nova Santa Cruz",44,44,0,39,39,0
9,4,2018,3,0,3,"Braga",8,"Rua Costa Gomes",0,41,41,-1,42,-43
9,4,2018,5,0,3,"Braga",1,"Avenida da Liberdade",25,25,0,124,124,0
9,4,2018,5,0,3,"Braga",2,"Avenida Central",25,25,0,124,124,0
9,4,2018,5,0,3,"Braga",3,"Rua de Caires",36,36,0,37,37,0
9,4,2018,5,0,3,"Braga",4,"N14 Bosch",47,47,0,48,48,0
9,4,2018,5,0,3,"Braga",5,"Avenida João Paulo II",39,39,0,9,9,0
9,4,2018,5,0,3,"Braga",6,"Avenida Padre Júlio Fragata",67,67,0,83,83,0
9,4,2018,5,0,3,"Braga",7,"Rua Nova Santa Cruz",44,44,0,39,39,0
9,4,2018,5,0,3,"Braga",8,"Rua Costa Gomes",0,41,41,-1,42,-43
9,4,2018,6,0,3,"Braga",1,"Avenida da Liberdade",25,25,0,124,124,0
9,4,2018,6,0,3,"Braga",2,"Avenida Central",25,25,0,124,124,0
9,4,2018,6,0,3,"Braga",3,"Rua de Caires",36,36,0,37,37,0
9,4,2018,6,0,3,"Braga",4,"N14 Bosch",47,47,0,48,48,0
9,4,2018,6,0,3,"Braga",5,"Avenida João Paulo II",39,39,0,9,9,0
9,4,2018,6,0,3,"Braga",6,"Avenida Padre Júlio Fragata",67,67,0,83,83,0
9,4,2018,6,0,3,"Braga",7,"Rua Nova Santa Cruz",44,44,0,39,39,0
9,4,2018,6,0,3,"Braga",8,"Rua Costa Gomes",0,41,41,-1,42,-43
9,4,2018,7,0,3,"Braga",1,"Avenida da Liberdade",25,25,0,124,124,0
9,4,2018,7,0,3,"Braga",2,"Avenida Central",25,25,0,124,124,0
9,4,2018,7,0,3,"Braga",3,"Rua de Caires",36,36,0,37,37,0
9,4,2018,7,0,3,"Braga",4,"N14 Bosch",47,47,0,48,48,0
9,4,2018,7,0,3,"Braga",5,"Avenida João Paulo II",39,39,0,9,9,0
9,4,2018,7,0,3,"Braga",6,"Avenida Padre Júlio Fragata",67,67,0,83,83,0
9,4,2018,7,0,3,"Braga",7,"Rua Nova Santa Cruz",44,44,0,39,39,0
9,4,2018,7,0,3,"Braga",8,"Rua Costa Gomes",0,41,41,-1,42,-43
9,4,2018,8,0,3,"Braga",1,"Avenida da Liberdade",25,25,0,124,124,0
9,4,2018,8,0,3,"Braga",2,"Avenida Central",25,25,0,124,124,0
9,4,2018,8,0,3,"Braga",3,"Rua de Caires",14,36,22,96,37,59
9,4,2018,8,0,3,"Braga",4,"N14 Bosch",35,47,12,64,48,16
9,4,2018,8,0,3,"Braga",5,"Avenida João Paulo II",39,39,0,9,9,0
9,4,2018,8,0,3,"Braga",6,"Avenida Padre Júlio Fragata",67,67,0,83,83,0
9,4,2018,8,0,3,"Braga",7,"Rua Nova Santa Cruz",27,44,17,64,39,25
9,4,2018,8,0,3,"Braga",8,"Rua Costa Gomes",0,41,41,-1,42,-43
9,4,2018,9,0,3,"Braga",1,"Avenida da Liberdade",25,25,0,124,124,0
9,4,2018,9,0,3,"Braga",2,"Avenida Central",25,25,0,124,124,0
9,4,2018,9,0,3,"Braga",3,"Rua de Caires",26,36,10,52,37,15
9,4,2018,9,0,3,"Braga",4,"N14 Bosch",28,47,19,80,48,32
9,4,2018,9,0,3,"Braga",5,"Avenida João Paulo II",39,39,0,9,9,0
9,4,2018,9,0,3,"Braga",6,"Avenida Padre Júlio Fragata",67,67,0,83,83,0
9,4,2018,9,0,3,"Braga",7,"Rua Nova Santa Cruz",44,44,0,39,39,0
9,4,2018,9,0,3,"Braga",8,"Rua Costa Gomes",0,41,41,-1,42,-43
9,4,2018,10,0,3,"Braga",1,"Avenida da Liberdade",25,25,0,124,124,0
9,4,2018,10,0,3,"Braga",2,"Avenida Central",25,25,0,124,124,0
9,4,2018,10,0,3,"Braga",3,"Rua de Caires",16,36,20,84,37,47
9,4,2018,10,0,3,"Braga",4,"N14 Bosch",47,47,0,48,48,0
9,4,2018,10,0,3,"Braga",5,"Avenida João Paulo II",39,39,0,9,9,0
9,4,2018,10,0,3,"Braga",6,"Avenida Padre Júlio Fragata",67,67,0,83,83,0
9,4,2018,10,0,3,"Braga",7,"Rua Nova Santa Cruz",44,44,0,39,39,0
9,4,2018,10,0,3,"Braga",8,"Rua Costa Gomes",0,41,41,-1,42,-43
9,4,2018,11,0,3,"Braga",1,"Avenida da Liberdade",19,25,6,163,124,39
9,4,2018,11,0,3,"Braga",2,"Avenida Central",19,25,6,163,124,39
9,4,2018,11,0,3,"Braga",3,"Rua de Caires",36,36,0,37,37,0
9,4,2018,11,0,3,"Braga",4,"N14 Bosch",32,47,15,70,48,22
9,4,2018,11,0,3,"Braga",5,"Avenida João Paulo II",27,39,12,13,9,4
9,4,2018,11,0,3,"Braga",6,"Avenida Padre Júlio Fragata",67,67,0,83,83,0
9,4,2018,11,0,3,"Braga",7,"Rua Nova Santa Cruz",44,44,0,39,39,0
9,4,2018,11,0,3,"Braga",8,"Rua Costa Gomes",0,41,41,-1,42,-43
9,4,2018,12,0,3,"Braga",1,"Avenida da Liberdade",18,25,7,172,124,48
9,4,2018,12,0,3,"Braga",2,"Avenida Central",18,25,7,172,124,48
9,4,2018,12,0,3,"Braga",3,"Rua de Caires",26,36,10,52,37,15
9,4,2018,12,0,3,"Braga",4,"N14 Bosch",33,47,14,68,48,20
9,4,2018,12,0,3,"Braga",5,"Avenida João Paulo II",39,39,0,9,9,0
9,4,2018,12,0,3,"Braga",6,"Avenida Padre Júlio Fragata",67,67,0,83,83,0
9,4,2018,12,0,3,"Braga",7,"Rua Nova Santa Cruz",44,44,0,39,39,0
9,4,2018,12,0,3,"Braga",8,"Rua Costa Gomes",0,41,41,-1,42,-43
9,4,2018,13,0,3,"Braga",1,"Avenida da Liberdade",25,25,0,124,124,0
9,4,2018,13,0,3,"Braga",2,"Avenida Central",25,25,0,124,124,0
9,4,2018,13,0,3,"Braga",3,"Rua de Caires",23,36,13,59,37,22
9,4,2018,13,0,3,"Braga",4,"N14 Bosch",33,47,14,68,48,20
9,4,2018,13,0,3,"Braga",5,"Avenida João Paulo II",39,39,0,9,9,0
9,4,2018,13,0,3,"Braga",6,"Avenida Padre Júlio Fragata",67,67,0,83,83,0
9,4,2018,13,0,3,"Braga",7,"Rua Nova Santa Cruz",44,44,0,39,39,0
9,4,2018,13,0,3,"Braga",8,"Rua Costa Gomes",0,41,41,-1,42,-43
9,4,2018,14,0,3,"Braga",1,"Avenida da Liberdade",25,25,0,124,124,0
9,4,2018,14,0,3,"Braga",2,"Avenida Central",25,25,0,124,124,0
9,4,2018,14,0,3,"Braga",3,"Rua de Caires",36,36,0,37,37,0
9,4,2018,14,0,3,"Braga",4,"N14 Bosch",15,47,32,150,48,102
9,4,2018,14,0,3,"Braga",5,"Avenida João Paulo II",39,39,0,9,9,0
9,4,2018,14,0,3,"Braga",6,"Avenida Padre Júlio Fragata",67,67,0,83,83,0
9,4,2018,14,0,3,"Braga",7,"Rua Nova Santa Cruz",44,44,0,39,39,0
9,4,2018,14,0,3,"Braga",8,"Rua Costa Gomes",0,41,41,-1,42,-43
9,4,2018,15,0,3,"Braga",1,"Avenida da Liberdade",25,25,0,124,124,0
9,4,2018,15,0,3,"Braga",2,"Avenida Central",25,25,0,124,124,0
9,4,2018,15,0,3,"Braga",3,"Rua de Caires",36,36,0,37,37,0
9,4,2018,15,0,3,"Braga",4,"N14 Bosch",26,47,21,86,48,38
9,4,2018,15,0,3,"Braga",5,"Avenida João Paulo II",39,39,0,9,9,0
9,4,2018,15,0,3,"Braga",6,"Avenida Padre Júlio Fragata",67,67,0,83,83,0
9,4,2018,15,0,3,"Braga",7,"Rua Nova Santa Cruz",44,44,0,39,39,0
9,4,2018,15,0,3,"Braga",8,"Rua Costa Gomes",0,41,41,-1,42,-43
9,4,2018,16,0,3,"Braga",1,"Avenida da Liberdade",17,25,8,182,124,58
9,4,2018,16,0,3,"Braga",2,"Avenida Central",17,25,8,182,124,58
9,4,2018,16,0,3,"Braga",3,"Rua de Caires",36,36,0,37,37,0
9,4,2018,16,0,3,"Braga",4,"N14 Bosch",32,47,15,70,48,22
9,4,2018,16,0,3,"Braga",5,"Avenida João Paulo II",29,39,10,12,9,3
9,4,2018,16,0,3,"Braga",6,"Avenida Padre Júlio Fragata",67,67,0,83,83,0
9,4,2018,16,0,3,"Braga",7,"Rua Nova Santa Cruz",33,44,11,52,39,13
9,4,2018,16,0,3,"Braga",8,"Rua Costa Gomes",0,41,41,-1,42,-43
9,4,2018,17,0,3,"Braga",1,"Avenida da Liberdade",19,25,6,163,124,39
9,4,2018,17,0,3,"Braga",2,"Avenida Central",19,25,6,163,124,39
9,4,2018,17,0,3,"Braga",3,"Rua de Caires",25,36,11,54,37,17
9,4,2018,17,0,3,"Braga",4,"N14 Bosch",16,47,31,140,48,92
9,4,2018,17,0,3,"Braga",5,"Avenida João Paulo II",10,39,29,35,9,26
9,4,2018,17,0,3,"Braga",6,"Avenida Padre Júlio Fragata",18,67,49,310,83,227
9,4,2018,17,0,3,"Braga",7,"Rua Nova Santa Cruz",31,44,13,56,39,17
9,4,2018,17,0,3,"Braga",8,"Rua Costa Gomes",0,41,41,-1,42,-43
9,4,2018,18,0,3,"Braga",1,"Avenida da Liberdade",25,25,0,124,124,0
9,4,2018,18,0,3,"Braga",2,"Avenida Central",25,25,0,124,124,0
9,4,2018,18,0,3,"Braga",3,"Rua de Caires",23,36,13,59,37,22
9,4,2018,18,0,3,"Braga",4,"N14 Bosch",17,47,30,132,48,84
9,4,2018,18,0,3,"Braga",5,"Avenida João Paulo II",19,39,20,18,9,9
9,4,2018,18,0,3,"Braga",6,"Avenida Padre Júlio Fragata",24,67,43,232,83,149
9,4,2018,18,0,3,"Braga",7,"Rua Nova Santa Cruz",44,44,0,39,39,0
9,4,2018,18,0,3,"Braga",8,"Rua Costa Gomes",0,41,41,-1,42,-43
9,4,2018,19,0,3,"Braga",1,"Avenida da Liberdade",25,25,0,124,124,0
9,4,2018,19,0,3,"Braga",2,"Avenida Central",25,25,0,124,124,0
9,4,2018,19,0,3,"Braga",3,"Rua de Caires",36,36,0,37,37,0
9,4,2018,19,0,3,"Braga",4,"N14 Bosch",47,47,0,48,48,0
9,4,2018,19,0,3,"Braga",5,"Avenida João Paulo II",39,39,0,9,9,0
9,4,2018,19,0,3,"Braga",6,"Avenida Padre Júlio Fragata",67,67,0,83,83,0
9,4,2018,19,0,3,"Braga",7,"Rua Nova Santa Cruz",31,44,13,56,39,17
9,4,2018,19,0,3,"Braga",8,"Rua Costa Gomes",0,41,41,-1,42,-43
9,4,2018,20,0,3,"Braga",1,"Avenida da Liberdade",25,25,0,124,124,0
9,4,2018,20,0,3,"Braga",2,"Avenida Central",25,25,0,124,124,0
9,4,2018,20,0,3,"Braga",3,"Rua de Caires",36,36,0,37,37,0
9,4,2018,20,0,3,"Braga",4,"N14 Bosch",47,47,0,48,48,0
9,4,2018,20,0,3,"Braga",5,"Avenida João Paulo II",39,39,0,9,9,0
9,4,2018,20,0,3,"Braga",6,"Avenida Padre Júlio Fragata",67,67,0,83,83,0
9,4,2018,20,0,3,"Braga",7,"Rua Nova Santa Cruz",44,44,0,39,39,0
9,4,2018,20,0,3,"Braga",8,"Rua Costa Gomes",0,41,41,-1,42,-43
9,4,2018,21,0,3,"Braga",1,"Avenida da Liberdade",25,25,0,124,124,0
9,4,2018,21,0,3,"Braga",2,"Avenida Central",25,25,0,124,124,0
9,4,2018,21,0,3,"Braga",3,"Rua de Caires",26,36,10,52,37,15
9,4,2018,21,0,3,"Braga",4,"N14 Bosch",47,47,0,48,48,0
9,4,2018,21,0,3,"Braga",5,"Avenida João Paulo II",39,39,0,9,9,0
9,4,2018,21,0,3,"Braga",6,"Avenida Padre Júlio Fragata",67,67,0,83,83,0
9,4,2018,21,0,3,"Braga",7,"Rua Nova Santa Cruz",44,44,0,39,39,0
9,4,2018,21,0,3,"Braga",8,"Rua Costa Gomes",0,41,41,-1,42,-43
9,4,2018,22,0,3,"Braga",1,"Avenida da Liberdade",25,25,0,124,124,0
9,4,2018,22,0,3,"Braga",2,"Avenida Central",25,25,0,124,124,0
9,4,2018,22,0,3,"Braga",3,"Rua de Caires",36,36,0,37,37,0
9,4,2018,22,0,3,"Braga",4,"N14 Bosch",47,47,0,48,48,0
9,4,2018,22,0,3,"Braga",5,"Avenida João Paulo II",39,39,0,9,9,0
9,4,2018,22,0,3,"Braga",6,"Avenida Padre Júlio Fragata",67,67,0,83,83,0
9,4,2018,22,0,3,"Braga",7,"Rua Nova Santa Cruz",44,44,0,39,39,0
9,4,2018,22,0,3,"Braga",8,"Rua Costa Gomes",0,41,41,-1,42,-43
9,4,2018,23,0,3,"Braga",1,"Avenida da Liberdade",25,25,0,124,124,0
9,4,2018,23,0,3,"Braga",2,"Avenida Central",25,25,0,124,124,0
9,4,2018,23,0,3,"Braga",3,"Rua de Caires",36,36,0,37,37,0
9,4,2018,23,0,3,"Braga",4,"N14 Bosch",47,47,0,48,48,0
9,4,2018,23,0,3,"Braga",5,"Avenida João Paulo II",39,39,0,9,9,0
9,4,2018,23,0,3,"Braga",6,"Avenida Padre Júlio Fragata",67,67,0,83,83,0
9,4,2018,23,0,3,"Braga",7,"Rua Nova Santa Cruz",44,44,0,39,39,0
9,4,2018,23,0,3,"Braga",8,"Rua Costa Gomes",0,41,41,-1,42,-43
9,5,2018,0,0,4,"Braga",1,"Avenida da Liberdade",25,25,0,124,124,0
9,5,2018,0,0,4,"Braga",2,"Avenida Central",25,25,0,124,124,0
9,5,2018,0,0,4,"Braga",3,"Rua de Caires",36,36,0,37,37,0
9,5,2018,0,0,4,"Braga",4,"N14 Bosch",47,47,0,48,48,0
9,5,2018,0,0,4,"Braga",5,"Avenida João Paulo II",39,39,0,9,9,0
9,5,2018,0,0,4,"Braga",6,"Avenida Padre Júlio Fragata",67,67,0,83,83,0
9,5,2018,0,0,4,"Braga",7,"Rua Nova Santa Cruz",44,44,0,39,39,0
9,5,2018,0,0,4,"Braga",8,"Rua Costa Gomes",0,41,41,-1,42,-43
9,5,2018,1,0,4,"Braga",1,"Avenida da Liberdade",25,25,0,124,124,0
9,5,2018,1,0,4,"Braga",2,"Avenida Central",25,25,0,124,124,0
9,5,2018,1,0,4,"Braga",3,"Rua de Caires",36,36,0,37,37,0
9,5,2018,1,0,4,"Braga",4,"N14 Bosch",47,47,0,48,48,0
9,5,2018,1,0,4,"Braga",5,"Avenida João Paulo II",39,39,0,9,9,0
9,5,2018,1,0,4,"Braga",6,"Avenida Padre Júlio Fragata",67,67,0,83,83,0
9,5,2018,1,0,4,"Braga",7,"Rua Nova Santa Cruz",44,44,0,39,39,0
9,5,2018,1,0,4,"Braga",8,"Rua Costa Gomes",0,41,41,-1,42,-43
9,5,2018,2,0,4,"Braga",1,"Avenida da Liberdade",25,25,0,124,124,0
9,5,2018,2,0,4,"Braga",2,"Avenida Central",25,25,0,124,124,0
9,5,2018,2,0,4,"Braga",3,"Rua de Caires",36,36,0,37,37,0
9,5,2018,2,0,4,"Braga",4,"N14 Bosch",47,47,0,48,48,0
9,5,2018,2,0,4,"Braga",5,"Avenida João Paulo II",39,39,0,9,9,0
9,5,2018,2,0,4,"Braga",6,"Avenida Padre Júlio Fragata",67,67,0,83,83,0
9,5,2018,2,0,4,"Braga",7,"Rua Nova Santa Cruz",44,44,0,39,39,0
9,5,2018,2,0,4,"Braga",8,"Rua Costa Gomes",0,41,41,-1,42,-43
9,5,2018,3,0,4,"Braga",1,"Avenida da Liberdade",25,25,0,124,124,0
9,5,2018,3,0,4,"Braga",2,"Avenida Central",25,25,0,124,124,0
9,5,2018,3,0,4,"Braga",3,"Rua de Caires",36,36,0,37,37,0
9,5,2018,3,0,4,"Braga",4,"N14 Bosch",47,47,0,48,48,0
9,5,2018,3,0,4,"Braga",5,"Avenida João Paulo II",39,39,0,9,9,0
9,5,2018,3,0,4,"Braga",6,"Avenida Padre Júlio Fragata",67,67,0,83,83,0
9,5,2018,3,0,4,"Braga",7,"Rua Nova Santa Cruz",44,44,0,39,39,0
9,5,2018,3,0,4,"Braga",8,"Rua Costa Gomes",0,41,41,-1,42,-43
9,5,2018,4,0,4,"Braga",1,"Avenida da Liberdade",25,25,0,124,124,0
9,5,2018,4,0,4,"Braga",2,"Avenida Central",25,25,0,124,124,0
9,5,2018,4,0,4,"Braga",3,"Rua de Caires",36,36,0,37,37,0
9,5,2018,4,0,4,"Braga",4,"N14 Bosch",47,47,0,48,48,0
9,5,2018,4,0,4,"Braga",5,"Avenida João Paulo II",39,39,0,9,9,0
9,5,2018,4,0,4,"Braga",6,"Avenida Padre Júlio Fragata",67,67,0,83,83,0
9,5,2018,4,0,4,"Braga",7,"Rua Nova Santa Cruz",44,44,0,39,39,0
9,5,2018,4,0,4,"Braga",8,"Rua Costa Gomes",0,41,41,-1,42,-43
9,5,2018,5,0,4,"Braga",1,"Avenida da Liberdade",25,25,0,124,124,0
9,5,2018,5,0,4,"Braga",2,"Avenida Central",25,25,0,124,124,0
9,5,2018,5,0,4,"Braga",3,"Rua de Caires",36,36,0,37,37,0
9,5,2018,5,0,4,"Braga",4,"N14 Bosch",47,47,0,48,48,0
9,5,2018,5,0,4,"Braga",5,"Avenida João Paulo II",39,39,0,9,9,0
9,5,2018,5,0,4,"Braga",6,"Avenida Padre Júlio Fragata",67,67,0,83,83,0
9,5,2018,5,0,4,"Braga",7,"Rua Nova Santa Cruz",44,44,0,39,39,0
9,5,2018,5,0,4,"Braga",8,"Rua Costa Gomes",0,41,41,-1,42,-43
9,5,2018,6,0,4,"Braga",1,"Avenida da Liberdade",25,25,0,124,124,0
9,5,2018,6,0,4,"Braga",2,"Avenida Central",25,25,0,124,124,0
9,5,2018,6,0,4,"Braga",3,"Rua de Caires",36,36,0,37,37,0
9,5,2018,6,0,4,"Braga",4,"N14 Bosch",47,47,0,48,48,0
9,5,2018,6,0,4,"Braga",5,"Avenida João Paulo II",39,39,0,9,9,0
9,5,2018,6,0,4,"Braga",6,"Avenida Padre Júlio Fragata",67,67,0,83,83,0
9,5,2018,6,0,4,"Braga",7,"Rua Nova Santa Cruz",44,44,0,39,39,0
9,5,2018,6,0,4,"Braga",8,"Rua Costa Gomes",0,41,41,-1,42,-43
9,5,2018,7,0,4,"Braga",1,"Avenida da Liberdade",25,25,0,124,124,0
9,5,2018,7,0,4,"Braga",2,"Avenida Central",25,25,0,124,124,0
9,5,2018,7,0,4,"Braga",3,"Rua de Caires",19,36,17,71,37,34
9,5,2018,7,0,4,"Braga",4,"N14 Bosch",47,47,0,48,48,0
9,5,2018,7,0,4,"Braga",5,"Avenida João Paulo II",39,39,0,9,9,0
9,5,2018,7,0,4,"Braga",6,"Avenida Padre Júlio Fragata",67,67,0,83,83,0
9,5,2018,7,0,4,"Braga",7,"Rua Nova Santa Cruz",44,44,0,39,39,0
9,5,2018,7,0,4,"Braga",8,"Rua Costa Gomes",0,41,41,-1,42,-43
9,5,2018,8,0,4,"Braga",1,"Avenida da Liberdade",17,25,8,182,124,58
9,5,2018,8,0,4,"Braga",2,"Avenida Central",17,25,8,182,124,58
9,5,2018,8,0,4,"Braga",3,"Rua de Caires",36,36,0,37,37,0
9,5,2018,8,0,4,"Braga",4,"N14 Bosch",47,47,0,48,48,0
9,5,2018,8,0,4,"Braga",5,"Avenida João Paulo II",8,39,31,44,9,35
9,5,2018,8,0,4,"Braga",6,"Avenida Padre Júlio Fragata",48,67,19,116,83,33
9,5,2018,8,0,4,"Braga",7,"Rua Nova Santa Cruz",44,44,0,39,39,0
9,5,2018,8,0,4,"Braga",8,"Rua Costa Gomes",0,41,41,-1,42,-43
9,5,2018,9,0,4,"Braga",1,"Avenida da Liberdade",25,25,0,124,124,0
9,5,2018,9,0,4,"Braga",2,"Avenida Central",25,25,0,124,124,0
9,5,2018,9,0,4,"Braga",3,"Rua de Caires",36,36,0,37,37,0
9,5,2018,9,0,4,"Braga",4,"N14 Bosch",47,47,0,48,48,0
9,5,2018,9,0,4,"Braga",5,"Avenida João Paulo II",39,39,0,9,9,0
9,5,2018,9,0,4,"Braga",6,"Avenida Padre Júlio Fragata",67,67,0,83,83,0
9,5,2018,9,0,4,"Braga",7,"Rua Nova Santa Cruz",44,44,0,39,39,0
9,5,2018,9,0,4,"Braga",8,"Rua Costa Gomes",0,41,41,-1,42,-43
9,5,2018,10,0,4,"Braga",1,"Avenida da Liberdade",25,25,0,124,124,0
9,5,2018,10,0,4,"Braga",2,"Avenida Central",25,25,0,124,124,0
9,5,2018,10,0,4,"Braga",3,"Rua de Caires",36,36,0,37,37,0
9,5,2018,10,0,4,"Braga",4,"N14 Bosch",47,47,0,48,48,0
9,5,2018,10,0,4,"Braga",5,"Avenida João Paulo II",39,39,0,9,9,0
9,5,2018,10,0,4,"Braga",6,"Avenida Padre Júlio Fragata",67,67,0,83,83,0
9,5,2018,10,0,4,"Braga",7,"Rua Nova Santa Cruz",44,44,0,39,39,0
9,5,2018,10,0,4,"Braga",8,"Rua Costa Gomes",0,41,41,-1,42,-43
9,5,2018,11,0,4,"Braga",1,"Avenida da Liberdade",19,25,6,163,124,39
9,5,2018,11,0,4,"Braga",2,"Avenida Central",19,25,6,163,124,39
9,5,2018,11,0,4,"Braga",3,"Rua de Caires",36,36,0,37,37,0
9,5,2018,11,0,4,"Braga",4,"N14 Bosch",47,47,0,48,48,0
9,5,2018,11,0,4,"Braga",5,"Avenida João Paulo II",39,39,0,9,9,0
9,5,2018,11,0,4,"Braga",6,"Avenida Padre Júlio Fragata",67,67,0,83,83,0
9,5,2018,11,0,4,"Braga",7,"Rua Nova Santa Cruz",44,44,0,39,39,0
9,5,2018,11,0,4,"Braga",8,"Rua Costa Gomes",0,41,41,-1,42,-43
9,5,2018,12,0,4,"Braga",1,"Avenida da Liberdade",25,25,0,124,124,0
9,5,2018,12,0,4,"Braga",2,"Avenida Central",25,25,0,124,124,0
9,5,2018,12,0,4,"Braga",3,"Rua de Caires",36,36,0,37,37,0
9,5,2018,12,0,4,"Braga",4,"N14 Bosch",20,47,27,112,48,64
9,5,2018,12,0,4,"Braga",5,"Avenida João Paulo II",39,39,0,9,9,0
9,5,2018,12,0,4,"Braga",6,"Avenida Padre Júlio Fragata",67,67,0,83,83,0
9,5,2018,12,0,4,"Braga",7,"Rua Nova Santa Cruz",44,44,0,39,39,0
9,5,2018,12,0,4,"Braga",8,"Rua Costa Gomes",0,41,41,-1,42,-43
9,5,2018,13,0,4,"Braga",1,"Avenida da Liberdade",25,25,0,124,124,0
9,5,2018,13,0,4,"Braga",2,"Avenida Central",25,25,0,124,124,0
9,5,2018,13,0,4,"Braga",3,"Rua de Caires",26,36,10,52,37,15
9,5,2018,13,0,4,"Braga",4,"N14 Bosch",18,47,29,125,48,77
9,5,2018,13,0,4,"Braga",5,"Avenida João Paulo II",39,39,0,9,9,0
9,5,2018,13,0,4,"Braga",6,"Avenida Padre Júlio Fragata",67,67,0,83,83,0
9,5,2018,13,0,4,"Braga",7,"Rua Nova Santa Cruz",44,44,0,39,39,0
9,5,2018,13,0,4,"Braga",8,"Rua Costa Gomes",0,41,41,-1,42,-43
9,5,2018,14,0,4,"Braga",1,"Avenida da Liberdade",25,25,0,124,124,0
9,5,2018,14,0,4,"Braga",2,"Avenida Central",25,25,0,124,124,0
9,5,2018,14,0,4,"Braga",3,"Rua de Caires",24,36,12,56,37,19
9,5,2018,14,0,4,"Braga",4,"N14 Bosch",22,47,25,102,48,54
9,5,2018,14,0,4,"Braga",5,"Avenida João Paulo II",39,39,0,9,9,0
9,5,2018,14,0,4,"Braga",6,"Avenida Padre Júlio Fragata",67,67,0,83,83,0
9,5,2018,14,0,4,"Braga",7,"Rua Nova Santa Cruz",33,44,11,52,39,13
9,5,2018,14,0,4,"Braga",8,"Rua Costa Gomes",0,41,41,-1,42,-43
9,5,2018,15,0,4,"Braga",1,"Avenida da Liberdade",16,25,9,194,124,70
9,5,2018,15,0,4,"Braga",2,"Avenida Central",16,25,9,194,124,70
9,5,2018,15,0,4,"Braga",3,"Rua de Caires",36,36,0,37,37,0
9,5,2018,15,0,4,"Braga",4,"N14 Bosch",22,47,25,102,48,54
9,5,2018,15,0,4,"Braga",5,"Avenida João Paulo II",39,39,0,9,9,0
9,5,2018,15,0,4,"Braga",6,"Avenida Padre Júlio Fragata",67,67,0,83,83,0
9,5,2018,15,0,4,"Braga",7,"Rua Nova Santa Cruz",44,44,0,39,39,0
9,5,2018,15,0,4,"Braga",8,"Rua Costa Gomes",0,41,41,-1,42,-43
9,5,2018,16,0,4,"Braga",1,"Avenida da Liberdade",16,25,9,194,124,70
9,5,2018,16,0,4,"Braga",2,"Avenida Central",16,25,9,194,124,70
9,5,2018,16,0,4,"Braga",3,"Rua de Caires",27,36,9,50,37,13
9,5,2018,16,0,4,"Braga",4,"N14 Bosch",18,47,29,125,48,77
9,5,2018,16,0,4,"Braga",5,"Avenida João Paulo II",21,39,18,17,9,8
9,5,2018,16,0,4,"Braga",6,"Avenida Padre Júlio Fragata",67,67,0,83,83,0
9,5,2018,16,0,4,"Braga",7,"Rua Nova Santa Cruz",44,44,0,39,39,0
9,5,2018,16,0,4,"Braga",8,"Rua Costa Gomes",0,41,41,-1,42,-43
9,5,2018,17,0,4,"Braga",1,"Avenida da Liberdade",15,25,10,207,124,83
9,5,2018,17,0,4,"Braga",2,"Avenida Central",15,25,10,207,124,83
9,5,2018,17,0,4,"Braga",3,"Rua de Caires",36,36,0,37,37,0
9,5,2018,17,0,4,"Braga",4,"N14 Bosch",15,47,32,150,48,102
9,5,2018,17,0,4,"Braga",5,"Avenida João Paulo II",13,39,26,27,9,18
9,5,2018,17,0,4,"Braga",6,"Avenida Padre Júlio Fragata",38,67,29,147,83,64
9,5,2018,17,0,4,"Braga",7,"Rua Nova Santa Cruz",44,44,0,39,39,0
9,5,2018,17,0,4,"Braga",8,"Rua Costa Gomes",0,41,41,-1,42,-43
9,5,2018,18,0,4,"Braga",1,"Avenida da Liberdade",19,25,6,163,124,39
9,5,2018,18,0,4,"Braga",2,"Avenida Central",19,25,6,163,124,39
9,5,2018,18,0,4,"Braga",3,"Rua de Caires",16,36,20,84,37,47
9,5,2018,18,0,4,"Braga",4,"N14 Bosch",21,47,26,107,48,59
9,5,2018,18,0,4,"Braga",5,"Avenida João Paulo II",21,39,18,17,9,8
9,5,2018,18,0,4,"Braga",6,"Avenida Padre Júlio Fragata",22,67,45,253,83,170
9,5,2018,18,0,4,"Braga",7,"Rua Nova Santa Cruz",44,44,0,39,39,0
9,5,2018,18,0,4,"Braga",8,"Rua Costa Gomes",0,41,41,-1,42,-43
9,5,2018,19,0,4,"Braga",1,"Avenida da Liberdade",19,25,6,163,124,39
9,5,2018,19,0,4,"Braga",2,"Avenida Central",19,25,6,163,124,39
9,5,2018,19,0,4,"Braga",3,"Rua de Caires",23,36,13,59,37,22
9,5,2018,19,0,4,"Braga",4,"N14 Bosch",35,47,12,64,48,16
9,5,2018,19,0,4,"Braga",5,"Avenida João Paulo II",28,39,11,12,9,3
9,5,2018,19,0,4,"Braga",6,"Avenida Padre Júlio Fragata",67,67,0,83,83,0
9,5,2018,19,0,4,"Braga",7,"Rua Nova Santa Cruz",44,44,0,39,39,0
9,5,2018,19,0,4,"Braga",8,"Rua Costa Gomes",0,41,41,-1,42,-43
9,5,2018,20,0,4,"Braga",1,"Avenida da Liberdade",25,25,0,124,124,0
9,5,2018,20,0,4,"Braga",2,"Avenida Central",25,25,0,124,124,0
9,5,2018,20,0,4,"Braga",3,"Rua de Caires",36,36,0,37,37,0
9,5,2018,20,0,4,"Braga",4,"N14 Bosch",47,47,0,48,48,0
9,5,2018,20,0,4,"Braga",5,"Avenida João Paulo II",39,39,0,9,9,0
9,5,2018,20,0,4,"Braga",6,"Avenida Padre Júlio Fragata",67,67,0,83,83,0
9,5,2018,20,0,4,"Braga",7,"Rua Nova Santa Cruz",44,44,0,39,39,0
9,5,2018,20,0,4,"Braga",8,"Rua Costa Gomes",0,41,41,-1,42,-43
9,5,2018,21,0,4,"Braga",1,"Avenida da Liberdade",25,25,0,124,124,0
9,5,2018,21,0,4,"Braga",2,"Avenida Central",25,25,0,124,124,0
9,5,2018,21,0,4,"Braga",3,"Rua de Caires",36,36,0,37,37,0
9,5,2018,21,0,4,"Braga",4,"N14 Bosch",47,47,0,48,48,0
9,5,2018,21,0,4,"Braga",5,"Avenida João Paulo II",39,39,0,9,9,0
9,5,2018,21,0,4,"Braga",6,"Avenida Padre Júlio Fragata",67,67,0,83,83,0
9,5,2018,21,0,4,"Braga",7,"Rua Nova Santa Cruz",44,44,0,39,39,0
9,5,2018,21,0,4,"Braga",8,"Rua Costa Gomes",0,41,41,-1,42,-43
9,5,2018,22,0,4,"Braga",1,"Avenida da Liberdade",25,25,0,124,124,0
9,5,2018,22,0,4,"Braga",2,"Avenida Central",25,25,0,124,124,0
9,5,2018,22,0,4,"Braga",3,"Rua de Caires",36,36,0,37,37,0
9,5,2018,22,0,4,"Braga",4,"N14 Bosch",47,47,0,48,48,0
9,5,2018,22,0,4,"Braga",5,"Avenida João Paulo II",39,39,0,9,9,0
9,5,2018,22,0,4,"Braga",6,"Avenida Padre Júlio Fragata",67,67,0,83,83,0
9,5,2018,22,0,4,"Braga",7,"Rua Nova Santa Cruz",44,44,0,39,39,0
9,5,2018,22,0,4,"Braga",8,"Rua Costa Gomes",0,41,41,-1,42,-43
9,5,2018,23,0,4,"Braga",1,"Avenida da Liberdade",25,25,0,124,124,0
9,5,2018,23,0,4,"Braga",2,"Avenida Central",25,25,0,124,124,0
9,5,2018,23,0,4,"Braga",3,"Rua de Caires",36,36,0,37,37,0
9,5,2018,23,0,4,"Braga",4,"N14 Bosch",47,47,0,48,48,0
9,5,2018,23,0,4,"Braga",5,"Avenida João Paulo II",39,39,0,9,9,0
9,5,2018,23,0,4,"Braga",6,"Avenida Padre Júlio Fragata",67,67,0,83,83,0
9,5,2018,23,0,4,"Braga",7,"Rua Nova Santa Cruz",44,44,0,39,39,0
9,5,2018,23,0,4,"Braga",8,"Rua Costa Gomes",0,41,41,-1,42,-43
9,6,2018,0,0,5,"Braga",1,"Avenida da Liberdade",25,25,0,124,124,0
9,6,2018,0,0,5,"Braga",2,"Avenida Central",25,25,0,124,124,0
9,6,2018,0,0,5,"Braga",3,"Rua de Caires",36,36,0,37,37,0
9,6,2018,0,0,5,"Braga",4,"N14 Bosch",47,47,0,48,48,0
9,6,2018,0,0,5,"Braga",5,"Avenida João Paulo II",39,39,0,9,9,0
9,6,2018,0,0,5,"Braga",6,"Avenida Padre Júlio Fragata",67,67,0,83,83,0
9,6,2018,0,0,5,"Braga",7,"Rua Nova Santa Cruz",44,44,0,39,39,0
9,6,2018,0,0,5,"Braga",8,"Rua Costa Gomes",0,41,41,-1,42,-43
9,6,2018,1,0,5,"Braga",1,"Avenida da Liberdade",25,25,0,124,124,0
9,6,2018,1,0,5,"Braga",2,"Avenida Central",25,25,0,124,124,0
9,6,2018,1,0,5,"Braga",3,"Rua de Caires",36,36,0,37,37,0
9,6,2018,1,0,5,"Braga",4,"N14 Bosch",47,47,0,48,48,0
9,6,2018,1,0,5,"Braga",5,"Avenida João Paulo II",39,39,0,9,9,0
9,6,2018,1,0,5,"Braga",6,"Avenida Padre Júlio Fragata",67,67,0,83,83,0
9,6,2018,1,0,5,"Braga",7,"Rua Nova Santa Cruz",44,44,0,39,39,0
9,6,2018,1,0,5,"Braga",8,"Rua Costa Gomes",0,41,41,-1,42,-43
9,6,2018,2,0,5,"Braga",1,"Avenida da Liberdade",25,25,0,124,124,0
9,6,2018,2,0,5,"Braga",2,"Avenida Central",25,25,0,124,124,0
9,6,2018,2,0,5,"Braga",3,"Rua de Caires",36,36,0,37,37,0
9,6,2018,2,0,5,"Braga",4,"N14 Bosch",47,47,0,48,48,0
9,6,2018,2,0,5,"Braga",5,"Avenida João Paulo II",39,39,0,9,9,0
9,6,2018,2,0,5,"Braga",6,"Avenida Padre Júlio Fragata",67,67,0,83,83,0
9,6,2018,2,0,5,"Braga",7,"Rua Nova Santa Cruz",44,44,0,39,39,0
9,6,2018,2,0,5,"Braga",8,"Rua Costa Gomes",0,41,41,-1,42,-43
9,6,2018,3,0,5,"Braga",1,"Avenida da Liberdade",25,25,0,124,124,0
9,6,2018,3,0,5,"Braga",2,"Avenida Central",25,25,0,124,124,0
9,6,2018,3,0,5,"Braga",3,"Rua de Caires",36,36,0,37,37,0
9,6,2018,3,0,5,"Braga",4,"N14 Bosch",47,47,0,48,48,0
9,6,2018,3,0,5,"Braga",5,"Avenida João Paulo II",39,39,0,9,9,0
9,6,2018,3,0,5,"Braga",6,"Avenida Padre Júlio Fragata",67,67,0,83,83,0
9,6,2018,3,0,5,"Braga",7,"Rua Nova Santa Cruz",44,44,0,39,39,0
9,6,2018,3,0,5,"Braga",8,"Rua Costa Gomes",0,41,41,-1,42,-43
9,6,2018,4,0,5,"Braga",1,"Avenida da Liberdade",25,25,0,124,124,0
9,6,2018,4,0,5,"Braga",2,"Avenida Central",25,25,0,124,124,0
9,6,2018,4,0,5,"Braga",3,"Rua de Caires",36,36,0,37,37,0
9,6,2018,4,0,5,"Braga",4,"N14 Bosch",47,47,0,48,48,0
9,6,2018,4,0,5,"Braga",5,"Avenida João Paulo II",39,39,0,9,9,0
9,6,2018,4,0,5,"Braga",6,"Avenida Padre Júlio Fragata",67,67,0,83,83,0
9,6,2018,4,0,5,"Braga",7,"Rua Nova Santa Cruz",44,44,0,39,39,0
9,6,2018,4,0,5,"Braga",8,"Rua Costa Gomes",0,41,41,-1,42,-43
9,6,2018,5,0,5,"Braga",1,"Avenida da Liberdade",25,25,0,124,124,0
9,6,2018,5,0,5,"Braga",2,"Avenida Central",25,25,0,124,124,0
9,6,2018,5,0,5,"Braga",3,"Rua de Caires",36,36,0,37,37,0
9,6,2018,5,0,5,"Braga",4,"N14 Bosch",47,47,0,48,48,0
9,6,2018,5,0,5,"Braga",5,"Avenida João Paulo II",39,39,0,9,9,0
9,6,2018,5,0,5,"Braga",6,"Avenida Padre Júlio Fragata",67,67,0,83,83,0
9,6,2018,5,0,5,"Braga",7,"Rua Nova Santa Cruz",44,44,0,39,39,0
9,6,2018,5,0,5,"Braga",8,"Rua Costa Gomes",0,41,41,-1,42,-43
9,6,2018,6,0,5,"Braga",1,"Avenida da Liberdade",25,25,0,124,124,0
9,6,2018,6,0,5,"Braga",2,"Avenida Central",25,25,0,124,124,0
9,6,2018,6,0,5,"Braga",3,"Rua de Caires",36,36,0,37,37,0
9,6,2018,6,0,5,"Braga",4,"N14 Bosch",47,47,0,48,48,0
9,6,2018,6,0,5,"Braga",5,"Avenida João Paulo II",39,39,0,9,9,0
9,6,2018,6,0,5,"Braga",6,"Avenida Padre Júlio Fragata",67,67,0,83,83,0
9,6,2018,6,0,5,"Braga",7,"Rua Nova Santa Cruz",44,44,0,39,39,0
9,6,2018,6,0,5,"Braga",8,"Rua Costa Gomes",0,41,41,-1,42,-43
9,6,2018,7,0,5,"Braga",1,"Avenida da Liberdade",25,25,0,124,124,0
9,6,2018,7,0,5,"Braga",2,"Avenida Central",25,25,0,124,124,0
9,6,2018,7,0,5,"Braga",3,"Rua de Caires",36,36,0,37,37,0
9,6,2018,7,0,5,"Braga",4,"N14 Bosch",47,47,0,48,48,0
9,6,2018,7,0,5,"Braga",5,"Avenida João Paulo II",39,39,0,9,9,0
9,6,2018,7,0,5,"Braga",6,"Avenida Padre Júlio Fragata",67,67,0,83,83,0
9,6,2018,7,0,5,"Braga",7,"Rua Nova Santa Cruz",44,44,0,39,39,0
9,6,2018,7,0,5,"Braga",8,"Rua Costa Gomes",0,41,41,-1,42,-43
9,6,2018,8,0,5,"Braga",1,"Avenida da Liberdade",17,25,8,182,124,58
9,6,2018,8,0,5,"Braga",2,"Avenida Central",17,25,8,182,124,58
9,6,2018,8,0,5,"Braga",3,"Rua de Caires",25,36,11,54,37,17
9,6,2018,8,0,5,"Braga",4,"N14 Bosch",30,47,17,75,48,27
9,6,2018,8,0,5,"Braga",5,"Avenida João Paulo II",25,39,14,14,9,5
9,6,2018,8,0,5,"Braga",6,"Avenida Padre Júlio Fragata",45,67,22,124,83,41
9,6,2018,8,0,5,"Braga",7,"Rua Nova Santa Cruz",44,44,0,39,39,0
9,6,2018,8,0,5,"Braga",8,"Rua Costa Gomes",0,41,41,-1,42,-43
9,6,2018,9,0,5,"Braga",1,"Avenida da Liberdade",25,25,0,124,124,0
9,6,2018,9,0,5,"Braga",2,"Avenida Central",25,25,0,124,124,0
9,6,2018,9,0,5,"Braga",3,"Rua de Caires",22,36,14,61,37,24
9,6,2018,9,0,5,"Braga",4,"N14 Bosch",27,47,20,83,48,35
9,6,2018,9,0,5,"Braga",5,"Avenida João Paulo II",39,39,0,9,9,0
9,6,2018,9,0,5,"Braga",6,"Avenida Padre Júlio Fragata",67,67,0,83,83,0
9,6,2018,9,0,5,"Braga",7,"Rua Nova Santa Cruz",44,44,0,39,39,0
9,6,2018,9,0,5,"Braga",8,"Rua Costa Gomes",0,41,41,-1,42,-43
9,6,2018,10,0,5,"Braga",1,"Avenida da Liberdade",25,25,0,124,124,0
9,6,2018,10,0,5,"Braga",2,"Avenida Central",25,25,0,124,124,0
9,6,2018,10,0,5,"Braga",3,"Rua de Caires",27,36,9,50,37,13
9,6,2018,10,0,5,"Braga",4,"N14 Bosch",30,47,17,75,48,27
9,6,2018,10,0,5,"Braga",5,"Avenida João Paulo II",39,39,0,9,9,0
9,6,2018,10,0,5,"Braga",6,"Avenida Padre Júlio Fragata",67,67,0,83,83,0
9,6,2018,10,0,5,"Braga",7,"Rua Nova Santa Cruz",44,44,0,39,39,0
9,6,2018,10,0,5,"Braga",8,"Rua Costa Gomes",0,41,41,-1,42,-43
9,6,2018,11,0,5,"Braga",1,"Avenida da Liberdade",25,25,0,124,124,0
9,6,2018,11,0,5,"Braga",2,"Avenida Central",25,25,0,124,124,0
9,6,2018,11,0,5,"Braga",3,"Rua de Caires",36,36,0,37,37,0
9,6,2018,11,0,5,"Braga",4,"N14 Bosch",32,47,15,70,48,22
9,6,2018,11,0,5,"Braga",5,"Avenida João Paulo II",39,39,0,9,9,0
9,6,2018,11,0,5,"Braga",6,"Avenida Padre Júlio Fragata",67,67,0,83,83,0
9,6,2018,11,0,5,"Braga",7,"Rua Nova Santa Cruz",44,44,0,39,39,0
9,6,2018,11,0,5,"Braga",8,"Rua Costa Gomes",0,41,41,-1,42,-43
9,6,2018,12,0,5,"Braga",1,"Avenida da Liberdade",25,25,0,124,124,0
9,6,2018,12,0,5,"Braga",2,"Avenida Central",25,25,0,124,124,0
9,6,2018,12,0,5,"Braga",3,"Rua de Caires",23,36,13,59,37,22
9,6,2018,12,0,5,"Braga",4,"N14 Bosch",22,47,25,102,48,54
9,6,2018,12,0,5,"Braga",5,"Avenida João Paulo II",39,39,0,9,9,0
9,6,2018,12,0,5,"Braga",6,"Avenida Padre Júlio Fragata",67,67,0,83,83,0
9,6,2018,12,0,5,"Braga",7,"Rua Nova Santa Cruz",44,44,0,39,39,0
9,6,2018,12,0,5,"Braga",8,"Rua Costa Gomes",0,41,41,-1,42,-43
9,6,2018,13,0,5,"Braga",1,"Avenida da Liberdade",25,25,0,124,124,0
9,6,2018,13,0,5,"Braga",2,"Avenida Central",25,25,0,124,124,0
9,6,2018,13,0,5,"Braga",3,"Rua de Caires",26,36,10,52,37,15
9,6,2018,13,0,5,"Braga",4,"N14 Bosch",30,47,17,75,48,27
9,6,2018,13,0,5,"Braga",5,"Avenida João Paulo II",39,39,0,9,9,0
9,6,2018,13,0,5,"Braga",6,"Avenida Padre Júlio Fragata",67,67,0,83,83,0
9,6,2018,13,0,5,"Braga",7,"Rua Nova Santa Cruz",32,44,12,54,39,15
9,6,2018,13,0,5,"Braga",8,"Rua Costa Gomes",0,41,41,-1,42,-43
9,6,2018,14,0,5,"Braga",1,"Avenida da Liberdade",18,25,7,172,124,48
9,6,2018,14,0,5,"Braga",2,"Avenida Central",18,25,7,172,124,48
9,6,2018,14,0,5,"Braga",3,"Rua de Caires",36,36,0,37,37,0
9,6,2018,14,0,5,"Braga",4,"N14 Bosch",27,47,20,83,48,35
9,6,2018,14,0,5,"Braga",5,"Avenida João Paulo II",21,39,18,17,9,8
9,6,2018,14,0,5,"Braga",6,"Avenida Padre Júlio Fragata",67,67,0,83,83,0
9,6,2018,14,0,5,"Braga",7,"Rua Nova Santa Cruz",44,44,0,39,39,0
9,6,2018,14,0,5,"Braga",8,"Rua Costa Gomes",0,41,41,-1,42,-43
9,6,2018,15,0,5,"Braga",1,"Avenida da Liberdade",16,25,9,194,124,70
9,6,2018,15,0,5,"Braga",2,"Avenida Central",16,25,9,194,124,70
9,6,2018,15,0,5,"Braga",3,"Rua de Caires",24,36,12,56,37,19
9,6,2018,15,0,5,"Braga",4,"N14 Bosch",24,47,23,94,48,46
9,6,2018,15,0,5,"Braga",5,"Avenida João Paulo II",17,39,22,21,9,12
9,6,2018,15,0,5,"Braga",6,"Avenida Padre Júlio Fragata",67,67,0,83,83,0
9,6,2018,15,0,5,"Braga",7,"Rua Nova Santa Cruz",44,44,0,39,39,0
9,6,2018,15,0,5,"Braga",8,"Rua Costa Gomes",0,41,41,-1,42,-43
9,6,2018,16,0,5,"Braga",1,"Avenida da Liberdade",19,25,6,163,124,39
9,6,2018,16,0,5,"Braga",2,"Avenida Central",20,25,5,155,124,31
9,6,2018,16,0,5,"Braga",3,"Rua de Caires",25,36,11,54,37,17
9,6,2018,16,0,5,"Braga",4,"N14 Bosch",20,47,27,112,48,64
9,6,2018,16,0,5,"Braga",5,"Avenida João Paulo II",31,39,8,11,9,2
9,6,2018,16,0,5,"Braga",6,"Avenida Padre Júlio Fragata",67,67,0,83,83,0
9,6,2018,16,0,5,"Braga",7,"Rua Nova Santa Cruz",44,44,0,39,39,0
9,6,2018,16,0,5,"Braga",8,"Rua Costa Gomes",0,41,41,-1,42,-43
9,6,2018,17,0,5,"Braga",1,"Avenida da Liberdade",17,25,8,182,124,58
9,6,2018,17,0,5,"Braga",2,"Avenida Central",17,25,8,182,124,58
9,6,2018,17,0,5,"Braga",3,"Rua de Caires",36,36,0,37,37,0
9,6,2018,17,0,5,"Braga",4,"N14 Bosch",13,47,34,173,48,125
9,6,2018,17,0,5,"Braga",5,"Avenida João Paulo II",29,39,10,12,9,3
9,6,2018,17,0,5,"Braga",6,"Avenida Padre Júlio Fragata",38,67,29,147,83,64
9,6,2018,17,0,5,"Braga",7,"Rua Nova Santa Cruz",44,44,0,39,39,0
9,6,2018,17,0,5,"Braga",8,"Rua Costa Gomes",0,41,41,-1,42,-43
9,6,2018,18,0,5,"Braga",1,"Avenida da Liberdade",18,25,7,172,124,48
9,6,2018,18,0,5,"Braga",2,"Avenida Central",18,25,7,172,124,48
9,6,2018,18,0,5,"Braga",3,"Rua de Caires",16,36,20,84,37,47
9,6,2018,18,0,5,"Braga",4,"N14 Bosch",30,47,17,75,48,27
9,6,2018,18,0,5,"Braga",5,"Avenida João Paulo II",12,39,27,29,9,20
9,6,2018,18,0,5,"Braga",6,"Avenida Padre Júlio Fragata",21,67,46,265,83,182
9,6,2018,18,0,5,"Braga",7,"Rua Nova Santa Cruz",44,44,0,39,39,0
9,6,2018,18,0,5,"Braga",8,"Rua Costa Gomes",0,41,41,-1,42,-43
9,6,2018,19,0,5,"Braga",1,"Avenida da Liberdade",25,25,0,124,124,0
9,6,2018,19,0,5,"Braga",2,"Avenida Central",25,25,0,124,124,0
9,6,2018,19,0,5,"Braga",3,"Rua de Caires",36,36,0,37,37,0
9,6,2018,19,0,5,"Braga",4,"N14 Bosch",47,47,0,48,48,0
9,6,2018,19,0,5,"Braga",5,"Avenida João Paulo II",39,39,0,9,9,0
9,6,2018,19,0,5,"Braga",6,"Avenida Padre Júlio Fragata",49,67,18,114,83,31
9,6,2018,19,0,5,"Braga",7,"Rua Nova Santa Cruz",44,44,0,39,39,0
9,6,2018,19,0,5,"Braga",8,"Rua Costa Gomes",0,41,41,-1,42,-43
9,6,2018,20,0,5,"Braga",1,"Avenida da Liberdade",25,25,0,124,124,0
9,6,2018,20,0,5,"Braga",2,"Avenida Central",25,25,0,124,124,0
9,6,2018,20,0,5,"Braga",3,"Rua de Caires",36,36,0,37,37,0
9,6,2018,20,0,5,"Braga",4,"N14 Bosch",47,47,0,48,48,0
9,6,2018,20,0,5,"Braga",5,"Avenida João Paulo II",39,39,0,9,9,0
9,6,2018,20,0,5,"Braga",6,"Avenida Padre Júlio Fragata",67,67,0,83,83,0
9,6,2018,20,0,5,"Braga",7,"Rua Nova Santa Cruz",44,44,0,39,39,0
9,6,2018,20,0,5,"Braga",8,"Rua Costa Gomes",0,41,41,-1,42,-43
9,6,2018,21,0,5,"Braga",1,"Avenida da Liberdade",25,25,0,124,124,0
9,6,2018,21,0,5,"Braga",2,"Avenida Central",25,25,0,124,124,0
9,6,2018,21,0,5,"Braga",3,"Rua de Caires",36,36,0,37,37,0
9,6,2018,21,0,5,"Braga",4,"N14 Bosch",47,47,0,48,48,0
9,6,2018,21,0,5,"Braga",5,"Avenida João Paulo II",39,39,0,9,9,0
9,6,2018,21,0,5,"Braga",6,"Avenida Padre Júlio Fragata",53,67,14,105,83,22
9,6,2018,21,0,5,"Braga",7,"Rua Nova Santa Cruz",44,44,0,39,39,0
9,6,2018,21,0,5,"Braga",8,"Rua Costa Gomes",0,41,41,-1,42,-43
9,6,2018,22,0,5,"Braga",1,"Avenida da Liberdade",25,25,0,124,124,0
9,6,2018,22,0,5,"Braga",2,"Avenida Central",25,25,0,124,124,0
9,6,2018,22,0,5,"Braga",3,"Rua de Caires",36,36,0,37,37,0
9,6,2018,22,0,5,"Braga",4,"N14 Bosch",47,47,0,48,48,0
9,6,2018,22,0,5,"Braga",5,"Avenida João Paulo II",39,39,0,9,9,0
9,6,2018,22,0,5,"Braga",6,"Avenida Padre Júlio Fragata",67,67,0,83,83,0
9,6,2018,22,0,5,"Braga",7,"Rua Nova Santa Cruz",44,44,0,39,39,0
9,6,2018,22,0,5,"Braga",8,"Rua Costa Gomes",0,41,41,-1,42,-43
9,6,2018,23,0,5,"Braga",1,"Avenida da Liberdade",25,25,0,124,124,0
9,6,2018,23,0,5,"Braga",2,"Avenida Central",25,25,0,124,124,0
9,6,2018,23,0,5,"Braga",3,"Rua de Caires",36,36,0,37,37,0
9,6,2018,23,0,5,"Braga",4,"N14 Bosch",47,47,0,48,48,0
9,6,2018,23,0,5,"Braga",5,"Avenida João Paulo II",39,39,0,9,9,0
9,6,2018,23,0,5,"Braga",6,"Avenida Padre Júlio Fragata",67,67,0,83,83,0
9,6,2018,23,0,5,"Braga",7,"Rua Nova Santa Cruz",44,44,0,39,39,0
9,6,2018,23,0,5,"Braga",8,"Rua Costa Gomes",0,41,41,-1,42,-43
9,7,2018,0,0,6,"Braga",1,"Avenida da Liberdade",25,25,0,124,124,0
9,7,2018,0,0,6,"Braga",2,"Avenida Central",25,25,0,124,124,0
9,7,2018,0,0,6,"Braga",3,"Rua de Caires",36,36,0,37,37,0
9,7,2018,0,0,6,"Braga",4,"N14 Bosch",47,47,0,48,48,0
9,7,2018,0,0,6,"Braga",5,"Avenida João Paulo II",39,39,0,9,9,0
9,7,2018,0,0,6,"Braga",6,"Avenida Padre Júlio Fragata",67,67,0,83,83,0
9,7,2018,0,0,6,"Braga",7,"Rua Nova Santa Cruz",44,44,0,39,39,0
9,7,2018,0,0,6,"Braga",8,"Rua Costa Gomes",0,41,41,-1,42,-43
9,7,2018,1,0,6,"Braga",1,"Avenida da Liberdade",25,25,0,124,124,0
9,7,2018,1,0,6,"Braga",2,"Avenida Central",25,25,0,124,124,0
9,7,2018,1,0,6,"Braga",3,"Rua de Caires",36,36,0,37,37,0
9,7,2018,1,0,6,"Braga",4,"N14 Bosch",47,47,0,48,48,0
9,7,2018,1,0,6,"Braga",5,"Avenida João Paulo II",39,39,0,9,9,0
9,7,2018,1,0,6,"Braga",6,"Avenida Padre Júlio Fragata",67,67,0,83,83,0
9,7,2018,1,0,6,"Braga",7,"Rua Nova Santa Cruz",44,44,0,39,39,0
9,7,2018,1,0,6,"Braga",8,"Rua Costa Gomes",0,41,41,-1,42,-43
9,7,2018,2,0,6,"Braga",1,"Avenida da Liberdade",25,25,0,124,124,0
9,7,2018,2,0,6,"Braga",2,"Avenida Central",25,25,0,124,124,0
9,7,2018,2,0,6,"Braga",3,"Rua de Caires",36,36,0,37,37,0
9,7,2018,2,0,6,"Braga",4,"N14 Bosch",47,47,0,48,48,0
9,7,2018,2,0,6,"Braga",5,"Avenida João Paulo II",39,39,0,9,9,0
9,7,2018,2,0,6,"Braga",6,"Avenida Padre Júlio Fragata",67,67,0,83,83,0
9,7,2018,2,0,6,"Braga",7,"Rua Nova Santa Cruz",44,44,0,39,39,0
9,7,2018,2,0,6,"Braga",8,"Rua Costa Gomes",0,41,41,-1,42,-43
9,7,2018,3,0,6,"Braga",1,"Avenida da Liberdade",25,25,0,124,124,0
9,7,2018,3,0,6,"Braga",2,"Avenida Central",25,25,0,124,124,0
9,7,2018,3,0,6,"Braga",3,"Rua de Caires",36,36,0,37,37,0
9,7,2018,3,0,6,"Braga",4,"N14 Bosch",47,47,0,48,48,0
9,7,2018,3,0,6,"Braga",5,"Avenida João Paulo II",39,39,0,9,9,0
9,7,2018,3,0,6,"Braga",6,"Avenida Padre Júlio Fragata",67,67,0,83,83,0
9,7,2018,3,0,6,"Braga",7,"Rua Nova Santa Cruz",44,44,0,39,39,0
9,7,2018,3,0,6,"Braga",8,"Rua Costa Gomes",0,41,41,-1,42,-43
9,7,2018,4,0,6,"Braga",1,"Avenida da Liberdade",25,25,0,124,124,0
9,7,2018,4,0,6,"Braga",2,"Avenida Central",25,25,0,124,124,0
9,7,2018,4,0,6,"Braga",3,"Rua de Caires",36,36,0,37,37,0
9,7,2018,4,0,6,"Braga",4,"N14 Bosch",47,47,0,48,48,0
9,7,2018,4,0,6,"Braga",5,"Avenida João Paulo II",39,39,0,9,9,0
9,7,2018,4,0,6,"Braga",6,"Avenida Padre Júlio Fragata",67,67,0,83,83,0
9,7,2018,4,0,6,"Braga",7,"Rua Nova Santa Cruz",44,44,0,39,39,0
9,7,2018,4,0,6,"Braga",8,"Rua Costa Gomes",0,41,41,-1,42,-43
9,7,2018,5,0,6,"Braga",1,"Avenida da Liberdade",25,25,0,124,124,0
9,7,2018,5,0,6,"Braga",2,"Avenida Central",25,25,0,124,124,0
9,7,2018,5,0,6,"Braga",3,"Rua de Caires",36,36,0,37,37,0
9,7,2018,5,0,6,"Braga",4,"N14 Bosch",47,47,0,48,48,0
9,7,2018,5,0,6,"Braga",5,"Avenida João Paulo II",39,39,0,9,9,0
9,7,2018,5,0,6,"Braga",6,"Avenida Padre Júlio Fragata",67,67,0,83,83,0
9,7,2018,5,0,6,"Braga",7,"Rua Nova Santa Cruz",44,44,0,39,39,0
9,7,2018,5,0,6,"Braga",8,"Rua Costa Gomes",0,41,41,-1,42,-43
9,7,2018,6,0,6,"Braga",1,"Avenida da Liberdade",25,25,0,124,124,0
9,7,2018,6,0,6,"Braga",2,"Avenida Central",25,25,0,124,124,0
9,7,2018,6,0,6,"Braga",3,"Rua de Caires",36,36,0,37,37,0
9,7,2018,6,0,6,"Braga",4,"N14 Bosch",47,47,0,48,48,0
9,7,2018,6,0,6,"Braga",5,"Avenida João Paulo II",39,39,0,9,9,0
9,7,2018,6,0,6,"Braga",6,"Avenida Padre Júlio Fragata",67,67,0,83,83,0
9,7,2018,6,0,6,"Braga",7,"Rua Nova Santa Cruz",44,44,0,39,39,0
9,7,2018,6,0,6,"Braga",8,"Rua Costa Gomes",0,41,41,-1,42,-43
9,7,2018,7,0,6,"Braga",1,"Avenida da Liberdade",25,25,0,124,124,0
9,7,2018,7,0,6,"Braga",2,"Avenida Central",25,25,0,124,124,0
9,7,2018,7,0,6,"Braga",3,"Rua de Caires",16,36,20,84,37,47
9,7,2018,7,0,6,"Braga",4,"N14 Bosch",34,47,13,66,48,18
9,7,2018,7,0,6,"Braga",5,"Avenida João Paulo II",39,39,0,9,9,0
9,7,2018,7,0,6,"Braga",6,"Avenida Padre Júlio Fragata",67,67,0,83,83,0
9,7,2018,7,0,6,"Braga",7,"Rua Nova Santa Cruz",44,44,0,39,39,0
9,7,2018,7,0,6,"Braga",8,"Rua Costa Gomes",0,41,41,-1,42,-43
9,7,2018,8,0,6,"Braga",1,"Avenida da Liberdade",25,25,0,124,124,0
9,7,2018,8,0,6,"Braga",2,"Avenida Central",25,25,0,124,124,0
9,7,2018,8,0,6,"Braga",3,"Rua de Caires",20,36,16,67,37,30
9,7,2018,8,0,6,"Braga",4,"N14 Bosch",30,47,17,75,48,27
9,7,2018,8,0,6,"Braga",5,"Avenida João Paulo II",39,39,0,9,9,0
9,7,2018,8,0,6,"Braga",6,"Avenida Padre Júlio Fragata",34,67,33,164,83,81
9,7,2018,8,0,6,"Braga",7,"Rua Nova Santa Cruz",44,44,0,39,39,0
9,7,2018,8,0,6,"Braga",8,"Rua Costa Gomes",0,41,41,-1,42,-43
9,7,2018,9,0,6,"Braga",1,"Avenida da Liberdade",25,25,0,124,124,0
9,7,2018,9,0,6,"Braga",2,"Avenida Central",25,25,0,124,124,0
9,7,2018,9,0,6,"Braga",3,"Rua de Caires",20,36,16,67,37,30
9,7,2018,9,0,6,"Braga",4,"N14 Bosch",47,47,0,48,48,0
9,7,2018,9,0,6,"Braga",5,"Avenida João Paulo II",39,39,0,9,9,0
9,7,2018,9,0,6,"Braga",6,"Avenida Padre Júlio Fragata",67,67,0,83,83,0
9,7,2018,9,0,6,"Braga",7,"Rua Nova Santa Cruz",22,44,22,79,39,40
9,7,2018,9,0,6,"Braga",8,"Rua Costa Gomes",0,41,41,-1,42,-43
9,7,2018,10,0,6,"Braga",1,"Avenida da Liberdade",25,25,0,124,124,0
9,7,2018,10,0,6,"Braga",2,"Avenida Central",25,25,0,124,124,0
9,7,2018,10,0,6,"Braga",3,"Rua de Caires",36,36,0,37,37,0
9,7,2018,10,0,6,"Braga",4,"N14 Bosch",30,47,17,75,48,27
9,7,2018,10,0,6,"Braga",5,"Avenida João Paulo II",39,39,0,9,9,0
9,7,2018,10,0,6,"Braga",6,"Avenida Padre Júlio Fragata",67,67,0,83,83,0
9,7,2018,10,0,6,"Braga",7,"Rua Nova Santa Cruz",44,44,0,39,39,0
9,7,2018,10,0,6,"Braga",8,"Rua Costa Gomes",0,41,41,-1,42,-43
9,7,2018,11,0,6,"Braga",1,"Avenida da Liberdade",25,25,0,124,124,0
9,7,2018,11,0,6,"Braga",2,"Avenida Central",25,25,0,124,124,0
9,7,2018,11,0,6,"Braga",3,"Rua de Caires",26,36,10,52,37,15
9,7,2018,11,0,6,"Braga",4,"N14 Bosch",34,47,13,66,48,18
9,7,2018,11,0,6,"Braga",5,"Avenida João Paulo II",21,39,18,17,9,8
9,7,2018,11,0,6,"Braga",6,"Avenida Padre Júlio Fragata",67,67,0,83,83,0
9,7,2018,11,0,6,"Braga",7,"Rua Nova Santa Cruz",27,44,17,64,39,25
9,7,2018,11,0,6,"Braga",8,"Rua Costa Gomes",0,41,41,-1,42,-43
9,7,2018,12,0,6,"Braga",1,"Avenida da Liberdade",25,25,0,124,124,0
9,7,2018,12,0,6,"Braga",2,"Avenida Central",25,25,0,124,124,0
9,7,2018,12,0,6,"Braga",3,"Rua de Caires",27,36,9,50,37,13
9,7,2018,12,0,6,"Braga",4,"N14 Bosch",16,47,31,140,48,92
9,7,2018,12,0,6,"Braga",5,"Avenida João Paulo II",30,39,9,12,9,3
9,7,2018,12,0,6,"Braga",6,"Avenida Padre Júlio Fragata",67,67,0,83,83,0
9,7,2018,12,0,6,"Braga",7,"Rua Nova Santa Cruz",44,44,0,39,39,0
9,7,2018,12,0,6,"Braga",8,"Rua Costa Gomes",0,41,41,-1,42,-43
9,7,2018,13,0,6,"Braga",1,"Avenida da Liberdade",25,25,0,124,124,0
9,7,2018,13,0,6,"Braga",2,"Avenida Central",25,25,0,124,124,0
9,7,2018,13,0,6,"Braga",3,"Rua de Caires",36,36,0,37,37,0
9,7,2018,13,0,6,"Braga",4,"N14 Bosch",18,47,29,125,48,77
9,7,2018,13,0,6,"Braga",5,"Avenida João Paulo II",39,39,0,9,9,0
9,7,2018,13,0,6,"Braga",6,"Avenida Padre Júlio Fragata",67,67,0,83,83,0
9,7,2018,13,0,6,"Braga",7,"Rua Nova Santa Cruz",34,44,10,51,39,12
9,7,2018,13,0,6,"Braga",8,"Rua Costa Gomes",0,41,41,-1,42,-43
9,7,2018,14,0,6,"Braga",1,"Avenida da Liberdade",25,25,0,124,124,0
9,7,2018,14,0,6,"Braga",2,"Avenida Central",25,25,0,124,124,0
9,7,2018,14,0,6,"Braga",3,"Rua de Caires",36,36,0,37,37,0
9,7,2018,14,0,6,"Braga",4,"N14 Bosch",19,47,28,118,48,70
9,7,2018,14,0,6,"Braga",5,"Avenida João Paulo II",39,39,0,9,9,0
9,7,2018,14,0,6,"Braga",6,"Avenida Padre Júlio Fragata",67,67,0,83,83,0
9,7,2018,14,0,6,"Braga",7,"Rua Nova Santa Cruz",44,44,0,39,39,0
9,7,2018,14,0,6,"Braga",8,"Rua Costa Gomes",0,41,41,-1,42,-43
9,7,2018,15,0,6,"Braga",1,"Avenida da Liberdade",25,25,0,124,124,0
9,7,2018,15,0,6,"Braga",2,"Avenida Central",25,25,0,124,124,0
9,7,2018,15,0,6,"Braga",3,"Rua de Caires",36,36,0,37,37,0
9,7,2018,15,0,6,"Braga",4,"N14 Bosch",47,47,0,48,48,0
9,7,2018,15,0,6,"Braga",5,"Avenida João Paulo II",26,39,13,13,9,4
9,7,2018,15,0,6,"Braga",6,"Avenida Padre Júlio Fragata",67,67,0,83,83,0
9,7,2018,15,0,6,"Braga",7,"Rua Nova Santa Cruz",44,44,0,39,39,0
9,7,2018,15,0,6,"Braga",8,"Rua Costa Gomes",0,41,41,-1,42,-43
9,7,2018,16,0,6,"Braga",1,"Avenida da Liberdade",17,25,8,182,124,58
9,7,2018,16,0,6,"Braga",2,"Avenida Central",17,25,8,182,124,58
9,7,2018,16,0,6,"Braga",3,"Rua de Caires",27,36,9,50,37,13
9,7,2018,16,0,6,"Braga",4,"N14 Bosch",19,47,28,118,48,70
9,7,2018,16,0,6,"Braga",5,"Avenida João Paulo II",39,39,0,9,9,0
9,7,2018,16,0,6,"Braga",6,"Avenida Padre Júlio Fragata",50,67,17,111,83,28
9,7,2018,16,0,6,"Braga",7,"Rua Nova Santa Cruz",44,44,0,39,39,0
9,7,2018,16,0,6,"Braga",8,"Rua Costa Gomes",0,41,41,-1,42,-43
9,7,2018,17,0,6,"Braga",1,"Avenida da Liberdade",17,25,8,182,124,58
9,7,2018,17,0,6,"Braga",2,"Avenida Central",17,25,8,182,124,58
9,7,2018,17,0,6,"Braga",3,"Rua de Caires",26,36,10,52,37,15
9,7,2018,17,0,6,"Braga",4,"N14 Bosch",12,47,35,187,48,139
9,7,2018,17,0,6,"Braga",5,"Avenida João Paulo II",24,39,15,15,9,6
9,7,2018,17,0,6,"Braga",6,"Avenida Padre Júlio Fragata",26,67,41,214,83,131
9,7,2018,17,0,6,"Braga",7,"Rua Nova Santa Cruz",44,44,0,39,39,0
9,7,2018,17,0,6,"Braga",8,"Rua Costa Gomes",0,41,41,-1,42,-43
9,7,2018,18,0,6,"Braga",1,"Avenida da Liberdade",25,25,0,124,124,0
9,7,2018,18,0,6,"Braga",2,"Avenida Central",25,25,0,124,124,0
9,7,2018,18,0,6,"Braga",3,"Rua de Caires",20,36,16,67,37,30
9,7,2018,18,0,6,"Braga",4,"N14 Bosch",17,47,30,132,48,84
9,7,2018,18,0,6,"Braga",5,"Avenida João Paulo II",20,39,19,17,9,8
9,7,2018,18,0,6,"Braga",6,"Avenida Padre Júlio Fragata",23,67,44,242,83,159
9,7,2018,18,0,6,"Braga",7,"Rua Nova Santa Cruz",44,44,0,39,39,0
9,7,2018,18,0,6,"Braga",8,"Rua Costa Gomes",0,41,41,-1,42,-43
9,7,2018,19,0,6,"Braga",1,"Avenida da Liberdade",25,25,0,124,124,0
9,7,2018,19,0,6,"Braga",2,"Avenida Central",25,25,0,124,124,0
9,7,2018,19,0,6,"Braga",3,"Rua de Caires",26,36,10,52,37,15
9,7,2018,19,0,6,"Braga",4,"N14 Bosch",24,47,23,94,48,46
9,7,2018,19,0,6,"Braga",5,"Avenida João Paulo II",29,39,10,12,9,3
9,7,2018,19,0,6,"Braga",6,"Avenida Padre Júlio Fragata",25,67,42,223,83,140
9,7,2018,19,0,6,"Braga",7,"Rua Nova Santa Cruz",44,44,0,39,39,0
9,7,2018,19,0,6,"Braga",8,"Rua Costa Gomes",0,41,41,-1,42,-43
9,7,2018,20,0,6,"Braga",1,"Avenida da Liberdade",25,25,0,124,124,0
9,7,2018,20,0,6,"Braga",2,"Avenida Central",25,25,0,124,124,0
9,7,2018,20,0,6,"Braga",3,"Rua de Caires",28,36,8,48,37,11
9,7,2018,20,0,6,"Braga",4,"N14 Bosch",29,47,18,77,48,29
9,7,2018,20,0,6,"Braga",5,"Avenida João Paulo II",39,39,0,9,9,0
9,7,2018,20,0,6,"Braga",6,"Avenida Padre Júlio Fragata",67,67,0,83,83,0
9,7,2018,20,0,6,"Braga",7,"Rua Nova Santa Cruz",44,44,0,39,39,0
9,7,2018,20,0,6,"Braga",8,"Rua Costa Gomes",0,41,41,-1,42,-43
9,7,2018,21,0,6,"Braga",1,"Avenida da Liberdade",25,25,0,124,124,0
9,7,2018,21,0,6,"Braga",2,"Avenida Central",25,25,0,124,124,0
9,7,2018,21,0,6,"Braga",3,"Rua de Caires",36,36,0,37,37,0
9,7,2018,21,0,6,"Braga",4,"N14 Bosch",47,47,0,48,48,0
9,7,2018,21,0,6,"Braga",5,"Avenida João Paulo II",39,39,0,9,9,0
9,7,2018,21,0,6,"Braga",6,"Avenida Padre Júlio Fragata",67,67,0,83,83,0
9,7,2018,21,0,6,"Braga",7,"Rua Nova Santa Cruz",44,44,0,39,39,0
9,7,2018,21,0,6,"Braga",8,"Rua Costa Gomes",0,41,41,-1,42,-43
9,7,2018,22,0,6,"Braga",1,"Avenida da Liberdade",25,25,0,124,124,0
9,7,2018,22,0,6,"Braga",2,"Avenida Central",25,25,0,124,124,0
9,7,2018,22,0,6,"Braga",3,"Rua de Caires",36,36,0,37,37,0
9,7,2018,22,0,6,"Braga",4,"N14 Bosch",47,47,0,48,48,0
9,7,2018,22,0,6,"Braga",5,"Avenida João Paulo II",39,39,0,9,9,0
9,7,2018,22,0,6,"Braga",6,"Avenida Padre Júlio Fragata",67,67,0,83,83,0
9,7,2018,22,0,6,"Braga",7,"Rua Nova Santa Cruz",44,44,0,39,39,0
9,7,2018,22,0,6,"Braga",8,"Rua Costa Gomes",0,41,41,-1,42,-43
9,7,2018,23,0,6,"Braga",1,"Avenida da Liberdade",25,25,0,124,124,0
9,7,2018,23,0,6,"Braga",2,"Avenida Central",25,25,0,124,124,0
9,7,2018,23,0,6,"Braga",3,"Rua de Caires",36,36,0,37,37,0
9,7,2018,23,0,6,"Braga",4,"N14 Bosch",47,47,0,48,48,0
9,7,2018,23,0,6,"Braga",5,"Avenida João Paulo II",39,39,0,9,9,0
9,7,2018,23,0,6,"Braga",6,"Avenida Padre Júlio Fragata",67,67,0,83,83,0
9,7,2018,23,0,6,"Braga",7,"Rua Nova Santa Cruz",44,44,0,39,39,0
9,7,2018,23,0,6,"Braga",8,"Rua Costa Gomes",0,41,41,-1,42,-43
9,8,2018,0,0,7,"Braga",1,"Avenida da Liberdade",25,25,0,124,124,0
9,8,2018,0,0,7,"Braga",2,"Avenida Central",25,25,0,124,124,0
9,8,2018,0,0,7,"Braga",3,"Rua de Caires",36,36,0,37,37,0
9,8,2018,0,0,7,"Braga",4,"N14 Bosch",47,47,0,48,48,0
9,8,2018,0,0,7,"Braga",5,"Avenida João Paulo II",39,39,0,9,9,0
9,8,2018,0,0,7,"Braga",6,"Avenida Padre Júlio Fragata",67,67,0,83,83,0
9,8,2018,0,0,7,"Braga",7,"Rua Nova Santa Cruz",44,44,0,39,39,0
9,8,2018,0,0,7,"Braga",8,"Rua Costa Gomes",0,41,41,-1,42,-43
9,8,2018,1,0,7,"Braga",1,"Avenida da Liberdade",25,25,0,124,124,0
9,8,2018,1,0,7,"Braga",2,"Avenida Central",25,25,0,124,124,0
9,8,2018,1,0,7,"Braga",3,"Rua de Caires",36,36,0,37,37,0
9,8,2018,1,0,7,"Braga",4,"N14 Bosch",47,47,0,48,48,0
9,8,2018,1,0,7,"Braga",5,"Avenida João Paulo II",39,39,0,9,9,0
9,8,2018,1,0,7,"Braga",6,"Avenida Padre Júlio Fragata",67,67,0,83,83,0
9,8,2018,1,0,7,"Braga",7,"Rua Nova Santa Cruz",44,44,0,39,39,0
9,8,2018,1,0,7,"Braga",8,"Rua Costa Gomes",0,41,41,-1,42,-43
9,8,2018,2,0,7,"Braga",1,"Avenida da Liberdade",25,25,0,124,124,0
9,8,2018,2,0,7,"Braga",2,"Avenida Central",25,25,0,124,124,0
9,8,2018,2,0,7,"Braga",3,"Rua de Caires",36,36,0,37,37,0
9,8,2018,2,0,7,"Braga",4,"N14 Bosch",47,47,0,48,48,0
9,8,2018,2,0,7,"Braga",5,"Avenida João Paulo II",39,39,0,9,9,0
9,8,2018,2,0,7,"Braga",6,"Avenida Padre Júlio Fragata",67,67,0,83,83,0
9,8,2018,2,0,7,"Braga",7,"Rua Nova Santa Cruz",44,44,0,39,39,0
9,8,2018,2,0,7,"Braga",8,"Rua Costa Gomes",0,41,41,-1,42,-43
9,8,2018,3,0,7,"Braga",1,"Avenida da Liberdade",25,25,0,124,124,0
9,8,2018,3,0,7,"Braga",2,"Avenida Central",25,25,0,124,124,0
9,8,2018,3,0,7,"Braga",3,"Rua de Caires",36,36,0,37,37,0
9,8,2018,3,0,7,"Braga",4,"N14 Bosch",47,47,0,48,48,0
9,8,2018,3,0,7,"Braga",5,"Avenida João Paulo II",39,39,0,9,9,0
9,8,2018,3,0,7,"Braga",6,"Avenida Padre Júlio Fragata",67,67,0,83,83,0
9,8,2018,3,0,7,"Braga",7,"Rua Nova Santa Cruz",44,44,0,39,39,0
9,8,2018,3,0,7,"Braga",8,"Rua Costa Gomes",0,41,41,-1,42,-43
9,8,2018,4,0,7,"Braga",1,"Avenida da Liberdade",25,25,0,124,124,0
9,8,2018,4,0,7,"Braga",2,"Avenida Central",25,25,0,124,124,0
9,8,2018,4,0,7,"Braga",3,"Rua de Caires",36,36,0,37,37,0
9,8,2018,4,0,7,"Braga",4,"N14 Bosch",47,47,0,48,48,0
9,8,2018,4,0,7,"Braga",5,"Avenida João Paulo II",39,39,0,9,9,0
9,8,2018,4,0,7,"Braga",6,"Avenida Padre Júlio Fragata",67,67,0,83,83,0
9,8,2018,4,0,7,"Braga",7,"Rua Nova Santa Cruz",44,44,0,39,39,0
9,8,2018,4,0,7,"Braga",8,"Rua Costa Gomes",0,41,41,-1,42,-43
9,8,2018,5,0,7,"Braga",1,"Avenida da Liberdade",25,25,0,124,124,0
9,8,2018,5,0,7,"Braga",2,"Avenida Central",25,25,0,124,124,0
9,8,2018,5,0,7,"Braga",3,"Rua de Caires",36,36,0,37,37,0
9,8,2018,5,0,7,"Braga",4,"N14 Bosch",47,47,0,48,48,0
9,8,2018,5,0,7,"Braga",5,"Avenida João Paulo II",39,39,0,9,9,0
9,8,2018,5,0,7,"Braga",6,"Avenida Padre Júlio Fragata",67,67,0,83,83,0
9,8,2018,5,0,7,"Braga",7,"Rua Nova Santa Cruz",44,44,0,39,39,0
9,8,2018,5,0,7,"Braga",8,"Rua Costa Gomes",0,41,41,-1,42,-43
9,8,2018,6,0,7,"Braga",1,"Avenida da Liberdade",25,25,0,124,124,0
9,8,2018,6,0,7,"Braga",2,"Avenida Central",25,25,0,124,124,0
9,8,2018,6,0,7,"Braga",3,"Rua de Caires",36,36,0,37,37,0
9,8,2018,6,0,7,"Braga",4,"N14 Bosch",47,47,0,48,48,0
9,8,2018,6,0,7,"Braga",5,"Avenida João Paulo II",39,39,0,9,9,0
9,8,2018,6,0,7,"Braga",6,"Avenida Padre Júlio Fragata",67,67,0,83,83,0
9,8,2018,6,0,7,"Braga",7,"Rua Nova Santa Cruz",44,44,0,39,39,0
9,8,2018,6,0,7,"Braga",8,"Rua Costa Gomes",0,41,41,-1,42,-43
9,8,2018,7,0,7,"Braga",1,"Avenida da Liberdade",25,25,0,124,124,0
9,8,2018,7,0,7,"Braga",2,"Avenida Central",25,25,0,124,124,0
9,8,2018,7,0,7,"Braga",3,"Rua de Caires",36,36,0,37,37,0
9,8,2018,7,0,7,"Braga",4,"N14 Bosch",47,47,0,48,48,0
9,8,2018,7,0,7,"Braga",5,"Avenida João Paulo II",39,39,0,9,9,0
9,8,2018,7,0,7,"Braga",6,"Avenida Padre Júlio Fragata",67,67,0,83,83,0
9,8,2018,7,0,7,"Braga",7,"Rua Nova Santa Cruz",44,44,0,39,39,0
9,8,2018,7,0,7,"Braga",8,"Rua Costa Gomes",0,41,41,-1,42,-43
9,8,2018,8,0,7,"Braga",1,"Avenida da Liberdade",25,25,0,124,124,0
9,8,2018,8,0,7,"Braga",2,"Avenida Central",25,25,0,124,124,0
9,8,2018,8,0,7,"Braga",3,"Rua de Caires",36,36,0,37,37,0
9,8,2018,8,0,7,"Braga",4,"N14 Bosch",47,47,0,48,48,0
9,8,2018,8,0,7,"Braga",5,"Avenida João Paulo II",39,39,0,9,9,0
9,8,2018,8,0,7,"Braga",6,"Avenida Padre Júlio Fragata",67,67,0,83,83,0
9,8,2018,8,0,7,"Braga",7,"Rua Nova Santa Cruz",44,44,0,39,39,0
9,8,2018,8,0,7,"Braga",8,"Rua Costa Gomes",0,41,41,-1,42,-43
9,8,2018,9,0,7,"Braga",1,"Avenida da Liberdade",25,25,0,124,124,0
9,8,2018,9,0,7,"Braga",2,"Avenida Central",25,25,0,124,124,0
9,8,2018,9,0,7,"Braga",3,"Rua de Caires",36,36,0,37,37,0
9,8,2018,9,0,7,"Braga",4,"N14 Bosch",47,47,0,48,48,0
9,8,2018,9,0,7,"Braga",5,"Avenida João Paulo II",39,39,0,9,9,0
9,8,2018,9,0,7,"Braga",6,"Avenida Padre Júlio Fragata",67,67,0,83,83,0
9,8,2018,9,0,7,"Braga",7,"Rua Nova Santa Cruz",44,44,0,39,39,0
9,8,2018,9,0,7,"Braga",8,"Rua Costa Gomes",0,41,41,-1,42,-43
9,8,2018,10,0,7,"Braga",1,"Avenida da Liberdade",25,25,0,124,124,0
9,8,2018,10,0,7,"Braga",2,"Avenida Central",25,25,0,124,124,0
9,8,2018,10,0,7,"Braga",3,"Rua de Caires",36,36,0,37,37,0
9,8,2018,10,0,7,"Braga",4,"N14 Bosch",47,47,0,48,48,0
9,8,2018,10,0,7,"Braga",5,"Avenida João Paulo II",39,39,0,9,9,0
9,8,2018,10,0,7,"Braga",6,"Avenida Padre Júlio Fragata",67,67,0,83,83,0
9,8,2018,10,0,7,"Braga",7,"Rua Nova Santa Cruz",44,44,0,39,39,0
9,8,2018,10,0,7,"Braga",8,"Rua Costa Gomes",0,41,41,-1,42,-43
9,8,2018,11,0,7,"Braga",1,"Avenida da Liberdade",25,25,0,124,124,0
9,8,2018,11,0,7,"Braga",2,"Avenida Central",25,25,0,124,124,0
9,8,2018,11,0,7,"Braga",3,"Rua de Caires",36,36,0,37,37,0
9,8,2018,11,0,7,"Braga",4,"N14 Bosch",27,47,20,83,48,35
9,8,2018,11,0,7,"Braga",5,"Avenida João Paulo II",39,39,0,9,9,0
9,8,2018,11,0,7,"Braga",6,"Avenida Padre Júlio Fragata",67,67,0,83,83,0
9,8,2018,11,0,7,"Braga",7,"Rua Nova Santa Cruz",44,44,0,39,39,0
9,8,2018,11,0,7,"Braga",8,"Rua Costa Gomes",0,41,41,-1,42,-43
9,8,2018,12,0,7,"Braga",1,"Avenida da Liberdade",18,25,7,172,124,48
9,8,2018,12,0,7,"Braga",2,"Avenida Central",18,25,7,172,124,48
9,8,2018,12,0,7,"Braga",3,"Rua de Caires",36,36,0,37,37,0
9,8,2018,12,0,7,"Braga",4,"N14 Bosch",35,47,12,64,48,16
9,8,2018,12,0,7,"Braga",5,"Avenida João Paulo II",39,39,0,9,9,0
9,8,2018,12,0,7,"Braga",6,"Avenida Padre Júlio Fragata",67,67,0,83,83,0
9,8,2018,12,0,7,"Braga",7,"Rua Nova Santa Cruz",33,44,11,52,39,13
9,8,2018,12,0,7,"Braga",8,"Rua Costa Gomes",0,41,41,-1,42,-43
9,8,2018,13,0,7,"Braga",1,"Avenida da Liberdade",25,25,0,124,124,0
9,8,2018,13,0,7,"Braga",2,"Avenida Central",25,25,0,124,124,0
9,8,2018,13,0,7,"Braga",3,"Rua de Caires",36,36,0,37,37,0
9,8,2018,13,0,7,"Braga",4,"N14 Bosch",47,47,0,48,48,0
9,8,2018,13,0,7,"Braga",5,"Avenida João Paulo II",39,39,0,9,9,0
9,8,2018,13,0,7,"Braga",6,"Avenida Padre Júlio Fragata",67,67,0,83,83,0
9,8,2018,13,0,7,"Braga",7,"Rua Nova Santa Cruz",44,44,0,39,39,0
9,8,2018,13,0,7,"Braga",8,"Rua Costa Gomes",0,41,41,-1,42,-43
9,8,2018,14,0,7,"Braga",1,"Avenida da Liberdade",25,25,0,124,124,0
9,8,2018,14,0,7,"Braga",2,"Avenida Central",25,25,0,124,124,0
9,8,2018,14,0,7,"Braga",3,"Rua de Caires",27,36,9,50,37,13
9,8,2018,14,0,7,"Braga",4,"N14 Bosch",47,47,0,48,48,0
9,8,2018,14,0,7,"Braga",5,"Avenida João Paulo II",39,39,0,9,9,0
9,8,2018,14,0,7,"Braga",6,"Avenida Padre Júlio Fragata",67,67,0,83,83,0
9,8,2018,14,0,7,"Braga",7,"Rua Nova Santa Cruz",44,44,0,39,39,0
9,8,2018,14,0,7,"Braga",8,"Rua Costa Gomes",0,41,41,-1,42,-43
9,8,2018,15,0,7,"Braga",1,"Avenida da Liberdade",25,25,0,124,124,0
9,8,2018,15,0,7,"Braga",2,"Avenida Central",25,25,0,124,124,0
9,8,2018,15,0,7,"Braga",3,"Rua de Caires",36,36,0,37,37,0
9,8,2018,15,0,7,"Braga",4,"N14 Bosch",35,47,12,64,48,16
9,8,2018,15,0,7,"Braga",5,"Avenida João Paulo II",28,39,11,12,9,3
9,8,2018,15,0,7,"Braga",6,"Avenida Padre Júlio Fragata",67,67,0,83,83,0
9,8,2018,15,0,7,"Braga",7,"Rua Nova Santa Cruz",44,44,0,39,39,0
9,8,2018,15,0,7,"Braga",8,"Rua Costa Gomes",0,41,41,-1,42,-43
9,8,2018,16,0,7,"Braga",1,"Avenida da Liberdade",25,25,0,124,124,0
9,8,2018,16,0,7,"Braga",2,"Avenida Central",25,25,0,124,124,0
9,8,2018,16,0,7,"Braga",3,"Rua de Caires",36,36,0,37,37,0
9,8,2018,16,0,7,"Braga",4,"N14 Bosch",47,47,0,48,48,0
9,8,2018,16,0,7,"Braga",5,"Avenida João Paulo II",39,39,0,9,9,0
9,8,2018,16,0,7,"Braga",6,"Avenida Padre Júlio Fragata",67,67,0,83,83,0
9,8,2018,16,0,7,"Braga",7,"Rua Nova Santa Cruz",44,44,0,39,39,0
9,8,2018,16,0,7,"Braga",8,"Rua Costa Gomes",0,41,41,-1,42,-43
9,8,2018,17,0,7,"Braga",1,"Avenida da Liberdade",25,25,0,124,124,0
9,8,2018,17,0,7,"Braga",2,"Avenida Central",25,25,0,124,124,0
9,8,2018,17,0,7,"Braga",3,"Rua de Caires",23,36,13,59,37,22
9,8,2018,17,0,7,"Braga",4,"N14 Bosch",47,47,0,48,48,0
9,8,2018,17,0,7,"Braga",5,"Avenida João Paulo II",28,39,11,12,9,3
9,8,2018,17,0,7,"Braga",6,"Avenida Padre Júlio Fragata",50,67,17,111,83,28
9,8,2018,17,0,7,"Braga",7,"Rua Nova Santa Cruz",44,44,0,39,39,0
9,8,2018,17,0,7,"Braga",8,"Rua Costa Gomes",0,41,41,-1,42,-43
9,8,2018,18,0,7,"Braga",1,"Avenida da Liberdade",25,25,0,124,124,0
9,8,2018,18,0,7,"Braga",2,"Avenida Central",25,25,0,124,124,0
9,8,2018,18,0,7,"Braga",3,"Rua de Caires",36,36,0,37,37,0
9,8,2018,18,0,7,"Braga",4,"N14 Bosch",47,47,0,48,48,0
9,8,2018,18,0,7,"Braga",5,"Avenida João Paulo II",39,39,0,9,9,0
9,8,2018,18,0,7,"Braga",6,"Avenida Padre Júlio Fragata",67,67,0,83,83,0
9,8,2018,18,0,7,"Braga",7,"Rua Nova Santa Cruz",44,44,0,39,39,0
9,8,2018,18,0,7,"Braga",8,"Rua Costa Gomes",0,41,41,-1,42,-43
9,8,2018,19,0,7,"Braga",1,"Avenida da Liberdade",25,25,0,124,124,0
9,8,2018,19,0,7,"Braga",2,"Avenida Central",25,25,0,124,124,0
9,8,2018,19,0,7,"Braga",3,"Rua de Caires",36,36,0,37,37,0
9,8,2018,19,0,7,"Braga",4,"N14 Bosch",35,47,12,64,48,16
9,8,2018,19,0,7,"Braga",5,"Avenida João Paulo II",39,39,0,9,9,0
9,8,2018,19,0,7,"Braga",6,"Avenida Padre Júlio Fragata",51,67,16,109,83,26
9,8,2018,19,0,7,"Braga",7,"Rua Nova Santa Cruz",32,44,12,54,39,15
9,8,2018,19,0,7,"Braga",8,"Rua Costa Gomes",0,41,41,-1,42,-43
9,8,2018,20,0,7,"Braga",1,"Avenida da Liberdade",25,25,0,124,124,0
9,8,2018,20,0,7,"Braga",2,"Avenida Central",25,25,0,124,124,0
9,8,2018,20,0,7,"Braga",3,"Rua de Caires",36,36,0,37,37,0
9,8,2018,20,0,7,"Braga",4,"N14 Bosch",47,47,0,48,48,0
9,8,2018,20,0,7,"Braga",5,"Avenida João Paulo II",39,39,0,9,9,0
9,8,2018,20,0,7,"Braga",6,"Avenida Padre Júlio Fragata",67,67,0,83,83,0
9,8,2018,20,0,7,"Braga",7,"Rua Nova Santa Cruz",44,44,0,39,39,0
9,8,2018,20,0,7,"Braga",8,"Rua Costa Gomes",0,41,41,-1,42,-43
9,8,2018,21,0,7,"Braga",1,"Avenida da Liberdade",25,25,0,124,124,0
9,8,2018,21,0,7,"Braga",2,"Avenida Central",25,25,0,124,124,0
9,8,2018,21,0,7,"Braga",3,"Rua de Caires",36,36,0,37,37,0
9,8,2018,21,0,7,"Braga",4,"N14 Bosch",47,47,0,48,48,0
9,8,2018,21,0,7,"Braga",5,"Avenida João Paulo II",39,39,0,9,9,0
9,8,2018,21,0,7,"Braga",6,"Avenida Padre Júlio Fragata",52,67,15,107,83,24
9,8,2018,21,0,7,"Braga",7,"Rua Nova Santa Cruz",44,44,0,39,39,0
9,8,2018,21,0,7,"Braga",8,"Rua Costa Gomes",0,41,41,-1,42,-43
9,8,2018,22,0,7,"Braga",1,"Avenida da Liberdade",25,25,0,124,124,0
9,8,2018,22,0,7,"Braga",2,"Avenida Central",25,25,0,124,124,0
9,8,2018,22,0,7,"Braga",3,"Rua de Caires",36,36,0,37,37,0
9,8,2018,22,0,7,"Braga",4,"N14 Bosch",47,47,0,48,48,0
9,8,2018,22,0,7,"Braga",5,"Avenida João Paulo II",39,39,0,9,9,0
9,8,2018,22,0,7,"Braga",6,"Avenida Padre Júlio Fragata",67,67,0,83,83,0
9,8,2018,22,0,7,"Braga",7,"Rua Nova Santa Cruz",44,44,0,39,39,0
9,8,2018,22,0,7,"Braga",8,"Rua Costa Gomes",0,41,41,-1,42,-43
9,8,2018,23,0,7,"Braga",1,"Avenida da Liberdade",25,25,0,124,124,0
9,8,2018,23,0,7,"Braga",2,"Avenida Central",25,25,0,124,124,0
9,8,2018,23,0,7,"Braga",3,"Rua de Caires",36,36,0,37,37,0
9,8,2018,23,0,7,"Braga",4,"N14 Bosch",47,47,0,48,48,0
9,8,2018,23,0,7,"Braga",5,"Avenida João Paulo II",39,39,0,9,9,0
9,8,2018,23,0,7,"Braga",6,"Avenida Padre Júlio Fragata",67,67,0,83,83,0
9,8,2018,23,0,7,"Braga",7,"Rua Nova Santa Cruz",44,44,0,39,39,0
9,8,2018,23,0,7,"Braga",8,"Rua Costa Gomes",0,41,41,-1,42,-43
9,9,2018,0,0,8,"Braga",1,"Avenida da Liberdade",25,25,0,124,124,0
9,9,2018,0,0,8,"Braga",2,"Avenida Central",25,25,0,124,124,0
9,9,2018,0,0,8,"Braga",3,"Rua de Caires",36,36,0,37,37,0
9,9,2018,0,0,8,"Braga",4,"N14 Bosch",47,47,0,48,48,0
9,9,2018,0,0,8,"Braga",5,"Avenida João Paulo II",39,39,0,9,9,0
9,9,2018,0,0,8,"Braga",6,"Avenida Padre Júlio Fragata",67,67,0,83,83,0
9,9,2018,0,0,8,"Braga",7,"Rua Nova Santa Cruz",44,44,0,39,39,0
9,9,2018,0,0,8,"Braga",8,"Rua Costa Gomes",0,41,41,-1,42,-43
9,9,2018,1,0,8,"Braga",1,"Avenida da Liberdade",25,25,0,124,124,0
9,9,2018,1,0,8,"Braga",2,"Avenida Central",25,25,0,124,124,0
9,9,2018,1,0,8,"Braga",3,"Rua de Caires",36,36,0,37,37,0
9,9,2018,1,0,8,"Braga",4,"N14 Bosch",47,47,0,48,48,0
9,9,2018,1,0,8,"Braga",5,"Avenida João Paulo II",39,39,0,9,9,0
9,9,2018,1,0,8,"Braga",6,"Avenida Padre Júlio Fragata",67,67,0,83,83,0
9,9,2018,1,0,8,"Braga",7,"Rua Nova Santa Cruz",44,44,0,39,39,0
9,9,2018,1,0,8,"Braga",8,"Rua Costa Gomes",0,41,41,-1,42,-43
9,9,2018,2,0,8,"Braga",1,"Avenida da Liberdade",25,25,0,124,124,0
9,9,2018,2,0,8,"Braga",2,"Avenida Central",25,25,0,124,124,0
9,9,2018,2,0,8,"Braga",3,"Rua de Caires",36,36,0,37,37,0
9,9,2018,2,0,8,"Braga",4,"N14 Bosch",47,47,0,48,48,0
9,9,2018,2,0,8,"Braga",5,"Avenida João Paulo II",39,39,0,9,9,0
9,9,2018,2,0,8,"Braga",6,"Avenida Padre Júlio Fragata",67,67,0,83,83,0
9,9,2018,2,0,8,"Braga",7,"Rua Nova Santa Cruz",44,44,0,39,39,0
9,9,2018,2,0,8,"Braga",8,"Rua Costa Gomes",0,41,41,-1,42,-43
9,9,2018,3,0,8,"Braga",1,"Avenida da Liberdade",25,25,0,124,124,0
9,9,2018,3,0,8,"Braga",2,"Avenida Central",25,25,0,124,124,0
9,9,2018,3,0,8,"Braga",3,"Rua de Caires",36,36,0,37,37,0
9,9,2018,3,0,8,"Braga",4,"N14 Bosch",47,47,0,48,48,0
9,9,2018,3,0,8,"Braga",5,"Avenida João Paulo II",39,39,0,9,9,0
9,9,2018,3,0,8,"Braga",6,"Avenida Padre Júlio Fragata",67,67,0,83,83,0
9,9,2018,3,0,8,"Braga",7,"Rua Nova Santa Cruz",44,44,0,39,39,0
9,9,2018,3,0,8,"Braga",8,"Rua Costa Gomes",0,41,41,-1,42,-43
9,9,2018,4,0,8,"Braga",1,"Avenida da Liberdade",25,25,0,124,124,0
9,9,2018,4,0,8,"Braga",2,"Avenida Central",25,25,0,124,124,0
9,9,2018,4,0,8,"Braga",3,"Rua de Caires",36,36,0,37,37,0
9,9,2018,4,0,8,"Braga",4,"N14 Bosch",47,47,0,48,48,0
9,9,2018,4,0,8,"Braga",5,"Avenida João Paulo II",39,39,0,9,9,0
9,9,2018,4,0,8,"Braga",6,"Avenida Padre Júlio Fragata",67,67,0,83,83,0
9,9,2018,4,0,8,"Braga",7,"Rua Nova Santa Cruz",44,44,0,39,39,0
9,9,2018,4,0,8,"Braga",8,"Rua Costa Gomes",0,41,41,-1,42,-43
9,9,2018,5,0,8,"Braga",1,"Avenida da Liberdade",25,25,0,124,124,0
9,9,2018,5,0,8,"Braga",2,"Avenida Central",25,25,0,124,124,0
9,9,2018,5,0,8,"Braga",3,"Rua de Caires",36,36,0,37,37,0
9,9,2018,5,0,8,"Braga",4,"N14 Bosch",47,47,0,48,48,0
9,9,2018,5,0,8,"Braga",5,"Avenida João Paulo II",39,39,0,9,9,0
9,9,2018,5,0,8,"Braga",6,"Avenida Padre Júlio Fragata",67,67,0,83,83,0
9,9,2018,5,0,8,"Braga",7,"Rua Nova Santa Cruz",44,44,0,39,39,0
9,9,2018,5,0,8,"Braga",8,"Rua Costa Gomes",0,41,41,-1,42,-43
9,9,2018,6,0,8,"Braga",1,"Avenida da Liberdade",25,25,0,124,124,0
9,9,2018,6,0,8,"Braga",2,"Avenida Central",25,25,0,124,124,0
9,9,2018,6,0,8,"Braga",3,"Rua de Caires",36,36,0,37,37,0
9,9,2018,6,0,8,"Braga",4,"N14 Bosch",47,47,0,48,48,0
9,9,2018,6,0,8,"Braga",5,"Avenida João Paulo II",39,39,0,9,9,0
9,9,2018,6,0,8,"Braga",6,"Avenida Padre Júlio Fragata",67,67,0,83,83,0
9,9,2018,6,0,8,"Braga",7,"Rua Nova Santa Cruz",44,44,0,39,39,0
9,9,2018,6,0,8,"Braga",8,"Rua Costa Gomes",0,41,41,-1,42,-43
9,9,2018,7,0,8,"Braga",1,"Avenida da Liberdade",25,25,0,124,124,0
9,9,2018,7,0,8,"Braga",2,"Avenida Central",25,25,0,124,124,0
9,9,2018,7,0,8,"Braga",3,"Rua de Caires",36,36,0,37,37,0
9,9,2018,7,0,8,"Braga",4,"N14 Bosch",47,47,0,48,48,0
9,9,2018,7,0,8,"Braga",5,"Avenida João Paulo II",39,39,0,9,9,0
9,9,2018,7,0,8,"Braga",6,"Avenida Padre Júlio Fragata",67,67,0,83,83,0
9,9,2018,7,0,8,"Braga",7,"Rua Nova Santa Cruz",44,44,0,39,39,0
9,9,2018,7,0,8,"Braga",8,"Rua Costa Gomes",0,41,41,-1,42,-43
9,9,2018,8,0,8,"Braga",1,"Avenida da Liberdade",25,25,0,124,124,0
9,9,2018,8,0,8,"Braga",2,"Avenida Central",25,25,0,124,124,0
9,9,2018,8,0,8,"Braga",3,"Rua de Caires",36,36,0,37,37,0
9,9,2018,8,0,8,"Braga",4,"N14 Bosch",47,47,0,48,48,0
9,9,2018,8,0,8,"Braga",5,"Avenida João Paulo II",39,39,0,9,9,0
9,9,2018,8,0,8,"Braga",6,"Avenida Padre Júlio Fragata",67,67,0,83,83,0
9,9,2018,8,0,8,"Braga",7,"Rua Nova Santa Cruz",44,44,0,39,39,0
9,9,2018,8,0,8,"Braga",8,"Rua Costa Gomes",0,41,41,-1,42,-43
9,9,2018,9,0,8,"Braga",1,"Avenida da Liberdade",25,25,0,124,124,0
9,9,2018,9,0,8,"Braga",2,"Avenida Central",25,25,0,124,124,0
9,9,2018,9,0,8,"Braga",3,"Rua de Caires",36,36,0,37,37,0
9,9,2018,9,0,8,"Braga",4,"N14 Bosch",47,47,0,48,48,0
9,9,2018,9,0,8,"Braga",5,"Avenida João Paulo II",39,39,0,9,9,0
9,9,2018,9,0,8,"Braga",6,"Avenida Padre Júlio Fragata",67,67,0,83,83,0
9,9,2018,9,0,8,"Braga",7,"Rua Nova Santa Cruz",44,44,0,39,39,0
9,9,2018,9,0,8,"Braga",8,"Rua Costa Gomes",0,41,41,-1,42,-43
9,9,2018,10,0,8,"Braga",1,"Avenida da Liberdade",25,25,0,124,124,0
9,9,2018,10,0,8,"Braga",2,"Avenida Central",25,25,0,124,124,0
9,9,2018,10,0,8,"Braga",3,"Rua de Caires",36,36,0,37,37,0
9,9,2018,10,0,8,"Braga",4,"N14 Bosch",47,47,0,48,48,0
9,9,2018,10,0,8,"Braga",5,"Avenida João Paulo II",39,39,0,9,9,0
9,9,2018,10,0,8,"Braga",6,"Avenida Padre Júlio Fragata",67,67,0,83,83,0
9,9,2018,10,0,8,"Braga",7,"Rua Nova Santa Cruz",44,44,0,39,39,0
9,9,2018,10,0,8,"Braga",8,"Rua Costa Gomes",0,41,41,-1,42,-43
9,9,2018,11,0,8,"Braga",1,"Avenida da Liberdade",25,25,0,124,124,0
9,9,2018,11,0,8,"Braga",2,"Avenida Central",25,25,0,124,124,0
9,9,2018,11,0,8,"Braga",3,"Rua de Caires",36,36,0,37,37,0
9,9,2018,11,0,8,"Braga",4,"N14 Bosch",35,47,12,64,48,16
9,9,2018,11,0,8,"Braga",5,"Avenida João Paulo II",39,39,0,9,9,0
9,9,2018,11,0,8,"Braga",6,"Avenida Padre Júlio Fragata",67,67,0,83,83,0
9,9,2018,11,0,8,"Braga",7,"Rua Nova Santa Cruz",44,44,0,39,39,0
9,9,2018,11,0,8,"Braga",8,"Rua Costa Gomes",0,41,41,-1,42,-43
9,9,2018,12,0,8,"Braga",1,"Avenida da Liberdade",25,25,0,124,124,0
9,9,2018,12,0,8,"Braga",2,"Avenida Central",25,25,0,124,124,0
9,9,2018,12,0,8,"Braga",3,"Rua de Caires",36,36,0,37,37,0
9,9,2018,12,0,8,"Braga",4,"N14 Bosch",47,47,0,48,48,0
9,9,2018,12,0,8,"Braga",5,"Avenida João Paulo II",39,39,0,9,9,0
9,9,2018,12,0,8,"Braga",6,"Avenida Padre Júlio Fragata",67,67,0,83,83,0
9,9,2018,12,0,8,"Braga",7,"Rua Nova Santa Cruz",44,44,0,39,39,0
9,9,2018,12,0,8,"Braga",8,"Rua Costa Gomes",0,41,41,-1,42,-43
9,9,2018,13,0,8,"Braga",1,"Avenida da Liberdade",25,25,0,124,124,0
9,9,2018,13,0,8,"Braga",2,"Avenida Central",25,25,0,124,124,0
9,9,2018,13,0,8,"Braga",3,"Rua de Caires",36,36,0,37,37,0
9,9,2018,13,0,8,"Braga",4,"N14 Bosch",47,47,0,48,48,0
9,9,2018,13,0,8,"Braga",5,"Avenida João Paulo II",39,39,0,9,9,0
9,9,2018,13,0,8,"Braga",6,"Avenida Padre Júlio Fragata",67,67,0,83,83,0
9,9,2018,13,0,8,"Braga",7,"Rua Nova Santa Cruz",44,44,0,39,39,0
9,9,2018,13,0,8,"Braga",8,"Rua Costa Gomes",0,41,41,-1,42,-43
9,9,2018,14,0,8,"Braga",1,"Avenida da Liberdade",25,25,0,124,124,0
9,9,2018,14,0,8,"Braga",2,"Avenida Central",25,25,0,124,124,0
9,9,2018,14,0,8,"Braga",3,"Rua de Caires",26,36,10,52,37,15
9,9,2018,14,0,8,"Braga",4,"N14 Bosch",47,47,0,48,48,0
9,9,2018,14,0,8,"Braga",5,"Avenida João Paulo II",39,39,0,9,9,0
9,9,2018,14,0,8,"Braga",6,"Avenida Padre Júlio Fragata",67,67,0,83,83,0
9,9,2018,14,0,8,"Braga",7,"Rua Nova Santa Cruz",44,44,0,39,39,0
9,9,2018,14,0,8,"Braga",8,"Rua Costa Gomes",0,41,41,-1,42,-43
9,9,2018,15,0,8,"Braga",1,"Avenida da Liberdade",25,25,0,124,124,0
9,9,2018,15,0,8,"Braga",2,"Avenida Central",25,25,0,124,124,0
9,9,2018,15,0,8,"Braga",3,"Rua de Caires",36,36,0,37,37,0
9,9,2018,15,0,8,"Braga",4,"N14 Bosch",18,47,29,125,48,77
9,9,2018,15,0,8,"Braga",5,"Avenida João Paulo II",29,39,10,12,9,3
9,9,2018,15,0,8,"Braga",6,"Avenida Padre Júlio Fragata",67,67,0,83,83,0
9,9,2018,15,0,8,"Braga",7,"Rua Nova Santa Cruz",28,44,16,62,39,23
9,9,2018,15,0,8,"Braga",8,"Rua Costa Gomes",0,41,41,-1,42,-43
9,9,2018,16,0,8,"Braga",1,"Avenida da Liberdade",25,25,0,124,124,0
9,9,2018,16,0,8,"Braga",2,"Avenida Central",25,25,0,124,124,0
9,9,2018,16,0,8,"Braga",3,"Rua de Caires",36,36,0,37,37,0
9,9,2018,16,0,8,"Braga",4,"N14 Bosch",35,47,12,64,48,16
9,9,2018,16,0,8,"Braga",5,"Avenida João Paulo II",39,39,0,9,9,0
9,9,2018,16,0,8,"Braga",6,"Avenida Padre Júlio Fragata",6,67,61,929,83,846
9,9,2018,16,0,8,"Braga",7,"Rua Nova Santa Cruz",44,44,0,39,39,0
9,9,2018,16,0,8,"Braga",8,"Rua Costa Gomes",0,41,41,-1,42,-43
9,9,2018,17,0,8,"Braga",1,"Avenida da Liberdade",25,25,0,124,124,0
9,9,2018,17,0,8,"Braga",2,"Avenida Central",25,25,0,124,124,0
9,9,2018,17,0,8,"Braga",3,"Rua de Caires",36,36,0,37,37,0
9,9,2018,17,0,8,"Braga",4,"N14 Bosch",47,47,0,48,48,0
9,9,2018,17,0,8,"Braga",5,"Avenida João Paulo II",39,39,0,9,9,0
9,9,2018,17,0,8,"Braga",6,"Avenida Padre Júlio Fragata",53,67,14,105,83,22
9,9,2018,17,0,8,"Braga",7,"Rua Nova Santa Cruz",44,44,0,39,39,0
9,9,2018,17,0,8,"Braga",8,"Rua Costa Gomes",0,41,41,-1,42,-43
9,9,2018,18,0,8,"Braga",1,"Avenida da Liberdade",25,25,0,124,124,0
9,9,2018,18,0,8,"Braga",2,"Avenida Central",25,25,0,124,124,0
9,9,2018,18,0,8,"Braga",3,"Rua de Caires",36,36,0,37,37,0
9,9,2018,18,0,8,"Braga",4,"N14 Bosch",47,47,0,48,48,0
9,9,2018,18,0,8,"Braga",5,"Avenida João Paulo II",39,39,0,9,9,0
9,9,2018,18,0,8,"Braga",6,"Avenida Padre Júlio Fragata",50,67,17,111,83,28
9,9,2018,18,0,8,"Braga",7,"Rua Nova Santa Cruz",44,44,0,39,39,0
9,9,2018,18,0,8,"Braga",8,"Rua Costa Gomes",0,41,41,-1,42,-43
9,9,2018,19,0,8,"Braga",1,"Avenida da Liberdade",25,25,0,124,124,0
9,9,2018,19,0,8,"Braga",2,"Avenida Central",25,25,0,124,124,0
9,9,2018,19,0,8,"Braga",3,"Rua de Caires",26,36,10,52,37,15
9,9,2018,19,0,8,"Braga",4,"N14 Bosch",47,47,0,48,48,0
9,9,2018,19,0,8,"Braga",5,"Avenida João Paulo II",39,39,0,9,9,0
9,9,2018,19,0,8,"Braga",6,"Avenida Padre Júlio Fragata",67,67,0,83,83,0
9,9,2018,19,0,8,"Braga",7,"Rua Nova Santa Cruz",44,44,0,39,39,0
9,9,2018,19,0,8,"Braga",8,"Rua Costa Gomes",0,41,41,-1,42,-43
9,9,2018,20,0,8,"Braga",1,"Avenida da Liberdade",25,25,0,124,124,0
9,9,2018,20,0,8,"Braga",2,"Avenida Central",25,25,0,124,124,0
9,9,2018,20,0,8,"Braga",3,"Rua de Caires",36,36,0,37,37,0
9,9,2018,20,0,8,"Braga",4,"N14 Bosch",47,47,0,48,48,0
9,9,2018,20,0,8,"Braga",5,"Avenida João Paulo II",29,39,10,12,9,3
9,9,2018,20,0,8,"Braga",6,"Avenida Padre Júlio Fragata",67,67,0,83,83,0
9,9,2018,20,0,8,"Braga",7,"Rua Nova Santa Cruz",44,44,0,39,39,0
9,9,2018,20,0,8,"Braga",8,"Rua Costa Gomes",0,41,41,-1,42,-43
9,9,2018,21,0,8,"Braga",1,"Avenida da Liberdade",25,25,0,124,124,0
9,9,2018,21,0,8,"Braga",2,"Avenida Central",25,25,0,124,124,0
9,9,2018,21,0,8,"Braga",3,"Rua de Caires",36,36,0,37,37,0
9,9,2018,21,0,8,"Braga",4,"N14 Bosch",47,47,0,48,48,0
9,9,2018,21,0,8,"Braga",5,"Avenida João Paulo II",39,39,0,9,9,0
9,9,2018,21,0,8,"Braga",6,"Avenida Padre Júlio Fragata",67,67,0,83,83,0
9,9,2018,21,0,8,"Braga",7,"Rua Nova Santa Cruz",34,44,10,51,39,12
9,9,2018,21,0,8,"Braga",8,"Rua Costa Gomes",0,41,41,-1,42,-43
9,9,2018,22,0,8,"Braga",1,"Avenida da Liberdade",25,25,0,124,124,0
9,9,2018,22,0,8,"Braga",2,"Avenida Central",25,25,0,124,124,0
9,9,2018,22,0,8,"Braga",3,"Rua de Caires",24,36,12,56,37,19
9,9,2018,22,0,8,"Braga",4,"N14 Bosch",47,47,0,48,48,0
9,9,2018,22,0,8,"Braga",5,"Avenida João Paulo II",39,39,0,9,9,0
9,9,2018,22,0,8,"Braga",6,"Avenida Padre Júlio Fragata",67,67,0,83,83,0
9,9,2018,22,0,8,"Braga",7,"Rua Nova Santa Cruz",44,44,0,39,39,0
9,9,2018,22,0,8,"Braga",8,"Rua Costa Gomes",0,41,41,-1,42,-43
9,9,2018,23,0,8,"Braga",1,"Avenida da Liberdade",25,25,0,124,124,0
9,9,2018,23,0,8,"Braga",2,"Avenida Central",25,25,0,124,124,0
9,9,2018,23,0,8,"Braga",3,"Rua de Caires",36,36,0,37,37,0
9,9,2018,23,0,8,"Braga",4,"N14 Bosch",47,47,0,48,48,0
9,9,2018,23,0,8,"Braga",5,"Avenida João Paulo II",30,39,9,12,9,3
9,9,2018,23,0,8,"Braga",6,"Avenida Padre Júlio Fragata",67,67,0,83,83,0
9,9,2018,23,0,8,"Braga",7,"Rua Nova Santa Cruz",44,44,0,39,39,0
9,9,2018,23,0,8,"Braga",8,"Rua Costa Gomes",0,41,41,-1,42,-43
9,10,2018,0,0,2,"Braga",1,"Avenida da Liberdade",25,25,0,124,124,0
9,10,2018,0,0,2,"Braga",2,"Avenida Central",25,25,0,124,124,0
9,10,2018,0,0,2,"Braga",3,"Rua de Caires",36,36,0,37,37,0
9,10,2018,0,0,2,"Braga",4,"N14 Bosch",47,47,0,48,48,0
9,10,2018,0,0,2,"Braga",5,"Avenida João Paulo II",39,39,0,9,9,0
9,10,2018,0,0,2,"Braga",6,"Avenida Padre Júlio Fragata",67,67,0,83,83,0
9,10,2018,0,0,2,"Braga",7,"Rua Nova Santa Cruz",44,44,0,39,39,0
9,10,2018,0,0,2,"Braga",8,"Rua Costa Gomes",0,41,41,-1,42,-43
9,10,2018,1,0,2,"Braga",1,"Avenida da Liberdade",25,25,0,124,124,0
9,10,2018,1,0,2,"Braga",2,"Avenida Central",25,25,0,124,124,0
9,10,2018,1,0,2,"Braga",3,"Rua de Caires",36,36,0,37,37,0
9,10,2018,1,0,2,"Braga",4,"N14 Bosch",47,47,0,48,48,0
9,10,2018,1,0,2,"Braga",5,"Avenida João Paulo II",39,39,0,9,9,0
9,10,2018,1,0,2,"Braga",6,"Avenida Padre Júlio Fragata",67,67,0,83,83,0
9,10,2018,1,0,2,"Braga",7,"Rua Nova Santa Cruz",44,44,0,39,39,0
9,10,2018,1,0,2,"Braga",8,"Rua Costa Gomes",0,41,41,-1,42,-43
9,10,2018,2,0,2,"Braga",1,"Avenida da Liberdade",25,25,0,124,124,0
9,10,2018,2,0,2,"Braga",2,"Avenida Central",25,25,0,124,124,0
9,10,2018,2,0,2,"Braga",3,"Rua de Caires",36,36,0,37,37,0
9,10,2018,2,0,2,"Braga",4,"N14 Bosch",47,47,0,48,48,0
9,10,2018,2,0,2,"Braga",5,"Avenida João Paulo II",39,39,0,9,9,0
9,10,2018,2,0,2,"Braga",6,"Avenida Padre Júlio Fragata",67,67,0,83,83,0
9,10,2018,2,0,2,"Braga",7,"Rua Nova Santa Cruz",44,44,0,39,39,0
9,10,2018,2,0,2,"Braga",8,"Rua Costa Gomes",0,41,41,-1,42,-43
9,10,2018,3,0,2,"Braga",1,"Avenida da Liberdade",25,25,0,124,124,0
9,10,2018,3,0,2,"Braga",2,"Avenida Central",25,25,0,124,124,0
9,10,2018,3,0,2,"Braga",3,"Rua de Caires",36,36,0,37,37,0
9,10,2018,3,0,2,"Braga",4,"N14 Bosch",47,47,0,48,48,0
9,10,2018,3,0,2,"Braga",5,"Avenida João Paulo II",39,39,0,9,9,0
9,10,2018,3,0,2,"Braga",6,"Avenida Padre Júlio Fragata",67,67,0,83,83,0
9,10,2018,3,0,2,"Braga",7,"Rua Nova Santa Cruz",44,44,0,39,39,0
9,10,2018,3,0,2,"Braga",8,"Rua Costa Gomes",0,41,41,-1,42,-43
9,10,2018,4,0,2,"Braga",1,"Avenida da Liberdade",25,25,0,124,124,0
9,10,2018,4,0,2,"Braga",2,"Avenida Central",25,25,0,124,124,0
9,10,2018,4,0,2,"Braga",3,"Rua de Caires",36,36,0,37,37,0
9,10,2018,4,0,2,"Braga",4,"N14 Bosch",47,47,0,48,48,0
9,10,2018,4,0,2,"Braga",5,"Avenida João Paulo II",39,39,0,9,9,0
9,10,2018,4,0,2,"Braga",6,"Avenida Padre Júlio Fragata",67,67,0,83,83,0
9,10,2018,4,0,2,"Braga",7,"Rua Nova Santa Cruz",44,44,0,39,39,0
9,10,2018,4,0,2,"Braga",8,"Rua Costa Gomes",0,41,41,-1,42,-43
9,10,2018,5,0,2,"Braga",1,"Avenida da Liberdade",25,25,0,124,124,0
9,10,2018,5,0,2,"Braga",2,"Avenida Central",25,25,0,124,124,0
9,10,2018,5,0,2,"Braga",3,"Rua de Caires",36,36,0,37,37,0
9,10,2018,5,0,2,"Braga",4,"N14 Bosch",47,47,0,48,48,0
9,10,2018,5,0,2,"Braga",5,"Avenida João Paulo II",39,39,0,9,9,0
9,10,2018,5,0,2,"Braga",6,"Avenida Padre Júlio Fragata",67,67,0,83,83,0
9,10,2018,5,0,2,"Braga",7,"Rua Nova Santa Cruz",44,44,0,39,39,0
9,10,2018,5,0,2,"Braga",8,"Rua Costa Gomes",0,41,41,-1,42,-43
9,10,2018,6,0,2,"Braga",1,"Avenida da Liberdade",25,25,0,124,124,0
9,10,2018,6,0,2,"Braga",2,"Avenida Central",25,25,0,124,124,0
9,10,2018,6,0,2,"Braga",3,"Rua de Caires",36,36,0,37,37,0
9,10,2018,6,0,2,"Braga",4,"N14 Bosch",47,47,0,48,48,0
9,10,2018,6,0,2,"Braga",5,"Avenida João Paulo II",39,39,0,9,9,0
9,10,2018,6,0,2,"Braga",6,"Avenida Padre Júlio Fragata",67,67,0,83,83,0
9,10,2018,6,0,2,"Braga",7,"Rua Nova Santa Cruz",44,44,0,39,39,0
9,10,2018,6,0,2,"Braga",8,"Rua Costa Gomes",0,41,41,-1,42,-43
9,10,2018,7,0,2,"Braga",1,"Avenida da Liberdade",25,25,0,124,124,0
9,10,2018,7,0,2,"Braga",2,"Avenida Central",25,25,0,124,124,0
9,10,2018,7,0,2,"Braga",3,"Rua de Caires",26,36,10,52,37,15
9,10,2018,7,0,2,"Braga",4,"N14 Bosch",28,47,19,80,48,32
9,10,2018,7,0,2,"Braga",5,"Avenida João Paulo II",39,39,0,9,9,0
9,10,2018,7,0,2,"Braga",6,"Avenida Padre Júlio Fragata",67,67,0,83,83,0
9,10,2018,7,0,2,"Braga",7,"Rua Nova Santa Cruz",28,44,16,62,39,23
9,10,2018,7,0,2,"Braga",8,"Rua Costa Gomes",0,41,41,-1,42,-43
9,10,2018,8,0,2,"Braga",1,"Avenida da Liberdade",25,25,0,124,124,0
9,10,2018,8,0,2,"Braga",2,"Avenida Central",25,25,0,124,124,0
9,10,2018,8,0,2,"Braga",3,"Rua de Caires",36,36,0,37,37,0
9,10,2018,8,0,2,"Braga",4,"N14 Bosch",30,47,17,75,48,27
9,10,2018,8,0,2,"Braga",5,"Avenida João Paulo II",39,39,0,9,9,0
9,10,2018,8,0,2,"Braga",6,"Avenida Padre Júlio Fragata",36,67,31,155,83,72
9,10,2018,8,0,2,"Braga",7,"Rua Nova Santa Cruz",4,44,40,432,39,393
9,10,2018,8,0,2,"Braga",8,"Rua Costa Gomes",0,41,41,-1,42,-43
9,10,2018,9,0,2,"Braga",1,"Avenida da Liberdade",25,25,0,124,124,0
9,10,2018,9,0,2,"Braga",2,"Avenida Central",25,25,0,124,124,0
9,10,2018,9,0,2,"Braga",3,"Rua de Caires",25,36,11,54,37,17
9,10,2018,9,0,2,"Braga",4,"N14 Bosch",31,47,16,72,48,24
9,10,2018,9,0,2,"Braga",5,"Avenida João Paulo II",39,39,0,9,9,0
9,10,2018,9,0,2,"Braga",6,"Avenida Padre Júlio Fragata",67,67,0,83,83,0
9,10,2018,9,0,2,"Braga",7,"Rua Nova Santa Cruz",9,44,35,192,39,153
9,10,2018,9,0,2,"Braga",8,"Rua Costa Gomes",0,41,41,-1,42,-43
9,10,2018,10,0,2,"Braga",1,"Avenida da Liberdade",25,25,0,124,124,0
9,10,2018,10,0,2,"Braga",2,"Avenida Central",25,25,0,124,124,0
9,10,2018,10,0,2,"Braga",3,"Rua de Caires",20,36,16,67,37,30
9,10,2018,10,0,2,"Braga",4,"N14 Bosch",47,47,0,48,48,0
9,10,2018,10,0,2,"Braga",5,"Avenida João Paulo II",39,39,0,9,9,0
9,10,2018,10,0,2,"Braga",6,"Avenida Padre Júlio Fragata",67,67,0,83,83,0
9,10,2018,10,0,2,"Braga",7,"Rua Nova Santa Cruz",44,44,0,39,39,0
9,10,2018,10,0,2,"Braga",8,"Rua Costa Gomes",0,41,41,-1,42,-43
9,10,2018,11,0,2,"Braga",1,"Avenida da Liberdade",25,25,0,124,124,0
9,10,2018,11,0,2,"Braga",2,"Avenida Central",25,25,0,124,124,0
9,10,2018,11,0,2,"Braga",3,"Rua de Caires",20,36,16,67,37,30
9,10,2018,11,0,2,"Braga",4,"N14 Bosch",32,47,15,70,48,22
9,10,2018,11,0,2,"Braga",5,"Avenida João Paulo II",39,39,0,9,9,0
9,10,2018,11,0,2,"Braga",6,"Avenida Padre Júlio Fragata",67,67,0,83,83,0
9,10,2018,11,0,2,"Braga",7,"Rua Nova Santa Cruz",44,44,0,39,39,0
9,10,2018,11,0,2,"Braga",8,"Rua Costa Gomes",0,41,41,-1,42,-43
9,10,2018,12,0,2,"Braga",1,"Avenida da Liberdade",25,25,0,124,124,0
9,10,2018,12,0,2,"Braga",2,"Avenida Central",25,25,0,124,124,0
9,10,2018,12,0,2,"Braga",3,"Rua de Caires",26,36,10,52,37,15
9,10,2018,12,0,2,"Braga",4,"N14 Bosch",34,47,13,66,48,18
9,10,2018,12,0,2,"Braga",5,"Avenida João Paulo II",39,39,0,9,9,0
9,10,2018,12,0,2,"Braga",6,"Avenida Padre Júlio Fragata",67,67,0,83,83,0
9,10,2018,12,0,2,"Braga",7,"Rua Nova Santa Cruz",23,44,21,75,39,36
9,10,2018,12,0,2,"Braga",8,"Rua Costa Gomes",0,41,41,-1,42,-43
9,10,2018,13,0,2,"Braga",1,"Avenida da Liberdade",25,25,0,124,124,0
9,10,2018,13,0,2,"Braga",2,"Avenida Central",25,25,0,124,124,0
9,10,2018,13,0,2,"Braga",3,"Rua de Caires",26,36,10,52,37,15
9,10,2018,13,0,2,"Braga",4,"N14 Bosch",30,47,17,75,48,27
9,10,2018,13,0,2,"Braga",5,"Avenida João Paulo II",39,39,0,9,9,0
9,10,2018,13,0,2,"Braga",6,"Avenida Padre Júlio Fragata",50,67,17,111,83,28
9,10,2018,13,0,2,"Braga",7,"Rua Nova Santa Cruz",44,44,0,39,39,0
9,10,2018,13,0,2,"Braga",8,"Rua Costa Gomes",0,41,41,-1,42,-43
9,10,2018,14,0,2,"Braga",1,"Avenida da Liberdade",25,25,0,124,124,0
9,10,2018,14,0,2,"Braga",2,"Avenida Central",25,25,0,124,124,0
9,10,2018,14,0,2,"Braga",3,"Rua de Caires",23,36,13,59,37,22
9,10,2018,14,0,2,"Braga",4,"N14 Bosch",21,47,26,107,48,59
9,10,2018,14,0,2,"Braga",5,"Avenida João Paulo II",39,39,0,9,9,0
9,10,2018,14,0,2,"Braga",6,"Avenida Padre Júlio Fragata",67,67,0,83,83,0
9,10,2018,14,0,2,"Braga",7,"Rua Nova Santa Cruz",44,44,0,39,39,0
9,10,2018,14,0,2,"Braga",8,"Rua Costa Gomes",0,41,41,-1,42,-43
9,10,2018,15,0,2,"Braga",1,"Avenida da Liberdade",25,25,0,124,124,0
9,10,2018,15,0,2,"Braga",2,"Avenida Central",25,25,0,124,124,0
9,10,2018,15,0,2,"Braga",3,"Rua de Caires",27,36,9,50,37,13
9,10,2018,15,0,2,"Braga",4,"N14 Bosch",25,47,22,90,48,42
9,10,2018,15,0,2,"Braga",5,"Avenida João Paulo II",30,39,9,12,9,3
9,10,2018,15,0,2,"Braga",6,"Avenida Padre Júlio Fragata",51,67,16,109,83,26
9,10,2018,15,0,2,"Braga",7,"Rua Nova Santa Cruz",24,44,20,72,39,33
9,10,2018,15,0,2,"Braga",8,"Rua Costa Gomes",0,41,41,-1,42,-43
9,10,2018,16,0,2,"Braga",1,"Avenida da Liberdade",16,25,9,194,124,70
9,10,2018,16,0,2,"Braga",2,"Avenida Central",16,25,9,194,124,70
9,10,2018,16,0,2,"Braga",3,"Rua de Caires",22,36,14,61,37,24
9,10,2018,16,0,2,"Braga",4,"N14 Bosch",21,47,26,107,48,59
9,10,2018,16,0,2,"Braga",5,"Avenida João Paulo II",30,39,9,12,9,3
9,10,2018,16,0,2,"Braga",6,"Avenida Padre Júlio Fragata",50,67,17,111,83,28
9,10,2018,16,0,2,"Braga",7,"Rua Nova Santa Cruz",27,44,17,64,39,25
9,10,2018,16,0,2,"Braga",8,"Rua Costa Gomes",0,41,41,-1,42,-43
9,10,2018,17,0,2,"Braga",1,"Avenida da Liberdade",17,25,8,182,124,58
9,10,2018,17,0,2,"Braga",2,"Avenida Central",17,25,8,182,124,58
9,10,2018,17,0,2,"Braga",3,"Rua de Caires",27,36,9,50,37,13
9,10,2018,17,0,2,"Braga",4,"N14 Bosch",14,47,33,160,48,112
9,10,2018,17,0,2,"Braga",5,"Avenida João Paulo II",25,39,14,14,9,5
9,10,2018,17,0,2,"Braga",6,"Avenida Padre Júlio Fragata",24,67,43,232,83,149
9,10,2018,17,0,2,"Braga",7,"Rua Nova Santa Cruz",20,44,24,86,39,47
9,10,2018,17,0,2,"Braga",8,"Rua Costa Gomes",0,41,41,-1,42,-43
9,10,2018,18,0,2,"Braga",1,"Avenida da Liberdade",18,25,7,172,124,48
9,10,2018,18,0,2,"Braga",2,"Avenida Central",18,25,7,172,124,48
9,10,2018,18,0,2,"Braga",3,"Rua de Caires",23,36,13,59,37,22
9,10,2018,18,0,2,"Braga",4,"N14 Bosch",10,47,37,225,48,177
9,10,2018,18,0,2,"Braga",5,"Avenida João Paulo II",14,39,25,25,9,16
9,10,2018,18,0,2,"Braga",6,"Avenida Padre Júlio Fragata",23,67,44,242,83,159
9,10,2018,18,0,2,"Braga",7,"Rua Nova Santa Cruz",34,44,10,51,39,12
9,10,2018,18,0,2,"Braga",8,"Rua Costa Gomes",0,41,41,-1,42,-43
9,10,2018,19,0,2,"Braga",1,"Avenida da Liberdade",18,25,7,172,124,48
9,10,2018,19,0,2,"Braga",2,"Avenida Central",18,25,7,172,124,48
9,10,2018,19,0,2,"Braga",3,"Rua de Caires",36,36,0,37,37,0
9,10,2018,19,0,2,"Braga",4,"N14 Bosch",47,47,0,48,48,0
9,10,2018,19,0,2,"Braga",5,"Avenida João Paulo II",22,39,17,16,9,7
9,10,2018,19,0,2,"Braga",6,"Avenida Padre Júlio Fragata",52,67,15,107,83,24
9,10,2018,19,0,2,"Braga",7,"Rua Nova Santa Cruz",32,44,12,54,39,15
9,10,2018,19,0,2,"Braga",8,"Rua Costa Gomes",0,41,41,-1,42,-43
9,10,2018,20,0,2,"Braga",1,"Avenida da Liberdade",25,25,0,124,124,0
9,10,2018,20,0,2,"Braga",2,"Avenida Central",25,25,0,124,124,0
9,10,2018,20,0,2,"Braga",3,"Rua de Caires",36,36,0,37,37,0
9,10,2018,20,0,2,"Braga",4,"N14 Bosch",47,47,0,48,48,0
9,10,2018,20,0,2,"Braga",5,"Avenida João Paulo II",39,39,0,9,9,0
9,10,2018,20,0,2,"Braga",6,"Avenida Padre Júlio Fragata",67,67,0,83,83,0
9,10,2018,20,0,2,"Braga",7,"Rua Nova Santa Cruz",44,44,0,39,39,0
9,10,2018,20,0,2,"Braga",8,"Rua Costa Gomes",0,41,41,-1,42,-43
9,10,2018,21,0,2,"Braga",1,"Avenida da Liberdade",25,25,0,124,124,0
9,10,2018,21,0,2,"Braga",2,"Avenida Central",25,25,0,124,124,0
9,10,2018,21,0,2,"Braga",3,"Rua de Caires",36,36,0,37,37,0
9,10,2018,21,0,2,"Braga",4,"N14 Bosch",47,47,0,48,48,0
9,10,2018,21,0,2,"Braga",5,"Avenida João Paulo II",39,39,0,9,9,0
9,10,2018,21,0,2,"Braga",6,"Avenida Padre Júlio Fragata",67,67,0,83,83,0
9,10,2018,21,0,2,"Braga",7,"Rua Nova Santa Cruz",44,44,0,39,39,0
9,10,2018,21,0,2,"Braga",8,"Rua Costa Gomes",0,41,41,-1,42,-43
9,10,2018,22,0,2,"Braga",1,"Avenida da Liberdade",25,25,0,124,124,0
9,10,2018,22,0,2,"Braga",2,"Avenida Central",25,25,0,124,124,0
9,10,2018,22,0,2,"Braga",3,"Rua de Caires",36,36,0,37,37,0
9,10,2018,22,0,2,"Braga",4,"N14 Bosch",47,47,0,48,48,0
9,10,2018,22,0,2,"Braga",5,"Avenida João Paulo II",39,39,0,9,9,0
9,10,2018,22,0,2,"Braga",6,"Avenida Padre Júlio Fragata",67,67,0,83,83,0
9,10,2018,22,0,2,"Braga",7,"Rua Nova Santa Cruz",44,44,0,39,39,0
9,10,2018,22,0,2,"Braga",8,"Rua Costa Gomes",0,41,41,-1,42,-43
9,10,2018,23,0,2,"Braga",1,"Avenida da Liberdade",25,25,0,124,124,0
9,10,2018,23,0,2,"Braga",2,"Avenida Central",25,25,0,124,124,0
9,10,2018,23,0,2,"Braga",3,"Rua de Caires",36,36,0,37,37,0
9,10,2018,23,0,2,"Braga",4,"N14 Bosch",47,47,0,48,48,0
9,10,2018,23,0,2,"Braga",5,"Avenida João Paulo II",39,39,0,9,9,0
9,10,2018,23,0,2,"Braga",6,"Avenida Padre Júlio Fragata",67,67,0,83,83,0
9,10,2018,23,0,2,"Braga",7,"Rua Nova Santa Cruz",44,44,0,39,39,0
9,10,2018,23,0,2,"Braga",8,"Rua Costa Gomes",0,41,41,-1,42,-43
9,11,2018,0,0,3,"Braga",1,"Avenida da Liberdade",25,25,0,124,124,0
9,11,2018,0,0,3,"Braga",2,"Avenida Central",25,25,0,124,124,0
9,11,2018,0,0,3,"Braga",3,"Rua de Caires",36,36,0,37,37,0
9,11,2018,0,0,3,"Braga",4,"N14 Bosch",47,47,0,48,48,0
9,11,2018,0,0,3,"Braga",5,"Avenida João Paulo II",39,39,0,9,9,0
9,11,2018,0,0,3,"Braga",6,"Avenida Padre Júlio Fragata",67,67,0,83,83,0
9,11,2018,0,0,3,"Braga",7,"Rua Nova Santa Cruz",44,44,0,39,39,0
9,11,2018,0,0,3,"Braga",8,"Rua Costa Gomes",0,41,41,-1,42,-43
9,11,2018,1,0,3,"Braga",1,"Avenida da Liberdade",25,25,0,124,124,0
9,11,2018,1,0,3,"Braga",2,"Avenida Central",25,25,0,124,124,0
9,11,2018,1,0,3,"Braga",3,"Rua de Caires",36,36,0,37,37,0
9,11,2018,1,0,3,"Braga",4,"N14 Bosch",47,47,0,48,48,0
9,11,2018,1,0,3,"Braga",5,"Avenida João Paulo II",39,39,0,9,9,0
9,11,2018,1,0,3,"Braga",6,"Avenida Padre Júlio Fragata",67,67,0,83,83,0
9,11,2018,1,0,3,"Braga",7,"Rua Nova Santa Cruz",44,44,0,39,39,0
9,11,2018,1,0,3,"Braga",8,"Rua Costa Gomes",0,41,41,-1,42,-43
9,11,2018,2,0,3,"Braga",1,"Avenida da Liberdade",25,25,0,124,124,0
9,11,2018,2,0,3,"Braga",2,"Avenida Central",25,25,0,124,124,0
9,11,2018,2,0,3,"Braga",3,"Rua de Caires",36,36,0,37,37,0
9,11,2018,2,0,3,"Braga",4,"N14 Bosch",47,47,0,48,48,0
9,11,2018,2,0,3,"Braga",5,"Avenida João Paulo II",39,39,0,9,9,0
9,11,2018,2,0,3,"Braga",6,"Avenida Padre Júlio Fragata",67,67,0,83,83,0
9,11,2018,2,0,3,"Braga",7,"Rua Nova Santa Cruz",44,44,0,39,39,0
9,11,2018,2,0,3,"Braga",8,"Rua Costa Gomes",0,41,41,-1,42,-43
9,11,2018,3,0,3,"Braga",1,"Avenida da Liberdade",25,25,0,124,124,0
9,11,2018,3,0,3,"Braga",2,"Avenida Central",25,25,0,124,124,0
9,11,2018,3,0,3,"Braga",3,"Rua de Caires",36,36,0,37,37,0
9,11,2018,3,0,3,"Braga",4,"N14 Bosch",47,47,0,48,48,0
9,11,2018,3,0,3,"Braga",5,"Avenida João Paulo II",39,39,0,9,9,0
9,11,2018,3,0,3,"Braga",6,"Avenida Padre Júlio Fragata",67,67,0,83,83,0
9,11,2018,3,0,3,"Braga",7,"Rua Nova Santa Cruz",44,44,0,39,39,0
9,11,2018,3,0,3,"Braga",8,"Rua Costa Gomes",0,41,41,-1,42,-43
9,11,2018,4,0,3,"Braga",1,"Avenida da Liberdade",25,25,0,124,124,0
9,11,2018,4,0,3,"Braga",2,"Avenida Central",25,25,0,124,124,0
9,11,2018,4,0,3,"Braga",3,"Rua de Caires",36,36,0,37,37,0
9,11,2018,4,0,3,"Braga",4,"N14 Bosch",47,47,0,48,48,0
9,11,2018,4,0,3,"Braga",5,"Avenida João Paulo II",39,39,0,9,9,0
9,11,2018,4,0,3,"Braga",6,"Avenida Padre Júlio Fragata",67,67,0,83,83,0
9,11,2018,4,0,3,"Braga",7,"Rua Nova Santa Cruz",44,44,0,39,39,0
9,11,2018,4,0,3,"Braga",8,"Rua Costa Gomes",0,41,41,-1,42,-43
9,11,2018,5,0,3,"Braga",1,"Avenida da Liberdade",25,25,0,124,124,0
9,11,2018,5,0,3,"Braga",2,"Avenida Central",25,25,0,124,124,0
9,11,2018,5,0,3,"Braga",3,"Rua de Caires",36,36,0,37,37,0
9,11,2018,5,0,3,"Braga",4,"N14 Bosch",47,47,0,48,48,0
9,11,2018,5,0,3,"Braga",5,"Avenida João Paulo II",39,39,0,9,9,0
9,11,2018,5,0,3,"Braga",6,"Avenida Padre Júlio Fragata",67,67,0,83,83,0
9,11,2018,5,0,3,"Braga",7,"Rua Nova Santa Cruz",44,44,0,39,39,0
9,11,2018,5,0,3,"Braga",8,"Rua Costa Gomes",0,41,41,-1,42,-43
9,11,2018,6,0,3,"Braga",1,"Avenida da Liberdade",25,25,0,124,124,0
9,11,2018,6,0,3,"Braga",2,"Avenida Central",25,25,0,124,124,0
9,11,2018,6,0,3,"Braga",3,"Rua de Caires",36,36,0,37,37,0
9,11,2018,6,0,3,"Braga",4,"N14 Bosch",47,47,0,48,48,0
9,11,2018,6,0,3,"Braga",5,"Avenida João Paulo II",39,39,0,9,9,0
9,11,2018,6,0,3,"Braga",6,"Avenida Padre Júlio Fragata",67,67,0,83,83,0
9,11,2018,6,0,3,"Braga",7,"Rua Nova Santa Cruz",44,44,0,39,39,0
9,11,2018,6,0,3,"Braga",8,"Rua Costa Gomes",0,41,41,-1,42,-43
9,11,2018,7,0,3,"Braga",1,"Avenida da Liberdade",25,25,0,124,124,0
9,11,2018,7,0,3,"Braga",2,"Avenida Central",25,25,0,124,124,0
9,11,2018,7,0,3,"Braga",3,"Rua de Caires",36,36,0,37,37,0
9,11,2018,7,0,3,"Braga",4,"N14 Bosch",47,47,0,48,48,0
9,11,2018,7,0,3,"Braga",5,"Avenida João Paulo II",39,39,0,9,9,0
9,11,2018,7,0,3,"Braga",6,"Avenida Padre Júlio Fragata",67,67,0,83,83,0
9,11,2018,7,0,3,"Braga",7,"Rua Nova Santa Cruz",33,44,11,52,39,13
9,11,2018,7,0,3,"Braga",8,"Rua Costa Gomes",0,41,41,-1,42,-43
9,11,2018,8,0,3,"Braga",1,"Avenida da Liberdade",18,25,7,172,124,48
9,11,2018,8,0,3,"Braga",2,"Avenida Central",18,25,7,172,124,48
9,11,2018,8,0,3,"Braga",3,"Rua de Caires",20,36,16,67,37,30
9,11,2018,8,0,3,"Braga",4,"N14 Bosch",18,47,29,125,48,77
9,11,2018,8,0,3,"Braga",5,"Avenida João Paulo II",39,39,0,9,9,0
9,11,2018,8,0,3,"Braga",6,"Avenida Padre Júlio Fragata",67,67,0,83,83,0
9,11,2018,8,0,3,"Braga",7,"Rua Nova Santa Cruz",13,44,31,133,39,94
9,11,2018,8,0,3,"Braga",8,"Rua Costa Gomes",0,41,41,-1,42,-43
9,11,2018,9,0,3,"Braga",1,"Avenida da Liberdade",25,25,0,124,124,0
9,11,2018,9,0,3,"Braga",2,"Avenida Central",25,25,0,124,124,0
9,11,2018,9,0,3,"Braga",3,"Rua de Caires",23,36,13,59,37,22
9,11,2018,9,0,3,"Braga",4,"N14 Bosch",30,47,17,75,48,27
9,11,2018,9,0,3,"Braga",5,"Avenida João Paulo II",39,39,0,9,9,0
9,11,2018,9,0,3,"Braga",6,"Avenida Padre Júlio Fragata",67,67,0,83,83,0
9,11,2018,9,0,3,"Braga",7,"Rua Nova Santa Cruz",28,44,16,62,39,23
9,11,2018,9,0,3,"Braga",8,"Rua Costa Gomes",0,41,41,-1,42,-43
9,11,2018,10,0,3,"Braga",1,"Avenida da Liberdade",25,25,0,124,124,0
9,11,2018,10,0,3,"Braga",2,"Avenida Central",25,25,0,124,124,0
9,11,2018,10,0,3,"Braga",3,"Rua de Caires",24,36,12,56,37,19
9,11,2018,10,0,3,"Braga",4,"N14 Bosch",33,47,14,68,48,20
9,11,2018,10,0,3,"Braga",5,"Avenida João Paulo II",39,39,0,9,9,0
9,11,2018,10,0,3,"Braga",6,"Avenida Padre Júlio Fragata",67,67,0,83,83,0
9,11,2018,10,0,3,"Braga",7,"Rua Nova Santa Cruz",44,44,0,39,39,0
9,11,2018,10,0,3,"Braga",8,"Rua Costa Gomes",0,41,41,-1,42,-43
9,11,2018,11,0,3,"Braga",1,"Avenida da Liberdade",25,25,0,124,124,0
9,11,2018,11,0,3,"Braga",2,"Avenida Central",25,25,0,124,124,0
9,11,2018,11,0,3,"Braga",3,"Rua de Caires",22,36,14,61,37,24
9,11,2018,11,0,3,"Braga",4,"N14 Bosch",27,47,20,83,48,35
9,11,2018,11,0,3,"Braga",5,"Avenida João Paulo II",39,39,0,9,9,0
9,11,2018,11,0,3,"Braga",6,"Avenida Padre Júlio Fragata",67,67,0,83,83,0
9,11,2018,11,0,3,"Braga",7,"Rua Nova Santa Cruz",44,44,0,39,39,0
9,11,2018,11,0,3,"Braga",8,"Rua Costa Gomes",0,41,41,-1,42,-43
9,11,2018,12,0,3,"Braga",1,"Avenida da Liberdade",18,25,7,172,124,48
9,11,2018,12,0,3,"Braga",2,"Avenida Central",18,25,7,172,124,48
9,11,2018,12,0,3,"Braga",3,"Rua de Caires",23,36,13,59,37,22
9,11,2018,12,0,3,"Braga",4,"N14 Bosch",34,47,13,66,48,18
9,11,2018,12,0,3,"Braga",5,"Avenida João Paulo II",39,39,0,9,9,0
9,11,2018,12,0,3,"Braga",6,"Avenida Padre Júlio Fragata",67,67,0,83,83,0
9,11,2018,12,0,3,"Braga",7,"Rua Nova Santa Cruz",26,44,18,66,39,27
9,11,2018,12,0,3,"Braga",8,"Rua Costa Gomes",0,41,41,-1,42,-43
9,11,2018,13,0,3,"Braga",1,"Avenida da Liberdade",25,25,0,124,124,0
9,11,2018,13,0,3,"Braga",2,"Avenida Central",25,25,0,124,124,0
9,11,2018,13,0,3,"Braga",3,"Rua de Caires",36,36,0,37,37,0
9,11,2018,13,0,3,"Braga",4,"N14 Bosch",23,47,24,98,48,50
9,11,2018,13,0,3,"Braga",5,"Avenida João Paulo II",39,39,0,9,9,0
9,11,2018,13,0,3,"Braga",6,"Avenida Padre Júlio Fragata",67,67,0,83,83,0
9,11,2018,13,0,3,"Braga",7,"Rua Nova Santa Cruz",12,44,32,144,39,105
9,11,2018,13,0,3,"Braga",8,"Rua Costa Gomes",0,41,41,-1,42,-43
9,11,2018,15,0,3,"Braga",1,"Avenida da Liberdade",25,25,0,124,124,0
9,11,2018,15,0,3,"Braga",2,"Avenida Central",25,25,0,124,124,0
9,11,2018,15,0,3,"Braga",3,"Rua de Caires",22,36,14,61,37,24
9,11,2018,15,0,3,"Braga",4,"N14 Bosch",47,47,0,48,48,0
9,11,2018,15,0,3,"Braga",5,"Avenida João Paulo II",39,39,0,9,9,0
9,11,2018,15,0,3,"Braga",6,"Avenida Padre Júlio Fragata",67,67,0,83,83,0
9,11,2018,15,0,3,"Braga",7,"Rua Nova Santa Cruz",44,44,0,39,39,0
9,11,2018,15,0,3,"Braga",8,"Rua Costa Gomes",0,41,41,-1,42,-43
9,11,2018,16,0,3,"Braga",1,"Avenida da Liberdade",18,25,7,172,124,48
9,11,2018,16,0,3,"Braga",2,"Avenida Central",18,25,7,172,124,48
9,11,2018,16,0,3,"Braga",3,"Rua de Caires",23,36,13,59,37,22
9,11,2018,16,0,3,"Braga",4,"N14 Bosch",33,47,14,68,48,20
9,11,2018,16,0,3,"Braga",5,"Avenida João Paulo II",39,39,0,9,9,0
9,11,2018,16,0,3,"Braga",6,"Avenida Padre Júlio Fragata",48,67,19,116,83,33
9,11,2018,16,0,3,"Braga",7,"Rua Nova Santa Cruz",17,44,27,102,39,63
9,11,2018,16,0,3,"Braga",8,"Rua Costa Gomes",0,41,41,-1,42,-43
9,11,2018,17,0,3,"Braga",1,"Avenida da Liberdade",6,25,19,517,124,393
9,11,2018,17,0,3,"Braga",2,"Avenida Central",6,25,19,517,124,393
9,11,2018,17,0,3,"Braga",3,"Rua de Caires",36,36,0,37,37,0
9,11,2018,17,0,3,"Braga",4,"N14 Bosch",12,47,35,187,48,139
9,11,2018,17,0,3,"Braga",5,"Avenida João Paulo II",28,39,11,12,9,3
9,11,2018,17,0,3,"Braga",6,"Avenida Padre Júlio Fragata",52,67,15,107,83,24
9,11,2018,17,0,3,"Braga",7,"Rua Nova Santa Cruz",19,44,25,91,39,52
9,11,2018,17,0,3,"Braga",8,"Rua Costa Gomes",0,41,41,-1,42,-43
9,11,2018,18,0,3,"Braga",1,"Avenida da Liberdade",18,25,7,172,124,48
9,11,2018,18,0,3,"Braga",2,"Avenida Central",18,25,7,172,124,48
9,11,2018,18,0,3,"Braga",3,"Rua de Caires",12,36,24,112,37,75
9,11,2018,18,0,3,"Braga",4,"N14 Bosch",12,47,35,187,48,139
9,11,2018,18,0,3,"Braga",5,"Avenida João Paulo II",11,39,28,32,9,23
9,11,2018,18,0,3,"Braga",6,"Avenida Padre Júlio Fragata",25,67,42,223,83,140
9,11,2018,18,0,3,"Braga",7,"Rua Nova Santa Cruz",17,44,27,102,39,63
9,11,2018,18,0,3,"Braga",8,"Rua Costa Gomes",0,41,41,-1,42,-43
9,11,2018,19,0,3,"Braga",1,"Avenida da Liberdade",25,25,0,124,124,0
9,11,2018,19,0,3,"Braga",2,"Avenida Central",25,25,0,124,124,0
9,11,2018,19,0,3,"Braga",3,"Rua de Caires",27,36,9,50,37,13
9,11,2018,19,0,3,"Braga",4,"N14 Bosch",31,47,16,72,48,24
9,11,2018,19,0,3,"Braga",5,"Avenida João Paulo II",39,39,0,9,9,0
9,11,2018,19,0,3,"Braga",6,"Avenida Padre Júlio Fragata",67,67,0,83,83,0
9,11,2018,19,0,3,"Braga",7,"Rua Nova Santa Cruz",44,44,0,39,39,0
9,11,2018,19,0,3,"Braga",8,"Rua Costa Gomes",0,41,41,-1,42,-43
9,11,2018,20,0,3,"Braga",1,"Avenida da Liberdade",25,25,0,124,124,0
9,11,2018,20,0,3,"Braga",2,"Avenida Central",25,25,0,124,124,0
9,11,2018,20,0,3,"Braga",3,"Rua de Caires",28,36,8,48,37,11
9,11,2018,20,0,3,"Braga",4,"N14 Bosch",25,47,22,90,48,42
9,11,2018,20,0,3,"Braga",5,"Avenida João Paulo II",39,39,0,9,9,0
9,11,2018,20,0,3,"Braga",6,"Avenida Padre Júlio Fragata",67,67,0,83,83,0
9,11,2018,20,0,3,"Braga",7,"Rua Nova Santa Cruz",44,44,0,39,39,0
9,11,2018,20,0,3,"Braga",8,"Rua Costa Gomes",0,41,41,-1,42,-43
9,11,2018,21,0,3,"Braga",1,"Avenida da Liberdade",25,25,0,124,124,0
9,11,2018,21,0,3,"Braga",2,"Avenida Central",25,25,0,124,124,0
9,11,2018,21,0,3,"Braga",3,"Rua de Caires",36,36,0,37,37,0
9,11,2018,21,0,3,"Braga",4,"N14 Bosch",47,47,0,48,48,0
9,11,2018,21,0,3,"Braga",5,"Avenida João Paulo II",39,39,0,9,9,0
9,11,2018,21,0,3,"Braga",6,"Avenida Padre Júlio Fragata",67,67,0,83,83,0
9,11,2018,21,0,3,"Braga",7,"Rua Nova Santa Cruz",44,44,0,39,39,0
9,11,2018,21,0,3,"Braga",8,"Rua Costa Gomes",0,41,41,-1,42,-43
9,11,2018,22,0,3,"Braga",1,"Avenida da Liberdade",25,25,0,124,124,0
9,11,2018,22,0,3,"Braga",2,"Avenida Central",25,25,0,124,124,0
9,11,2018,22,0,3,"Braga",3,"Rua de Caires",36,36,0,37,37,0
9,11,2018,22,0,3,"Braga",4,"N14 Bosch",47,47,0,48,48,0
9,11,2018,22,0,3,"Braga",5,"Avenida João Paulo II",39,39,0,9,9,0
9,11,2018,22,0,3,"Braga",6,"Avenida Padre Júlio Fragata",67,67,0,83,83,0
9,11,2018,22,0,3,"Braga",7,"Rua Nova Santa Cruz",44,44,0,39,39,0
9,11,2018,22,0,3,"Braga",8,"Rua Costa Gomes",0,41,41,-1,42,-43
9,11,2018,23,0,3,"Braga",1,"Avenida da Liberdade",25,25,0,124,124,0
9,11,2018,23,0,3,"Braga",2,"Avenida Central",25,25,0,124,124,0
9,11,2018,23,0,3,"Braga",3,"Rua de Caires",36,36,0,37,37,0
9,11,2018,23,0,3,"Braga",4,"N14 Bosch",47,47,0,48,48,0
9,11,2018,23,0,3,"Braga",5,"Avenida João Paulo II",39,39,0,9,9,0
9,11,2018,23,0,3,"Braga",6,"Avenida Padre Júlio Fragata",67,67,0,83,83,0
9,11,2018,23,0,3,"Braga",7,"Rua Nova Santa Cruz",44,44,0,39,39,0
9,11,2018,23,0,3,"Braga",8,"Rua Costa Gomes",0,41,41,-1,42,-43
9,12,2018,0,0,4,"Braga",1,"Avenida da Liberdade",25,25,0,124,124,0
9,12,2018,0,0,4,"Braga",2,"Avenida Central",25,25,0,124,124,0
9,12,2018,0,0,4,"Braga",3,"Rua de Caires",9,36,27,150,37,113
9,12,2018,0,0,4,"Braga",4,"N14 Bosch",47,47,0,48,48,0
9,12,2018,0,0,4,"Braga",5,"Avenida João Paulo II",39,39,0,9,9,0
9,12,2018,0,0,4,"Braga",6,"Avenida Padre Júlio Fragata",67,67,0,83,83,0
9,12,2018,0,0,4,"Braga",7,"Rua Nova Santa Cruz",44,44,0,39,39,0
9,12,2018,0,0,4,"Braga",8,"Rua Costa Gomes",0,41,41,-1,42,-43
9,12,2018,1,0,4,"Braga",1,"Avenida da Liberdade",25,25,0,124,124,0
9,12,2018,1,0,4,"Braga",2,"Avenida Central",25,25,0,124,124,0
9,12,2018,1,0,4,"Braga",3,"Rua de Caires",36,36,0,37,37,0
9,12,2018,1,0,4,"Braga",4,"N14 Bosch",47,47,0,48,48,0
9,12,2018,1,0,4,"Braga",5,"Avenida João Paulo II",39,39,0,9,9,0
9,12,2018,1,0,4,"Braga",6,"Avenida Padre Júlio Fragata",67,67,0,83,83,0
9,12,2018,1,0,4,"Braga",7,"Rua Nova Santa Cruz",44,44,0,39,39,0
9,12,2018,1,0,4,"Braga",8,"Rua Costa Gomes",0,41,41,-1,42,-43
9,12,2018,2,0,4,"Braga",1,"Avenida da Liberdade",25,25,0,124,124,0
9,12,2018,2,0,4,"Braga",2,"Avenida Central",25,25,0,124,124,0
9,12,2018,2,0,4,"Braga",3,"Rua de Caires",36,36,0,37,37,0
9,12,2018,2,0,4,"Braga",4,"N14 Bosch",47,47,0,48,48,0
9,12,2018,2,0,4,"Braga",5,"Avenida João Paulo II",39,39,0,9,9,0
9,12,2018,2,0,4,"Braga",6,"Avenida Padre Júlio Fragata",67,67,0,83,83,0
9,12,2018,2,0,4,"Braga",7,"Rua Nova Santa Cruz",44,44,0,39,39,0
9,12,2018,2,0,4,"Braga",8,"Rua Costa Gomes",0,41,41,-1,42,-43
9,12,2018,3,0,4,"Braga",1,"Avenida da Liberdade",25,25,0,124,124,0
9,12,2018,3,0,4,"Braga",2,"Avenida Central",25,25,0,124,124,0
9,12,2018,3,0,4,"Braga",3,"Rua de Caires",36,36,0,37,37,0
9,12,2018,3,0,4,"Braga",4,"N14 Bosch",47,47,0,48,48,0
9,12,2018,3,0,4,"Braga",5,"Avenida João Paulo II",39,39,0,9,9,0
9,12,2018,3,0,4,"Braga",6,"Avenida Padre Júlio Fragata",67,67,0,83,83,0
9,12,2018,3,0,4,"Braga",7,"Rua Nova Santa Cruz",44,44,0,39,39,0
9,12,2018,3,0,4,"Braga",8,"Rua Costa Gomes",0,41,41,-1,42,-43
9,12,2018,4,0,4,"Braga",1,"Avenida da Liberdade",25,25,0,124,124,0
9,12,2018,4,0,4,"Braga",2,"Avenida Central",25,25,0,124,124,0
9,12,2018,4,0,4,"Braga",3,"Rua de Caires",36,36,0,37,37,0
9,12,2018,4,0,4,"Braga",4,"N14 Bosch",47,47,0,48,48,0
9,12,2018,4,0,4,"Braga",5,"Avenida João Paulo II",39,39,0,9,9,0
9,12,2018,4,0,4,"Braga",6,"Avenida Padre Júlio Fragata",67,67,0,83,83,0
9,12,2018,4,0,4,"Braga",7,"Rua Nova Santa Cruz",44,44,0,39,39,0
9,12,2018,4,0,4,"Braga",8,"Rua Costa Gomes",0,41,41,-1,42,-43
9,12,2018,5,0,4,"Braga",1,"Avenida da Liberdade",25,25,0,124,124,0
9,12,2018,5,0,4,"Braga",2,"Avenida Central",25,25,0,124,124,0
9,12,2018,5,0,4,"Braga",3,"Rua de Caires",36,36,0,37,37,0
9,12,2018,5,0,4,"Braga",4,"N14 Bosch",47,47,0,48,48,0
9,12,2018,5,0,4,"Braga",5,"Avenida João Paulo II",39,39,0,9,9,0
9,12,2018,5,0,4,"Braga",6,"Avenida Padre Júlio Fragata",67,67,0,83,83,0
9,12,2018,5,0,4,"Braga",7,"Rua Nova Santa Cruz",44,44,0,39,39,0
9,12,2018,5,0,4,"Braga",8,"Rua Costa Gomes",0,41,41,-1,42,-43
9,12,2018,6,0,4,"Braga",1,"Avenida da Liberdade",25,25,0,124,124,0
9,12,2018,6,0,4,"Braga",2,"Avenida Central",25,25,0,124,124,0
9,12,2018,6,0,4,"Braga",3,"Rua de Caires",36,36,0,37,37,0
9,12,2018,6,0,4,"Braga",4,"N14 Bosch",47,47,0,48,48,0
9,12,2018,6,0,4,"Braga",5,"Avenida João Paulo II",39,39,0,9,9,0
9,12,2018,6,0,4,"Braga",6,"Avenida Padre Júlio Fragata",67,67,0,83,83,0
9,12,2018,6,0,4,"Braga",7,"Rua Nova Santa Cruz",44,44,0,39,39,0
9,12,2018,6,0,4,"Braga",8,"Rua Costa Gomes",0,41,41,-1,42,-43
9,12,2018,7,0,4,"Braga",1,"Avenida da Liberdade",25,25,0,124,124,0
9,12,2018,7,0,4,"Braga",2,"Avenida Central",25,25,0,124,124,0
9,12,2018,7,0,4,"Braga",3,"Rua de Caires",26,36,10,52,37,15
9,12,2018,7,0,4,"Braga",4,"N14 Bosch",47,47,0,48,48,0
9,12,2018,7,0,4,"Braga",5,"Avenida João Paulo II",39,39,0,9,9,0
9,12,2018,7,0,4,"Braga",6,"Avenida Padre Júlio Fragata",67,67,0,83,83,0
9,12,2018,7,0,4,"Braga",7,"Rua Nova Santa Cruz",30,44,14,58,39,19
9,12,2018,7,0,4,"Braga",8,"Rua Costa Gomes",0,41,41,-1,42,-43
9,12,2018,8,0,4,"Braga",1,"Avenida da Liberdade",18,25,7,172,124,48
9,12,2018,8,0,4,"Braga",2,"Avenida Central",18,25,7,172,124,48
9,12,2018,8,0,4,"Braga",3,"Rua de Caires",24,36,12,56,37,19
9,12,2018,8,0,4,"Braga",4,"N14 Bosch",29,47,18,77,48,29
9,12,2018,8,0,4,"Braga",5,"Avenida João Paulo II",39,39,0,9,9,0
9,12,2018,8,0,4,"Braga",6,"Avenida Padre Júlio Fragata",67,67,0,83,83,0
9,12,2018,8,0,4,"Braga",7,"Rua Nova Santa Cruz",4,44,40,432,39,393
9,12,2018,8,0,4,"Braga",8,"Rua Costa Gomes",0,41,41,-1,42,-43
9,12,2018,9,0,4,"Braga",1,"Avenida da Liberdade",25,25,0,124,124,0
9,12,2018,9,0,4,"Braga",2,"Avenida Central",25,25,0,124,124,0
9,12,2018,9,0,4,"Braga",3,"Rua de Caires",27,36,9,50,37,13
9,12,2018,9,0,4,"Braga",4,"N14 Bosch",7,47,40,321,48,273
9,12,2018,9,0,4,"Braga",5,"Avenida João Paulo II",29,39,10,12,9,3
9,12,2018,9,0,4,"Braga",6,"Avenida Padre Júlio Fragata",67,67,0,83,83,0
9,12,2018,9,0,4,"Braga",7,"Rua Nova Santa Cruz",27,44,17,64,39,25
9,12,2018,9,0,4,"Braga",8,"Rua Costa Gomes",0,41,41,-1,42,-43
9,12,2018,10,0,4,"Braga",1,"Avenida da Liberdade",25,25,0,124,124,0
9,12,2018,10,0,4,"Braga",2,"Avenida Central",25,25,0,124,124,0
9,12,2018,10,0,4,"Braga",3,"Rua de Caires",36,36,0,37,37,0
9,12,2018,10,0,4,"Braga",4,"N14 Bosch",27,47,20,83,48,35
9,12,2018,10,0,4,"Braga",5,"Avenida João Paulo II",39,39,0,9,9,0
9,12,2018,10,0,4,"Braga",6,"Avenida Padre Júlio Fragata",67,67,0,83,83,0
9,12,2018,10,0,4,"Braga",7,"Rua Nova Santa Cruz",31,44,13,56,39,17
9,12,2018,10,0,4,"Braga",8,"Rua Costa Gomes",0,41,41,-1,42,-43
9,12,2018,11,0,4,"Braga",1,"Avenida da Liberdade",19,25,6,163,124,39
9,12,2018,11,0,4,"Braga",2,"Avenida Central",19,25,6,163,124,39
9,12,2018,11,0,4,"Braga",3,"Rua de Caires",36,36,0,37,37,0
9,12,2018,11,0,4,"Braga",4,"N14 Bosch",47,47,0,48,48,0
9,12,2018,11,0,4,"Braga",5,"Avenida João Paulo II",39,39,0,9,9,0
9,12,2018,11,0,4,"Braga",6,"Avenida Padre Júlio Fragata",67,67,0,83,83,0
9,12,2018,11,0,4,"Braga",7,"Rua Nova Santa Cruz",32,44,12,54,39,15
9,12,2018,11,0,4,"Braga",8,"Rua Costa Gomes",0,41,41,-1,42,-43
9,12,2018,12,0,4,"Braga",1,"Avenida da Liberdade",25,25,0,124,124,0
9,12,2018,12,0,4,"Braga",2,"Avenida Central",25,25,0,124,124,0
9,12,2018,12,0,4,"Braga",3,"Rua de Caires",10,36,26,135,37,98
9,12,2018,12,0,4,"Braga",4,"N14 Bosch",30,47,17,75,48,27
9,12,2018,12,0,4,"Braga",5,"Avenida João Paulo II",30,39,9,12,9,3
9,12,2018,12,0,4,"Braga",6,"Avenida Padre Júlio Fragata",67,67,0,83,83,0
9,12,2018,12,0,4,"Braga",7,"Rua Nova Santa Cruz",18,44,26,96,39,57
9,12,2018,12,0,4,"Braga",8,"Rua Costa Gomes",0,41,41,-1,42,-43
9,12,2018,13,0,4,"Braga",1,"Avenida da Liberdade",17,25,8,182,124,58
9,12,2018,13,0,4,"Braga",2,"Avenida Central",17,25,8,182,124,58
9,12,2018,13,0,4,"Braga",3,"Rua de Caires",28,36,8,48,37,11
9,12,2018,13,0,4,"Braga",4,"N14 Bosch",17,47,30,132,48,84
9,12,2018,13,0,4,"Braga",5,"Avenida João Paulo II",39,39,0,9,9,0
9,12,2018,13,0,4,"Braga",6,"Avenida Padre Júlio Fragata",67,67,0,83,83,0
9,12,2018,13,0,4,"Braga",7,"Rua Nova Santa Cruz",28,44,16,62,39,23
9,12,2018,13,0,4,"Braga",8,"Rua Costa Gomes",0,41,41,-1,42,-43
9,12,2018,14,0,4,"Braga",1,"Avenida da Liberdade",25,25,0,124,124,0
9,12,2018,14,0,4,"Braga",2,"Avenida Central",25,25,0,124,124,0
9,12,2018,14,0,4,"Braga",3,"Rua de Caires",21,36,15,64,37,27
9,12,2018,14,0,4,"Braga",4,"N14 Bosch",17,47,30,132,48,84
9,12,2018,14,0,4,"Braga",5,"Avenida João Paulo II",39,39,0,9,9,0
9,12,2018,14,0,4,"Braga",6,"Avenida Padre Júlio Fragata",67,67,0,83,83,0
9,12,2018,14,0,4,"Braga",7,"Rua Nova Santa Cruz",32,44,12,54,39,15
9,12,2018,14,0,4,"Braga",8,"Rua Costa Gomes",0,41,41,-1,42,-43
9,12,2018,15,0,4,"Braga",1,"Avenida da Liberdade",12,25,13,258,124,134
9,12,2018,15,0,4,"Braga",2,"Avenida Central",12,25,13,258,124,134
9,12,2018,15,0,4,"Braga",3,"Rua de Caires",25,36,11,54,37,17
9,12,2018,15,0,4,"Braga",4,"N14 Bosch",27,47,20,83,48,35
9,12,2018,15,0,4,"Braga",5,"Avenida João Paulo II",39,39,0,9,9,0
9,12,2018,15,0,4,"Braga",6,"Avenida Padre Júlio Fragata",67,67,0,83,83,0
9,12,2018,15,0,4,"Braga",7,"Rua Nova Santa Cruz",27,44,17,64,39,25
9,12,2018,15,0,4,"Braga",8,"Rua Costa Gomes",0,41,41,-1,42,-43
9,12,2018,16,0,4,"Braga",1,"Avenida da Liberdade",15,25,10,207,124,83
9,12,2018,16,0,4,"Braga",2,"Avenida Central",15,25,10,207,124,83
9,12,2018,16,0,4,"Braga",3,"Rua de Caires",26,36,10,52,37,15
9,12,2018,16,0,4,"Braga",4,"N14 Bosch",23,47,24,98,48,50
9,12,2018,16,0,4,"Braga",5,"Avenida João Paulo II",26,39,13,13,9,4
9,12,2018,16,0,4,"Braga",6,"Avenida Padre Júlio Fragata",52,67,15,107,83,24
9,12,2018,16,0,4,"Braga",7,"Rua Nova Santa Cruz",32,44,12,54,39,15
9,12,2018,16,0,4,"Braga",8,"Rua Costa Gomes",0,41,41,-1,42,-43
9,12,2018,17,0,4,"Braga",1,"Avenida da Liberdade",16,25,9,194,124,70
9,12,2018,17,0,4,"Braga",2,"Avenida Central",16,25,9,194,124,70
9,12,2018,17,0,4,"Braga",3,"Rua de Caires",36,36,0,37,37,0
9,12,2018,17,0,4,"Braga",4,"N14 Bosch",10,47,37,225,48,177
9,12,2018,17,0,4,"Braga",5,"Avenida João Paulo II",39,39,0,9,9,0
9,12,2018,17,0,4,"Braga",6,"Avenida Padre Júlio Fragata",36,67,31,155,83,72
9,12,2018,17,0,4,"Braga",7,"Rua Nova Santa Cruz",11,44,33,157,39,118
9,12,2018,17,0,4,"Braga",8,"Rua Costa Gomes",0,41,41,-1,42,-43
9,12,2018,18,0,4,"Braga",1,"Avenida da Liberdade",17,25,8,182,124,58
9,12,2018,18,0,4,"Braga",2,"Avenida Central",17,25,8,182,124,58
9,12,2018,18,0,4,"Braga",3,"Rua de Caires",22,36,14,61,37,24
9,12,2018,18,0,4,"Braga",4,"N14 Bosch",8,47,39,281,48,233
9,12,2018,18,0,4,"Braga",5,"Avenida João Paulo II",18,39,21,19,9,10
9,12,2018,18,0,4,"Braga",6,"Avenida Padre Júlio Fragata",21,67,46,265,83,182
9,12,2018,18,0,4,"Braga",7,"Rua Nova Santa Cruz",44,44,0,39,39,0
9,12,2018,18,0,4,"Braga",8,"Rua Costa Gomes",0,41,41,-1,42,-43
9,12,2018,19,0,4,"Braga",1,"Avenida da Liberdade",25,25,0,124,124,0
9,12,2018,19,0,4,"Braga",2,"Avenida Central",25,25,0,124,124,0
9,12,2018,19,0,4,"Braga",3,"Rua de Caires",27,36,9,50,37,13
9,12,2018,19,0,4,"Braga",4,"N14 Bosch",11,47,36,204,48,156
9,12,2018,19,0,4,"Braga",5,"Avenida João Paulo II",39,39,0,9,9,0
9,12,2018,19,0,4,"Braga",6,"Avenida Padre Júlio Fragata",67,67,0,83,83,0
9,12,2018,19,0,4,"Braga",7,"Rua Nova Santa Cruz",29,44,15,60,39,21
9,12,2018,19,0,4,"Braga",8,"Rua Costa Gomes",0,41,41,-1,42,-43
9,12,2018,20,0,4,"Braga",1,"Avenida da Liberdade",25,25,0,124,124,0
9,12,2018,20,0,4,"Braga",2,"Avenida Central",25,25,0,124,124,0
9,12,2018,20,0,4,"Braga",3,"Rua de Caires",36,36,0,37,37,0
9,12,2018,20,0,4,"Braga",4,"N14 Bosch",47,47,0,48,48,0
9,12,2018,20,0,4,"Braga",5,"Avenida João Paulo II",22,39,17,16,9,7
9,12,2018,20,0,4,"Braga",6,"Avenida Padre Júlio Fragata",67,67,0,83,83,0
9,12,2018,20,0,4,"Braga",7,"Rua Nova Santa Cruz",44,44,0,39,39,0
9,12,2018,20,0,4,"Braga",8,"Rua Costa Gomes",0,41,41,-1,42,-43
9,12,2018,21,0,4,"Braga",1,"Avenida da Liberdade",25,25,0,124,124,0
9,12,2018,21,0,4,"Braga",2,"Avenida Central",25,25,0,124,124,0
9,12,2018,21,0,4,"Braga",3,"Rua de Caires",36,36,0,37,37,0
9,12,2018,21,0,4,"Braga",4,"N14 Bosch",47,47,0,48,48,0
9,12,2018,21,0,4,"Braga",5,"Avenida João Paulo II",30,39,9,12,9,3
9,12,2018,21,0,4,"Braga",6,"Avenida Padre Júlio Fragata",67,67,0,83,83,0
9,12,2018,21,0,4,"Braga",7,"Rua Nova Santa Cruz",30,44,14,58,39,19
9,12,2018,21,0,4,"Braga",8,"Rua Costa Gomes",0,41,41,-1,42,-43
9,12,2018,22,0,4,"Braga",1,"Avenida da Liberdade",25,25,0,124,124,0
9,12,2018,22,0,4,"Braga",2,"Avenida Central",25,25,0,124,124,0
9,12,2018,22,0,4,"Braga",3,"Rua de Caires",36,36,0,37,37,0
9,12,2018,22,0,4,"Braga",4,"N14 Bosch",47,47,0,48,48,0
9,12,2018,22,0,4,"Braga",5,"Avenida João Paulo II",39,39,0,9,9,0
9,12,2018,22,0,4,"Braga",6,"Avenida Padre Júlio Fragata",67,67,0,83,83,0
9,12,2018,22,0,4,"Braga",7,"Rua Nova Santa Cruz",44,44,0,39,39,0
9,12,2018,22,0,4,"Braga",8,"Rua Costa Gomes",0,41,41,-1,42,-43
9,12,2018,23,0,4,"Braga",1,"Avenida da Liberdade",25,25,0,124,124,0
9,12,2018,23,0,4,"Braga",2,"Avenida Central",25,25,0,124,124,0
9,12,2018,23,0,4,"Braga",3,"Rua de Caires",36,36,0,37,37,0
9,12,2018,23,0,4,"Braga",4,"N14 Bosch",47,47,0,48,48,0
9,12,2018,23,0,4,"Braga",5,"Avenida João Paulo II",39,39,0,9,9,0
9,12,2018,23,0,4,"Braga",6,"Avenida Padre Júlio Fragata",67,67,0,83,83,0
9,12,2018,23,0,4,"Braga",7,"Rua Nova Santa Cruz",26,44,18,66,39,27
9,12,2018,23,0,4,"Braga",8,"Rua Costa Gomes",0,41,41,-1,42,-43
9,13,2018,0,0,5,"Braga",1,"Avenida da Liberdade",25,25,0,124,124,0
9,13,2018,0,0,5,"Braga",2,"Avenida Central",25,25,0,124,124,0
9,13,2018,0,0,5,"Braga",3,"Rua de Caires",36,36,0,37,37,0
9,13,2018,0,0,5,"Braga",4,"N14 Bosch",47,47,0,48,48,0
9,13,2018,0,0,5,"Braga",5,"Avenida João Paulo II",39,39,0,9,9,0
9,13,2018,0,0,5,"Braga",6,"Avenida Padre Júlio Fragata",67,67,0,83,83,0
9,13,2018,0,0,5,"Braga",7,"Rua Nova Santa Cruz",44,44,0,39,39,0
9,13,2018,0,0,5,"Braga",8,"Rua Costa Gomes",0,41,41,-1,42,-43
9,13,2018,1,0,5,"Braga",1,"Avenida da Liberdade",25,25,0,124,124,0
9,13,2018,1,0,5,"Braga",2,"Avenida Central",25,25,0,124,124,0
9,13,2018,1,0,5,"Braga",3,"Rua de Caires",28,36,8,48,37,11
9,13,2018,1,0,5,"Braga",4,"N14 Bosch",47,47,0,48,48,0
9,13,2018,1,0,5,"Braga",5,"Avenida João Paulo II",39,39,0,9,9,0
9,13,2018,1,0,5,"Braga",6,"Avenida Padre Júlio Fragata",67,67,0,83,83,0
9,13,2018,1,0,5,"Braga",7,"Rua Nova Santa Cruz",44,44,0,39,39,0
9,13,2018,1,0,5,"Braga",8,"Rua Costa Gomes",0,41,41,-1,42,-43
9,13,2018,2,0,5,"Braga",1,"Avenida da Liberdade",25,25,0,124,124,0
9,13,2018,2,0,5,"Braga",2,"Avenida Central",25,25,0,124,124,0
9,13,2018,2,0,5,"Braga",3,"Rua de Caires",36,36,0,37,37,0
9,13,2018,2,0,5,"Braga",4,"N14 Bosch",47,47,0,48,48,0
9,13,2018,2,0,5,"Braga",5,"Avenida João Paulo II",39,39,0,9,9,0
9,13,2018,2,0,5,"Braga",6,"Avenida Padre Júlio Fragata",67,67,0,83,83,0
9,13,2018,2,0,5,"Braga",7,"Rua Nova Santa Cruz",35,44,9,49,39,10
9,13,2018,2,0,5,"Braga",8,"Rua Costa Gomes",0,41,41,-1,42,-43
9,13,2018,3,0,5,"Braga",1,"Avenida da Liberdade",25,25,0,124,124,0
9,13,2018,3,0,5,"Braga",2,"Avenida Central",25,25,0,124,124,0
9,13,2018,3,0,5,"Braga",3,"Rua de Caires",36,36,0,37,37,0
9,13,2018,3,0,5,"Braga",4,"N14 Bosch",47,47,0,48,48,0
9,13,2018,3,0,5,"Braga",5,"Avenida João Paulo II",39,39,0,9,9,0
9,13,2018,3,0,5,"Braga",6,"Avenida Padre Júlio Fragata",67,67,0,83,83,0
9,13,2018,3,0,5,"Braga",7,"Rua Nova Santa Cruz",44,44,0,39,39,0
9,13,2018,3,0,5,"Braga",8,"Rua Costa Gomes",0,41,41,-1,42,-43
9,13,2018,4,0,5,"Braga",1,"Avenida da Liberdade",25,25,0,124,124,0
9,13,2018,4,0,5,"Braga",2,"Avenida Central",25,25,0,124,124,0
9,13,2018,4,0,5,"Braga",3,"Rua de Caires",36,36,0,37,37,0
9,13,2018,4,0,5,"Braga",4,"N14 Bosch",47,47,0,48,48,0
9,13,2018,4,0,5,"Braga",5,"Avenida João Paulo II",39,39,0,9,9,0
9,13,2018,4,0,5,"Braga",6,"Avenida Padre Júlio Fragata",67,67,0,83,83,0
9,13,2018,4,0,5,"Braga",7,"Rua Nova Santa Cruz",44,44,0,39,39,0
9,13,2018,4,0,5,"Braga",8,"Rua Costa Gomes",0,41,41,-1,42,-43
9,13,2018,5,0,5,"Braga",1,"Avenida da Liberdade",25,25,0,124,124,0
9,13,2018,5,0,5,"Braga",2,"Avenida Central",25,25,0,124,124,0
9,13,2018,5,0,5,"Braga",3,"Rua de Caires",36,36,0,37,37,0
9,13,2018,5,0,5,"Braga",4,"N14 Bosch",47,47,0,48,48,0
9,13,2018,5,0,5,"Braga",5,"Avenida João Paulo II",39,39,0,9,9,0
9,13,2018,5,0,5,"Braga",6,"Avenida Padre Júlio Fragata",67,67,0,83,83,0
9,13,2018,5,0,5,"Braga",7,"Rua Nova Santa Cruz",44,44,0,39,39,0
9,13,2018,5,0,5,"Braga",8,"Rua Costa Gomes",0,41,41,-1,42,-43
9,13,2018,6,0,5,"Braga",1,"Avenida da Liberdade",25,25,0,124,124,0
9,13,2018,6,0,5,"Braga",2,"Avenida Central",25,25,0,124,124,0
9,13,2018,6,0,5,"Braga",3,"Rua de Caires",36,36,0,37,37,0
9,13,2018,6,0,5,"Braga",4,"N14 Bosch",47,47,0,48,48,0
9,13,2018,6,0,5,"Braga",5,"Avenida João Paulo II",39,39,0,9,9,0
9,13,2018,6,0,5,"Braga",6,"Avenida Padre Júlio Fragata",67,67,0,83,83,0
9,13,2018,6,0,5,"Braga",7,"Rua Nova Santa Cruz",44,44,0,39,39,0
9,13,2018,6,0,5,"Braga",8,"Rua Costa Gomes",0,41,41,-1,42,-43
9,13,2018,7,0,5,"Braga",1,"Avenida da Liberdade",25,25,0,124,124,0
9,13,2018,7,0,5,"Braga",2,"Avenida Central",25,25,0,124,124,0
9,13,2018,7,0,5,"Braga",3,"Rua de Caires",27,36,9,50,37,13
9,13,2018,7,0,5,"Braga",4,"N14 Bosch",47,47,0,48,48,0
9,13,2018,7,0,5,"Braga",5,"Avenida João Paulo II",39,39,0,9,9,0
9,13,2018,7,0,5,"Braga",6,"Avenida Padre Júlio Fragata",67,67,0,83,83,0
9,13,2018,7,0,5,"Braga",7,"Rua Nova Santa Cruz",44,44,0,39,39,0
9,13,2018,7,0,5,"Braga",8,"Rua Costa Gomes",0,41,41,-1,42,-43
9,13,2018,8,0,5,"Braga",1,"Avenida da Liberdade",15,25,10,207,124,83
9,13,2018,8,0,5,"Braga",2,"Avenida Central",15,25,10,207,124,83
9,13,2018,8,0,5,"Braga",3,"Rua de Caires",36,36,0,37,37,0
9,13,2018,8,0,5,"Braga",4,"N14 Bosch",19,47,28,118,48,70
9,13,2018,8,0,5,"Braga",5,"Avenida João Paulo II",39,39,0,9,9,0
9,13,2018,8,0,5,"Braga",6,"Avenida Padre Júlio Fragata",42,67,25,133,83,50
9,13,2018,8,0,5,"Braga",7,"Rua Nova Santa Cruz",27,44,17,64,39,25
9,13,2018,8,0,5,"Braga",8,"Rua Costa Gomes",0,41,41,-1,42,-43
9,13,2018,9,0,5,"Braga",1,"Avenida da Liberdade",19,25,6,163,124,39
9,13,2018,9,0,5,"Braga",2,"Avenida Central",19,25,6,163,124,39
9,13,2018,9,0,5,"Braga",3,"Rua de Caires",28,36,8,48,37,11
9,13,2018,9,0,5,"Braga",4,"N14 Bosch",47,47,0,48,48,0
9,13,2018,9,0,5,"Braga",5,"Avenida João Paulo II",39,39,0,9,9,0
9,13,2018,9,0,5,"Braga",6,"Avenida Padre Júlio Fragata",67,67,0,83,83,0
9,13,2018,9,0,5,"Braga",7,"Rua Nova Santa Cruz",14,44,30,123,39,84
9,13,2018,9,0,5,"Braga",8,"Rua Costa Gomes",0,41,41,-1,42,-43
9,13,2018,10,0,5,"Braga",1,"Avenida da Liberdade",19,25,6,163,124,39
9,13,2018,10,0,5,"Braga",2,"Avenida Central",19,25,6,163,124,39
9,13,2018,10,0,5,"Braga",3,"Rua de Caires",18,36,18,75,37,38
9,13,2018,10,0,5,"Braga",4,"N14 Bosch",30,47,17,75,48,27
9,13,2018,10,0,5,"Braga",5,"Avenida João Paulo II",39,39,0,9,9,0
9,13,2018,10,0,5,"Braga",6,"Avenida Padre Júlio Fragata",67,67,0,83,83,0
9,13,2018,10,0,5,"Braga",7,"Rua Nova Santa Cruz",44,44,0,39,39,0
9,13,2018,10,0,5,"Braga",8,"Rua Costa Gomes",0,41,41,-1,42,-43
9,13,2018,11,0,5,"Braga",1,"Avenida da Liberdade",25,25,0,124,124,0
9,13,2018,11,0,5,"Braga",2,"Avenida Central",25,25,0,124,124,0
9,13,2018,11,0,5,"Braga",3,"Rua de Caires",28,36,8,48,37,11
9,13,2018,11,0,5,"Braga",4,"N14 Bosch",29,47,18,77,48,29
9,13,2018,11,0,5,"Braga",5,"Avenida João Paulo II",39,39,0,9,9,0
9,13,2018,11,0,5,"Braga",6,"Avenida Padre Júlio Fragata",67,67,0,83,83,0
9,13,2018,11,0,5,"Braga",7,"Rua Nova Santa Cruz",44,44,0,39,39,0
9,13,2018,11,0,5,"Braga",8,"Rua Costa Gomes",0,41,41,-1,42,-43
9,13,2018,12,0,5,"Braga",1,"Avenida da Liberdade",25,25,0,124,124,0
9,13,2018,12,0,5,"Braga",2,"Avenida Central",25,25,0,124,124,0
9,13,2018,12,0,5,"Braga",3,"Rua de Caires",36,36,0,37,37,0
9,13,2018,12,0,5,"Braga",4,"N14 Bosch",34,47,13,66,48,18
9,13,2018,12,0,5,"Braga",5,"Avenida João Paulo II",39,39,0,9,9,0
9,13,2018,12,0,5,"Braga",6,"Avenida Padre Júlio Fragata",67,67,0,83,83,0
9,13,2018,12,0,5,"Braga",7,"Rua Nova Santa Cruz",21,44,23,82,39,43
9,13,2018,12,0,5,"Braga",8,"Rua Costa Gomes",0,41,41,-1,42,-43
9,13,2018,13,0,5,"Braga",1,"Avenida da Liberdade",25,25,0,124,124,0
9,13,2018,13,0,5,"Braga",2,"Avenida Central",25,25,0,124,124,0
9,13,2018,13,0,5,"Braga",3,"Rua de Caires",36,36,0,37,37,0
9,13,2018,13,0,5,"Braga",4,"N14 Bosch",17,47,30,132,48,84
9,13,2018,13,0,5,"Braga",5,"Avenida João Paulo II",39,39,0,9,9,0
9,13,2018,13,0,5,"Braga",6,"Avenida Padre Júlio Fragata",67,67,0,83,83,0
9,13,2018,13,0,5,"Braga",7,"Rua Nova Santa Cruz",14,44,30,123,39,84
9,13,2018,13,0,5,"Braga",8,"Rua Costa Gomes",0,41,41,-1,42,-43
9,13,2018,14,0,5,"Braga",1,"Avenida da Liberdade",25,25,0,124,124,0
9,13,2018,14,0,5,"Braga",2,"Avenida Central",25,25,0,124,124,0
9,13,2018,14,0,5,"Braga",3,"Rua de Caires",22,36,14,61,37,24
9,13,2018,14,0,5,"Braga",4,"N14 Bosch",16,47,31,140,48,92
9,13,2018,14,0,5,"Braga",5,"Avenida João Paulo II",39,39,0,9,9,0
9,13,2018,14,0,5,"Braga",6,"Avenida Padre Júlio Fragata",67,67,0,83,83,0
9,13,2018,14,0,5,"Braga",7,"Rua Nova Santa Cruz",29,44,15,60,39,21
9,13,2018,14,0,5,"Braga",8,"Rua Costa Gomes",0,41,41,-1,42,-43
9,13,2018,15,0,5,"Braga",1,"Avenida da Liberdade",14,25,11,221,124,97
9,13,2018,15,0,5,"Braga",2,"Avenida Central",14,25,11,221,124,97
9,13,2018,15,0,5,"Braga",3,"Rua de Caires",36,36,0,37,37,0
9,13,2018,15,0,5,"Braga",4,"N14 Bosch",31,47,16,72,48,24
9,13,2018,15,0,5,"Braga",5,"Avenida João Paulo II",39,39,0,9,9,0
9,13,2018,15,0,5,"Braga",6,"Avenida Padre Júlio Fragata",67,67,0,83,83,0
9,13,2018,15,0,5,"Braga",7,"Rua Nova Santa Cruz",26,44,18,66,39,27
9,13,2018,15,0,5,"Braga",8,"Rua Costa Gomes",0,41,41,-1,42,-43
9,13,2018,16,0,5,"Braga",1,"Avenida da Liberdade",15,25,10,207,124,83
9,13,2018,16,0,5,"Braga",2,"Avenida Central",15,25,10,207,124,83
9,13,2018,16,0,5,"Braga",3,"Rua de Caires",23,36,13,59,37,22
9,13,2018,16,0,5,"Braga",4,"N14 Bosch",29,47,18,77,48,29
9,13,2018,16,0,5,"Braga",5,"Avenida João Paulo II",25,39,14,14,9,5
9,13,2018,16,0,5,"Braga",6,"Avenida Padre Júlio Fragata",50,67,17,111,83,28
9,13,2018,16,0,5,"Braga",7,"Rua Nova Santa Cruz",23,44,21,75,39,36
9,13,2018,16,0,5,"Braga",8,"Rua Costa Gomes",0,41,41,-1,42,-43
9,13,2018,17,0,5,"Braga",1,"Avenida da Liberdade",11,25,14,282,124,158
9,13,2018,17,0,5,"Braga",2,"Avenida Central",11,25,14,282,124,158
9,13,2018,17,0,5,"Braga",3,"Rua de Caires",17,36,19,79,37,42
9,13,2018,17,0,5,"Braga",4,"N14 Bosch",13,47,34,173,48,125
9,13,2018,17,0,5,"Braga",5,"Avenida João Paulo II",21,39,18,17,9,8
9,13,2018,17,0,5,"Braga",6,"Avenida Padre Júlio Fragata",35,67,32,159,83,76
9,13,2018,17,0,5,"Braga",7,"Rua Nova Santa Cruz",11,44,33,157,39,118
9,13,2018,17,0,5,"Braga",8,"Rua Costa Gomes",0,41,41,-1,42,-43
9,13,2018,18,0,5,"Braga",1,"Avenida da Liberdade",18,25,7,172,124,48
9,13,2018,18,0,5,"Braga",2,"Avenida Central",18,25,7,172,124,48
9,13,2018,18,0,5,"Braga",3,"Rua de Caires",17,36,19,79,37,42
9,13,2018,18,0,5,"Braga",4,"N14 Bosch",32,47,15,70,48,22
9,13,2018,18,0,5,"Braga",5,"Avenida João Paulo II",8,39,31,44,9,35
9,13,2018,18,0,5,"Braga",6,"Avenida Padre Júlio Fragata",21,67,46,265,83,182
9,13,2018,18,0,5,"Braga",7,"Rua Nova Santa Cruz",44,44,0,39,39,0
9,13,2018,18,0,5,"Braga",8,"Rua Costa Gomes",0,41,41,-1,42,-43
9,13,2018,19,0,5,"Braga",1,"Avenida da Liberdade",25,25,0,124,124,0
9,13,2018,19,0,5,"Braga",2,"Avenida Central",25,25,0,124,124,0
9,13,2018,19,0,5,"Braga",3,"Rua de Caires",36,36,0,37,37,0
9,13,2018,19,0,5,"Braga",4,"N14 Bosch",36,47,11,62,48,14
9,13,2018,19,0,5,"Braga",5,"Avenida João Paulo II",39,39,0,9,9,0
9,13,2018,19,0,5,"Braga",6,"Avenida Padre Júlio Fragata",67,67,0,83,83,0
9,13,2018,19,0,5,"Braga",7,"Rua Nova Santa Cruz",44,44,0,39,39,0
9,13,2018,19,0,5,"Braga",8,"Rua Costa Gomes",0,41,41,-1,42,-43
9,13,2018,20,0,5,"Braga",1,"Avenida da Liberdade",25,25,0,124,124,0
9,13,2018,20,0,5,"Braga",2,"Avenida Central",25,25,0,124,124,0
9,13,2018,20,0,5,"Braga",3,"Rua de Caires",36,36,0,37,37,0
9,13,2018,20,0,5,"Braga",4,"N14 Bosch",47,47,0,48,48,0
9,13,2018,20,0,5,"Braga",5,"Avenida João Paulo II",39,39,0,9,9,0
9,13,2018,20,0,5,"Braga",6,"Avenida Padre Júlio Fragata",43,67,24,130,83,47
9,13,2018,20,0,5,"Braga",7,"Rua Nova Santa Cruz",44,44,0,39,39,0
9,13,2018,20,0,5,"Braga",8,"Rua Costa Gomes",0,41,41,-1,42,-43
9,13,2018,21,0,5,"Braga",1,"Avenida da Liberdade",25,25,0,124,124,0
9,13,2018,21,0,5,"Braga",2,"Avenida Central",25,25,0,124,124,0
9,13,2018,21,0,5,"Braga",3,"Rua de Caires",36,36,0,37,37,0
9,13,2018,21,0,5,"Braga",4,"N14 Bosch",47,47,0,48,48,0
9,13,2018,21,0,5,"Braga",5,"Avenida João Paulo II",39,39,0,9,9,0
9,13,2018,21,0,5,"Braga",6,"Avenida Padre Júlio Fragata",67,67,0,83,83,0
9,13,2018,21,0,5,"Braga",7,"Rua Nova Santa Cruz",32,44,12,54,39,15
9,13,2018,21,0,5,"Braga",8,"Rua Costa Gomes",0,41,41,-1,42,-43
9,13,2018,22,0,5,"Braga",1,"Avenida da Liberdade",25,25,0,124,124,0
9,13,2018,22,0,5,"Braga",2,"Avenida Central",25,25,0,124,124,0
9,13,2018,22,0,5,"Braga",3,"Rua de Caires",36,36,0,37,37,0
9,13,2018,22,0,5,"Braga",4,"N14 Bosch",47,47,0,48,48,0
9,13,2018,22,0,5,"Braga",5,"Avenida João Paulo II",39,39,0,9,9,0
9,13,2018,22,0,5,"Braga",6,"Avenida Padre Júlio Fragata",67,67,0,83,83,0
9,13,2018,22,0,5,"Braga",7,"Rua Nova Santa Cruz",44,44,0,39,39,0
9,13,2018,22,0,5,"Braga",8,"Rua Costa Gomes",0,41,41,-1,42,-43
9,13,2018,23,0,5,"Braga",1,"Avenida da Liberdade",25,25,0,124,124,0
9,13,2018,23,0,5,"Braga",2,"Avenida Central",25,25,0,124,124,0
9,13,2018,23,0,5,"Braga",3,"Rua de Caires",36,36,0,37,37,0
9,13,2018,23,0,5,"Braga",4,"N14 Bosch",47,47,0,48,48,0
9,13,2018,23,0,5,"Braga",5,"Avenida João Paulo II",39,39,0,9,9,0
9,13,2018,23,0,5,"Braga",6,"Avenida Padre Júlio Fragata",52,67,15,107,83,24
9,13,2018,23,0,5,"Braga",7,"Rua Nova Santa Cruz",44,44,0,39,39,0
9,13,2018,23,0,5,"Braga",8,"Rua Costa Gomes",0,41,41,-1,42,-43
9,14,2018,0,0,6,"Braga",1,"Avenida da Liberdade",25,25,0,124,124,0
9,14,2018,0,0,6,"Braga",2,"Avenida Central",25,25,0,124,124,0
9,14,2018,0,0,6,"Braga",3,"Rua de Caires",36,36,0,37,37,0
9,14,2018,0,0,6,"Braga",4,"N14 Bosch",47,47,0,48,48,0
9,14,2018,0,0,6,"Braga",5,"Avenida João Paulo II",39,39,0,9,9,0
9,14,2018,0,0,6,"Braga",6,"Avenida Padre Júlio Fragata",67,67,0,83,83,0
9,14,2018,0,0,6,"Braga",7,"Rua Nova Santa Cruz",44,44,0,39,39,0
9,14,2018,0,0,6,"Braga",8,"Rua Costa Gomes",0,41,41,-1,42,-43
9,14,2018,1,0,6,"Braga",1,"Avenida da Liberdade",25,25,0,124,124,0
9,14,2018,1,0,6,"Braga",2,"Avenida Central",25,25,0,124,124,0
9,14,2018,1,0,6,"Braga",3,"Rua de Caires",36,36,0,37,37,0
9,14,2018,1,0,6,"Braga",4,"N14 Bosch",47,47,0,48,48,0
9,14,2018,1,0,6,"Braga",5,"Avenida João Paulo II",39,39,0,9,9,0
9,14,2018,1,0,6,"Braga",6,"Avenida Padre Júlio Fragata",67,67,0,83,83,0
9,14,2018,1,0,6,"Braga",7,"Rua Nova Santa Cruz",44,44,0,39,39,0
9,14,2018,1,0,6,"Braga",8,"Rua Costa Gomes",0,41,41,-1,42,-43
9,14,2018,2,0,6,"Braga",1,"Avenida da Liberdade",25,25,0,124,124,0
9,14,2018,2,0,6,"Braga",2,"Avenida Central",25,25,0,124,124,0
9,14,2018,2,0,6,"Braga",3,"Rua de Caires",36,36,0,37,37,0
9,14,2018,2,0,6,"Braga",4,"N14 Bosch",47,47,0,48,48,0
9,14,2018,2,0,6,"Braga",5,"Avenida João Paulo II",39,39,0,9,9,0
9,14,2018,2,0,6,"Braga",6,"Avenida Padre Júlio Fragata",67,67,0,83,83,0
9,14,2018,2,0,6,"Braga",7,"Rua Nova Santa Cruz",44,44,0,39,39,0
9,14,2018,2,0,6,"Braga",8,"Rua Costa Gomes",0,41,41,-1,42,-43
9,14,2018,3,0,6,"Braga",1,"Avenida da Liberdade",25,25,0,124,124,0
9,14,2018,3,0,6,"Braga",2,"Avenida Central",25,25,0,124,124,0
9,14,2018,3,0,6,"Braga",3,"Rua de Caires",36,36,0,37,37,0
9,14,2018,3,0,6,"Braga",4,"N14 Bosch",47,47,0,48,48,0
9,14,2018,3,0,6,"Braga",5,"Avenida João Paulo II",39,39,0,9,9,0
9,14,2018,3,0,6,"Braga",6,"Avenida Padre Júlio Fragata",67,67,0,83,83,0
9,14,2018,3,0,6,"Braga",7,"Rua Nova Santa Cruz",44,44,0,39,39,0
9,14,2018,3,0,6,"Braga",8,"Rua Costa Gomes",0,41,41,-1,42,-43
9,14,2018,4,0,6,"Braga",1,"Avenida da Liberdade",25,25,0,124,124,0
9,14,2018,4,0,6,"Braga",2,"Avenida Central",25,25,0,124,124,0
9,14,2018,4,0,6,"Braga",3,"Rua de Caires",36,36,0,37,37,0
9,14,2018,4,0,6,"Braga",4,"N14 Bosch",47,47,0,48,48,0
9,14,2018,4,0,6,"Braga",5,"Avenida João Paulo II",39,39,0,9,9,0
9,14,2018,4,0,6,"Braga",6,"Avenida Padre Júlio Fragata",67,67,0,83,83,0
9,14,2018,4,0,6,"Braga",7,"Rua Nova Santa Cruz",44,44,0,39,39,0
9,14,2018,4,0,6,"Braga",8,"Rua Costa Gomes",0,41,41,-1,42,-43
9,14,2018,5,0,6,"Braga",1,"Avenida da Liberdade",25,25,0,124,124,0
9,14,2018,5,0,6,"Braga",2,"Avenida Central",25,25,0,124,124,0
9,14,2018,5,0,6,"Braga",3,"Rua de Caires",36,36,0,37,37,0
9,14,2018,5,0,6,"Braga",4,"N14 Bosch",47,47,0,48,48,0
9,14,2018,5,0,6,"Braga",5,"Avenida João Paulo II",39,39,0,9,9,0
9,14,2018,5,0,6,"Braga",6,"Avenida Padre Júlio Fragata",67,67,0,83,83,0
9,14,2018,5,0,6,"Braga",7,"Rua Nova Santa Cruz",44,44,0,39,39,0
9,14,2018,5,0,6,"Braga",8,"Rua Costa Gomes",0,41,41,-1,42,-43
9,14,2018,6,0,6,"Braga",1,"Avenida da Liberdade",25,25,0,124,124,0
9,14,2018,6,0,6,"Braga",2,"Avenida Central",25,25,0,124,124,0
9,14,2018,6,0,6,"Braga",3,"Rua de Caires",36,36,0,37,37,0
9,14,2018,6,0,6,"Braga",4,"N14 Bosch",47,47,0,48,48,0
9,14,2018,6,0,6,"Braga",5,"Avenida João Paulo II",39,39,0,9,9,0
9,14,2018,6,0,6,"Braga",6,"Avenida Padre Júlio Fragata",67,67,0,83,83,0
9,14,2018,6,0,6,"Braga",7,"Rua Nova Santa Cruz",44,44,0,39,39,0
9,14,2018,6,0,6,"Braga",8,"Rua Costa Gomes",0,41,41,-1,42,-43
9,14,2018,7,0,6,"Braga",1,"Avenida da Liberdade",25,25,0,124,124,0
9,14,2018,7,0,6,"Braga",2,"Avenida Central",25,25,0,124,124,0
9,14,2018,7,0,6,"Braga",3,"Rua de Caires",26,36,10,52,37,15
9,14,2018,7,0,6,"Braga",4,"N14 Bosch",25,47,22,90,48,42
9,14,2018,7,0,6,"Braga",5,"Avenida João Paulo II",39,39,0,9,9,0
9,14,2018,7,0,6,"Braga",6,"Avenida Padre Júlio Fragata",67,67,0,83,83,0
9,14,2018,7,0,6,"Braga",7,"Rua Nova Santa Cruz",44,44,0,39,39,0
9,14,2018,7,0,6,"Braga",8,"Rua Costa Gomes",0,41,41,-1,42,-43
9,14,2018,8,0,6,"Braga",1,"Avenida da Liberdade",25,25,0,124,124,0
9,14,2018,8,0,6,"Braga",2,"Avenida Central",25,25,0,124,124,0
9,14,2018,8,0,6,"Braga",3,"Rua de Caires",28,36,8,48,37,11
9,14,2018,8,0,6,"Braga",4,"N14 Bosch",12,47,35,187,48,139
9,14,2018,8,0,6,"Braga",5,"Avenida João Paulo II",39,39,0,9,9,0
9,14,2018,8,0,6,"Braga",6,"Avenida Padre Júlio Fragata",34,67,33,164,83,81
9,14,2018,8,0,6,"Braga",7,"Rua Nova Santa Cruz",12,44,32,144,39,105
9,14,2018,8,0,6,"Braga",8,"Rua Costa Gomes",0,41,41,-1,42,-43
9,14,2018,9,0,6,"Braga",1,"Avenida da Liberdade",25,25,0,124,124,0
9,14,2018,9,0,6,"Braga",2,"Avenida Central",25,25,0,124,124,0
9,14,2018,9,0,6,"Braga",3,"Rua de Caires",36,36,0,37,37,0
9,14,2018,9,0,6,"Braga",4,"N14 Bosch",32,47,15,70,48,22
9,14,2018,9,0,6,"Braga",5,"Avenida João Paulo II",27,39,12,13,9,4
9,14,2018,9,0,6,"Braga",6,"Avenida Padre Júlio Fragata",67,67,0,83,83,0
9,14,2018,9,0,6,"Braga",7,"Rua Nova Santa Cruz",44,44,0,39,39,0
9,14,2018,9,0,6,"Braga",8,"Rua Costa Gomes",0,41,41,-1,42,-43
9,14,2018,10,0,6,"Braga",1,"Avenida da Liberdade",25,25,0,124,124,0
9,14,2018,10,0,6,"Braga",2,"Avenida Central",25,25,0,124,124,0
9,14,2018,10,0,6,"Braga",3,"Rua de Caires",27,36,9,50,37,13
9,14,2018,10,0,6,"Braga",4,"N14 Bosch",37,47,10,61,48,13
9,14,2018,10,0,6,"Braga",5,"Avenida João Paulo II",26,39,13,13,9,4
9,14,2018,10,0,6,"Braga",6,"Avenida Padre Júlio Fragata",67,67,0,83,83,0
9,14,2018,10,0,6,"Braga",7,"Rua Nova Santa Cruz",44,44,0,39,39,0
9,14,2018,10,0,6,"Braga",8,"Rua Costa Gomes",0,41,41,-1,42,-43
9,14,2018,11,0,6,"Braga",1,"Avenida da Liberdade",25,25,0,124,124,0
9,14,2018,11,0,6,"Braga",2,"Avenida Central",25,25,0,124,124,0
9,14,2018,11,0,6,"Braga",3,"Rua de Caires",36,36,0,37,37,0
9,14,2018,11,0,6,"Braga",4,"N14 Bosch",32,47,15,70,48,22
9,14,2018,11,0,6,"Braga",5,"Avenida João Paulo II",39,39,0,9,9,0
9,14,2018,11,0,6,"Braga",6,"Avenida Padre Júlio Fragata",67,67,0,83,83,0
9,14,2018,11,0,6,"Braga",7,"Rua Nova Santa Cruz",44,44,0,39,39,0
9,14,2018,11,0,6,"Braga",8,"Rua Costa Gomes",0,41,41,-1,42,-43
9,14,2018,12,0,6,"Braga",1,"Avenida da Liberdade",25,25,0,124,124,0
9,14,2018,12,0,6,"Braga",2,"Avenida Central",25,25,0,124,124,0
9,14,2018,12,0,6,"Braga",3,"Rua de Caires",36,36,0,37,37,0
9,14,2018,12,0,6,"Braga",4,"N14 Bosch",47,47,0,48,48,0
9,14,2018,12,0,6,"Braga",5,"Avenida João Paulo II",25,39,14,14,9,5
9,14,2018,12,0,6,"Braga",6,"Avenida Padre Júlio Fragata",67,67,0,83,83,0
9,14,2018,12,0,6,"Braga",7,"Rua Nova Santa Cruz",24,44,20,72,39,33
9,14,2018,12,0,6,"Braga",8,"Rua Costa Gomes",0,41,41,-1,42,-43
9,14,2018,13,0,6,"Braga",1,"Avenida da Liberdade",18,25,7,172,124,48
9,14,2018,13,0,6,"Braga",2,"Avenida Central",18,25,7,172,124,48
9,14,2018,13,0,6,"Braga",3,"Rua de Caires",36,36,0,37,37,0
9,14,2018,13,0,6,"Braga",4,"N14 Bosch",35,47,12,64,48,16
9,14,2018,13,0,6,"Braga",5,"Avenida João Paulo II",39,39,0,9,9,0
9,14,2018,13,0,6,"Braga",6,"Avenida Padre Júlio Fragata",67,67,0,83,83,0
9,14,2018,13,0,6,"Braga",7,"Rua Nova Santa Cruz",17,44,27,102,39,63
9,14,2018,13,0,6,"Braga",8,"Rua Costa Gomes",0,41,41,-1,42,-43
9,14,2018,14,0,6,"Braga",1,"Avenida da Liberdade",16,25,9,194,124,70
9,14,2018,14,0,6,"Braga",2,"Avenida Central",16,25,9,194,124,70
9,14,2018,14,0,6,"Braga",3,"Rua de Caires",36,36,0,37,37,0
9,14,2018,14,0,6,"Braga",4,"N14 Bosch",35,47,12,64,48,16
9,14,2018,14,0,6,"Braga",5,"Avenida João Paulo II",39,39,0,9,9,0
9,14,2018,14,0,6,"Braga",6,"Avenida Padre Júlio Fragata",67,67,0,83,83,0
9,14,2018,14,0,6,"Braga",7,"Rua Nova Santa Cruz",32,44,12,54,39,15
9,14,2018,14,0,6,"Braga",8,"Rua Costa Gomes",0,41,41,-1,42,-43
9,14,2018,15,0,6,"Braga",1,"Avenida da Liberdade",19,25,6,163,124,39
9,14,2018,15,0,6,"Braga",2,"Avenida Central",19,25,6,163,124,39
9,14,2018,15,0,6,"Braga",3,"Rua de Caires",13,36,23,104,37,67
9,14,2018,15,0,6,"Braga",4,"N14 Bosch",47,47,0,48,48,0
9,14,2018,15,0,6,"Braga",5,"Avenida João Paulo II",39,39,0,9,9,0
9,14,2018,15,0,6,"Braga",6,"Avenida Padre Júlio Fragata",49,67,18,114,83,31
9,14,2018,15,0,6,"Braga",7,"Rua Nova Santa Cruz",34,44,10,51,39,12
9,14,2018,15,0,6,"Braga",8,"Rua Costa Gomes",0,41,41,-1,42,-43
9,14,2018,16,0,6,"Braga",1,"Avenida da Liberdade",17,25,8,182,124,58
9,14,2018,16,0,6,"Braga",2,"Avenida Central",17,25,8,182,124,58
9,14,2018,16,0,6,"Braga",3,"Rua de Caires",22,36,14,61,37,24
9,14,2018,16,0,6,"Braga",4,"N14 Bosch",15,47,32,150,48,102
9,14,2018,16,0,6,"Braga",5,"Avenida João Paulo II",39,39,0,9,9,0
9,14,2018,16,0,6,"Braga",6,"Avenida Padre Júlio Fragata",67,67,0,83,83,0
9,14,2018,16,0,6,"Braga",7,"Rua Nova Santa Cruz",44,44,0,39,39,0
9,14,2018,16,0,6,"Braga",8,"Rua Costa Gomes",0,41,41,-1,42,-43
9,14,2018,17,0,6,"Braga",1,"Avenida da Liberdade",10,25,15,310,124,186
9,14,2018,17,0,6,"Braga",2,"Avenida Central",10,25,15,310,124,186
9,14,2018,17,0,6,"Braga",3,"Rua de Caires",27,36,9,50,37,13
9,14,2018,17,0,6,"Braga",4,"N14 Bosch",17,47,30,132,48,84
9,14,2018,17,0,6,"Braga",5,"Avenida João Paulo II",39,39,0,9,9,0
9,14,2018,17,0,6,"Braga",6,"Avenida Padre Júlio Fragata",31,67,36,180,83,97
9,14,2018,17,0,6,"Braga",7,"Rua Nova Santa Cruz",26,44,18,66,39,27
9,14,2018,17,0,6,"Braga",8,"Rua Costa Gomes",0,41,41,-1,42,-43
9,14,2018,18,0,6,"Braga",1,"Avenida da Liberdade",13,25,12,238,124,114
9,14,2018,18,0,6,"Braga",2,"Avenida Central",13,25,12,238,124,114
9,14,2018,18,0,6,"Braga",3,"Rua de Caires",24,36,12,56,37,19
9,14,2018,18,0,6,"Braga",4,"N14 Bosch",15,47,32,150,48,102
9,14,2018,18,0,6,"Braga",5,"Avenida João Paulo II",39,39,0,9,9,0
9,14,2018,18,0,6,"Braga",6,"Avenida Padre Júlio Fragata",21,67,46,265,83,182
9,14,2018,18,0,6,"Braga",7,"Rua Nova Santa Cruz",14,44,30,123,39,84
9,14,2018,18,0,6,"Braga",8,"Rua Costa Gomes",0,41,41,-1,42,-43
9,14,2018,19,0,6,"Braga",1,"Avenida da Liberdade",25,25,0,124,124,0
9,14,2018,19,0,6,"Braga",2,"Avenida Central",25,25,0,124,124,0
9,14,2018,19,0,6,"Braga",3,"Rua de Caires",36,36,0,37,37,0
9,14,2018,19,0,6,"Braga",4,"N14 Bosch",22,47,25,102,48,54
9,14,2018,19,0,6,"Braga",5,"Avenida João Paulo II",39,39,0,9,9,0
9,14,2018,19,0,6,"Braga",6,"Avenida Padre Júlio Fragata",26,67,41,214,83,131
9,14,2018,19,0,6,"Braga",7,"Rua Nova Santa Cruz",44,44,0,39,39,0
9,14,2018,19,0,6,"Braga",8,"Rua Costa Gomes",0,41,41,-1,42,-43
9,14,2018,20,0,6,"Braga",1,"Avenida da Liberdade",25,25,0,124,124,0
9,14,2018,20,0,6,"Braga",2,"Avenida Central",25,25,0,124,124,0
9,14,2018,20,0,6,"Braga",3,"Rua de Caires",36,36,0,37,37,0
9,14,2018,20,0,6,"Braga",4,"N14 Bosch",47,47,0,48,48,0
9,14,2018,20,0,6,"Braga",5,"Avenida João Paulo II",27,39,12,13,9,4
9,14,2018,20,0,6,"Braga",6,"Avenida Padre Júlio Fragata",67,67,0,83,83,0
9,14,2018,20,0,6,"Braga",7,"Rua Nova Santa Cruz",44,44,0,39,39,0
9,14,2018,20,0,6,"Braga",8,"Rua Costa Gomes",0,41,41,-1,42,-43
9,14,2018,21,0,6,"Braga",1,"Avenida da Liberdade",25,25,0,124,124,0
9,14,2018,21,0,6,"Braga",2,"Avenida Central",25,25,0,124,124,0
9,14,2018,21,0,6,"Braga",3,"Rua de Caires",36,36,0,37,37,0
9,14,2018,21,0,6,"Braga",4,"N14 Bosch",47,47,0,48,48,0
9,14,2018,21,0,6,"Braga",5,"Avenida João Paulo II",39,39,0,9,9,0
9,14,2018,21,0,6,"Braga",6,"Avenida Padre Júlio Fragata",67,67,0,83,83,0
9,14,2018,21,0,6,"Braga",7,"Rua Nova Santa Cruz",44,44,0,39,39,0
9,14,2018,21,0,6,"Braga",8,"Rua Costa Gomes",0,41,41,-1,42,-43
9,14,2018,22,0,6,"Braga",1,"Avenida da Liberdade",25,25,0,124,124,0
9,14,2018,22,0,6,"Braga",2,"Avenida Central",25,25,0,124,124,0
9,14,2018,22,0,6,"Braga",3,"Rua de Caires",36,36,0,37,37,0
9,14,2018,22,0,6,"Braga",4,"N14 Bosch",17,47,30,132,48,84
9,14,2018,22,0,6,"Braga",5,"Avenida João Paulo II",39,39,0,9,9,0
9,14,2018,22,0,6,"Braga",6,"Avenida Padre Júlio Fragata",67,67,0,83,83,0
9,14,2018,22,0,6,"Braga",7,"Rua Nova Santa Cruz",25,44,19,69,39,30
9,14,2018,22,0,6,"Braga",8,"Rua Costa Gomes",0,41,41,-1,42,-43
9,14,2018,23,0,6,"Braga",1,"Avenida da Liberdade",25,25,0,124,124,0
9,14,2018,23,0,6,"Braga",2,"Avenida Central",25,25,0,124,124,0
9,14,2018,23,0,6,"Braga",3,"Rua de Caires",36,36,0,37,37,0
9,14,2018,23,0,6,"Braga",4,"N14 Bosch",47,47,0,48,48,0
9,14,2018,23,0,6,"Braga",5,"Avenida João Paulo II",39,39,0,9,9,0
9,14,2018,23,0,6,"Braga",6,"Avenida Padre Júlio Fragata",67,67,0,83,83,0
9,14,2018,23,0,6,"Braga",7,"Rua Nova Santa Cruz",44,44,0,39,39,0
9,14,2018,23,0,6,"Braga",8,"Rua Costa Gomes",0,41,41,-1,42,-43
9,15,2018,0,0,7,"Braga",1,"Avenida da Liberdade",25,25,0,124,124,0
9,15,2018,0,0,7,"Braga",2,"Avenida Central",25,25,0,124,124,0
9,15,2018,0,0,7,"Braga",3,"Rua de Caires",36,36,0,37,37,0
9,15,2018,0,0,7,"Braga",4,"N14 Bosch",47,47,0,48,48,0
9,15,2018,0,0,7,"Braga",5,"Avenida João Paulo II",39,39,0,9,9,0
9,15,2018,0,0,7,"Braga",6,"Avenida Padre Júlio Fragata",67,67,0,83,83,0
9,15,2018,0,0,7,"Braga",7,"Rua Nova Santa Cruz",44,44,0,39,39,0
9,15,2018,0,0,7,"Braga",8,"Rua Costa Gomes",0,41,41,-1,42,-43
9,15,2018,1,0,7,"Braga",1,"Avenida da Liberdade",25,25,0,124,124,0
9,15,2018,1,0,7,"Braga",2,"Avenida Central",25,25,0,124,124,0
9,15,2018,1,0,7,"Braga",3,"Rua de Caires",36,36,0,37,37,0
9,15,2018,1,0,7,"Braga",4,"N14 Bosch",47,47,0,48,48,0
9,15,2018,1,0,7,"Braga",5,"Avenida João Paulo II",39,39,0,9,9,0
9,15,2018,1,0,7,"Braga",6,"Avenida Padre Júlio Fragata",67,67,0,83,83,0
9,15,2018,1,0,7,"Braga",7,"Rua Nova Santa Cruz",44,44,0,39,39,0
9,15,2018,1,0,7,"Braga",8,"Rua Costa Gomes",0,41,41,-1,42,-43
9,15,2018,2,0,7,"Braga",1,"Avenida da Liberdade",25,25,0,124,124,0
9,15,2018,2,0,7,"Braga",2,"Avenida Central",25,25,0,124,124,0
9,15,2018,2,0,7,"Braga",3,"Rua de Caires",36,36,0,37,37,0
9,15,2018,2,0,7,"Braga",4,"N14 Bosch",47,47,0,48,48,0
9,15,2018,2,0,7,"Braga",5,"Avenida João Paulo II",39,39,0,9,9,0
9,15,2018,2,0,7,"Braga",6,"Avenida Padre Júlio Fragata",67,67,0,83,83,0
9,15,2018,2,0,7,"Braga",7,"Rua Nova Santa Cruz",44,44,0,39,39,0
9,15,2018,2,0,7,"Braga",8,"Rua Costa Gomes",0,41,41,-1,42,-43
9,15,2018,3,0,7,"Braga",1,"Avenida da Liberdade",25,25,0,124,124,0
9,15,2018,3,0,7,"Braga",2,"Avenida Central",25,25,0,124,124,0
9,15,2018,3,0,7,"Braga",3,"Rua de Caires",36,36,0,37,37,0
9,15,2018,3,0,7,"Braga",4,"N14 Bosch",47,47,0,48,48,0
9,15,2018,3,0,7,"Braga",5,"Avenida João Paulo II",39,39,0,9,9,0
9,15,2018,3,0,7,"Braga",6,"Avenida Padre Júlio Fragata",67,67,0,83,83,0
9,15,2018,3,0,7,"Braga",7,"Rua Nova Santa Cruz",44,44,0,39,39,0
9,15,2018,3,0,7,"Braga",8,"Rua Costa Gomes",0,41,41,-1,42,-43
9,15,2018,4,0,7,"Braga",1,"Avenida da Liberdade",25,25,0,124,124,0
9,15,2018,4,0,7,"Braga",2,"Avenida Central",25,25,0,124,124,0
9,15,2018,4,0,7,"Braga",3,"Rua de Caires",36,36,0,37,37,0
9,15,2018,4,0,7,"Braga",4,"N14 Bosch",47,47,0,48,48,0
9,15,2018,4,0,7,"Braga",5,"Avenida João Paulo II",39,39,0,9,9,0
9,15,2018,4,0,7,"Braga",6,"Avenida Padre Júlio Fragata",67,67,0,83,83,0
9,15,2018,4,0,7,"Braga",7,"Rua Nova Santa Cruz",44,44,0,39,39,0
9,15,2018,4,0,7,"Braga",8,"Rua Costa Gomes",0,41,41,-1,42,-43
9,15,2018,5,0,7,"Braga",1,"Avenida da Liberdade",25,25,0,124,124,0
9,15,2018,5,0,7,"Braga",2,"Avenida Central",25,25,0,124,124,0
9,15,2018,5,0,7,"Braga",3,"Rua de Caires",36,36,0,37,37,0
9,15,2018,5,0,7,"Braga",4,"N14 Bosch",47,47,0,48,48,0
9,15,2018,5,0,7,"Braga",5,"Avenida João Paulo II",39,39,0,9,9,0
9,15,2018,5,0,7,"Braga",6,"Avenida Padre Júlio Fragata",67,67,0,83,83,0
9,15,2018,5,0,7,"Braga",7,"Rua Nova Santa Cruz",44,44,0,39,39,0
9,15,2018,5,0,7,"Braga",8,"Rua Costa Gomes",0,41,41,-1,42,-43
9,15,2018,6,0,7,"Braga",1,"Avenida da Liberdade",25,25,0,124,124,0
9,15,2018,6,0,7,"Braga",2,"Avenida Central",25,25,0,124,124,0
9,15,2018,6,0,7,"Braga",3,"Rua de Caires",36,36,0,37,37,0
9,15,2018,6,0,7,"Braga",4,"N14 Bosch",37,47,10,61,48,13
9,15,2018,6,0,7,"Braga",5,"Avenida João Paulo II",39,39,0,9,9,0
9,15,2018,6,0,7,"Braga",6,"Avenida Padre Júlio Fragata",67,67,0,83,83,0
9,15,2018,6,0,7,"Braga",7,"Rua Nova Santa Cruz",44,44,0,39,39,0
9,15,2018,6,0,7,"Braga",8,"Rua Costa Gomes",0,41,41,-1,42,-43
9,15,2018,7,0,7,"Braga",1,"Avenida da Liberdade",25,25,0,124,124,0
9,15,2018,7,0,7,"Braga",2,"Avenida Central",25,25,0,124,124,0
9,15,2018,7,0,7,"Braga",3,"Rua de Caires",36,36,0,37,37,0
9,15,2018,7,0,7,"Braga",4,"N14 Bosch",47,47,0,48,48,0
9,15,2018,7,0,7,"Braga",5,"Avenida João Paulo II",39,39,0,9,9,0
9,15,2018,7,0,7,"Braga",6,"Avenida Padre Júlio Fragata",67,67,0,83,83,0
9,15,2018,7,0,7,"Braga",7,"Rua Nova Santa Cruz",44,44,0,39,39,0
9,15,2018,7,0,7,"Braga",8,"Rua Costa Gomes",0,41,41,-1,42,-43
9,15,2018,8,0,7,"Braga",1,"Avenida da Liberdade",25,25,0,124,124,0
9,15,2018,8,0,7,"Braga",2,"Avenida Central",25,25,0,124,124,0
9,15,2018,8,0,7,"Braga",3,"Rua de Caires",23,36,13,59,37,22
9,15,2018,8,0,7,"Braga",4,"N14 Bosch",36,47,11,62,48,14
9,15,2018,8,0,7,"Braga",5,"Avenida João Paulo II",39,39,0,9,9,0
9,15,2018,8,0,7,"Braga",6,"Avenida Padre Júlio Fragata",67,67,0,83,83,0
9,15,2018,8,0,7,"Braga",7,"Rua Nova Santa Cruz",44,44,0,39,39,0
9,15,2018,8,0,7,"Braga",8,"Rua Costa Gomes",0,41,41,-1,42,-43
9,15,2018,9,0,7,"Braga",1,"Avenida da Liberdade",25,25,0,124,124,0
9,15,2018,9,0,7,"Braga",2,"Avenida Central",25,25,0,124,124,0
9,15,2018,9,0,7,"Braga",3,"Rua de Caires",25,36,11,54,37,17
9,15,2018,9,0,7,"Braga",4,"N14 Bosch",47,47,0,48,48,0
9,15,2018,9,0,7,"Braga",5,"Avenida João Paulo II",39,39,0,9,9,0
9,15,2018,9,0,7,"Braga",6,"Avenida Padre Júlio Fragata",67,67,0,83,83,0
9,15,2018,9,0,7,"Braga",7,"Rua Nova Santa Cruz",27,44,17,64,39,25
9,15,2018,9,0,7,"Braga",8,"Rua Costa Gomes",0,41,41,-1,42,-43
9,15,2018,10,0,7,"Braga",1,"Avenida da Liberdade",25,25,0,124,124,0
9,15,2018,10,0,7,"Braga",2,"Avenida Central",25,25,0,124,124,0
9,15,2018,10,0,7,"Braga",3,"Rua de Caires",22,36,14,61,37,24
9,15,2018,10,0,7,"Braga",4,"N14 Bosch",37,47,10,61,48,13
9,15,2018,10,0,7,"Braga",5,"Avenida João Paulo II",28,39,11,12,9,3
9,15,2018,10,0,7,"Braga",6,"Avenida Padre Júlio Fragata",67,67,0,83,83,0
9,15,2018,10,0,7,"Braga",7,"Rua Nova Santa Cruz",44,44,0,39,39,0
9,15,2018,10,0,7,"Braga",8,"Rua Costa Gomes",0,41,41,-1,42,-43
9,15,2018,11,0,7,"Braga",1,"Avenida da Liberdade",25,25,0,124,124,0
9,15,2018,11,0,7,"Braga",2,"Avenida Central",25,25,0,124,124,0
9,15,2018,11,0,7,"Braga",3,"Rua de Caires",26,36,10,52,37,15
9,15,2018,11,0,7,"Braga",4,"N14 Bosch",47,47,0,48,48,0
9,15,2018,11,0,7,"Braga",5,"Avenida João Paulo II",39,39,0,9,9,0
9,15,2018,11,0,7,"Braga",6,"Avenida Padre Júlio Fragata",67,67,0,83,83,0
9,15,2018,11,0,7,"Braga",7,"Rua Nova Santa Cruz",44,44,0,39,39,0
9,15,2018,11,0,7,"Braga",8,"Rua Costa Gomes",0,41,41,-1,42,-43
9,15,2018,12,0,7,"Braga",1,"Avenida da Liberdade",25,25,0,124,124,0
9,15,2018,12,0,7,"Braga",2,"Avenida Central",25,25,0,124,124,0
9,15,2018,12,0,7,"Braga",3,"Rua de Caires",36,36,0,37,37,0
9,15,2018,12,0,7,"Braga",4,"N14 Bosch",47,47,0,48,48,0
9,15,2018,12,0,7,"Braga",5,"Avenida João Paulo II",39,39,0,9,9,0
9,15,2018,12,0,7,"Braga",6,"Avenida Padre Júlio Fragata",67,67,0,83,83,0
9,15,2018,12,0,7,"Braga",7,"Rua Nova Santa Cruz",44,44,0,39,39,0
9,15,2018,12,0,7,"Braga",8,"Rua Costa Gomes",0,41,41,-1,42,-43
9,15,2018,13,0,7,"Braga",1,"Avenida da Liberdade",25,25,0,124,124,0
9,15,2018,13,0,7,"Braga",2,"Avenida Central",25,25,0,124,124,0
9,15,2018,13,0,7,"Braga",3,"Rua de Caires",27,36,9,50,37,13
9,15,2018,13,0,7,"Braga",4,"N14 Bosch",47,47,0,48,48,0
9,15,2018,13,0,7,"Braga",5,"Avenida João Paulo II",39,39,0,9,9,0
9,15,2018,13,0,7,"Braga",6,"Avenida Padre Júlio Fragata",67,67,0,83,83,0
9,15,2018,13,0,7,"Braga",7,"Rua Nova Santa Cruz",44,44,0,39,39,0
9,15,2018,13,0,7,"Braga",8,"Rua Costa Gomes",0,41,41,-1,42,-43
9,15,2018,14,0,7,"Braga",1,"Avenida da Liberdade",25,25,0,124,124,0
9,15,2018,14,0,7,"Braga",2,"Avenida Central",25,25,0,124,124,0
9,15,2018,14,0,7,"Braga",3,"Rua de Caires",36,36,0,37,37,0
9,15,2018,14,0,7,"Braga",4,"N14 Bosch",47,47,0,48,48,0
9,15,2018,14,0,7,"Braga",5,"Avenida João Paulo II",39,39,0,9,9,0
9,15,2018,14,0,7,"Braga",6,"Avenida Padre Júlio Fragata",53,67,14,105,83,22
9,15,2018,14,0,7,"Braga",7,"Rua Nova Santa Cruz",44,44,0,39,39,0
9,15,2018,14,0,7,"Braga",8,"Rua Costa Gomes",0,41,41,-1,42,-43
9,15,2018,15,0,7,"Braga",1,"Avenida da Liberdade",25,25,0,124,124,0
9,15,2018,15,0,7,"Braga",2,"Avenida Central",25,25,0,124,124,0
9,15,2018,15,0,7,"Braga",3,"Rua de Caires",36,36,0,37,37,0
9,15,2018,15,0,7,"Braga",4,"N14 Bosch",47,47,0,48,48,0
9,15,2018,15,0,7,"Braga",5,"Avenida João Paulo II",39,39,0,9,9,0
9,15,2018,15,0,7,"Braga",6,"Avenida Padre Júlio Fragata",67,67,0,83,83,0
9,15,2018,15,0,7,"Braga",7,"Rua Nova Santa Cruz",44,44,0,39,39,0
9,15,2018,15,0,7,"Braga",8,"Rua Costa Gomes",0,41,41,-1,42,-43
9,15,2018,16,0,7,"Braga",1,"Avenida da Liberdade",25,25,0,124,124,0
9,15,2018,16,0,7,"Braga",2,"Avenida Central",25,25,0,124,124,0
9,15,2018,16,0,7,"Braga",3,"Rua de Caires",36,36,0,37,37,0
9,15,2018,16,0,7,"Braga",4,"N14 Bosch",47,47,0,48,48,0
9,15,2018,16,0,7,"Braga",5,"Avenida João Paulo II",30,39,9,12,9,3
9,15,2018,16,0,7,"Braga",6,"Avenida Padre Júlio Fragata",67,67,0,83,83,0
9,15,2018,16,0,7,"Braga",7,"Rua Nova Santa Cruz",44,44,0,39,39,0
9,15,2018,16,0,7,"Braga",8,"Rua Costa Gomes",0,41,41,-1,42,-43
9,15,2018,17,0,7,"Braga",1,"Avenida da Liberdade",25,25,0,124,124,0
9,15,2018,17,0,7,"Braga",2,"Avenida Central",25,25,0,124,124,0
9,15,2018,17,0,7,"Braga",3,"Rua de Caires",13,36,23,104,37,67
9,15,2018,17,0,7,"Braga",4,"N14 Bosch",47,47,0,48,48,0
9,15,2018,17,0,7,"Braga",5,"Avenida João Paulo II",39,39,0,9,9,0
9,15,2018,17,0,7,"Braga",6,"Avenida Padre Júlio Fragata",67,67,0,83,83,0
9,15,2018,17,0,7,"Braga",7,"Rua Nova Santa Cruz",33,44,11,52,39,13
9,15,2018,17,0,7,"Braga",8,"Rua Costa Gomes",0,41,41,-1,42,-43
9,15,2018,18,0,7,"Braga",1,"Avenida da Liberdade",25,25,0,124,124,0
9,15,2018,18,0,7,"Braga",2,"Avenida Central",25,25,0,124,124,0
9,15,2018,18,0,7,"Braga",3,"Rua de Caires",25,36,11,54,37,17
9,15,2018,18,0,7,"Braga",4,"N14 Bosch",47,47,0,48,48,0
9,15,2018,18,0,7,"Braga",5,"Avenida João Paulo II",39,39,0,9,9,0
9,15,2018,18,0,7,"Braga",6,"Avenida Padre Júlio Fragata",33,67,34,169,83,86
9,15,2018,18,0,7,"Braga",7,"Rua Nova Santa Cruz",44,44,0,39,39,0
9,15,2018,18,0,7,"Braga",8,"Rua Costa Gomes",0,41,41,-1,42,-43
9,15,2018,19,0,7,"Braga",1,"Avenida da Liberdade",25,25,0,124,124,0
9,15,2018,19,0,7,"Braga",2,"Avenida Central",25,25,0,124,124,0
9,15,2018,19,0,7,"Braga",3,"Rua de Caires",26,36,10,52,37,15
9,15,2018,19,0,7,"Braga",4,"N14 Bosch",47,47,0,48,48,0
9,15,2018,19,0,7,"Braga",5,"Avenida João Paulo II",23,39,16,15,9,6
9,15,2018,19,0,7,"Braga",6,"Avenida Padre Júlio Fragata",43,67,24,130,83,47
9,15,2018,19,0,7,"Braga",7,"Rua Nova Santa Cruz",44,44,0,39,39,0
9,15,2018,19,0,7,"Braga",8,"Rua Costa Gomes",0,41,41,-1,42,-43
9,15,2018,20,0,7,"Braga",1,"Avenida da Liberdade",19,25,6,163,124,39
9,15,2018,20,0,7,"Braga",2,"Avenida Central",19,25,6,163,124,39
9,15,2018,20,0,7,"Braga",3,"Rua de Caires",26,36,10,52,37,15
9,15,2018,20,0,7,"Braga",4,"N14 Bosch",47,47,0,48,48,0
9,15,2018,20,0,7,"Braga",5,"Avenida João Paulo II",39,39,0,9,9,0
9,15,2018,20,0,7,"Braga",6,"Avenida Padre Júlio Fragata",67,67,0,83,83,0
9,15,2018,20,0,7,"Braga",7,"Rua Nova Santa Cruz",44,44,0,39,39,0
9,15,2018,20,0,7,"Braga",8,"Rua Costa Gomes",0,41,41,-1,42,-43
9,15,2018,21,0,7,"Braga",1,"Avenida da Liberdade",25,25,0,124,124,0
9,15,2018,21,0,7,"Braga",2,"Avenida Central",25,25,0,124,124,0
9,15,2018,21,0,7,"Braga",3,"Rua de Caires",36,36,0,37,37,0
9,15,2018,21,0,7,"Braga",4,"N14 Bosch",47,47,0,48,48,0
9,15,2018,21,0,7,"Braga",5,"Avenida João Paulo II",39,39,0,9,9,0
9,15,2018,21,0,7,"Braga",6,"Avenida Padre Júlio Fragata",67,67,0,83,83,0
9,15,2018,21,0,7,"Braga",7,"Rua Nova Santa Cruz",44,44,0,39,39,0
9,15,2018,21,0,7,"Braga",8,"Rua Costa Gomes",0,41,41,-1,42,-43
9,15,2018,22,0,7,"Braga",1,"Avenida da Liberdade",25,25,0,124,124,0
9,15,2018,22,0,7,"Braga",2,"Avenida Central",25,25,0,124,124,0
9,15,2018,22,0,7,"Braga",3,"Rua de Caires",17,36,19,79,37,42
9,15,2018,22,0,7,"Braga",4,"N14 Bosch",47,47,0,48,48,0
9,15,2018,22,0,7,"Braga",5,"Avenida João Paulo II",39,39,0,9,9,0
9,15,2018,22,0,7,"Braga",6,"Avenida Padre Júlio Fragata",67,67,0,83,83,0
9,15,2018,22,0,7,"Braga",7,"Rua Nova Santa Cruz",44,44,0,39,39,0
9,15,2018,22,0,7,"Braga",8,"Rua Costa Gomes",0,41,41,-1,42,-43
9,15,2018,23,0,7,"Braga",1,"Avenida da Liberdade",25,25,0,124,124,0
9,15,2018,23,0,7,"Braga",2,"Avenida Central",25,25,0,124,124,0
9,15,2018,23,0,7,"Braga",3,"Rua de Caires",36,36,0,37,37,0
9,15,2018,23,0,7,"Braga",4,"N14 Bosch",47,47,0,48,48,0
9,15,2018,23,0,7,"Braga",5,"Avenida João Paulo II",39,39,0,9,9,0
9,15,2018,23,0,7,"Braga",6,"Avenida Padre Júlio Fragata",67,67,0,83,83,0
9,15,2018,23,0,7,"Braga",7,"Rua Nova Santa Cruz",44,44,0,39,39,0
9,15,2018,23,0,7,"Braga",8,"Rua Costa Gomes",0,41,41,-1,42,-43
9,16,2018,0,0,8,"Braga",1,"Avenida da Liberdade",25,25,0,124,124,0
9,16,2018,0,0,8,"Braga",2,"Avenida Central",25,25,0,124,124,0
9,16,2018,0,0,8,"Braga",3,"Rua de Caires",36,36,0,37,37,0
9,16,2018,0,0,8,"Braga",4,"N14 Bosch",47,47,0,48,48,0
9,16,2018,0,0,8,"Braga",5,"Avenida João Paulo II",39,39,0,9,9,0
9,16,2018,0,0,8,"Braga",6,"Avenida Padre Júlio Fragata",67,67,0,83,83,0
9,16,2018,0,0,8,"Braga",7,"Rua Nova Santa Cruz",44,44,0,39,39,0
9,16,2018,0,0,8,"Braga",8,"Rua Costa Gomes",0,41,41,-1,42,-43
9,16,2018,1,0,8,"Braga",1,"Avenida da Liberdade",25,25,0,124,124,0
9,16,2018,1,0,8,"Braga",2,"Avenida Central",25,25,0,124,124,0
9,16,2018,1,0,8,"Braga",3,"Rua de Caires",36,36,0,37,37,0
9,16,2018,1,0,8,"Braga",4,"N14 Bosch",47,47,0,48,48,0
9,16,2018,1,0,8,"Braga",5,"Avenida João Paulo II",39,39,0,9,9,0
9,16,2018,1,0,8,"Braga",6,"Avenida Padre Júlio Fragata",67,67,0,83,83,0
9,16,2018,1,0,8,"Braga",7,"Rua Nova Santa Cruz",44,44,0,39,39,0
9,16,2018,1,0,8,"Braga",8,"Rua Costa Gomes",0,41,41,-1,42,-43
9,16,2018,2,0,8,"Braga",1,"Avenida da Liberdade",25,25,0,124,124,0
9,16,2018,2,0,8,"Braga",2,"Avenida Central",25,25,0,124,124,0
9,16,2018,2,0,8,"Braga",3,"Rua de Caires",36,36,0,37,37,0
9,16,2018,2,0,8,"Braga",4,"N14 Bosch",47,47,0,48,48,0
9,16,2018,2,0,8,"Braga",5,"Avenida João Paulo II",39,39,0,9,9,0
9,16,2018,2,0,8,"Braga",6,"Avenida Padre Júlio Fragata",67,67,0,83,83,0
9,16,2018,2,0,8,"Braga",7,"Rua Nova Santa Cruz",44,44,0,39,39,0
9,16,2018,2,0,8,"Braga",8,"Rua Costa Gomes",0,41,41,-1,42,-43
9,16,2018,3,0,8,"Braga",1,"Avenida da Liberdade",25,25,0,124,124,0
9,16,2018,3,0,8,"Braga",2,"Avenida Central",25,25,0,124,124,0
9,16,2018,3,0,8,"Braga",3,"Rua de Caires",36,36,0,37,37,0
9,16,2018,3,0,8,"Braga",4,"N14 Bosch",47,47,0,48,48,0
9,16,2018,3,0,8,"Braga",5,"Avenida João Paulo II",39,39,0,9,9,0
9,16,2018,3,0,8,"Braga",6,"Avenida Padre Júlio Fragata",67,67,0,83,83,0
9,16,2018,3,0,8,"Braga",7,"Rua Nova Santa Cruz",44,44,0,39,39,0
9,16,2018,3,0,8,"Braga",8,"Rua Costa Gomes",0,41,41,-1,42,-43
9,16,2018,4,0,8,"Braga",1,"Avenida da Liberdade",25,25,0,124,124,0
9,16,2018,4,0,8,"Braga",2,"Avenida Central",25,25,0,124,124,0
9,16,2018,4,0,8,"Braga",3,"Rua de Caires",36,36,0,37,37,0
9,16,2018,4,0,8,"Braga",4,"N14 Bosch",47,47,0,48,48,0
9,16,2018,4,0,8,"Braga",5,"Avenida João Paulo II",39,39,0,9,9,0
9,16,2018,4,0,8,"Braga",6,"Avenida Padre Júlio Fragata",67,67,0,83,83,0
9,16,2018,4,0,8,"Braga",7,"Rua Nova Santa Cruz",44,44,0,39,39,0
9,16,2018,4,0,8,"Braga",8,"Rua Costa Gomes",0,41,41,-1,42,-43
9,16,2018,5,0,8,"Braga",1,"Avenida da Liberdade",25,25,0,124,124,0
9,16,2018,5,0,8,"Braga",2,"Avenida Central",25,25,0,124,124,0
9,16,2018,5,0,8,"Braga",3,"Rua de Caires",36,36,0,37,37,0
9,16,2018,5,0,8,"Braga",4,"N14 Bosch",47,47,0,48,48,0
9,16,2018,5,0,8,"Braga",5,"Avenida João Paulo II",39,39,0,9,9,0
9,16,2018,5,0,8,"Braga",6,"Avenida Padre Júlio Fragata",67,67,0,83,83,0
9,16,2018,5,0,8,"Braga",7,"Rua Nova Santa Cruz",44,44,0,39,39,0
9,16,2018,5,0,8,"Braga",8,"Rua Costa Gomes",0,41,41,-1,42,-43
9,16,2018,6,0,8,"Braga",1,"Avenida da Liberdade",25,25,0,124,124,0
9,16,2018,6,0,8,"Braga",2,"Avenida Central",25,25,0,124,124,0
9,16,2018,6,0,8,"Braga",3,"Rua de Caires",36,36,0,37,37,0
9,16,2018,6,0,8,"Braga",4,"N14 Bosch",47,47,0,48,48,0
9,16,2018,6,0,8,"Braga",5,"Avenida João Paulo II",39,39,0,9,9,0
9,16,2018,6,0,8,"Braga",6,"Avenida Padre Júlio Fragata",67,67,0,83,83,0
9,16,2018,6,0,8,"Braga",7,"Rua Nova Santa Cruz",44,44,0,39,39,0
9,16,2018,6,0,8,"Braga",8,"Rua Costa Gomes",0,41,41,-1,42,-43
9,16,2018,7,0,8,"Braga",1,"Avenida da Liberdade",25,25,0,124,124,0
9,16,2018,7,0,8,"Braga",2,"Avenida Central",25,25,0,124,124,0
9,16,2018,7,0,8,"Braga",3,"Rua de Caires",36,36,0,37,37,0
9,16,2018,7,0,8,"Braga",4,"N14 Bosch",47,47,0,48,48,0
9,16,2018,7,0,8,"Braga",5,"Avenida João Paulo II",39,39,0,9,9,0
9,16,2018,7,0,8,"Braga",6,"Avenida Padre Júlio Fragata",67,67,0,83,83,0
9,16,2018,7,0,8,"Braga",7,"Rua Nova Santa Cruz",44,44,0,39,39,0
9,16,2018,7,0,8,"Braga",8,"Rua Costa Gomes",0,41,41,-1,42,-43
9,16,2018,8,0,8,"Braga",1,"Avenida da Liberdade",25,25,0,124,124,0
9,16,2018,8,0,8,"Braga",2,"Avenida Central",25,25,0,124,124,0
9,16,2018,8,0,8,"Braga",3,"Rua de Caires",36,36,0,37,37,0
9,16,2018,8,0,8,"Braga",4,"N14 Bosch",47,47,0,48,48,0
9,16,2018,8,0,8,"Braga",5,"Avenida João Paulo II",39,39,0,9,9,0
9,16,2018,8,0,8,"Braga",6,"Avenida Padre Júlio Fragata",67,67,0,83,83,0
9,16,2018,8,0,8,"Braga",7,"Rua Nova Santa Cruz",44,44,0,39,39,0
9,16,2018,8,0,8,"Braga",8,"Rua Costa Gomes",0,41,41,-1,42,-43
9,16,2018,9,0,8,"Braga",1,"Avenida da Liberdade",25,25,0,124,124,0
9,16,2018,9,0,8,"Braga",2,"Avenida Central",25,25,0,124,124,0
9,16,2018,9,0,8,"Braga",3,"Rua de Caires",36,36,0,37,37,0
9,16,2018,9,0,8,"Braga",4,"N14 Bosch",47,47,0,48,48,0
9,16,2018,9,0,8,"Braga",5,"Avenida João Paulo II",39,39,0,9,9,0
9,16,2018,9,0,8,"Braga",6,"Avenida Padre Júlio Fragata",67,67,0,83,83,0
9,16,2018,9,0,8,"Braga",7,"Rua Nova Santa Cruz",44,44,0,39,39,0
9,16,2018,9,0,8,"Braga",8,"Rua Costa Gomes",0,41,41,-1,42,-43
9,16,2018,10,0,8,"Braga",1,"Avenida da Liberdade",25,25,0,124,124,0
9,16,2018,10,0,8,"Braga",2,"Avenida Central",25,25,0,124,124,0
9,16,2018,10,0,8,"Braga",3,"Rua de Caires",36,36,0,37,37,0
9,16,2018,10,0,8,"Braga",4,"N14 Bosch",47,47,0,48,48,0
9,16,2018,10,0,8,"Braga",5,"Avenida João Paulo II",39,39,0,9,9,0
9,16,2018,10,0,8,"Braga",6,"Avenida Padre Júlio Fragata",67,67,0,83,83,0
9,16,2018,10,0,8,"Braga",7,"Rua Nova Santa Cruz",44,44,0,39,39,0
9,16,2018,10,0,8,"Braga",8,"Rua Costa Gomes",0,41,41,-1,42,-43
9,16,2018,11,0,8,"Braga",1,"Avenida da Liberdade",25,25,0,124,124,0
9,16,2018,11,0,8,"Braga",2,"Avenida Central",25,25,0,124,124,0
9,16,2018,11,0,8,"Braga",3,"Rua de Caires",36,36,0,37,37,0
9,16,2018,11,0,8,"Braga",4,"N14 Bosch",47,47,0,48,48,0
9,16,2018,11,0,8,"Braga",5,"Avenida João Paulo II",28,39,11,12,9,3
9,16,2018,11,0,8,"Braga",6,"Avenida Padre Júlio Fragata",67,67,0,83,83,0
9,16,2018,11,0,8,"Braga",7,"Rua Nova Santa Cruz",44,44,0,39,39,0
9,16,2018,11,0,8,"Braga",8,"Rua Costa Gomes",0,41,41,-1,42,-43
9,16,2018,12,0,8,"Braga",1,"Avenida da Liberdade",25,25,0,124,124,0
9,16,2018,12,0,8,"Braga",2,"Avenida Central",25,25,0,124,124,0
9,16,2018,12,0,8,"Braga",3,"Rua de Caires",36,36,0,37,37,0
9,16,2018,12,0,8,"Braga",4,"N14 Bosch",47,47,0,48,48,0
9,16,2018,12,0,8,"Braga",5,"Avenida João Paulo II",39,39,0,9,9,0
9,16,2018,12,0,8,"Braga",6,"Avenida Padre Júlio Fragata",67,67,0,83,83,0
9,16,2018,12,0,8,"Braga",7,"Rua Nova Santa Cruz",44,44,0,39,39,0
9,16,2018,12,0,8,"Braga",8,"Rua Costa Gomes",0,41,41,-1,42,-43
9,16,2018,13,0,8,"Braga",1,"Avenida da Liberdade",25,25,0,124,124,0
9,16,2018,13,0,8,"Braga",2,"Avenida Central",25,25,0,124,124,0
9,16,2018,13,0,8,"Braga",3,"Rua de Caires",28,36,8,48,37,11
9,16,2018,13,0,8,"Braga",4,"N14 Bosch",47,47,0,48,48,0
9,16,2018,13,0,8,"Braga",5,"Avenida João Paulo II",39,39,0,9,9,0
9,16,2018,13,0,8,"Braga",6,"Avenida Padre Júlio Fragata",67,67,0,83,83,0
9,16,2018,13,0,8,"Braga",7,"Rua Nova Santa Cruz",44,44,0,39,39,0
9,16,2018,13,0,8,"Braga",8,"Rua Costa Gomes",0,41,41,-1,42,-43
9,16,2018,14,0,8,"Braga",1,"Avenida da Liberdade",25,25,0,124,124,0
9,16,2018,14,0,8,"Braga",2,"Avenida Central",25,25,0,124,124,0
9,16,2018,14,0,8,"Braga",3,"Rua de Caires",28,36,8,48,37,11
9,16,2018,14,0,8,"Braga",4,"N14 Bosch",47,47,0,48,48,0
9,16,2018,14,0,8,"Braga",5,"Avenida João Paulo II",39,39,0,9,9,0
9,16,2018,14,0,8,"Braga",6,"Avenida Padre Júlio Fragata",67,67,0,83,83,0
9,16,2018,14,0,8,"Braga",7,"Rua Nova Santa Cruz",44,44,0,39,39,0
9,16,2018,14,0,8,"Braga",8,"Rua Costa Gomes",0,41,41,-1,42,-43
9,16,2018,15,0,8,"Braga",1,"Avenida da Liberdade",25,25,0,124,124,0
9,16,2018,15,0,8,"Braga",2,"Avenida Central",25,25,0,124,124,0
9,16,2018,15,0,8,"Braga",3,"Rua de Caires",27,36,9,50,37,13
9,16,2018,15,0,8,"Braga",4,"N14 Bosch",47,47,0,48,48,0
9,16,2018,15,0,8,"Braga",5,"Avenida João Paulo II",39,39,0,9,9,0
9,16,2018,15,0,8,"Braga",6,"Avenida Padre Júlio Fragata",52,67,15,107,83,24
9,16,2018,15,0,8,"Braga",7,"Rua Nova Santa Cruz",44,44,0,39,39,0
9,16,2018,15,0,8,"Braga",8,"Rua Costa Gomes",0,41,41,-1,42,-43
9,16,2018,16,0,8,"Braga",1,"Avenida da Liberdade",25,25,0,124,124,0
9,16,2018,16,0,8,"Braga",2,"Avenida Central",25,25,0,124,124,0
9,16,2018,16,0,8,"Braga",3,"Rua de Caires",36,36,0,37,37,0
9,16,2018,16,0,8,"Braga",4,"N14 Bosch",47,47,0,48,48,0
9,16,2018,16,0,8,"Braga",5,"Avenida João Paulo II",39,39,0,9,9,0
9,16,2018,16,0,8,"Braga",6,"Avenida Padre Júlio Fragata",53,67,14,105,83,22
9,16,2018,16,0,8,"Braga",7,"Rua Nova Santa Cruz",44,44,0,39,39,0
9,16,2018,16,0,8,"Braga",8,"Rua Costa Gomes",0,41,41,-1,42,-43
9,16,2018,17,0,8,"Braga",1,"Avenida da Liberdade",25,25,0,124,124,0
9,16,2018,17,0,8,"Braga",2,"Avenida Central",25,25,0,124,124,0
9,16,2018,17,0,8,"Braga",3,"Rua de Caires",36,36,0,37,37,0
9,16,2018,17,0,8,"Braga",4,"N14 Bosch",47,47,0,48,48,0
9,16,2018,17,0,8,"Braga",5,"Avenida João Paulo II",39,39,0,9,9,0
9,16,2018,17,0,8,"Braga",6,"Avenida Padre Júlio Fragata",67,67,0,83,83,0
9,16,2018,17,0,8,"Braga",7,"Rua Nova Santa Cruz",44,44,0,39,39,0
9,16,2018,17,0,8,"Braga",8,"Rua Costa Gomes",0,41,41,-1,42,-43
9,16,2018,18,0,8,"Braga",1,"Avenida da Liberdade",25,25,0,124,124,0
9,16,2018,18,0,8,"Braga",2,"Avenida Central",25,25,0,124,124,0
9,16,2018,18,0,8,"Braga",3,"Rua de Caires",36,36,0,37,37,0
9,16,2018,18,0,8,"Braga",4,"N14 Bosch",47,47,0,48,48,0
9,16,2018,18,0,8,"Braga",5,"Avenida João Paulo II",28,39,11,12,9,3
9,16,2018,18,0,8,"Braga",6,"Avenida Padre Júlio Fragata",42,67,25,133,83,50
9,16,2018,18,0,8,"Braga",7,"Rua Nova Santa Cruz",44,44,0,39,39,0
9,16,2018,18,0,8,"Braga",8,"Rua Costa Gomes",0,41,41,-1,42,-43
9,16,2018,19,0,8,"Braga",1,"Avenida da Liberdade",25,25,0,124,124,0
9,16,2018,19,0,8,"Braga",2,"Avenida Central",25,25,0,124,124,0
9,16,2018,19,0,8,"Braga",3,"Rua de Caires",28,36,8,48,37,11
9,16,2018,19,0,8,"Braga",4,"N14 Bosch",37,47,10,61,48,13
9,16,2018,19,0,8,"Braga",5,"Avenida João Paulo II",22,39,17,16,9,7
9,16,2018,19,0,8,"Braga",6,"Avenida Padre Júlio Fragata",67,67,0,83,83,0
9,16,2018,19,0,8,"Braga",7,"Rua Nova Santa Cruz",44,44,0,39,39,0
9,16,2018,19,0,8,"Braga",8,"Rua Costa Gomes",0,41,41,-1,42,-43
9,16,2018,20,0,8,"Braga",1,"Avenida da Liberdade",25,25,0,124,124,0
9,16,2018,20,0,8,"Braga",2,"Avenida Central",25,25,0,124,124,0
9,16,2018,20,0,8,"Braga",3,"Rua de Caires",36,36,0,37,37,0
9,16,2018,20,0,8,"Braga",4,"N14 Bosch",47,47,0,48,48,0
9,16,2018,20,0,8,"Braga",5,"Avenida João Paulo II",39,39,0,9,9,0
9,16,2018,20,0,8,"Braga",6,"Avenida Padre Júlio Fragata",67,67,0,83,83,0
9,16,2018,20,0,8,"Braga",7,"Rua Nova Santa Cruz",44,44,0,39,39,0
9,16,2018,20,0,8,"Braga",8,"Rua Costa Gomes",0,41,41,-1,42,-43
9,16,2018,21,0,8,"Braga",1,"Avenida da Liberdade",25,25,0,124,124,0
9,16,2018,21,0,8,"Braga",2,"Avenida Central",25,25,0,124,124,0
9,16,2018,21,0,8,"Braga",3,"Rua de Caires",36,36,0,37,37,0
9,16,2018,21,0,8,"Braga",4,"N14 Bosch",47,47,0,48,48,0
9,16,2018,21,0,8,"Braga",5,"Avenida João Paulo II",39,39,0,9,9,0
9,16,2018,21,0,8,"Braga",6,"Avenida Padre Júlio Fragata",53,67,14,105,83,22
9,16,2018,21,0,8,"Braga",7,"Rua Nova Santa Cruz",44,44,0,39,39,0
9,16,2018,21,0,8,"Braga",8,"Rua Costa Gomes",0,41,41,-1,42,-43
9,16,2018,22,0,8,"Braga",1,"Avenida da Liberdade",25,25,0,124,124,0
9,16,2018,22,0,8,"Braga",2,"Avenida Central",25,25,0,124,124,0
9,16,2018,22,0,8,"Braga",3,"Rua de Caires",36,36,0,37,37,0
9,16,2018,22,0,8,"Braga",4,"N14 Bosch",47,47,0,48,48,0
9,16,2018,22,0,8,"Braga",5,"Avenida João Paulo II",39,39,0,9,9,0
9,16,2018,22,0,8,"Braga",6,"Avenida Padre Júlio Fragata",67,67,0,83,83,0
9,16,2018,22,0,8,"Braga",7,"Rua Nova Santa Cruz",44,44,0,39,39,0
9,16,2018,22,0,8,"Braga",8,"Rua Costa Gomes",0,41,41,-1,42,-43
9,16,2018,23,0,8,"Braga",1,"Avenida da Liberdade",25,25,0,124,124,0
9,16,2018,23,0,8,"Braga",2,"Avenida Central",25,25,0,124,124,0
9,16,2018,23,0,8,"Braga",3,"Rua de Caires",36,36,0,37,37,0
9,16,2018,23,0,8,"Braga",4,"N14 Bosch",47,47,0,48,48,0
9,16,2018,23,0,8,"Braga",5,"Avenida João Paulo II",39,39,0,9,9,0
9,16,2018,23,0,8,"Braga",6,"Avenida Padre Júlio Fragata",67,67,0,83,83,0
9,16,2018,23,0,8,"Braga",7,"Rua Nova Santa Cruz",44,44,0,39,39,0
9,16,2018,23,0,8,"Braga",8,"Rua Costa Gomes",0,41,41,-1,42,-43
9,17,2018,0,0,2,"Braga",1,"Avenida da Liberdade",25,25,0,124,124,0
9,17,2018,0,0,2,"Braga",2,"Avenida Central",25,25,0,124,124,0
9,17,2018,0,0,2,"Braga",3,"Rua de Caires",36,36,0,37,37,0
9,17,2018,0,0,2,"Braga",4,"N14 Bosch",47,47,0,48,48,0
9,17,2018,0,0,2,"Braga",5,"Avenida João Paulo II",39,39,0,9,9,0
9,17,2018,0,0,2,"Braga",6,"Avenida Padre Júlio Fragata",48,67,19,116,83,33
9,17,2018,0,0,2,"Braga",7,"Rua Nova Santa Cruz",44,44,0,39,39,0
9,17,2018,0,0,2,"Braga",8,"Rua Costa Gomes",0,41,41,-1,42,-43
9,17,2018,1,0,2,"Braga",1,"Avenida da Liberdade",25,25,0,124,124,0
9,17,2018,1,0,2,"Braga",2,"Avenida Central",25,25,0,124,124,0
9,17,2018,1,0,2,"Braga",3,"Rua de Caires",36,36,0,37,37,0
9,17,2018,1,0,2,"Braga",4,"N14 Bosch",47,47,0,48,48,0
9,17,2018,1,0,2,"Braga",5,"Avenida João Paulo II",39,39,0,9,9,0
9,17,2018,1,0,2,"Braga",6,"Avenida Padre Júlio Fragata",67,67,0,83,83,0
9,17,2018,1,0,2,"Braga",7,"Rua Nova Santa Cruz",44,44,0,39,39,0
9,17,2018,1,0,2,"Braga",8,"Rua Costa Gomes",0,41,41,-1,42,-43
9,17,2018,2,0,2,"Braga",1,"Avenida da Liberdade",25,25,0,124,124,0
9,17,2018,2,0,2,"Braga",2,"Avenida Central",25,25,0,124,124,0
9,17,2018,2,0,2,"Braga",3,"Rua de Caires",36,36,0,37,37,0
9,17,2018,2,0,2,"Braga",4,"N14 Bosch",47,47,0,48,48,0
9,17,2018,2,0,2,"Braga",5,"Avenida João Paulo II",39,39,0,9,9,0
9,17,2018,2,0,2,"Braga",6,"Avenida Padre Júlio Fragata",67,67,0,83,83,0
9,17,2018,2,0,2,"Braga",7,"Rua Nova Santa Cruz",44,44,0,39,39,0
9,17,2018,2,0,2,"Braga",8,"Rua Costa Gomes",0,41,41,-1,42,-43
9,17,2018,3,0,2,"Braga",1,"Avenida da Liberdade",25,25,0,124,124,0
9,17,2018,3,0,2,"Braga",2,"Avenida Central",25,25,0,124,124,0
9,17,2018,3,0,2,"Braga",3,"Rua de Caires",36,36,0,37,37,0
9,17,2018,3,0,2,"Braga",4,"N14 Bosch",47,47,0,48,48,0
9,17,2018,3,0,2,"Braga",5,"Avenida João Paulo II",39,39,0,9,9,0
9,17,2018,3,0,2,"Braga",6,"Avenida Padre Júlio Fragata",67,67,0,83,83,0
9,17,2018,3,0,2,"Braga",7,"Rua Nova Santa Cruz",44,44,0,39,39,0
9,17,2018,3,0,2,"Braga",8,"Rua Costa Gomes",0,41,41,-1,42,-43
9,17,2018,4,0,2,"Braga",1,"Avenida da Liberdade",25,25,0,124,124,0
9,17,2018,4,0,2,"Braga",2,"Avenida Central",25,25,0,124,124,0
9,17,2018,4,0,2,"Braga",3,"Rua de Caires",36,36,0,37,37,0
9,17,2018,4,0,2,"Braga",4,"N14 Bosch",47,47,0,48,48,0
9,17,2018,4,0,2,"Braga",5,"Avenida João Paulo II",39,39,0,9,9,0
9,17,2018,4,0,2,"Braga",6,"Avenida Padre Júlio Fragata",67,67,0,83,83,0
9,17,2018,4,0,2,"Braga",7,"Rua Nova Santa Cruz",44,44,0,39,39,0
9,17,2018,4,0,2,"Braga",8,"Rua Costa Gomes",0,41,41,-1,42,-43
9,17,2018,5,0,2,"Braga",1,"Avenida da Liberdade",25,25,0,124,124,0
9,17,2018,5,0,2,"Braga",2,"Avenida Central",25,25,0,124,124,0
9,17,2018,5,0,2,"Braga",3,"Rua de Caires",36,36,0,37,37,0
9,17,2018,5,0,2,"Braga",4,"N14 Bosch",47,47,0,48,48,0
9,17,2018,5,0,2,"Braga",5,"Avenida João Paulo II",39,39,0,9,9,0
9,17,2018,5,0,2,"Braga",6,"Avenida Padre Júlio Fragata",67,67,0,83,83,0
9,17,2018,5,0,2,"Braga",7,"Rua Nova Santa Cruz",44,44,0,39,39,0
9,17,2018,5,0,2,"Braga",8,"Rua Costa Gomes",0,41,41,-1,42,-43
9,17,2018,6,0,2,"Braga",1,"Avenida da Liberdade",25,25,0,124,124,0
9,17,2018,6,0,2,"Braga",2,"Avenida Central",25,25,0,124,124,0
9,17,2018,6,0,2,"Braga",3,"Rua de Caires",36,36,0,37,37,0
9,17,2018,6,0,2,"Braga",4,"N14 Bosch",47,47,0,48,48,0
9,17,2018,6,0,2,"Braga",5,"Avenida João Paulo II",39,39,0,9,9,0
9,17,2018,6,0,2,"Braga",6,"Avenida Padre Júlio Fragata",67,67,0,83,83,0
9,17,2018,6,0,2,"Braga",7,"Rua Nova Santa Cruz",44,44,0,39,39,0
9,17,2018,6,0,2,"Braga",8,"Rua Costa Gomes",0,41,41,-1,42,-43
9,17,2018,7,0,2,"Braga",1,"Avenida da Liberdade",25,25,0,124,124,0
9,17,2018,7,0,2,"Braga",2,"Avenida Central",25,25,0,124,124,0
9,17,2018,7,0,2,"Braga",3,"Rua de Caires",36,36,0,37,37,0
9,17,2018,7,0,2,"Braga",4,"N14 Bosch",32,47,15,70,48,22
9,17,2018,7,0,2,"Braga",5,"Avenida João Paulo II",26,39,13,13,9,4
9,17,2018,7,0,2,"Braga",6,"Avenida Padre Júlio Fragata",67,67,0,83,83,0
9,17,2018,7,0,2,"Braga",7,"Rua Nova Santa Cruz",8,44,36,216,39,177
9,17,2018,7,0,2,"Braga",8,"Rua Costa Gomes",0,41,41,-1,42,-43
9,17,2018,8,0,2,"Braga",1,"Avenida da Liberdade",16,25,9,194,124,70
9,17,2018,8,0,2,"Braga",2,"Avenida Central",16,25,9,194,124,70
9,17,2018,8,0,2,"Braga",3,"Rua de Caires",36,36,0,37,37,0
9,17,2018,8,0,2,"Braga",4,"N14 Bosch",25,47,22,90,48,42
9,17,2018,8,0,2,"Braga",5,"Avenida João Paulo II",20,39,19,17,9,8
9,17,2018,8,0,2,"Braga",6,"Avenida Padre Júlio Fragata",34,67,33,164,83,81
9,17,2018,8,0,2,"Braga",7,"Rua Nova Santa Cruz",2,44,42,864,39,825
9,17,2018,8,0,2,"Braga",8,"Rua Costa Gomes",0,41,41,-1,42,-43
9,17,2018,9,0,2,"Braga",1,"Avenida da Liberdade",17,25,8,182,124,58
9,17,2018,9,0,2,"Braga",2,"Avenida Central",17,25,8,182,124,58
9,17,2018,9,0,2,"Braga",3,"Rua de Caires",25,36,11,54,37,17
9,17,2018,9,0,2,"Braga",4,"N14 Bosch",35,47,12,64,48,16
9,17,2018,9,0,2,"Braga",5,"Avenida João Paulo II",28,39,11,12,9,3
9,17,2018,9,0,2,"Braga",6,"Avenida Padre Júlio Fragata",67,67,0,83,83,0
9,17,2018,9,0,2,"Braga",7,"Rua Nova Santa Cruz",26,44,18,66,39,27
9,17,2018,9,0,2,"Braga",8,"Rua Costa Gomes",0,41,41,-1,42,-43
9,17,2018,10,0,2,"Braga",1,"Avenida da Liberdade",18,25,7,172,124,48
9,17,2018,10,0,2,"Braga",2,"Avenida Central",18,25,7,172,124,48
9,17,2018,10,0,2,"Braga",3,"Rua de Caires",19,36,17,71,37,34
9,17,2018,10,0,2,"Braga",4,"N14 Bosch",29,47,18,77,48,29
9,17,2018,10,0,2,"Braga",5,"Avenida João Paulo II",39,39,0,9,9,0
9,17,2018,10,0,2,"Braga",6,"Avenida Padre Júlio Fragata",67,67,0,83,83,0
9,17,2018,10,0,2,"Braga",7,"Rua Nova Santa Cruz",44,44,0,39,39,0
9,17,2018,10,0,2,"Braga",8,"Rua Costa Gomes",0,41,41,-1,42,-43
9,17,2018,11,0,2,"Braga",1,"Avenida da Liberdade",25,25,0,124,124,0
9,17,2018,11,0,2,"Braga",2,"Avenida Central",25,25,0,124,124,0
9,17,2018,11,0,2,"Braga",3,"Rua de Caires",26,36,10,52,37,15
9,17,2018,11,0,2,"Braga",4,"N14 Bosch",27,47,20,83,48,35
9,17,2018,11,0,2,"Braga",5,"Avenida João Paulo II",39,39,0,9,9,0
9,17,2018,11,0,2,"Braga",6,"Avenida Padre Júlio Fragata",67,67,0,83,83,0
9,17,2018,11,0,2,"Braga",7,"Rua Nova Santa Cruz",44,44,0,39,39,0
9,17,2018,11,0,2,"Braga",8,"Rua Costa Gomes",0,41,41,-1,42,-43
9,17,2018,12,0,2,"Braga",1,"Avenida da Liberdade",25,25,0,124,124,0
9,17,2018,12,0,2,"Braga",2,"Avenida Central",25,25,0,124,124,0
9,17,2018,12,0,2,"Braga",3,"Rua de Caires",36,36,0,37,37,0
9,17,2018,12,0,2,"Braga",4,"N14 Bosch",22,47,25,102,48,54
9,17,2018,12,0,2,"Braga",5,"Avenida João Paulo II",39,39,0,9,9,0
9,17,2018,12,0,2,"Braga",6,"Avenida Padre Júlio Fragata",67,67,0,83,83,0
9,17,2018,12,0,2,"Braga",7,"Rua Nova Santa Cruz",44,44,0,39,39,0
9,17,2018,12,0,2,"Braga",8,"Rua Costa Gomes",0,41,41,-1,42,-43
9,17,2018,13,0,2,"Braga",1,"Avenida da Liberdade",25,25,0,124,124,0
9,17,2018,13,0,2,"Braga",2,"Avenida Central",25,25,0,124,124,0
9,17,2018,13,0,2,"Braga",3,"Rua de Caires",23,36,13,59,37,22
9,17,2018,13,0,2,"Braga",4,"N14 Bosch",19,47,28,118,48,70
9,17,2018,13,0,2,"Braga",5,"Avenida João Paulo II",39,39,0,9,9,0
9,17,2018,13,0,2,"Braga",6,"Avenida Padre Júlio Fragata",67,67,0,83,83,0
9,17,2018,13,0,2,"Braga",7,"Rua Nova Santa Cruz",12,44,32,144,39,105
9,17,2018,13,0,2,"Braga",8,"Rua Costa Gomes",0,41,41,-1,42,-43
9,17,2018,14,0,2,"Braga",1,"Avenida da Liberdade",19,25,6,163,124,39
9,17,2018,14,0,2,"Braga",2,"Avenida Central",19,25,6,163,124,39
9,17,2018,14,0,2,"Braga",3,"Rua de Caires",36,36,0,37,37,0
9,17,2018,14,0,2,"Braga",4,"N14 Bosch",14,47,33,160,48,112
9,17,2018,14,0,2,"Braga",5,"Avenida João Paulo II",39,39,0,9,9,0
9,17,2018,14,0,2,"Braga",6,"Avenida Padre Júlio Fragata",67,67,0,83,83,0
9,17,2018,14,0,2,"Braga",7,"Rua Nova Santa Cruz",22,44,22,79,39,40
9,17,2018,14,0,2,"Braga",8,"Rua Costa Gomes",0,41,41,-1,42,-43
9,17,2018,15,0,2,"Braga",1,"Avenida da Liberdade",17,25,8,182,124,58
9,17,2018,15,0,2,"Braga",2,"Avenida Central",17,25,8,182,124,58
9,17,2018,15,0,2,"Braga",3,"Rua de Caires",36,36,0,37,37,0
9,17,2018,15,0,2,"Braga",4,"N14 Bosch",22,47,25,102,48,54
9,17,2018,15,0,2,"Braga",5,"Avenida João Paulo II",39,39,0,9,9,0
9,17,2018,15,0,2,"Braga",6,"Avenida Padre Júlio Fragata",67,67,0,83,83,0
9,17,2018,15,0,2,"Braga",7,"Rua Nova Santa Cruz",25,44,19,69,39,30
9,17,2018,15,0,2,"Braga",8,"Rua Costa Gomes",0,41,41,-1,42,-43
9,17,2018,16,0,2,"Braga",1,"Avenida da Liberdade",15,25,10,207,124,83
9,17,2018,16,0,2,"Braga",2,"Avenida Central",15,25,10,207,124,83
9,17,2018,16,0,2,"Braga",3,"Rua de Caires",23,36,13,59,37,22
9,17,2018,16,0,2,"Braga",4,"N14 Bosch",47,47,0,48,48,0
9,17,2018,16,0,2,"Braga",5,"Avenida João Paulo II",39,39,0,9,9,0
9,17,2018,16,0,2,"Braga",6,"Avenida Padre Júlio Fragata",67,67,0,83,83,0
9,17,2018,16,0,2,"Braga",7,"Rua Nova Santa Cruz",14,44,30,123,39,84
9,17,2018,16,0,2,"Braga",8,"Rua Costa Gomes",0,41,41,-1,42,-43
9,17,2018,17,0,2,"Braga",1,"Avenida da Liberdade",16,25,9,194,124,70
9,17,2018,17,0,2,"Braga",2,"Avenida Central",16,25,9,194,124,70
9,17,2018,17,0,2,"Braga",3,"Rua de Caires",27,36,9,50,37,13
9,17,2018,17,0,2,"Braga",4,"N14 Bosch",15,47,32,150,48,102
9,17,2018,17,0,2,"Braga",5,"Avenida João Paulo II",28,39,11,12,9,3
9,17,2018,17,0,2,"Braga",6,"Avenida Padre Júlio Fragata",35,67,32,159,83,76
9,17,2018,17,0,2,"Braga",7,"Rua Nova Santa Cruz",31,44,13,56,39,17
9,17,2018,17,0,2,"Braga",8,"Rua Costa Gomes",0,41,41,-1,42,-43
9,17,2018,18,0,2,"Braga",1,"Avenida da Liberdade",14,25,11,221,124,97
9,17,2018,18,0,2,"Braga",2,"Avenida Central",14,25,11,221,124,97
9,17,2018,18,0,2,"Braga",3,"Rua de Caires",36,36,0,37,37,0
9,17,2018,18,0,2,"Braga",4,"N14 Bosch",11,47,36,204,48,156
9,17,2018,18,0,2,"Braga",5,"Avenida João Paulo II",39,39,0,9,9,0
9,17,2018,18,0,2,"Braga",6,"Avenida Padre Júlio Fragata",21,67,46,265,83,182
9,17,2018,18,0,2,"Braga",7,"Rua Nova Santa Cruz",11,44,33,157,39,118
9,17,2018,18,0,2,"Braga",8,"Rua Costa Gomes",0,41,41,-1,42,-43
9,17,2018,19,0,2,"Braga",1,"Avenida da Liberdade",25,25,0,124,124,0
9,17,2018,19,0,2,"Braga",2,"Avenida Central",25,25,0,124,124,0
9,17,2018,19,0,2,"Braga",3,"Rua de Caires",36,36,0,37,37,0
9,17,2018,19,0,2,"Braga",4,"N14 Bosch",47,47,0,48,48,0
9,17,2018,19,0,2,"Braga",5,"Avenida João Paulo II",39,39,0,9,9,0
9,17,2018,19,0,2,"Braga",6,"Avenida Padre Júlio Fragata",67,67,0,83,83,0
9,17,2018,19,0,2,"Braga",7,"Rua Nova Santa Cruz",12,44,32,144,39,105
9,17,2018,19,0,2,"Braga",8,"Rua Costa Gomes",0,41,41,-1,42,-43
9,17,2018,20,0,2,"Braga",1,"Avenida da Liberdade",19,25,6,163,124,39
9,17,2018,20,0,2,"Braga",2,"Avenida Central",19,25,6,163,124,39
9,17,2018,20,0,2,"Braga",3,"Rua de Caires",36,36,0,37,37,0
9,17,2018,20,0,2,"Braga",4,"N14 Bosch",47,47,0,48,48,0
9,17,2018,20,0,2,"Braga",5,"Avenida João Paulo II",39,39,0,9,9,0
9,17,2018,20,0,2,"Braga",6,"Avenida Padre Júlio Fragata",67,67,0,83,83,0
9,17,2018,20,0,2,"Braga",7,"Rua Nova Santa Cruz",25,44,19,69,39,30
9,17,2018,20,0,2,"Braga",8,"Rua Costa Gomes",0,41,41,-1,42,-43
9,17,2018,21,0,2,"Braga",1,"Avenida da Liberdade",25,25,0,124,124,0
9,17,2018,21,0,2,"Braga",2,"Avenida Central",25,25,0,124,124,0
9,17,2018,21,0,2,"Braga",3,"Rua de Caires",36,36,0,37,37,0
9,17,2018,21,0,2,"Braga",4,"N14 Bosch",47,47,0,48,48,0
9,17,2018,21,0,2,"Braga",5,"Avenida João Paulo II",39,39,0,9,9,0
9,17,2018,21,0,2,"Braga",6,"Avenida Padre Júlio Fragata",67,67,0,83,83,0
9,17,2018,21,0,2,"Braga",7,"Rua Nova Santa Cruz",26,44,18,66,39,27
9,17,2018,21,0,2,"Braga",8,"Rua Costa Gomes",0,41,41,-1,42,-43
9,17,2018,22,0,2,"Braga",1,"Avenida da Liberdade",25,25,0,124,124,0
9,17,2018,22,0,2,"Braga",2,"Avenida Central",25,25,0,124,124,0
9,17,2018,22,0,2,"Braga",3,"Rua de Caires",36,36,0,37,37,0
9,17,2018,22,0,2,"Braga",4,"N14 Bosch",47,47,0,48,48,0
9,17,2018,22,0,2,"Braga",5,"Avenida João Paulo II",39,39,0,9,9,0
9,17,2018,22,0,2,"Braga",6,"Avenida Padre Júlio Fragata",67,67,0,83,83,0
9,17,2018,22,0,2,"Braga",7,"Rua Nova Santa Cruz",44,44,0,39,39,0
9,17,2018,22,0,2,"Braga",8,"Rua Costa Gomes",0,41,41,-1,42,-43
9,17,2018,23,0,2,"Braga",1,"Avenida da Liberdade",25,25,0,124,124,0
9,17,2018,23,0,2,"Braga",2,"Avenida Central",25,25,0,124,124,0
9,17,2018,23,0,2,"Braga",3,"Rua de Caires",36,36,0,37,37,0
9,17,2018,23,0,2,"Braga",4,"N14 Bosch",47,47,0,48,48,0
9,17,2018,23,0,2,"Braga",5,"Avenida João Paulo II",39,39,0,9,9,0
9,17,2018,23,0,2,"Braga",6,"Avenida Padre Júlio Fragata",67,67,0,83,83,0
9,17,2018,23,0,2,"Braga",7,"Rua Nova Santa Cruz",44,44,0,39,39,0
9,17,2018,23,0,2,"Braga",8,"Rua Costa Gomes",0,41,41,-1,42,-43
9,18,2018,0,0,3,"Braga",1,"Avenida da Liberdade",25,25,0,124,124,0
9,18,2018,0,0,3,"Braga",2,"Avenida Central",25,25,0,124,124,0
9,18,2018,0,0,3,"Braga",3,"Rua de Caires",36,36,0,37,37,0
9,18,2018,0,0,3,"Braga",4,"N14 Bosch",47,47,0,48,48,0
9,18,2018,0,0,3,"Braga",5,"Avenida João Paulo II",39,39,0,9,9,0
9,18,2018,0,0,3,"Braga",6,"Avenida Padre Júlio Fragata",67,67,0,83,83,0
9,18,2018,0,0,3,"Braga",7,"Rua Nova Santa Cruz",44,44,0,39,39,0
9,18,2018,0,0,3,"Braga",8,"Rua Costa Gomes",0,41,41,-1,42,-43
9,18,2018,1,0,3,"Braga",1,"Avenida da Liberdade",25,25,0,124,124,0
9,18,2018,1,0,3,"Braga",2,"Avenida Central",25,25,0,124,124,0
9,18,2018,1,0,3,"Braga",3,"Rua de Caires",36,36,0,37,37,0
9,18,2018,1,0,3,"Braga",4,"N14 Bosch",47,47,0,48,48,0
9,18,2018,1,0,3,"Braga",5,"Avenida João Paulo II",39,39,0,9,9,0
9,18,2018,1,0,3,"Braga",6,"Avenida Padre Júlio Fragata",67,67,0,83,83,0
9,18,2018,1,0,3,"Braga",7,"Rua Nova Santa Cruz",44,44,0,39,39,0
9,18,2018,1,0,3,"Braga",8,"Rua Costa Gomes",0,41,41,-1,42,-43
9,18,2018,2,0,3,"Braga",1,"Avenida da Liberdade",25,25,0,124,124,0
9,18,2018,2,0,3,"Braga",2,"Avenida Central",25,25,0,124,124,0
9,18,2018,2,0,3,"Braga",3,"Rua de Caires",36,36,0,37,37,0
9,18,2018,2,0,3,"Braga",4,"N14 Bosch",47,47,0,48,48,0
9,18,2018,2,0,3,"Braga",5,"Avenida João Paulo II",39,39,0,9,9,0
9,18,2018,2,0,3,"Braga",6,"Avenida Padre Júlio Fragata",67,67,0,83,83,0
9,18,2018,2,0,3,"Braga",7,"Rua Nova Santa Cruz",44,44,0,39,39,0
9,18,2018,2,0,3,"Braga",8,"Rua Costa Gomes",0,41,41,-1,42,-43
9,18,2018,3,0,3,"Braga",1,"Avenida da Liberdade",25,25,0,124,124,0
9,18,2018,3,0,3,"Braga",2,"Avenida Central",25,25,0,124,124,0
9,18,2018,3,0,3,"Braga",3,"Rua de Caires",36,36,0,37,37,0
9,18,2018,3,0,3,"Braga",4,"N14 Bosch",47,47,0,48,48,0
9,18,2018,3,0,3,"Braga",5,"Avenida João Paulo II",39,39,0,9,9,0
9,18,2018,3,0,3,"Braga",6,"Avenida Padre Júlio Fragata",67,67,0,83,83,0
9,18,2018,3,0,3,"Braga",7,"Rua Nova Santa Cruz",44,44,0,39,39,0
9,18,2018,3,0,3,"Braga",8,"Rua Costa Gomes",0,41,41,-1,42,-43
9,18,2018,4,0,3,"Braga",1,"Avenida da Liberdade",25,25,0,124,124,0
9,18,2018,4,0,3,"Braga",2,"Avenida Central",25,25,0,124,124,0
9,18,2018,4,0,3,"Braga",3,"Rua de Caires",36,36,0,37,37,0
9,18,2018,4,0,3,"Braga",4,"N14 Bosch",47,47,0,48,48,0
9,18,2018,4,0,3,"Braga",5,"Avenida João Paulo II",39,39,0,9,9,0
9,18,2018,4,0,3,"Braga",6,"Avenida Padre Júlio Fragata",67,67,0,83,83,0
9,18,2018,4,0,3,"Braga",7,"Rua Nova Santa Cruz",44,44,0,39,39,0
9,18,2018,4,0,3,"Braga",8,"Rua Costa Gomes",0,41,41,-1,42,-43
9,18,2018,5,0,3,"Braga",1,"Avenida da Liberdade",25,25,0,124,124,0
9,18,2018,5,0,3,"Braga",2,"Avenida Central",25,25,0,124,124,0
9,18,2018,5,0,3,"Braga",3,"Rua de Caires",36,36,0,37,37,0
9,18,2018,5,0,3,"Braga",4,"N14 Bosch",47,47,0,48,48,0
9,18,2018,5,0,3,"Braga",5,"Avenida João Paulo II",39,39,0,9,9,0
9,18,2018,5,0,3,"Braga",6,"Avenida Padre Júlio Fragata",67,67,0,83,83,0
9,18,2018,5,0,3,"Braga",7,"Rua Nova Santa Cruz",44,44,0,39,39,0
9,18,2018,5,0,3,"Braga",8,"Rua Costa Gomes",0,41,41,-1,42,-43
9,18,2018,6,0,3,"Braga",1,"Avenida da Liberdade",25,25,0,124,124,0
9,18,2018,6,0,3,"Braga",2,"Avenida Central",25,25,0,124,124,0
9,18,2018,6,0,3,"Braga",3,"Rua de Caires",36,36,0,37,37,0
9,18,2018,6,0,3,"Braga",4,"N14 Bosch",47,47,0,48,48,0
9,18,2018,6,0,3,"Braga",5,"Avenida João Paulo II",39,39,0,9,9,0
9,18,2018,6,0,3,"Braga",6,"Avenida Padre Júlio Fragata",67,67,0,83,83,0
9,18,2018,6,0,3,"Braga",7,"Rua Nova Santa Cruz",34,44,10,51,39,12
9,18,2018,6,0,3,"Braga",8,"Rua Costa Gomes",0,41,41,-1,42,-43
9,18,2018,7,0,3,"Braga",1,"Avenida da Liberdade",25,25,0,124,124,0
9,18,2018,7,0,3,"Braga",2,"Avenida Central",25,25,0,124,124,0
9,18,2018,7,0,3,"Braga",3,"Rua de Caires",25,36,11,54,37,17
9,18,2018,7,0,3,"Braga",4,"N14 Bosch",35,47,12,64,48,16
9,18,2018,7,0,3,"Braga",5,"Avenida João Paulo II",39,39,0,9,9,0
9,18,2018,7,0,3,"Braga",6,"Avenida Padre Júlio Fragata",67,67,0,83,83,0
9,18,2018,7,0,3,"Braga",7,"Rua Nova Santa Cruz",44,44,0,39,39,0
9,18,2018,7,0,3,"Braga",8,"Rua Costa Gomes",0,41,41,-1,42,-43
9,18,2018,8,0,3,"Braga",1,"Avenida da Liberdade",25,25,0,124,124,0
9,18,2018,8,0,3,"Braga",2,"Avenida Central",25,25,0,124,124,0
9,18,2018,8,0,3,"Braga",3,"Rua de Caires",20,36,16,67,37,30
9,18,2018,8,0,3,"Braga",4,"N14 Bosch",24,47,23,94,48,46
9,18,2018,8,0,3,"Braga",5,"Avenida João Paulo II",29,39,10,12,9,3
9,18,2018,8,0,3,"Braga",6,"Avenida Padre Júlio Fragata",38,67,29,147,83,64
9,18,2018,8,0,3,"Braga",7,"Rua Nova Santa Cruz",3,44,41,576,39,537
9,18,2018,8,0,3,"Braga",8,"Rua Costa Gomes",0,41,41,-1,42,-43
9,18,2018,9,0,3,"Braga",1,"Avenida da Liberdade",25,25,0,124,124,0
9,18,2018,9,0,3,"Braga",2,"Avenida Central",25,25,0,124,124,0
9,18,2018,9,0,3,"Braga",3,"Rua de Caires",25,36,11,54,37,17
9,18,2018,9,0,3,"Braga",4,"N14 Bosch",34,47,13,66,48,18
9,18,2018,9,0,3,"Braga",5,"Avenida João Paulo II",39,39,0,9,9,0
9,18,2018,9,0,3,"Braga",6,"Avenida Padre Júlio Fragata",67,67,0,83,83,0
9,18,2018,9,0,3,"Braga",7,"Rua Nova Santa Cruz",24,44,20,72,39,33
9,18,2018,9,0,3,"Braga",8,"Rua Costa Gomes",0,41,41,-1,42,-43
9,18,2018,10,0,3,"Braga",1,"Avenida da Liberdade",15,25,10,207,124,83
9,18,2018,10,0,3,"Braga",2,"Avenida Central",15,25,10,207,124,83
9,18,2018,10,0,3,"Braga",3,"Rua de Caires",36,36,0,37,37,0
9,18,2018,10,0,3,"Braga",4,"N14 Bosch",47,47,0,48,48,0
9,18,2018,10,0,3,"Braga",5,"Avenida João Paulo II",39,39,0,9,9,0
9,18,2018,10,0,3,"Braga",6,"Avenida Padre Júlio Fragata",67,67,0,83,83,0
9,18,2018,10,0,3,"Braga",7,"Rua Nova Santa Cruz",28,44,16,62,39,23
9,18,2018,10,0,3,"Braga",8,"Rua Costa Gomes",0,41,41,-1,42,-43
9,18,2018,11,0,3,"Braga",1,"Avenida da Liberdade",25,25,0,124,124,0
9,18,2018,11,0,3,"Braga",2,"Avenida Central",25,25,0,124,124,0
9,18,2018,11,0,3,"Braga",3,"Rua de Caires",26,36,10,52,37,15
9,18,2018,11,0,3,"Braga",4,"N14 Bosch",47,47,0,48,48,0
9,18,2018,11,0,3,"Braga",5,"Avenida João Paulo II",39,39,0,9,9,0
9,18,2018,11,0,3,"Braga",6,"Avenida Padre Júlio Fragata",67,67,0,83,83,0
9,18,2018,11,0,3,"Braga",7,"Rua Nova Santa Cruz",44,44,0,39,39,0
9,18,2018,11,0,3,"Braga",8,"Rua Costa Gomes",0,41,41,-1,42,-43
9,18,2018,12,0,3,"Braga",1,"Avenida da Liberdade",25,25,0,124,124,0
9,18,2018,12,0,3,"Braga",2,"Avenida Central",25,25,0,124,124,0
9,18,2018,12,0,3,"Braga",3,"Rua de Caires",36,36,0,37,37,0
9,18,2018,12,0,3,"Braga",4,"N14 Bosch",30,47,17,75,48,27
9,18,2018,12,0,3,"Braga",5,"Avenida João Paulo II",39,39,0,9,9,0
9,18,2018,12,0,3,"Braga",6,"Avenida Padre Júlio Fragata",67,67,0,83,83,0
9,18,2018,12,0,3,"Braga",7,"Rua Nova Santa Cruz",27,44,17,64,39,25
9,18,2018,12,0,3,"Braga",8,"Rua Costa Gomes",0,41,41,-1,42,-43
9,18,2018,13,0,3,"Braga",1,"Avenida da Liberdade",19,25,6,163,124,39
9,18,2018,13,0,3,"Braga",2,"Avenida Central",19,25,6,163,124,39
9,18,2018,13,0,3,"Braga",3,"Rua de Caires",36,36,0,37,37,0
9,18,2018,13,0,3,"Braga",4,"N14 Bosch",25,47,22,90,48,42
9,18,2018,13,0,3,"Braga",5,"Avenida João Paulo II",27,39,12,13,9,4
9,18,2018,13,0,3,"Braga",6,"Avenida Padre Júlio Fragata",67,67,0,83,83,0
9,18,2018,13,0,3,"Braga",7,"Rua Nova Santa Cruz",7,44,37,247,39,208
9,18,2018,13,0,3,"Braga",8,"Rua Costa Gomes",0,41,41,-1,42,-43
9,18,2018,14,0,3,"Braga",1,"Avenida da Liberdade",18,25,7,172,124,48
9,18,2018,14,0,3,"Braga",2,"Avenida Central",18,25,7,172,124,48
9,18,2018,14,0,3,"Braga",3,"Rua de Caires",36,36,0,37,37,0
9,18,2018,14,0,3,"Braga",4,"N14 Bosch",47,47,0,48,48,0
9,18,2018,14,0,3,"Braga",5,"Avenida João Paulo II",39,39,0,9,9,0
9,18,2018,14,0,3,"Braga",6,"Avenida Padre Júlio Fragata",67,67,0,83,83,0
9,18,2018,14,0,3,"Braga",7,"Rua Nova Santa Cruz",30,44,14,58,39,19
9,18,2018,14,0,3,"Braga",8,"Rua Costa Gomes",0,41,41,-1,42,-43
9,18,2018,15,0,3,"Braga",1,"Avenida da Liberdade",25,25,0,124,124,0
9,18,2018,15,0,3,"Braga",2,"Avenida Central",25,25,0,124,124,0
9,18,2018,15,0,3,"Braga",3,"Rua de Caires",36,36,0,37,37,0
9,18,2018,15,0,3,"Braga",4,"N14 Bosch",30,47,17,75,48,27
9,18,2018,15,0,3,"Braga",5,"Avenida João Paulo II",39,39,0,9,9,0
9,18,2018,15,0,3,"Braga",6,"Avenida Padre Júlio Fragata",34,67,33,164,83,81
9,18,2018,15,0,3,"Braga",7,"Rua Nova Santa Cruz",44,44,0,39,39,0
9,18,2018,15,0,3,"Braga",8,"Rua Costa Gomes",0,41,41,-1,42,-43
9,18,2018,16,0,3,"Braga",1,"Avenida da Liberdade",25,25,0,124,124,0
9,18,2018,16,0,3,"Braga",2,"Avenida Central",25,25,0,124,124,0
9,18,2018,16,0,3,"Braga",3,"Rua de Caires",25,36,11,54,37,17
9,18,2018,16,0,3,"Braga",4,"N14 Bosch",34,47,13,66,48,18
9,18,2018,16,0,3,"Braga",5,"Avenida João Paulo II",29,39,10,12,9,3
9,18,2018,16,0,3,"Braga",6,"Avenida Padre Júlio Fragata",67,67,0,83,83,0
9,18,2018,16,0,3,"Braga",7,"Rua Nova Santa Cruz",44,44,0,39,39,0
9,18,2018,16,0,3,"Braga",8,"Rua Costa Gomes",0,41,41,-1,42,-43
9,18,2018,17,0,3,"Braga",1,"Avenida da Liberdade",13,25,12,238,124,114
9,18,2018,17,0,3,"Braga",2,"Avenida Central",13,25,12,238,124,114
9,18,2018,17,0,3,"Braga",3,"Rua de Caires",20,36,16,67,37,30
9,18,2018,17,0,3,"Braga",4,"N14 Bosch",11,47,36,204,48,156
9,18,2018,17,0,3,"Braga",5,"Avenida João Paulo II",39,39,0,9,9,0
9,18,2018,17,0,3,"Braga",6,"Avenida Padre Júlio Fragata",42,67,25,133,83,50
9,18,2018,17,0,3,"Braga",7,"Rua Nova Santa Cruz",15,44,29,115,39,76
9,18,2018,17,0,3,"Braga",8,"Rua Costa Gomes",0,41,41,-1,42,-43
9,18,2018,18,0,3,"Braga",1,"Avenida da Liberdade",15,25,10,207,124,83
9,18,2018,18,0,3,"Braga",2,"Avenida Central",15,25,10,207,124,83
9,18,2018,18,0,3,"Braga",3,"Rua de Caires",36,36,0,37,37,0
9,18,2018,18,0,3,"Braga",4,"N14 Bosch",47,47,0,48,48,0
9,18,2018,18,0,3,"Braga",5,"Avenida João Paulo II",23,39,16,15,9,6
9,18,2018,18,0,3,"Braga",6,"Avenida Padre Júlio Fragata",21,67,46,265,83,182
9,18,2018,18,0,3,"Braga",7,"Rua Nova Santa Cruz",31,44,13,56,39,17
9,18,2018,18,0,3,"Braga",8,"Rua Costa Gomes",0,41,41,-1,42,-43
9,18,2018,19,0,3,"Braga",1,"Avenida da Liberdade",25,25,0,124,124,0
9,18,2018,19,0,3,"Braga",2,"Avenida Central",25,25,0,124,124,0
9,18,2018,19,0,3,"Braga",3,"Rua de Caires",36,36,0,37,37,0
9,18,2018,19,0,3,"Braga",4,"N14 Bosch",31,47,16,72,48,24
9,18,2018,19,0,3,"Braga",5,"Avenida João Paulo II",30,39,9,12,9,3
9,18,2018,19,0,3,"Braga",6,"Avenida Padre Júlio Fragata",67,67,0,83,83,0
9,18,2018,19,0,3,"Braga",7,"Rua Nova Santa Cruz",4,44,40,432,39,393
9,18,2018,19,0,3,"Braga",8,"Rua Costa Gomes",0,41,41,-1,42,-43
9,18,2018,20,0,3,"Braga",1,"Avenida da Liberdade",25,25,0,124,124,0
9,18,2018,20,0,3,"Braga",2,"Avenida Central",25,25,0,124,124,0
9,18,2018,20,0,3,"Braga",3,"Rua de Caires",28,36,8,48,37,11
9,18,2018,20,0,3,"Braga",4,"N14 Bosch",35,47,12,64,48,16
9,18,2018,20,0,3,"Braga",5,"Avenida João Paulo II",39,39,0,9,9,0
9,18,2018,20,0,3,"Braga",6,"Avenida Padre Júlio Fragata",67,67,0,83,83,0
9,18,2018,20,0,3,"Braga",7,"Rua Nova Santa Cruz",44,44,0,39,39,0
9,18,2018,20,0,3,"Braga",8,"Rua Costa Gomes",0,41,41,-1,42,-43
9,18,2018,21,0,3,"Braga",1,"Avenida da Liberdade",25,25,0,124,124,0
9,18,2018,21,0,3,"Braga",2,"Avenida Central",25,25,0,124,124,0
9,18,2018,21,0,3,"Braga",3,"Rua de Caires",36,36,0,37,37,0
9,18,2018,21,0,3,"Braga",4,"N14 Bosch",47,47,0,48,48,0
9,18,2018,21,0,3,"Braga",5,"Avenida João Paulo II",39,39,0,9,9,0
9,18,2018,21,0,3,"Braga",6,"Avenida Padre Júlio Fragata",67,67,0,83,83,0
9,18,2018,21,0,3,"Braga",7,"Rua Nova Santa Cruz",44,44,0,39,39,0
9,18,2018,21,0,3,"Braga",8,"Rua Costa Gomes",0,41,41,-1,42,-43
9,18,2018,22,0,3,"Braga",1,"Avenida da Liberdade",25,25,0,124,124,0
9,18,2018,22,0,3,"Braga",2,"Avenida Central",25,25,0,124,124,0
9,18,2018,22,0,3,"Braga",3,"Rua de Caires",36,36,0,37,37,0
9,18,2018,22,0,3,"Braga",4,"N14 Bosch",47,47,0,48,48,0
9,18,2018,22,0,3,"Braga",5,"Avenida João Paulo II",39,39,0,9,9,0
9,18,2018,22,0,3,"Braga",6,"Avenida Padre Júlio Fragata",67,67,0,83,83,0
9,18,2018,22,0,3,"Braga",7,"Rua Nova Santa Cruz",44,44,0,39,39,0
9,18,2018,22,0,3,"Braga",8,"Rua Costa Gomes",0,41,41,-1,42,-43
9,18,2018,23,0,3,"Braga",1,"Avenida da Liberdade",25,25,0,124,124,0
9,18,2018,23,0,3,"Braga",2,"Avenida Central",25,25,0,124,124,0
9,18,2018,23,0,3,"Braga",3,"Rua de Caires",36,36,0,37,37,0
9,18,2018,23,0,3,"Braga",4,"N14 Bosch",47,47,0,48,48,0
9,18,2018,23,0,3,"Braga",5,"Avenida João Paulo II",39,39,0,9,9,0
9,18,2018,23,0,3,"Braga",6,"Avenida Padre Júlio Fragata",67,67,0,83,83,0
9,18,2018,23,0,3,"Braga",7,"Rua Nova Santa Cruz",44,44,0,39,39,0
9,18,2018,23,0,3,"Braga",8,"Rua Costa Gomes",0,41,41,-1,42,-43
9,19,2018,0,0,4,"Braga",1,"Avenida da Liberdade",25,25,0,124,124,0
9,19,2018,0,0,4,"Braga",2,"Avenida Central",25,25,0,124,124,0
9,19,2018,0,0,4,"Braga",3,"Rua de Caires",36,36,0,37,37,0
9,19,2018,0,0,4,"Braga",4,"N14 Bosch",47,47,0,48,48,0
9,19,2018,0,0,4,"Braga",5,"Avenida João Paulo II",39,39,0,9,9,0
9,19,2018,0,0,4,"Braga",6,"Avenida Padre Júlio Fragata",67,67,0,83,83,0
9,19,2018,0,0,4,"Braga",7,"Rua Nova Santa Cruz",44,44,0,39,39,0
9,19,2018,0,0,4,"Braga",8,"Rua Costa Gomes",0,41,41,-1,42,-43
9,19,2018,1,0,4,"Braga",1,"Avenida da Liberdade",25,25,0,124,124,0
9,19,2018,1,0,4,"Braga",2,"Avenida Central",25,25,0,124,124,0
9,19,2018,1,0,4,"Braga",3,"Rua de Caires",36,36,0,37,37,0
9,19,2018,1,0,4,"Braga",4,"N14 Bosch",47,47,0,48,48,0
9,19,2018,1,0,4,"Braga",5,"Avenida João Paulo II",39,39,0,9,9,0
9,19,2018,1,0,4,"Braga",6,"Avenida Padre Júlio Fragata",67,67,0,83,83,0
9,19,2018,1,0,4,"Braga",7,"Rua Nova Santa Cruz",44,44,0,39,39,0
9,19,2018,1,0,4,"Braga",8,"Rua Costa Gomes",0,41,41,-1,42,-43
9,19,2018,2,0,4,"Braga",1,"Avenida da Liberdade",25,25,0,124,124,0
9,19,2018,2,0,4,"Braga",2,"Avenida Central",25,25,0,124,124,0
9,19,2018,2,0,4,"Braga",3,"Rua de Caires",36,36,0,37,37,0
9,19,2018,2,0,4,"Braga",4,"N14 Bosch",47,47,0,48,48,0
9,19,2018,2,0,4,"Braga",5,"Avenida João Paulo II",30,39,9,12,9,3
9,19,2018,2,0,4,"Braga",6,"Avenida Padre Júlio Fragata",67,67,0,83,83,0
9,19,2018,2,0,4,"Braga",7,"Rua Nova Santa Cruz",44,44,0,39,39,0
9,19,2018,2,0,4,"Braga",8,"Rua Costa Gomes",0,41,41,-1,42,-43
9,19,2018,3,0,4,"Braga",1,"Avenida da Liberdade",25,25,0,124,124,0
9,19,2018,3,0,4,"Braga",2,"Avenida Central",25,25,0,124,124,0
9,19,2018,3,0,4,"Braga",3,"Rua de Caires",36,36,0,37,37,0
9,19,2018,3,0,4,"Braga",4,"N14 Bosch",47,47,0,48,48,0
9,19,2018,3,0,4,"Braga",5,"Avenida João Paulo II",39,39,0,9,9,0
9,19,2018,3,0,4,"Braga",6,"Avenida Padre Júlio Fragata",67,67,0,83,83,0
9,19,2018,3,0,4,"Braga",7,"Rua Nova Santa Cruz",44,44,0,39,39,0
9,19,2018,3,0,4,"Braga",8,"Rua Costa Gomes",0,41,41,-1,42,-43
9,19,2018,4,0,4,"Braga",1,"Avenida da Liberdade",25,25,0,124,124,0
9,19,2018,4,0,4,"Braga",2,"Avenida Central",25,25,0,124,124,0
9,19,2018,4,0,4,"Braga",3,"Rua de Caires",36,36,0,37,37,0
9,19,2018,4,0,4,"Braga",4,"N14 Bosch",47,47,0,48,48,0
9,19,2018,4,0,4,"Braga",5,"Avenida João Paulo II",39,39,0,9,9,0
9,19,2018,4,0,4,"Braga",6,"Avenida Padre Júlio Fragata",67,67,0,83,83,0
9,19,2018,4,0,4,"Braga",7,"Rua Nova Santa Cruz",44,44,0,39,39,0
9,19,2018,4,0,4,"Braga",8,"Rua Costa Gomes",0,41,41,-1,42,-43
9,19,2018,5,0,4,"Braga",1,"Avenida da Liberdade",25,25,0,124,124,0
9,19,2018,5,0,4,"Braga",2,"Avenida Central",25,25,0,124,124,0
9,19,2018,5,0,4,"Braga",3,"Rua de Caires",36,36,0,37,37,0
9,19,2018,5,0,4,"Braga",4,"N14 Bosch",47,47,0,48,48,0
9,19,2018,5,0,4,"Braga",5,"Avenida João Paulo II",39,39,0,9,9,0
9,19,2018,5,0,4,"Braga",6,"Avenida Padre Júlio Fragata",67,67,0,83,83,0
9,19,2018,5,0,4,"Braga",7,"Rua Nova Santa Cruz",44,44,0,39,39,0
9,19,2018,5,0,4,"Braga",8,"Rua Costa Gomes",0,41,41,-1,42,-43
9,19,2018,6,0,4,"Braga",1,"Avenida da Liberdade",25,25,0,124,124,0
9,19,2018,6,0,4,"Braga",2,"Avenida Central",25,25,0,124,124,0
9,19,2018,6,0,4,"Braga",3,"Rua de Caires",36,36,0,37,37,0
9,19,2018,6,0,4,"Braga",4,"N14 Bosch",47,47,0,48,48,0
9,19,2018,6,0,4,"Braga",5,"Avenida João Paulo II",39,39,0,9,9,0
9,19,2018,6,0,4,"Braga",6,"Avenida Padre Júlio Fragata",67,67,0,83,83,0
9,19,2018,6,0,4,"Braga",7,"Rua Nova Santa Cruz",44,44,0,39,39,0
9,19,2018,6,0,4,"Braga",8,"Rua Costa Gomes",0,41,41,-1,42,-43
9,19,2018,7,0,4,"Braga",1,"Avenida da Liberdade",25,25,0,124,124,0
9,19,2018,7,0,4,"Braga",2,"Avenida Central",25,25,0,124,124,0
9,19,2018,7,0,4,"Braga",3,"Rua de Caires",14,36,22,96,37,59
9,19,2018,7,0,4,"Braga",4,"N14 Bosch",28,47,19,80,48,32
9,19,2018,7,0,4,"Braga",5,"Avenida João Paulo II",39,39,0,9,9,0
9,19,2018,7,0,4,"Braga",6,"Avenida Padre Júlio Fragata",67,67,0,83,83,0
9,19,2018,7,0,4,"Braga",7,"Rua Nova Santa Cruz",44,44,0,39,39,0
9,19,2018,7,0,4,"Braga",8,"Rua Costa Gomes",0,41,41,-1,42,-43
9,19,2018,8,0,4,"Braga",1,"Avenida da Liberdade",17,25,8,182,124,58
9,19,2018,8,0,4,"Braga",2,"Avenida Central",17,25,8,182,124,58
9,19,2018,8,0,4,"Braga",3,"Rua de Caires",23,36,13,59,37,22
9,19,2018,8,0,4,"Braga",4,"N14 Bosch",24,47,23,94,48,46
9,19,2018,8,0,4,"Braga",5,"Avenida João Paulo II",26,39,13,13,9,4
9,19,2018,8,0,4,"Braga",6,"Avenida Padre Júlio Fragata",46,67,21,121,83,38
9,19,2018,8,0,4,"Braga",7,"Rua Nova Santa Cruz",2,44,42,864,39,825
9,19,2018,8,0,4,"Braga",8,"Rua Costa Gomes",0,41,41,-1,42,-43
9,19,2018,9,0,4,"Braga",1,"Avenida da Liberdade",25,25,0,124,124,0
9,19,2018,9,0,4,"Braga",2,"Avenida Central",25,25,0,124,124,0
9,19,2018,9,0,4,"Braga",3,"Rua de Caires",36,36,0,37,37,0
9,19,2018,9,0,4,"Braga",4,"N14 Bosch",28,47,19,80,48,32
9,19,2018,9,0,4,"Braga",5,"Avenida João Paulo II",39,39,0,9,9,0
9,19,2018,9,0,4,"Braga",6,"Avenida Padre Júlio Fragata",67,67,0,83,83,0
9,19,2018,9,0,4,"Braga",7,"Rua Nova Santa Cruz",44,44,0,39,39,0
9,19,2018,9,0,4,"Braga",8,"Rua Costa Gomes",0,41,41,-1,42,-43
9,19,2018,10,0,4,"Braga",1,"Avenida da Liberdade",25,25,0,124,124,0
9,19,2018,10,0,4,"Braga",2,"Avenida Central",25,25,0,124,124,0
9,19,2018,10,0,4,"Braga",3,"Rua de Caires",20,36,16,67,37,30
9,19,2018,10,0,4,"Braga",4,"N14 Bosch",18,47,29,125,48,77
9,19,2018,10,0,4,"Braga",5,"Avenida João Paulo II",39,39,0,9,9,0
9,19,2018,10,0,4,"Braga",6,"Avenida Padre Júlio Fragata",67,67,0,83,83,0
9,19,2018,10,0,4,"Braga",7,"Rua Nova Santa Cruz",44,44,0,39,39,0
9,19,2018,10,0,4,"Braga",8,"Rua Costa Gomes",0,41,41,-1,42,-43
9,19,2018,11,0,4,"Braga",1,"Avenida da Liberdade",17,25,8,182,124,58
9,19,2018,11,0,4,"Braga",2,"Avenida Central",17,25,8,182,124,58
9,19,2018,11,0,4,"Braga",3,"Rua de Caires",26,36,10,52,37,15
9,19,2018,11,0,4,"Braga",4,"N14 Bosch",32,47,15,70,48,22
9,19,2018,11,0,4,"Braga",5,"Avenida João Paulo II",30,39,9,12,9,3
9,19,2018,11,0,4,"Braga",6,"Avenida Padre Júlio Fragata",67,67,0,83,83,0
9,19,2018,11,0,4,"Braga",7,"Rua Nova Santa Cruz",44,44,0,39,39,0
9,19,2018,11,0,4,"Braga",8,"Rua Costa Gomes",0,41,41,-1,42,-43
9,19,2018,12,0,4,"Braga",1,"Avenida da Liberdade",25,25,0,124,124,0
9,19,2018,12,0,4,"Braga",2,"Avenida Central",25,25,0,124,124,0
9,19,2018,12,0,4,"Braga",3,"Rua de Caires",15,36,21,90,37,53
9,19,2018,12,0,4,"Braga",4,"N14 Bosch",35,47,12,64,48,16
9,19,2018,12,0,4,"Braga",5,"Avenida João Paulo II",28,39,11,12,9,3
9,19,2018,12,0,4,"Braga",6,"Avenida Padre Júlio Fragata",67,67,0,83,83,0
9,19,2018,12,0,4,"Braga",7,"Rua Nova Santa Cruz",27,44,17,64,39,25
9,19,2018,12,0,4,"Braga",8,"Rua Costa Gomes",0,41,41,-1,42,-43
9,19,2018,13,0,4,"Braga",1,"Avenida da Liberdade",25,25,0,124,124,0
9,19,2018,13,0,4,"Braga",2,"Avenida Central",25,25,0,124,124,0
9,19,2018,13,0,4,"Braga",3,"Rua de Caires",36,36,0,37,37,0
9,19,2018,13,0,4,"Braga",4,"N14 Bosch",18,47,29,125,48,77
9,19,2018,13,0,4,"Braga",5,"Avenida João Paulo II",39,39,0,9,9,0
9,19,2018,13,0,4,"Braga",6,"Avenida Padre Júlio Fragata",67,67,0,83,83,0
9,19,2018,13,0,4,"Braga",7,"Rua Nova Santa Cruz",26,44,18,66,39,27
9,19,2018,13,0,4,"Braga",8,"Rua Costa Gomes",0,41,41,-1,42,-43
9,21,2018,12,0,6,"Braga",1,"Avenida da Liberdade",18,25,7,172,124,48
9,21,2018,12,0,6,"Braga",2,"Avenida Central",18,25,7,172,124,48
9,21,2018,12,0,6,"Braga",3,"Rua de Caires",26,36,10,52,37,15
9,21,2018,12,0,6,"Braga",4,"N14 Bosch",47,47,0,48,48,0
9,21,2018,12,0,6,"Braga",5,"Avenida João Paulo II",28,39,11,12,9,3
9,21,2018,12,0,6,"Braga",6,"Avenida Padre Júlio Fragata",67,67,0,83,83,0
9,21,2018,12,0,6,"Braga",7,"Rua Nova Santa Cruz",9,44,35,192,39,153
9,21,2018,12,0,6,"Braga",8,"Rua Costa Gomes",0,41,41,-1,42,-43
9,21,2018,13,0,6,"Braga",1,"Avenida da Liberdade",19,25,6,163,124,39
9,21,2018,13,0,6,"Braga",2,"Avenida Central",19,25,6,163,124,39
9,21,2018,13,0,6,"Braga",3,"Rua de Caires",26,36,10,52,37,15
9,21,2018,13,0,6,"Braga",4,"N14 Bosch",28,47,19,80,48,32
9,21,2018,13,0,6,"Braga",5,"Avenida João Paulo II",26,39,13,13,9,4
9,21,2018,13,0,6,"Braga",6,"Avenida Padre Júlio Fragata",67,67,0,83,83,0
9,21,2018,13,0,6,"Braga",7,"Rua Nova Santa Cruz",5,44,39,346,39,307
9,21,2018,13,0,6,"Braga",8,"Rua Costa Gomes",0,41,41,-1,42,-43
9,21,2018,14,0,6,"Braga",1,"Avenida da Liberdade",19,25,6,163,124,39
9,21,2018,14,0,6,"Braga",2,"Avenida Central",19,25,6,163,124,39
9,21,2018,14,0,6,"Braga",3,"Rua de Caires",21,36,15,64,37,27
9,21,2018,14,0,6,"Braga",4,"N14 Bosch",31,47,16,72,48,24
9,21,2018,14,0,6,"Braga",5,"Avenida João Paulo II",39,39,0,9,9,0
9,21,2018,14,0,6,"Braga",6,"Avenida Padre Júlio Fragata",53,67,14,105,83,22
9,21,2018,14,0,6,"Braga",7,"Rua Nova Santa Cruz",44,44,0,39,39,0
9,21,2018,14,0,6,"Braga",8,"Rua Costa Gomes",0,41,41,-1,42,-43
9,21,2018,15,0,6,"Braga",1,"Avenida da Liberdade",25,25,0,124,124,0
9,21,2018,15,0,6,"Braga",2,"Avenida Central",25,25,0,124,124,0
9,21,2018,15,0,6,"Braga",3,"Rua de Caires",19,36,17,71,37,34
9,21,2018,15,0,6,"Braga",4,"N14 Bosch",36,47,11,62,48,14
9,21,2018,15,0,6,"Braga",5,"Avenida João Paulo II",25,39,14,14,9,5
9,21,2018,15,0,6,"Braga",6,"Avenida Padre Júlio Fragata",67,67,0,83,83,0
9,21,2018,15,0,6,"Braga",7,"Rua Nova Santa Cruz",32,44,12,54,39,15
9,21,2018,15,0,6,"Braga",8,"Rua Costa Gomes",0,41,41,-1,42,-43
9,21,2018,16,0,6,"Braga",1,"Avenida da Liberdade",18,25,7,172,124,48
9,21,2018,16,0,6,"Braga",2,"Avenida Central",18,25,7,172,124,48
9,21,2018,16,0,6,"Braga",3,"Rua de Caires",36,36,0,37,37,0
9,21,2018,16,0,6,"Braga",4,"N14 Bosch",12,47,35,187,48,139
9,21,2018,16,0,6,"Braga",5,"Avenida João Paulo II",39,39,0,9,9,0
9,21,2018,16,0,6,"Braga",6,"Avenida Padre Júlio Fragata",45,67,22,124,83,41
9,21,2018,16,0,6,"Braga",7,"Rua Nova Santa Cruz",18,44,26,96,39,57
9,21,2018,16,0,6,"Braga",8,"Rua Costa Gomes",0,41,41,-1,42,-43
9,21,2018,17,0,6,"Braga",1,"Avenida da Liberdade",14,25,11,221,124,97
9,21,2018,17,0,6,"Braga",2,"Avenida Central",14,25,11,221,124,97
9,21,2018,17,0,6,"Braga",3,"Rua de Caires",18,36,18,75,37,38
9,21,2018,17,0,6,"Braga",4,"N14 Bosch",26,47,21,86,48,38
9,21,2018,17,0,6,"Braga",5,"Avenida João Paulo II",39,39,0,9,9,0
9,21,2018,17,0,6,"Braga",6,"Avenida Padre Júlio Fragata",36,67,31,155,83,72
9,21,2018,17,0,6,"Braga",7,"Rua Nova Santa Cruz",9,44,35,192,39,153
9,21,2018,17,0,6,"Braga",8,"Rua Costa Gomes",0,41,41,-1,42,-43
9,21,2018,18,0,6,"Braga",1,"Avenida da Liberdade",19,25,6,163,124,39
9,21,2018,18,0,6,"Braga",2,"Avenida Central",19,25,6,163,124,39
9,21,2018,18,0,6,"Braga",3,"Rua de Caires",28,36,8,48,37,11
9,21,2018,18,0,6,"Braga",4,"N14 Bosch",17,47,30,132,48,84
9,21,2018,18,0,6,"Braga",5,"Avenida João Paulo II",7,39,32,50,9,41
9,21,2018,18,0,6,"Braga",6,"Avenida Padre Júlio Fragata",24,67,43,232,83,149
9,21,2018,18,0,6,"Braga",7,"Rua Nova Santa Cruz",44,44,0,39,39,0
9,21,2018,18,0,6,"Braga",8,"Rua Costa Gomes",0,41,41,-1,42,-43
9,21,2018,19,0,6,"Braga",1,"Avenida da Liberdade",25,25,0,124,124,0
9,21,2018,19,0,6,"Braga",2,"Avenida Central",25,25,0,124,124,0
9,21,2018,19,0,6,"Braga",3,"Rua de Caires",23,36,13,59,37,22
9,21,2018,19,0,6,"Braga",4,"N14 Bosch",19,47,28,118,48,70
9,21,2018,19,0,6,"Braga",5,"Avenida João Paulo II",26,39,13,13,9,4
9,21,2018,19,0,6,"Braga",6,"Avenida Padre Júlio Fragata",29,67,38,192,83,109
9,21,2018,19,0,6,"Braga",7,"Rua Nova Santa Cruz",17,44,27,102,39,63
9,21,2018,19,0,6,"Braga",8,"Rua Costa Gomes",0,41,41,-1,42,-43
9,21,2018,20,0,6,"Braga",1,"Avenida da Liberdade",19,25,6,163,124,39
9,21,2018,20,0,6,"Braga",2,"Avenida Central",18,25,7,172,124,48
9,21,2018,20,0,6,"Braga",3,"Rua de Caires",36,36,0,37,37,0
9,21,2018,20,0,6,"Braga",4,"N14 Bosch",47,47,0,48,48,0
9,21,2018,20,0,6,"Braga",5,"Avenida João Paulo II",39,39,0,9,9,0
9,21,2018,20,0,6,"Braga",6,"Avenida Padre Júlio Fragata",67,67,0,83,83,0
9,21,2018,20,0,6,"Braga",7,"Rua Nova Santa Cruz",44,44,0,39,39,0
9,21,2018,20,0,6,"Braga",8,"Rua Costa Gomes",0,41,41,-1,42,-43
9,21,2018,21,0,6,"Braga",1,"Avenida da Liberdade",25,25,0,124,124,0
9,21,2018,21,0,6,"Braga",2,"Avenida Central",25,25,0,124,124,0
9,21,2018,21,0,6,"Braga",3,"Rua de Caires",28,36,8,48,37,11
9,21,2018,21,0,6,"Braga",4,"N14 Bosch",47,47,0,48,48,0
9,21,2018,21,0,6,"Braga",5,"Avenida João Paulo II",39,39,0,9,9,0
9,21,2018,21,0,6,"Braga",6,"Avenida Padre Júlio Fragata",67,67,0,83,83,0
9,21,2018,21,0,6,"Braga",7,"Rua Nova Santa Cruz",44,44,0,39,39,0
9,21,2018,21,0,6,"Braga",8,"Rua Costa Gomes",0,41,41,-1,42,-43
9,21,2018,22,0,6,"Braga",1,"Avenida da Liberdade",25,25,0,124,124,0
9,21,2018,22,0,6,"Braga",2,"Avenida Central",25,25,0,124,124,0
9,21,2018,22,0,6,"Braga",3,"Rua de Caires",36,36,0,37,37,0
9,21,2018,22,0,6,"Braga",4,"N14 Bosch",47,47,0,48,48,0
9,21,2018,22,0,6,"Braga",5,"Avenida João Paulo II",39,39,0,9,9,0
9,21,2018,22,0,6,"Braga",6,"Avenida Padre Júlio Fragata",67,67,0,83,83,0
9,21,2018,22,0,6,"Braga",7,"Rua Nova Santa Cruz",44,44,0,39,39,0
9,21,2018,22,0,6,"Braga",8,"Rua Costa Gomes",0,41,41,-1,42,-43
9,21,2018,23,0,6,"Braga",1,"Avenida da Liberdade",25,25,0,124,124,0
9,21,2018,23,0,6,"Braga",2,"Avenida Central",25,25,0,124,124,0
9,21,2018,23,0,6,"Braga",3,"Rua de Caires",36,36,0,37,37,0
9,21,2018,23,0,6,"Braga",4,"N14 Bosch",47,47,0,48,48,0
9,21,2018,23,0,6,"Braga",5,"Avenida João Paulo II",39,39,0,9,9,0
9,21,2018,23,0,6,"Braga",6,"Avenida Padre Júlio Fragata",67,67,0,83,83,0
9,21,2018,23,0,6,"Braga",7,"Rua Nova Santa Cruz",44,44,0,39,39,0
9,21,2018,23,0,6,"Braga",8,"Rua Costa Gomes",0,41,41,-1,42,-43
9,22,2018,0,0,7,"Braga",1,"Avenida da Liberdade",25,25,0,124,124,0
9,22,2018,0,0,7,"Braga",2,"Avenida Central",25,25,0,124,124,0
9,22,2018,0,0,7,"Braga",3,"Rua de Caires",36,36,0,37,37,0
9,22,2018,0,0,7,"Braga",4,"N14 Bosch",47,47,0,48,48,0
9,22,2018,0,0,7,"Braga",5,"Avenida João Paulo II",39,39,0,9,9,0
9,22,2018,0,0,7,"Braga",6,"Avenida Padre Júlio Fragata",67,67,0,83,83,0
9,22,2018,0,0,7,"Braga",7,"Rua Nova Santa Cruz",26,44,18,66,39,27
9,22,2018,0,0,7,"Braga",8,"Rua Costa Gomes",0,41,41,-1,42,-43
9,22,2018,1,0,7,"Braga",1,"Avenida da Liberdade",25,25,0,124,124,0
9,22,2018,1,0,7,"Braga",2,"Avenida Central",25,25,0,124,124,0
9,22,2018,1,0,7,"Braga",3,"Rua de Caires",36,36,0,37,37,0
9,22,2018,1,0,7,"Braga",4,"N14 Bosch",47,47,0,48,48,0
9,22,2018,1,0,7,"Braga",5,"Avenida João Paulo II",30,39,9,12,9,3
9,22,2018,1,0,7,"Braga",6,"Avenida Padre Júlio Fragata",67,67,0,83,83,0
9,22,2018,1,0,7,"Braga",7,"Rua Nova Santa Cruz",44,44,0,39,39,0
9,22,2018,1,0,7,"Braga",8,"Rua Costa Gomes",0,41,41,-1,42,-43
9,22,2018,2,0,7,"Braga",1,"Avenida da Liberdade",25,25,0,124,124,0
9,22,2018,2,0,7,"Braga",2,"Avenida Central",25,25,0,124,124,0
9,22,2018,2,0,7,"Braga",3,"Rua de Caires",36,36,0,37,37,0
9,22,2018,2,0,7,"Braga",4,"N14 Bosch",47,47,0,48,48,0
9,22,2018,2,0,7,"Braga",5,"Avenida João Paulo II",39,39,0,9,9,0
9,22,2018,2,0,7,"Braga",6,"Avenida Padre Júlio Fragata",67,67,0,83,83,0
9,22,2018,2,0,7,"Braga",7,"Rua Nova Santa Cruz",44,44,0,39,39,0
9,22,2018,2,0,7,"Braga",8,"Rua Costa Gomes",0,41,41,-1,42,-43
9,22,2018,3,0,7,"Braga",1,"Avenida da Liberdade",25,25,0,124,124,0
9,22,2018,3,0,7,"Braga",2,"Avenida Central",25,25,0,124,124,0
9,22,2018,3,0,7,"Braga",3,"Rua de Caires",36,36,0,37,37,0
9,22,2018,3,0,7,"Braga",4,"N14 Bosch",47,47,0,48,48,0
9,22,2018,3,0,7,"Braga",5,"Avenida João Paulo II",39,39,0,9,9,0
9,22,2018,3,0,7,"Braga",6,"Avenida Padre Júlio Fragata",67,67,0,83,83,0
9,22,2018,3,0,7,"Braga",7,"Rua Nova Santa Cruz",44,44,0,39,39,0
9,22,2018,3,0,7,"Braga",8,"Rua Costa Gomes",0,41,41,-1,42,-43
9,22,2018,4,0,7,"Braga",1,"Avenida da Liberdade",25,25,0,124,124,0
9,22,2018,4,0,7,"Braga",2,"Avenida Central",25,25,0,124,124,0
9,22,2018,4,0,7,"Braga",3,"Rua de Caires",36,36,0,37,37,0
9,22,2018,4,0,7,"Braga",4,"N14 Bosch",47,47,0,48,48,0
9,22,2018,4,0,7,"Braga",5,"Avenida João Paulo II",39,39,0,9,9,0
9,22,2018,4,0,7,"Braga",6,"Avenida Padre Júlio Fragata",67,67,0,83,83,0
9,22,2018,4,0,7,"Braga",7,"Rua Nova Santa Cruz",44,44,0,39,39,0
9,22,2018,4,0,7,"Braga",8,"Rua Costa Gomes",0,41,41,-1,42,-43
9,22,2018,5,0,7,"Braga",1,"Avenida da Liberdade",25,25,0,124,124,0
9,22,2018,5,0,7,"Braga",2,"Avenida Central",25,25,0,124,124,0
9,22,2018,5,0,7,"Braga",3,"Rua de Caires",36,36,0,37,37,0
9,22,2018,5,0,7,"Braga",4,"N14 Bosch",47,47,0,48,48,0
9,22,2018,5,0,7,"Braga",5,"Avenida João Paulo II",39,39,0,9,9,0
9,22,2018,5,0,7,"Braga",6,"Avenida Padre Júlio Fragata",67,67,0,83,83,0
9,22,2018,5,0,7,"Braga",7,"Rua Nova Santa Cruz",44,44,0,39,39,0
9,22,2018,5,0,7,"Braga",8,"Rua Costa Gomes",0,41,41,-1,42,-43
9,22,2018,6,0,7,"Braga",1,"Avenida da Liberdade",25,25,0,124,124,0
9,22,2018,6,0,7,"Braga",2,"Avenida Central",25,25,0,124,124,0
9,22,2018,6,0,7,"Braga",3,"Rua de Caires",27,36,9,50,37,13
9,22,2018,6,0,7,"Braga",4,"N14 Bosch",47,47,0,48,48,0
9,22,2018,6,0,7,"Braga",5,"Avenida João Paulo II",39,39,0,9,9,0
9,22,2018,6,0,7,"Braga",6,"Avenida Padre Júlio Fragata",67,67,0,83,83,0
9,22,2018,6,0,7,"Braga",7,"Rua Nova Santa Cruz",44,44,0,39,39,0
9,22,2018,6,0,7,"Braga",8,"Rua Costa Gomes",0,41,41,-1,42,-43
9,22,2018,7,0,7,"Braga",1,"Avenida da Liberdade",25,25,0,124,124,0
9,22,2018,7,0,7,"Braga",2,"Avenida Central",25,25,0,124,124,0
9,22,2018,7,0,7,"Braga",3,"Rua de Caires",36,36,0,37,37,0
9,22,2018,7,0,7,"Braga",4,"N14 Bosch",47,47,0,48,48,0
9,22,2018,7,0,7,"Braga",5,"Avenida João Paulo II",39,39,0,9,9,0
9,22,2018,7,0,7,"Braga",6,"Avenida Padre Júlio Fragata",67,67,0,83,83,0
9,22,2018,7,0,7,"Braga",7,"Rua Nova Santa Cruz",44,44,0,39,39,0
9,22,2018,7,0,7,"Braga",8,"Rua Costa Gomes",0,41,41,-1,42,-43
9,22,2018,8,0,7,"Braga",1,"Avenida da Liberdade",25,25,0,124,124,0
9,22,2018,8,0,7,"Braga",2,"Avenida Central",25,25,0,124,124,0
9,22,2018,8,0,7,"Braga",3,"Rua de Caires",36,36,0,37,37,0
9,22,2018,8,0,7,"Braga",4,"N14 Bosch",47,47,0,48,48,0
9,22,2018,8,0,7,"Braga",5,"Avenida João Paulo II",39,39,0,9,9,0
9,22,2018,8,0,7,"Braga",6,"Avenida Padre Júlio Fragata",67,67,0,83,83,0
9,22,2018,8,0,7,"Braga",7,"Rua Nova Santa Cruz",44,44,0,39,39,0
9,22,2018,8,0,7,"Braga",8,"Rua Costa Gomes",0,41,41,-1,42,-43
9,22,2018,9,0,7,"Braga",1,"Avenida da Liberdade",25,25,0,124,124,0
9,22,2018,9,0,7,"Braga",2,"Avenida Central",25,25,0,124,124,0
9,22,2018,9,0,7,"Braga",3,"Rua de Caires",23,36,13,59,37,22
9,22,2018,9,0,7,"Braga",4,"N14 Bosch",47,47,0,48,48,0
9,22,2018,9,0,7,"Braga",5,"Avenida João Paulo II",39,39,0,9,9,0
9,22,2018,9,0,7,"Braga",6,"Avenida Padre Júlio Fragata",67,67,0,83,83,0
9,22,2018,9,0,7,"Braga",7,"Rua Nova Santa Cruz",44,44,0,39,39,0
9,22,2018,9,0,7,"Braga",8,"Rua Costa Gomes",0,41,41,-1,42,-43
9,22,2018,10,0,7,"Braga",1,"Avenida da Liberdade",17,25,8,182,124,58
9,22,2018,10,0,7,"Braga",2,"Avenida Central",17,25,8,182,124,58
9,22,2018,10,0,7,"Braga",3,"Rua de Caires",27,36,9,50,37,13
9,22,2018,10,0,7,"Braga",4,"N14 Bosch",37,47,10,61,48,13
9,22,2018,10,0,7,"Braga",5,"Avenida João Paulo II",39,39,0,9,9,0
9,22,2018,10,0,7,"Braga",6,"Avenida Padre Júlio Fragata",67,67,0,83,83,0
9,22,2018,10,0,7,"Braga",7,"Rua Nova Santa Cruz",44,44,0,39,39,0
9,22,2018,10,0,7,"Braga",8,"Rua Costa Gomes",0,41,41,-1,42,-43
9,22,2018,11,0,7,"Braga",1,"Avenida da Liberdade",25,25,0,124,124,0
9,22,2018,11,0,7,"Braga",2,"Avenida Central",25,25,0,124,124,0
9,22,2018,11,0,7,"Braga",3,"Rua de Caires",36,36,0,37,37,0
9,22,2018,11,0,7,"Braga",4,"N14 Bosch",21,47,26,107,48,59
9,22,2018,11,0,7,"Braga",5,"Avenida João Paulo II",39,39,0,9,9,0
9,22,2018,11,0,7,"Braga",6,"Avenida Padre Júlio Fragata",67,67,0,83,83,0
9,22,2018,11,0,7,"Braga",7,"Rua Nova Santa Cruz",44,44,0,39,39,0
9,22,2018,11,0,7,"Braga",8,"Rua Costa Gomes",0,41,41,-1,42,-43
9,22,2018,12,0,7,"Braga",1,"Avenida da Liberdade",19,25,6,163,124,39
9,22,2018,12,0,7,"Braga",2,"Avenida Central",19,25,6,163,124,39
9,22,2018,12,0,7,"Braga",3,"Rua de Caires",36,36,0,37,37,0
9,22,2018,12,0,7,"Braga",4,"N14 Bosch",47,47,0,48,48,0
9,22,2018,12,0,7,"Braga",5,"Avenida João Paulo II",39,39,0,9,9,0
9,22,2018,12,0,7,"Braga",6,"Avenida Padre Júlio Fragata",67,67,0,83,83,0
9,22,2018,12,0,7,"Braga",7,"Rua Nova Santa Cruz",44,44,0,39,39,0
9,22,2018,12,0,7,"Braga",8,"Rua Costa Gomes",0,41,41,-1,42,-43
9,22,2018,13,0,7,"Braga",1,"Avenida da Liberdade",25,25,0,124,124,0
9,22,2018,13,0,7,"Braga",2,"Avenida Central",25,25,0,124,124,0
9,22,2018,13,0,7,"Braga",3,"Rua de Caires",16,36,20,84,37,47
9,22,2018,13,0,7,"Braga",4,"N14 Bosch",16,47,31,140,48,92
9,22,2018,13,0,7,"Braga",5,"Avenida João Paulo II",39,39,0,9,9,0
9,22,2018,13,0,7,"Braga",6,"Avenida Padre Júlio Fragata",67,67,0,83,83,0
9,22,2018,13,0,7,"Braga",7,"Rua Nova Santa Cruz",44,44,0,39,39,0
9,22,2018,13,0,7,"Braga",8,"Rua Costa Gomes",0,41,41,-1,42,-43
9,22,2018,14,0,7,"Braga",1,"Avenida da Liberdade",18,25,7,172,124,48
9,22,2018,14,0,7,"Braga",2,"Avenida Central",18,25,7,172,124,48
9,22,2018,14,0,7,"Braga",3,"Rua de Caires",24,36,12,56,37,19
9,22,2018,14,0,7,"Braga",4,"N14 Bosch",47,47,0,48,48,0
9,22,2018,14,0,7,"Braga",5,"Avenida João Paulo II",28,39,11,12,9,3
9,22,2018,14,0,7,"Braga",6,"Avenida Padre Júlio Fragata",67,67,0,83,83,0
9,22,2018,14,0,7,"Braga",7,"Rua Nova Santa Cruz",44,44,0,39,39,0
9,22,2018,14,0,7,"Braga",8,"Rua Costa Gomes",0,41,41,-1,42,-43
9,22,2018,15,0,7,"Braga",1,"Avenida da Liberdade",25,25,0,124,124,0
9,22,2018,15,0,7,"Braga",2,"Avenida Central",25,25,0,124,124,0
9,22,2018,15,0,7,"Braga",3,"Rua de Caires",36,36,0,37,37,0
9,22,2018,15,0,7,"Braga",4,"N14 Bosch",47,47,0,48,48,0
9,22,2018,15,0,7,"Braga",5,"Avenida João Paulo II",39,39,0,9,9,0
9,22,2018,15,0,7,"Braga",6,"Avenida Padre Júlio Fragata",67,67,0,83,83,0
9,22,2018,15,0,7,"Braga",7,"Rua Nova Santa Cruz",44,44,0,39,39,0
9,22,2018,15,0,7,"Braga",8,"Rua Costa Gomes",0,41,41,-1,42,-43
9,22,2018,16,0,7,"Braga",1,"Avenida da Liberdade",25,25,0,124,124,0
9,22,2018,16,0,7,"Braga",2,"Avenida Central",25,25,0,124,124,0
9,22,2018,16,0,7,"Braga",3,"Rua de Caires",36,36,0,37,37,0
9,22,2018,16,0,7,"Braga",4,"N14 Bosch",47,47,0,48,48,0
9,22,2018,16,0,7,"Braga",5,"Avenida João Paulo II",39,39,0,9,9,0
9,22,2018,16,0,7,"Braga",6,"Avenida Padre Júlio Fragata",67,67,0,83,83,0
9,22,2018,16,0,7,"Braga",7,"Rua Nova Santa Cruz",44,44,0,39,39,0
9,22,2018,16,0,7,"Braga",8,"Rua Costa Gomes",0,41,41,-1,42,-43
9,22,2018,17,0,7,"Braga",1,"Avenida da Liberdade",19,25,6,163,124,39
9,22,2018,17,0,7,"Braga",2,"Avenida Central",19,25,6,163,124,39
9,22,2018,17,0,7,"Braga",3,"Rua de Caires",36,36,0,37,37,0
9,22,2018,17,0,7,"Braga",4,"N14 Bosch",47,47,0,48,48,0
9,22,2018,17,0,7,"Braga",5,"Avenida João Paulo II",39,39,0,9,9,0
9,22,2018,17,0,7,"Braga",6,"Avenida Padre Júlio Fragata",67,67,0,83,83,0
9,22,2018,17,0,7,"Braga",7,"Rua Nova Santa Cruz",44,44,0,39,39,0
9,22,2018,17,0,7,"Braga",8,"Rua Costa Gomes",0,41,41,-1,42,-43
9,22,2018,18,0,7,"Braga",1,"Avenida da Liberdade",19,25,6,163,124,39
9,22,2018,18,0,7,"Braga",2,"Avenida Central",19,25,6,163,124,39
9,22,2018,18,0,7,"Braga",3,"Rua de Caires",36,36,0,37,37,0
9,22,2018,18,0,7,"Braga",4,"N14 Bosch",47,47,0,48,48,0
9,22,2018,18,0,7,"Braga",5,"Avenida João Paulo II",39,39,0,9,9,0
9,22,2018,18,0,7,"Braga",6,"Avenida Padre Júlio Fragata",53,67,14,105,83,22
9,22,2018,18,0,7,"Braga",7,"Rua Nova Santa Cruz",44,44,0,39,39,0
9,22,2018,18,0,7,"Braga",8,"Rua Costa Gomes",0,41,41,-1,42,-43
9,22,2018,19,0,7,"Braga",1,"Avenida da Liberdade",25,25,0,124,124,0
9,22,2018,19,0,7,"Braga",2,"Avenida Central",25,25,0,124,124,0
9,22,2018,19,0,7,"Braga",3,"Rua de Caires",36,36,0,37,37,0
9,22,2018,19,0,7,"Braga",4,"N14 Bosch",47,47,0,48,48,0
9,22,2018,19,0,7,"Braga",5,"Avenida João Paulo II",17,39,22,21,9,12
9,22,2018,19,0,7,"Braga",6,"Avenida Padre Júlio Fragata",48,67,19,116,83,33
9,22,2018,19,0,7,"Braga",7,"Rua Nova Santa Cruz",44,44,0,39,39,0
9,22,2018,19,0,7,"Braga",8,"Rua Costa Gomes",0,41,41,-1,42,-43
9,22,2018,20,0,7,"Braga",1,"Avenida da Liberdade",25,25,0,124,124,0
9,22,2018,20,0,7,"Braga",2,"Avenida Central",25,25,0,124,124,0
9,22,2018,20,0,7,"Braga",3,"Rua de Caires",23,36,13,59,37,22
9,22,2018,20,0,7,"Braga",4,"N14 Bosch",29,47,18,77,48,29
9,22,2018,20,0,7,"Braga",5,"Avenida João Paulo II",39,39,0,9,9,0
9,22,2018,20,0,7,"Braga",6,"Avenida Padre Júlio Fragata",67,67,0,83,83,0
9,22,2018,20,0,7,"Braga",7,"Rua Nova Santa Cruz",44,44,0,39,39,0
9,22,2018,20,0,7,"Braga",8,"Rua Costa Gomes",0,41,41,-1,42,-43
9,22,2018,21,0,7,"Braga",1,"Avenida da Liberdade",25,25,0,124,124,0
9,22,2018,21,0,7,"Braga",2,"Avenida Central",25,25,0,124,124,0
9,22,2018,21,0,7,"Braga",3,"Rua de Caires",36,36,0,37,37,0
9,22,2018,21,0,7,"Braga",4,"N14 Bosch",47,47,0,48,48,0
9,22,2018,21,0,7,"Braga",5,"Avenida João Paulo II",39,39,0,9,9,0
9,22,2018,21,0,7,"Braga",6,"Avenida Padre Júlio Fragata",67,67,0,83,83,0
9,22,2018,21,0,7,"Braga",7,"Rua Nova Santa Cruz",44,44,0,39,39,0
9,22,2018,21,0,7,"Braga",8,"Rua Costa Gomes",0,41,41,-1,42,-43
9,22,2018,22,0,7,"Braga",1,"Avenida da Liberdade",25,25,0,124,124,0
9,22,2018,22,0,7,"Braga",2,"Avenida Central",25,25,0,124,124,0
9,22,2018,22,0,7,"Braga",3,"Rua de Caires",36,36,0,37,37,0
9,22,2018,22,0,7,"Braga",4,"N14 Bosch",47,47,0,48,48,0
9,22,2018,22,0,7,"Braga",5,"Avenida João Paulo II",39,39,0,9,9,0
9,22,2018,22,0,7,"Braga",6,"Avenida Padre Júlio Fragata",67,67,0,83,83,0
9,22,2018,22,0,7,"Braga",7,"Rua Nova Santa Cruz",44,44,0,39,39,0
9,22,2018,22,0,7,"Braga",8,"Rua Costa Gomes",0,41,41,-1,42,-43
9,22,2018,23,0,7,"Braga",1,"Avenida da Liberdade",25,25,0,124,124,0
9,22,2018,23,0,7,"Braga",2,"Avenida Central",25,25,0,124,124,0
9,22,2018,23,0,7,"Braga",3,"Rua de Caires",36,36,0,37,37,0
9,22,2018,23,0,7,"Braga",4,"N14 Bosch",47,47,0,48,48,0
9,22,2018,23,0,7,"Braga",5,"Avenida João Paulo II",39,39,0,9,9,0
9,22,2018,23,0,7,"Braga",6,"Avenida Padre Júlio Fragata",67,67,0,83,83,0
9,22,2018,23,0,7,"Braga",7,"Rua Nova Santa Cruz",44,44,0,39,39,0
9,22,2018,23,0,7,"Braga",8,"Rua Costa Gomes",0,41,41,-1,42,-43
9,23,2018,0,0,8,"Braga",1,"Avenida da Liberdade",18,25,7,172,124,48
9,23,2018,0,0,8,"Braga",2,"Avenida Central",18,25,7,172,124,48
9,23,2018,0,0,8,"Braga",3,"Rua de Caires",36,36,0,37,37,0
9,23,2018,0,0,8,"Braga",4,"N14 Bosch",47,47,0,48,48,0
9,23,2018,0,0,8,"Braga",5,"Avenida João Paulo II",39,39,0,9,9,0
9,23,2018,0,0,8,"Braga",6,"Avenida Padre Júlio Fragata",67,67,0,83,83,0
9,23,2018,0,0,8,"Braga",7,"Rua Nova Santa Cruz",44,44,0,39,39,0
9,23,2018,0,0,8,"Braga",8,"Rua Costa Gomes",0,41,41,-1,42,-43
9,23,2018,1,0,8,"Braga",1,"Avenida da Liberdade",25,25,0,124,124,0
9,23,2018,1,0,8,"Braga",2,"Avenida Central",25,25,0,124,124,0
9,23,2018,1,0,8,"Braga",3,"Rua de Caires",36,36,0,37,37,0
9,23,2018,1,0,8,"Braga",4,"N14 Bosch",47,47,0,48,48,0
9,23,2018,1,0,8,"Braga",5,"Avenida João Paulo II",39,39,0,9,9,0
9,23,2018,1,0,8,"Braga",6,"Avenida Padre Júlio Fragata",67,67,0,83,83,0
9,23,2018,1,0,8,"Braga",7,"Rua Nova Santa Cruz",44,44,0,39,39,0
9,23,2018,1,0,8,"Braga",8,"Rua Costa Gomes",0,41,41,-1,42,-43
9,23,2018,2,0,8,"Braga",1,"Avenida da Liberdade",25,25,0,124,124,0
9,23,2018,2,0,8,"Braga",2,"Avenida Central",25,25,0,124,124,0
9,23,2018,2,0,8,"Braga",3,"Rua de Caires",36,36,0,37,37,0
9,23,2018,2,0,8,"Braga",4,"N14 Bosch",47,47,0,48,48,0
9,23,2018,2,0,8,"Braga",5,"Avenida João Paulo II",39,39,0,9,9,0
9,23,2018,2,0,8,"Braga",6,"Avenida Padre Júlio Fragata",67,67,0,83,83,0
9,23,2018,2,0,8,"Braga",7,"Rua Nova Santa Cruz",44,44,0,39,39,0
9,23,2018,2,0,8,"Braga",8,"Rua Costa Gomes",0,41,41,-1,42,-43
9,23,2018,3,0,8,"Braga",1,"Avenida da Liberdade",25,25,0,124,124,0
9,23,2018,3,0,8,"Braga",2,"Avenida Central",25,25,0,124,124,0
9,23,2018,3,0,8,"Braga",3,"Rua de Caires",36,36,0,37,37,0
9,23,2018,3,0,8,"Braga",4,"N14 Bosch",47,47,0,48,48,0
9,23,2018,3,0,8,"Braga",5,"Avenida João Paulo II",39,39,0,9,9,0
9,23,2018,3,0,8,"Braga",6,"Avenida Padre Júlio Fragata",67,67,0,83,83,0
9,23,2018,3,0,8,"Braga",7,"Rua Nova Santa Cruz",44,44,0,39,39,0
9,23,2018,3,0,8,"Braga",8,"Rua Costa Gomes",0,41,41,-1,42,-43
9,23,2018,4,0,8,"Braga",1,"Avenida da Liberdade",25,25,0,124,124,0
9,23,2018,4,0,8,"Braga",2,"Avenida Central",25,25,0,124,124,0
9,23,2018,4,0,8,"Braga",3,"Rua de Caires",36,36,0,37,37,0
9,23,2018,4,0,8,"Braga",4,"N14 Bosch",47,47,0,48,48,0
9,23,2018,4,0,8,"Braga",5,"Avenida João Paulo II",39,39,0,9,9,0
9,23,2018,4,0,8,"Braga",6,"Avenida Padre Júlio Fragata",67,67,0,83,83,0
9,23,2018,4,0,8,"Braga",7,"Rua Nova Santa Cruz",44,44,0,39,39,0
9,23,2018,4,0,8,"Braga",8,"Rua Costa Gomes",0,41,41,-1,42,-43
9,23,2018,5,0,8,"Braga",1,"Avenida da Liberdade",25,25,0,124,124,0
9,23,2018,5,0,8,"Braga",2,"Avenida Central",25,25,0,124,124,0
9,23,2018,5,0,8,"Braga",3,"Rua de Caires",36,36,0,37,37,0
9,23,2018,5,0,8,"Braga",4,"N14 Bosch",47,47,0,48,48,0
9,23,2018,5,0,8,"Braga",5,"Avenida João Paulo II",39,39,0,9,9,0
9,23,2018,5,0,8,"Braga",6,"Avenida Padre Júlio Fragata",67,67,0,83,83,0
9,23,2018,5,0,8,"Braga",7,"Rua Nova Santa Cruz",44,44,0,39,39,0
9,23,2018,5,0,8,"Braga",8,"Rua Costa Gomes",0,41,41,-1,42,-43
9,23,2018,6,0,8,"Braga",1,"Avenida da Liberdade",25,25,0,124,124,0
9,23,2018,6,0,8,"Braga",2,"Avenida Central",25,25,0,124,124,0
9,23,2018,6,0,8,"Braga",3,"Rua de Caires",36,36,0,37,37,0
9,23,2018,6,0,8,"Braga",4,"N14 Bosch",47,47,0,48,48,0
9,23,2018,6,0,8,"Braga",5,"Avenida João Paulo II",39,39,0,9,9,0
9,23,2018,6,0,8,"Braga",6,"Avenida Padre Júlio Fragata",67,67,0,83,83,0
9,23,2018,6,0,8,"Braga",7,"Rua Nova Santa Cruz",44,44,0,39,39,0
9,23,2018,6,0,8,"Braga",8,"Rua Costa Gomes",0,41,41,-1,42,-43
9,23,2018,7,0,8,"Braga",1,"Avenida da Liberdade",25,25,0,124,124,0
9,23,2018,7,0,8,"Braga",2,"Avenida Central",25,25,0,124,124,0
9,23,2018,7,0,8,"Braga",3,"Rua de Caires",36,36,0,37,37,0
9,23,2018,7,0,8,"Braga",4,"N14 Bosch",47,47,0,48,48,0
9,23,2018,7,0,8,"Braga",5,"Avenida João Paulo II",29,39,10,12,9,3
9,23,2018,7,0,8,"Braga",6,"Avenida Padre Júlio Fragata",67,67,0,83,83,0
9,23,2018,7,0,8,"Braga",7,"Rua Nova Santa Cruz",44,44,0,39,39,0
9,23,2018,7,0,8,"Braga",8,"Rua Costa Gomes",0,41,41,-1,42,-43
9,23,2018,8,0,8,"Braga",1,"Avenida da Liberdade",25,25,0,124,124,0
9,23,2018,8,0,8,"Braga",2,"Avenida Central",25,25,0,124,124,0
9,23,2018,8,0,8,"Braga",3,"Rua de Caires",36,36,0,37,37,0
9,23,2018,8,0,8,"Braga",4,"N14 Bosch",47,47,0,48,48,0
9,23,2018,8,0,8,"Braga",5,"Avenida João Paulo II",39,39,0,9,9,0
9,23,2018,8,0,8,"Braga",6,"Avenida Padre Júlio Fragata",67,67,0,83,83,0
9,23,2018,8,0,8,"Braga",7,"Rua Nova Santa Cruz",44,44,0,39,39,0
9,23,2018,8,0,8,"Braga",8,"Rua Costa Gomes",0,41,41,-1,42,-43
9,23,2018,9,0,8,"Braga",1,"Avenida da Liberdade",25,25,0,124,124,0
9,23,2018,9,0,8,"Braga",2,"Avenida Central",25,25,0,124,124,0
9,23,2018,9,0,8,"Braga",3,"Rua de Caires",36,36,0,37,37,0
9,23,2018,9,0,8,"Braga",4,"N14 Bosch",47,47,0,48,48,0
9,23,2018,9,0,8,"Braga",5,"Avenida João Paulo II",39,39,0,9,9,0
9,23,2018,9,0,8,"Braga",6,"Avenida Padre Júlio Fragata",67,67,0,83,83,0
9,23,2018,9,0,8,"Braga",7,"Rua Nova Santa Cruz",44,44,0,39,39,0
9,23,2018,9,0,8,"Braga",8,"Rua Costa Gomes",0,41,41,-1,42,-43
9,23,2018,10,0,8,"Braga",1,"Avenida da Liberdade",25,25,0,124,124,0
9,23,2018,10,0,8,"Braga",2,"Avenida Central",25,25,0,124,124,0
9,23,2018,10,0,8,"Braga",3,"Rua de Caires",36,36,0,37,37,0
9,23,2018,10,0,8,"Braga",4,"N14 Bosch",36,47,11,62,48,14
9,23,2018,10,0,8,"Braga",5,"Avenida João Paulo II",39,39,0,9,9,0
9,23,2018,10,0,8,"Braga",6,"Avenida Padre Júlio Fragata",67,67,0,83,83,0
9,23,2018,10,0,8,"Braga",7,"Rua Nova Santa Cruz",44,44,0,39,39,0
9,23,2018,10,0,8,"Braga",8,"Rua Costa Gomes",0,41,41,-1,42,-43
9,23,2018,11,0,8,"Braga",1,"Avenida da Liberdade",25,25,0,124,124,0
9,23,2018,11,0,8,"Braga",2,"Avenida Central",25,25,0,124,124,0
9,23,2018,11,0,8,"Braga",3,"Rua de Caires",27,36,9,50,37,13
9,23,2018,11,0,8,"Braga",4,"N14 Bosch",47,47,0,48,48,0
9,23,2018,11,0,8,"Braga",5,"Avenida João Paulo II",39,39,0,9,9,0
9,23,2018,11,0,8,"Braga",6,"Avenida Padre Júlio Fragata",67,67,0,83,83,0
9,23,2018,11,0,8,"Braga",7,"Rua Nova Santa Cruz",44,44,0,39,39,0
9,23,2018,11,0,8,"Braga",8,"Rua Costa Gomes",0,41,41,-1,42,-43
9,23,2018,12,0,8,"Braga",1,"Avenida da Liberdade",25,25,0,124,124,0
9,23,2018,12,0,8,"Braga",2,"Avenida Central",25,25,0,124,124,0
9,23,2018,12,0,8,"Braga",3,"Rua de Caires",28,36,8,48,37,11
9,23,2018,12,0,8,"Braga",4,"N14 Bosch",47,47,0,48,48,0
9,23,2018,12,0,8,"Braga",5,"Avenida João Paulo II",20,39,19,17,9,8
9,23,2018,12,0,8,"Braga",6,"Avenida Padre Júlio Fragata",67,67,0,83,83,0
9,23,2018,12,0,8,"Braga",7,"Rua Nova Santa Cruz",44,44,0,39,39,0
9,23,2018,12,0,8,"Braga",8,"Rua Costa Gomes",0,41,41,-1,42,-43
9,23,2018,13,0,8,"Braga",1,"Avenida da Liberdade",25,25,0,124,124,0
9,23,2018,13,0,8,"Braga",2,"Avenida Central",25,25,0,124,124,0
9,23,2018,13,0,8,"Braga",3,"Rua de Caires",36,36,0,37,37,0
9,23,2018,13,0,8,"Braga",4,"N14 Bosch",47,47,0,48,48,0
9,23,2018,13,0,8,"Braga",5,"Avenida João Paulo II",39,39,0,9,9,0
9,23,2018,13,0,8,"Braga",6,"Avenida Padre Júlio Fragata",67,67,0,83,83,0
9,23,2018,13,0,8,"Braga",7,"Rua Nova Santa Cruz",44,44,0,39,39,0
9,23,2018,13,0,8,"Braga",8,"Rua Costa Gomes",0,41,41,-1,42,-43
9,23,2018,14,0,8,"Braga",1,"Avenida da Liberdade",25,25,0,124,124,0
9,23,2018,14,0,8,"Braga",2,"Avenida Central",25,25,0,124,124,0
9,23,2018,14,0,8,"Braga",3,"Rua de Caires",36,36,0,37,37,0
9,23,2018,14,0,8,"Braga",4,"N14 Bosch",47,47,0,48,48,0
9,23,2018,14,0,8,"Braga",5,"Avenida João Paulo II",17,39,22,21,9,12
9,23,2018,14,0,8,"Braga",6,"Avenida Padre Júlio Fragata",51,67,16,109,83,26
9,23,2018,14,0,8,"Braga",7,"Rua Nova Santa Cruz",44,44,0,39,39,0
9,23,2018,14,0,8,"Braga",8,"Rua Costa Gomes",0,41,41,-1,42,-43
9,23,2018,15,0,8,"Braga",1,"Avenida da Liberdade",25,25,0,124,124,0
9,23,2018,15,0,8,"Braga",2,"Avenida Central",25,25,0,124,124,0
9,23,2018,15,0,8,"Braga",3,"Rua de Caires",36,36,0,37,37,0
9,23,2018,15,0,8,"Braga",4,"N14 Bosch",26,47,21,86,48,38
9,23,2018,15,0,8,"Braga",5,"Avenida João Paulo II",29,39,10,12,9,3
9,23,2018,15,0,8,"Braga",6,"Avenida Padre Júlio Fragata",67,67,0,83,83,0
9,23,2018,15,0,8,"Braga",7,"Rua Nova Santa Cruz",44,44,0,39,39,0
9,23,2018,15,0,8,"Braga",8,"Rua Costa Gomes",0,41,41,-1,42,-43
9,23,2018,16,0,8,"Braga",1,"Avenida da Liberdade",25,25,0,124,124,0
9,23,2018,16,0,8,"Braga",2,"Avenida Central",25,25,0,124,124,0
9,23,2018,16,0,8,"Braga",3,"Rua de Caires",28,36,8,48,37,11
9,23,2018,16,0,8,"Braga",4,"N14 Bosch",47,47,0,48,48,0
9,23,2018,16,0,8,"Braga",5,"Avenida João Paulo II",39,39,0,9,9,0
9,23,2018,16,0,8,"Braga",6,"Avenida Padre Júlio Fragata",67,67,0,83,83,0
9,23,2018,16,0,8,"Braga",7,"Rua Nova Santa Cruz",44,44,0,39,39,0
9,23,2018,16,0,8,"Braga",8,"Rua Costa Gomes",0,41,41,-1,42,-43
9,23,2018,17,0,8,"Braga",1,"Avenida da Liberdade",25,25,0,124,124,0
9,23,2018,17,0,8,"Braga",2,"Avenida Central",25,25,0,124,124,0
9,23,2018,17,0,8,"Braga",3,"Rua de Caires",36,36,0,37,37,0
9,23,2018,17,0,8,"Braga",4,"N14 Bosch",47,47,0,48,48,0
9,23,2018,17,0,8,"Braga",5,"Avenida João Paulo II",18,39,21,19,9,10
9,23,2018,17,0,8,"Braga",6,"Avenida Padre Júlio Fragata",67,67,0,83,83,0
9,23,2018,17,0,8,"Braga",7,"Rua Nova Santa Cruz",44,44,0,39,39,0
9,23,2018,17,0,8,"Braga",8,"Rua Costa Gomes",0,41,41,-1,42,-43
9,23,2018,18,0,8,"Braga",1,"Avenida da Liberdade",25,25,0,124,124,0
9,23,2018,18,0,8,"Braga",2,"Avenida Central",25,25,0,124,124,0
9,23,2018,18,0,8,"Braga",3,"Rua de Caires",36,36,0,37,37,0
9,23,2018,18,0,8,"Braga",4,"N14 Bosch",47,47,0,48,48,0
9,23,2018,18,0,8,"Braga",5,"Avenida João Paulo II",39,39,0,9,9,0
9,23,2018,18,0,8,"Braga",6,"Avenida Padre Júlio Fragata",35,67,32,159,83,76
9,23,2018,18,0,8,"Braga",7,"Rua Nova Santa Cruz",44,44,0,39,39,0
9,23,2018,18,0,8,"Braga",8,"Rua Costa Gomes",0,41,41,-1,42,-43
9,23,2018,19,0,8,"Braga",1,"Avenida da Liberdade",25,25,0,124,124,0
9,23,2018,19,0,8,"Braga",2,"Avenida Central",25,25,0,124,124,0
9,23,2018,19,0,8,"Braga",3,"Rua de Caires",36,36,0,37,37,0
9,23,2018,19,0,8,"Braga",4,"N14 Bosch",36,47,11,62,48,14
9,23,2018,19,0,8,"Braga",5,"Avenida João Paulo II",39,39,0,9,9,0
9,23,2018,19,0,8,"Braga",6,"Avenida Padre Júlio Fragata",67,67,0,83,83,0
9,23,2018,19,0,8,"Braga",7,"Rua Nova Santa Cruz",33,44,11,52,39,13
9,23,2018,19,0,8,"Braga",8,"Rua Costa Gomes",0,41,41,-1,42,-43
9,23,2018,20,0,8,"Braga",1,"Avenida da Liberdade",25,25,0,124,124,0
9,23,2018,20,0,8,"Braga",2,"Avenida Central",25,25,0,124,124,0
9,23,2018,20,0,8,"Braga",3,"Rua de Caires",36,36,0,37,37,0
9,23,2018,20,0,8,"Braga",4,"N14 Bosch",47,47,0,48,48,0
9,23,2018,20,0,8,"Braga",5,"Avenida João Paulo II",39,39,0,9,9,0
9,23,2018,20,0,8,"Braga",6,"Avenida Padre Júlio Fragata",52,67,15,107,83,24
9,23,2018,20,0,8,"Braga",7,"Rua Nova Santa Cruz",34,44,10,51,39,12
9,23,2018,20,0,8,"Braga",8,"Rua Costa Gomes",0,41,41,-1,42,-43
9,23,2018,21,0,8,"Braga",1,"Avenida da Liberdade",25,25,0,124,124,0
9,23,2018,21,0,8,"Braga",2,"Avenida Central",25,25,0,124,124,0
9,23,2018,21,0,8,"Braga",3,"Rua de Caires",36,36,0,37,37,0
9,23,2018,21,0,8,"Braga",4,"N14 Bosch",47,47,0,48,48,0
9,23,2018,21,0,8,"Braga",5,"Avenida João Paulo II",39,39,0,9,9,0
9,23,2018,21,0,8,"Braga",6,"Avenida Padre Júlio Fragata",67,67,0,83,83,0
9,23,2018,21,0,8,"Braga",7,"Rua Nova Santa Cruz",44,44,0,39,39,0
9,23,2018,21,0,8,"Braga",8,"Rua Costa Gomes",0,41,41,-1,42,-43
9,23,2018,22,0,8,"Braga",1,"Avenida da Liberdade",25,25,0,124,124,0
9,23,2018,22,0,8,"Braga",2,"Avenida Central",25,25,0,124,124,0
9,23,2018,22,0,8,"Braga",3,"Rua de Caires",36,36,0,37,37,0
9,23,2018,22,0,8,"Braga",4,"N14 Bosch",47,47,0,48,48,0
9,23,2018,22,0,8,"Braga",5,"Avenida João Paulo II",39,39,0,9,9,0
9,23,2018,22,0,8,"Braga",6,"Avenida Padre Júlio Fragata",67,67,0,83,83,0
9,23,2018,22,0,8,"Braga",7,"Rua Nova Santa Cruz",44,44,0,39,39,0
9,23,2018,22,0,8,"Braga",8,"Rua Costa Gomes",0,41,41,-1,42,-43
9,23,2018,23,0,8,"Braga",1,"Avenida da Liberdade",25,25,0,124,124,0
9,23,2018,23,0,8,"Braga",2,"Avenida Central",25,25,0,124,124,0
9,23,2018,23,0,8,"Braga",3,"Rua de Caires",36,36,0,37,37,0
9,23,2018,23,0,8,"Braga",4,"N14 Bosch",47,47,0,48,48,0
9,23,2018,23,0,8,"Braga",5,"Avenida João Paulo II",39,39,0,9,9,0
9,23,2018,23,0,8,"Braga",6,"Avenida Padre Júlio Fragata",67,67,0,83,83,0
9,23,2018,23,0,8,"Braga",7,"Rua Nova Santa Cruz",44,44,0,39,39,0
9,23,2018,23,0,8,"Braga",8,"Rua Costa Gomes",0,41,41,-1,42,-43
9,24,2018,0,0,2,"Braga",1,"Avenida da Liberdade",25,25,0,124,124,0
9,24,2018,0,0,2,"Braga",2,"Avenida Central",25,25,0,124,124,0
9,24,2018,0,0,2,"Braga",3,"Rua de Caires",36,36,0,37,37,0
9,24,2018,0,0,2,"Braga",4,"N14 Bosch",47,47,0,48,48,0
9,24,2018,0,0,2,"Braga",5,"Avenida João Paulo II",39,39,0,9,9,0
9,24,2018,0,0,2,"Braga",6,"Avenida Padre Júlio Fragata",67,67,0,83,83,0
9,24,2018,0,0,2,"Braga",7,"Rua Nova Santa Cruz",44,44,0,39,39,0
9,24,2018,0,0,2,"Braga",8,"Rua Costa Gomes",0,41,41,-1,42,-43
9,24,2018,1,0,2,"Braga",1,"Avenida da Liberdade",25,25,0,124,124,0
9,24,2018,1,0,2,"Braga",2,"Avenida Central",25,25,0,124,124,0
9,24,2018,1,0,2,"Braga",3,"Rua de Caires",36,36,0,37,37,0
9,24,2018,1,0,2,"Braga",4,"N14 Bosch",47,47,0,48,48,0
9,24,2018,1,0,2,"Braga",5,"Avenida João Paulo II",39,39,0,9,9,0
9,24,2018,1,0,2,"Braga",6,"Avenida Padre Júlio Fragata",67,67,0,83,83,0
9,24,2018,1,0,2,"Braga",7,"Rua Nova Santa Cruz",44,44,0,39,39,0
9,24,2018,1,0,2,"Braga",8,"Rua Costa Gomes",0,41,41,-1,42,-43
9,24,2018,2,0,2,"Braga",1,"Avenida da Liberdade",25,25,0,124,124,0
9,24,2018,2,0,2,"Braga",2,"Avenida Central",25,25,0,124,124,0
9,24,2018,2,0,2,"Braga",3,"Rua de Caires",36,36,0,37,37,0
9,24,2018,2,0,2,"Braga",4,"N14 Bosch",47,47,0,48,48,0
9,24,2018,2,0,2,"Braga",5,"Avenida João Paulo II",39,39,0,9,9,0
9,24,2018,2,0,2,"Braga",6,"Avenida Padre Júlio Fragata",67,67,0,83,83,0
9,24,2018,2,0,2,"Braga",7,"Rua Nova Santa Cruz",44,44,0,39,39,0
9,24,2018,2,0,2,"Braga",8,"Rua Costa Gomes",0,41,41,-1,42,-43
9,24,2018,3,0,2,"Braga",1,"Avenida da Liberdade",25,25,0,124,124,0
9,24,2018,3,0,2,"Braga",2,"Avenida Central",25,25,0,124,124,0
9,24,2018,3,0,2,"Braga",3,"Rua de Caires",36,36,0,37,37,0
9,24,2018,3,0,2,"Braga",4,"N14 Bosch",47,47,0,48,48,0
9,24,2018,3,0,2,"Braga",5,"Avenida João Paulo II",39,39,0,9,9,0
9,24,2018,3,0,2,"Braga",6,"Avenida Padre Júlio Fragata",67,67,0,83,83,0
9,24,2018,3,0,2,"Braga",7,"Rua Nova Santa Cruz",44,44,0,39,39,0
9,24,2018,3,0,2,"Braga",8,"Rua Costa Gomes",0,41,41,-1,42,-43
9,24,2018,4,0,2,"Braga",1,"Avenida da Liberdade",25,25,0,124,124,0
9,24,2018,4,0,2,"Braga",2,"Avenida Central",25,25,0,124,124,0
9,24,2018,4,0,2,"Braga",3,"Rua de Caires",36,36,0,37,37,0
9,24,2018,4,0,2,"Braga",4,"N14 Bosch",47,47,0,48,48,0
9,24,2018,4,0,2,"Braga",5,"Avenida João Paulo II",39,39,0,9,9,0
9,24,2018,4,0,2,"Braga",6,"Avenida Padre Júlio Fragata",67,67,0,83,83,0
9,24,2018,4,0,2,"Braga",7,"Rua Nova Santa Cruz",44,44,0,39,39,0
9,24,2018,4,0,2,"Braga",8,"Rua Costa Gomes",0,41,41,-1,42,-43
9,24,2018,5,0,2,"Braga",1,"Avenida da Liberdade",25,25,0,124,124,0
9,24,2018,5,0,2,"Braga",2,"Avenida Central",25,25,0,124,124,0
9,24,2018,5,0,2,"Braga",3,"Rua de Caires",36,36,0,37,37,0
9,24,2018,5,0,2,"Braga",4,"N14 Bosch",47,47,0,48,48,0
9,24,2018,5,0,2,"Braga",5,"Avenida João Paulo II",39,39,0,9,9,0
9,24,2018,5,0,2,"Braga",6,"Avenida Padre Júlio Fragata",67,67,0,83,83,0
9,24,2018,5,0,2,"Braga",7,"Rua Nova Santa Cruz",44,44,0,39,39,0
9,24,2018,5,0,2,"Braga",8,"Rua Costa Gomes",0,41,41,-1,42,-43
9,24,2018,6,0,2,"Braga",1,"Avenida da Liberdade",25,25,0,124,124,0
9,24,2018,6,0,2,"Braga",2,"Avenida Central",25,25,0,124,124,0
9,24,2018,6,0,2,"Braga",3,"Rua de Caires",36,36,0,37,37,0
9,24,2018,6,0,2,"Braga",4,"N14 Bosch",47,47,0,48,48,0
9,24,2018,6,0,2,"Braga",5,"Avenida João Paulo II",39,39,0,9,9,0
9,24,2018,6,0,2,"Braga",6,"Avenida Padre Júlio Fragata",67,67,0,83,83,0
9,24,2018,6,0,2,"Braga",7,"Rua Nova Santa Cruz",44,44,0,39,39,0
9,24,2018,6,0,2,"Braga",8,"Rua Costa Gomes",0,41,41,-1,42,-43
9,24,2018,7,0,2,"Braga",1,"Avenida da Liberdade",25,25,0,124,124,0
9,24,2018,7,0,2,"Braga",2,"Avenida Central",25,25,0,124,124,0
9,24,2018,7,0,2,"Braga",3,"Rua de Caires",24,36,12,56,37,19
9,24,2018,7,0,2,"Braga",4,"N14 Bosch",30,47,17,75,48,27
9,24,2018,7,0,2,"Braga",5,"Avenida João Paulo II",39,39,0,9,9,0
9,24,2018,7,0,2,"Braga",6,"Avenida Padre Júlio Fragata",67,67,0,83,83,0
9,24,2018,7,0,2,"Braga",7,"Rua Nova Santa Cruz",44,44,0,39,39,0
9,24,2018,7,0,2,"Braga",8,"Rua Costa Gomes",0,41,41,-1,42,-43
9,24,2018,8,0,2,"Braga",1,"Avenida da Liberdade",12,25,13,258,124,134
9,24,2018,8,0,2,"Braga",2,"Avenida Central",12,25,13,258,124,134
9,24,2018,8,0,2,"Braga",3,"Rua de Caires",20,36,16,67,37,30
9,24,2018,8,0,2,"Braga",4,"N14 Bosch",21,47,26,107,48,59
9,24,2018,8,0,2,"Braga",5,"Avenida João Paulo II",39,39,0,9,9,0
9,24,2018,8,0,2,"Braga",6,"Avenida Padre Júlio Fragata",34,67,33,164,83,81
9,24,2018,8,0,2,"Braga",7,"Rua Nova Santa Cruz",18,44,26,96,39,57
9,24,2018,8,0,2,"Braga",8,"Rua Costa Gomes",0,41,41,-1,42,-43
9,24,2018,9,0,2,"Braga",1,"Avenida da Liberdade",25,25,0,124,124,0
9,24,2018,9,0,2,"Braga",2,"Avenida Central",25,25,0,124,124,0
9,24,2018,9,0,2,"Braga",3,"Rua de Caires",36,36,0,37,37,0
9,24,2018,9,0,2,"Braga",4,"N14 Bosch",30,47,17,75,48,27
9,24,2018,9,0,2,"Braga",5,"Avenida João Paulo II",39,39,0,9,9,0
9,24,2018,9,0,2,"Braga",6,"Avenida Padre Júlio Fragata",67,67,0,83,83,0
9,24,2018,9,0,2,"Braga",7,"Rua Nova Santa Cruz",44,44,0,39,39,0
9,24,2018,9,0,2,"Braga",8,"Rua Costa Gomes",0,41,41,-1,42,-43
9,24,2018,10,0,2,"Braga",1,"Avenida da Liberdade",25,25,0,124,124,0
9,24,2018,10,0,2,"Braga",2,"Avenida Central",25,25,0,124,124,0
9,24,2018,10,0,2,"Braga",3,"Rua de Caires",36,36,0,37,37,0
9,24,2018,10,0,2,"Braga",4,"N14 Bosch",47,47,0,48,48,0
9,24,2018,10,0,2,"Braga",5,"Avenida João Paulo II",39,39,0,9,9,0
9,24,2018,10,0,2,"Braga",6,"Avenida Padre Júlio Fragata",67,67,0,83,83,0
9,24,2018,10,0,2,"Braga",7,"Rua Nova Santa Cruz",29,44,15,60,39,21
9,24,2018,10,0,2,"Braga",8,"Rua Costa Gomes",0,41,41,-1,42,-43
9,24,2018,11,0,2,"Braga",1,"Avenida da Liberdade",19,25,6,163,124,39
9,24,2018,11,0,2,"Braga",2,"Avenida Central",19,25,6,163,124,39
9,24,2018,11,0,2,"Braga",3,"Rua de Caires",20,36,16,67,37,30
9,24,2018,11,0,2,"Braga",4,"N14 Bosch",47,47,0,48,48,0
9,24,2018,11,0,2,"Braga",5,"Avenida João Paulo II",39,39,0,9,9,0
9,24,2018,11,0,2,"Braga",6,"Avenida Padre Júlio Fragata",67,67,0,83,83,0
9,24,2018,11,0,2,"Braga",7,"Rua Nova Santa Cruz",30,44,14,58,39,19
9,24,2018,11,0,2,"Braga",8,"Rua Costa Gomes",0,41,41,-1,42,-43
9,24,2018,12,0,2,"Braga",1,"Avenida da Liberdade",25,25,0,124,124,0
9,24,2018,12,0,2,"Braga",2,"Avenida Central",25,25,0,124,124,0
9,24,2018,12,0,2,"Braga",3,"Rua de Caires",13,36,23,104,37,67
9,24,2018,12,0,2,"Braga",4,"N14 Bosch",35,47,12,64,48,16
9,24,2018,12,0,2,"Braga",5,"Avenida João Paulo II",39,39,0,9,9,0
9,24,2018,12,0,2,"Braga",6,"Avenida Padre Júlio Fragata",67,67,0,83,83,0
9,24,2018,12,0,2,"Braga",7,"Rua Nova Santa Cruz",15,44,29,115,39,76
9,24,2018,12,0,2,"Braga",8,"Rua Costa Gomes",0,41,41,-1,42,-43
9,24,2018,13,0,2,"Braga",1,"Avenida da Liberdade",25,25,0,124,124,0
9,24,2018,13,0,2,"Braga",2,"Avenida Central",25,25,0,124,124,0
9,24,2018,13,0,2,"Braga",3,"Rua de Caires",21,36,15,64,37,27
9,24,2018,13,0,2,"Braga",4,"N14 Bosch",16,47,31,140,48,92
9,24,2018,13,0,2,"Braga",5,"Avenida João Paulo II",39,39,0,9,9,0
9,24,2018,13,0,2,"Braga",6,"Avenida Padre Júlio Fragata",67,67,0,83,83,0
9,24,2018,13,0,2,"Braga",7,"Rua Nova Santa Cruz",25,44,19,69,39,30
9,24,2018,13,0,2,"Braga",8,"Rua Costa Gomes",0,41,41,-1,42,-43
9,24,2018,14,0,2,"Braga",1,"Avenida da Liberdade",19,25,6,163,124,39
9,24,2018,14,0,2,"Braga",2,"Avenida Central",19,25,6,163,124,39
9,24,2018,14,0,2,"Braga",3,"Rua de Caires",16,36,20,84,37,47
9,24,2018,14,0,2,"Braga",4,"N14 Bosch",47,47,0,48,48,0
9,24,2018,14,0,2,"Braga",5,"Avenida João Paulo II",39,39,0,9,9,0
9,24,2018,14,0,2,"Braga",6,"Avenida Padre Júlio Fragata",67,67,0,83,83,0
9,24,2018,14,0,2,"Braga",7,"Rua Nova Santa Cruz",44,44,0,39,39,0
9,24,2018,14,0,2,"Braga",8,"Rua Costa Gomes",0,41,41,-1,42,-43
9,24,2018,15,0,2,"Braga",1,"Avenida da Liberdade",25,25,0,124,124,0
9,24,2018,15,0,2,"Braga",2,"Avenida Central",25,25,0,124,124,0
9,24,2018,15,0,2,"Braga",3,"Rua de Caires",36,36,0,37,37,0
9,24,2018,15,0,2,"Braga",4,"N14 Bosch",47,47,0,48,48,0
9,24,2018,15,0,2,"Braga",5,"Avenida João Paulo II",39,39,0,9,9,0
9,24,2018,15,0,2,"Braga",6,"Avenida Padre Júlio Fragata",67,67,0,83,83,0
9,24,2018,15,0,2,"Braga",7,"Rua Nova Santa Cruz",12,44,32,144,39,105
9,24,2018,15,0,2,"Braga",8,"Rua Costa Gomes",0,41,41,-1,42,-43
9,24,2018,16,0,2,"Braga",1,"Avenida da Liberdade",25,25,0,124,124,0
9,24,2018,16,0,2,"Braga",2,"Avenida Central",25,25,0,124,124,0
9,24,2018,16,0,2,"Braga",3,"Rua de Caires",25,36,11,54,37,17
9,24,2018,16,0,2,"Braga",4,"N14 Bosch",31,47,16,72,48,24
9,24,2018,16,0,2,"Braga",5,"Avenida João Paulo II",39,39,0,9,9,0
9,24,2018,16,0,2,"Braga",6,"Avenida Padre Júlio Fragata",52,67,15,107,83,24
9,24,2018,16,0,2,"Braga",7,"Rua Nova Santa Cruz",21,44,23,82,39,43
9,24,2018,16,0,2,"Braga",8,"Rua Costa Gomes",0,41,41,-1,42,-43
9,24,2018,17,0,2,"Braga",1,"Avenida da Liberdade",8,25,17,387,124,263
9,24,2018,17,0,2,"Braga",2,"Avenida Central",7,25,18,443,124,319
9,24,2018,17,0,2,"Braga",3,"Rua de Caires",22,36,14,61,37,24
9,24,2018,17,0,2,"Braga",4,"N14 Bosch",25,47,22,90,48,42
9,24,2018,17,0,2,"Braga",5,"Avenida João Paulo II",39,39,0,9,9,0
9,24,2018,17,0,2,"Braga",6,"Avenida Padre Júlio Fragata",27,67,40,206,83,123
9,24,2018,17,0,2,"Braga",7,"Rua Nova Santa Cruz",8,44,36,216,39,177
9,24,2018,17,0,2,"Braga",8,"Rua Costa Gomes",0,41,41,-1,42,-43
9,24,2018,18,0,2,"Braga",1,"Avenida da Liberdade",15,25,10,207,124,83
9,24,2018,18,0,2,"Braga",2,"Avenida Central",15,25,10,207,124,83
9,24,2018,18,0,2,"Braga",3,"Rua de Caires",36,36,0,37,37,0
9,24,2018,18,0,2,"Braga",4,"N14 Bosch",11,47,36,204,48,156
9,24,2018,18,0,2,"Braga",5,"Avenida João Paulo II",6,39,33,58,9,49
9,24,2018,18,0,2,"Braga",6,"Avenida Padre Júlio Fragata",16,67,51,348,83,265
9,24,2018,18,0,2,"Braga",7,"Rua Nova Santa Cruz",44,44,0,39,39,0
9,24,2018,18,0,2,"Braga",8,"Rua Costa Gomes",0,41,41,-1,42,-43
9,24,2018,19,0,2,"Braga",1,"Avenida da Liberdade",25,25,0,124,124,0
9,24,2018,19,0,2,"Braga",2,"Avenida Central",25,25,0,124,124,0
9,24,2018,19,0,2,"Braga",3,"Rua de Caires",36,36,0,37,37,0
9,24,2018,19,0,2,"Braga",4,"N14 Bosch",47,47,0,48,48,0
9,24,2018,19,0,2,"Braga",5,"Avenida João Paulo II",39,39,0,9,9,0
9,24,2018,19,0,2,"Braga",6,"Avenida Padre Júlio Fragata",24,67,43,232,83,149
9,24,2018,19,0,2,"Braga",7,"Rua Nova Santa Cruz",3,44,41,576,39,537
9,24,2018,19,0,2,"Braga",8,"Rua Costa Gomes",0,41,41,-1,42,-43
9,24,2018,20,0,2,"Braga",1,"Avenida da Liberdade",25,25,0,124,124,0
9,24,2018,20,0,2,"Braga",2,"Avenida Central",25,25,0,124,124,0
9,24,2018,20,0,2,"Braga",3,"Rua de Caires",36,36,0,37,37,0
9,24,2018,20,0,2,"Braga",4,"N14 Bosch",47,47,0,48,48,0
9,24,2018,20,0,2,"Braga",5,"Avenida João Paulo II",39,39,0,9,9,0
9,24,2018,20,0,2,"Braga",6,"Avenida Padre Júlio Fragata",67,67,0,83,83,0
9,24,2018,20,0,2,"Braga",7,"Rua Nova Santa Cruz",33,44,11,52,39,13
9,24,2018,20,0,2,"Braga",8,"Rua Costa Gomes",0,41,41,-1,42,-43
9,24,2018,21,0,2,"Braga",1,"Avenida da Liberdade",25,25,0,124,124,0
9,24,2018,21,0,2,"Braga",2,"Avenida Central",25,25,0,124,124,0
9,24,2018,21,0,2,"Braga",3,"Rua de Caires",36,36,0,37,37,0
9,24,2018,21,0,2,"Braga",4,"N14 Bosch",47,47,0,48,48,0
9,24,2018,21,0,2,"Braga",5,"Avenida João Paulo II",39,39,0,9,9,0
9,24,2018,21,0,2,"Braga",6,"Avenida Padre Júlio Fragata",67,67,0,83,83,0
9,24,2018,21,0,2,"Braga",7,"Rua Nova Santa Cruz",44,44,0,39,39,0
9,24,2018,21,0,2,"Braga",8,"Rua Costa Gomes",0,41,41,-1,42,-43
9,24,2018,22,0,2,"Braga",1,"Avenida da Liberdade",25,25,0,124,124,0
9,24,2018,22,0,2,"Braga",2,"Avenida Central",25,25,0,124,124,0
9,24,2018,22,0,2,"Braga",3,"Rua de Caires",36,36,0,37,37,0
9,24,2018,22,0,2,"Braga",4,"N14 Bosch",47,47,0,48,48,0
9,24,2018,22,0,2,"Braga",5,"Avenida João Paulo II",39,39,0,9,9,0
9,24,2018,22,0,2,"Braga",6,"Avenida Padre Júlio Fragata",67,67,0,83,83,0
9,24,2018,22,0,2,"Braga",7,"Rua Nova Santa Cruz",44,44,0,39,39,0
9,24,2018,22,0,2,"Braga",8,"Rua Costa Gomes",0,41,41,-1,42,-43
9,24,2018,23,0,2,"Braga",1,"Avenida da Liberdade",25,25,0,124,124,0
9,24,2018,23,0,2,"Braga",2,"Avenida Central",25,25,0,124,124,0
9,24,2018,23,0,2,"Braga",3,"Rua de Caires",36,36,0,37,37,0
9,24,2018,23,0,2,"Braga",4,"N14 Bosch",47,47,0,48,48,0
9,24,2018,23,0,2,"Braga",5,"Avenida João Paulo II",39,39,0,9,9,0
9,24,2018,23,0,2,"Braga",6,"Avenida Padre Júlio Fragata",67,67,0,83,83,0
9,24,2018,23,0,2,"Braga",7,"Rua Nova Santa Cruz",44,44,0,39,39,0
9,24,2018,23,0,2,"Braga",8,"Rua Costa Gomes",0,41,41,-1,42,-43
9,25,2018,0,0,3,"Braga",1,"Avenida da Liberdade",25,25,0,124,124,0
9,25,2018,0,0,3,"Braga",2,"Avenida Central",25,25,0,124,124,0
9,25,2018,0,0,3,"Braga",3,"Rua de Caires",36,36,0,37,37,0
9,25,2018,0,0,3,"Braga",4,"N14 Bosch",47,47,0,48,48,0
9,25,2018,0,0,3,"Braga",5,"Avenida João Paulo II",39,39,0,9,9,0
9,25,2018,0,0,3,"Braga",6,"Avenida Padre Júlio Fragata",67,67,0,83,83,0
9,25,2018,0,0,3,"Braga",7,"Rua Nova Santa Cruz",44,44,0,39,39,0
9,25,2018,0,0,3,"Braga",8,"Rua Costa Gomes",0,41,41,-1,42,-43
9,25,2018,1,0,3,"Braga",1,"Avenida da Liberdade",25,25,0,124,124,0
9,25,2018,1,0,3,"Braga",2,"Avenida Central",25,25,0,124,124,0
9,25,2018,1,0,3,"Braga",3,"Rua de Caires",36,36,0,37,37,0
9,25,2018,1,0,3,"Braga",4,"N14 Bosch",47,47,0,48,48,0
9,25,2018,1,0,3,"Braga",5,"Avenida João Paulo II",39,39,0,9,9,0
9,25,2018,1,0,3,"Braga",6,"Avenida Padre Júlio Fragata",67,67,0,83,83,0
9,25,2018,1,0,3,"Braga",7,"Rua Nova Santa Cruz",44,44,0,39,39,0
9,25,2018,1,0,3,"Braga",8,"Rua Costa Gomes",0,41,41,-1,42,-43
9,25,2018,2,0,3,"Braga",1,"Avenida da Liberdade",25,25,0,124,124,0
9,25,2018,2,0,3,"Braga",2,"Avenida Central",25,25,0,124,124,0
9,25,2018,2,0,3,"Braga",3,"Rua de Caires",36,36,0,37,37,0
9,25,2018,2,0,3,"Braga",4,"N14 Bosch",47,47,0,48,48,0
9,25,2018,2,0,3,"Braga",5,"Avenida João Paulo II",39,39,0,9,9,0
9,25,2018,2,0,3,"Braga",6,"Avenida Padre Júlio Fragata",67,67,0,83,83,0
9,25,2018,2,0,3,"Braga",7,"Rua Nova Santa Cruz",44,44,0,39,39,0
9,25,2018,2,0,3,"Braga",8,"Rua Costa Gomes",0,41,41,-1,42,-43
9,25,2018,3,0,3,"Braga",1,"Avenida da Liberdade",25,25,0,124,124,0
9,25,2018,3,0,3,"Braga",2,"Avenida Central",25,25,0,124,124,0
9,25,2018,3,0,3,"Braga",3,"Rua de Caires",36,36,0,37,37,0
9,25,2018,3,0,3,"Braga",4,"N14 Bosch",47,47,0,48,48,0
9,25,2018,3,0,3,"Braga",5,"Avenida João Paulo II",39,39,0,9,9,0
9,25,2018,3,0,3,"Braga",6,"Avenida Padre Júlio Fragata",67,67,0,83,83,0
9,25,2018,3,0,3,"Braga",7,"Rua Nova Santa Cruz",44,44,0,39,39,0
9,25,2018,3,0,3,"Braga",8,"Rua Costa Gomes",0,41,41,-1,42,-43
9,25,2018,4,0,3,"Braga",1,"Avenida da Liberdade",25,25,0,124,124,0
9,25,2018,4,0,3,"Braga",2,"Avenida Central",25,25,0,124,124,0
9,25,2018,4,0,3,"Braga",3,"Rua de Caires",36,36,0,37,37,0
9,25,2018,4,0,3,"Braga",4,"N14 Bosch",47,47,0,48,48,0
9,25,2018,4,0,3,"Braga",5,"Avenida João Paulo II",39,39,0,9,9,0
9,25,2018,4,0,3,"Braga",6,"Avenida Padre Júlio Fragata",67,67,0,83,83,0
9,25,2018,4,0,3,"Braga",7,"Rua Nova Santa Cruz",44,44,0,39,39,0
9,25,2018,4,0,3,"Braga",8,"Rua Costa Gomes",0,41,41,-1,42,-43
9,25,2018,5,0,3,"Braga",1,"Avenida da Liberdade",25,25,0,124,124,0
9,25,2018,5,0,3,"Braga",2,"Avenida Central",25,25,0,124,124,0
9,25,2018,5,0,3,"Braga",3,"Rua de Caires",36,36,0,37,37,0
9,25,2018,5,0,3,"Braga",4,"N14 Bosch",47,47,0,48,48,0
9,25,2018,5,0,3,"Braga",5,"Avenida João Paulo II",39,39,0,9,9,0
9,25,2018,5,0,3,"Braga",6,"Avenida Padre Júlio Fragata",67,67,0,83,83,0
9,25,2018,5,0,3,"Braga",7,"Rua Nova Santa Cruz",44,44,0,39,39,0
9,25,2018,5,0,3,"Braga",8,"Rua Costa Gomes",0,41,41,-1,42,-43
9,25,2018,6,0,3,"Braga",1,"Avenida da Liberdade",25,25,0,124,124,0
9,25,2018,6,0,3,"Braga",2,"Avenida Central",25,25,0,124,124,0
9,25,2018,6,0,3,"Braga",3,"Rua de Caires",36,36,0,37,37,0
9,25,2018,6,0,3,"Braga",4,"N14 Bosch",47,47,0,48,48,0
9,25,2018,6,0,3,"Braga",5,"Avenida João Paulo II",39,39,0,9,9,0
9,25,2018,6,0,3,"Braga",6,"Avenida Padre Júlio Fragata",67,67,0,83,83,0
9,25,2018,6,0,3,"Braga",7,"Rua Nova Santa Cruz",44,44,0,39,39,0
9,25,2018,6,0,3,"Braga",8,"Rua Costa Gomes",0,41,41,-1,42,-43
9,25,2018,7,0,3,"Braga",1,"Avenida da Liberdade",18,25,7,172,124,48
9,25,2018,7,0,3,"Braga",2,"Avenida Central",18,25,7,172,124,48
9,25,2018,7,0,3,"Braga",3,"Rua de Caires",22,36,14,61,37,24
9,25,2018,7,0,3,"Braga",4,"N14 Bosch",25,47,22,90,48,42
9,25,2018,7,0,3,"Braga",5,"Avenida João Paulo II",39,39,0,9,9,0
9,25,2018,7,0,3,"Braga",6,"Avenida Padre Júlio Fragata",67,67,0,83,83,0
9,25,2018,7,0,3,"Braga",7,"Rua Nova Santa Cruz",30,44,14,58,39,19
9,25,2018,7,0,3,"Braga",8,"Rua Costa Gomes",0,41,41,-1,42,-43
9,25,2018,8,0,3,"Braga",1,"Avenida da Liberdade",14,25,11,221,124,97
9,25,2018,8,0,3,"Braga",2,"Avenida Central",14,25,11,221,124,97
9,25,2018,8,0,3,"Braga",3,"Rua de Caires",26,36,10,52,37,15
9,25,2018,8,0,3,"Braga",4,"N14 Bosch",29,47,18,77,48,29
9,25,2018,8,0,3,"Braga",5,"Avenida João Paulo II",39,39,0,9,9,0
9,25,2018,8,0,3,"Braga",6,"Avenida Padre Júlio Fragata",31,67,36,180,83,97
9,25,2018,8,0,3,"Braga",7,"Rua Nova Santa Cruz",7,44,37,247,39,208
9,25,2018,8,0,3,"Braga",8,"Rua Costa Gomes",0,41,41,-1,42,-43
9,25,2018,9,0,3,"Braga",1,"Avenida da Liberdade",19,25,6,163,124,39
9,25,2018,9,0,3,"Braga",2,"Avenida Central",19,25,6,163,124,39
9,25,2018,9,0,3,"Braga",3,"Rua de Caires",23,36,13,59,37,22
9,25,2018,9,0,3,"Braga",4,"N14 Bosch",31,47,16,72,48,24
9,25,2018,9,0,3,"Braga",5,"Avenida João Paulo II",39,39,0,9,9,0
9,25,2018,9,0,3,"Braga",6,"Avenida Padre Júlio Fragata",67,67,0,83,83,0
9,25,2018,9,0,3,"Braga",7,"Rua Nova Santa Cruz",26,44,18,66,39,27
9,25,2018,9,0,3,"Braga",8,"Rua Costa Gomes",0,41,41,-1,42,-43
9,25,2018,10,0,3,"Braga",1,"Avenida da Liberdade",25,25,0,124,124,0
9,25,2018,10,0,3,"Braga",2,"Avenida Central",25,25,0,124,124,0
9,25,2018,10,0,3,"Braga",3,"Rua de Caires",15,36,21,90,37,53
9,25,2018,10,0,3,"Braga",4,"N14 Bosch",26,47,21,86,48,38
9,25,2018,10,0,3,"Braga",5,"Avenida João Paulo II",39,39,0,9,9,0
9,25,2018,10,0,3,"Braga",6,"Avenida Padre Júlio Fragata",67,67,0,83,83,0
9,25,2018,10,0,3,"Braga",7,"Rua Nova Santa Cruz",44,44,0,39,39,0
9,25,2018,10,0,3,"Braga",8,"Rua Costa Gomes",0,41,41,-1,42,-43
9,25,2018,11,0,3,"Braga",1,"Avenida da Liberdade",19,25,6,163,124,39
9,25,2018,11,0,3,"Braga",2,"Avenida Central",19,25,6,163,124,39
9,25,2018,11,0,3,"Braga",3,"Rua de Caires",36,36,0,37,37,0
9,25,2018,11,0,3,"Braga",4,"N14 Bosch",26,47,21,86,48,38
9,25,2018,11,0,3,"Braga",5,"Avenida João Paulo II",39,39,0,9,9,0
9,25,2018,11,0,3,"Braga",6,"Avenida Padre Júlio Fragata",67,67,0,83,83,0
9,25,2018,11,0,3,"Braga",7,"Rua Nova Santa Cruz",44,44,0,39,39,0
9,25,2018,11,0,3,"Braga",8,"Rua Costa Gomes",0,41,41,-1,42,-43
9,25,2018,12,0,3,"Braga",1,"Avenida da Liberdade",25,25,0,124,124,0
9,25,2018,12,0,3,"Braga",2,"Avenida Central",25,25,0,124,124,0
9,25,2018,12,0,3,"Braga",3,"Rua de Caires",25,36,11,54,37,17
9,25,2018,12,0,3,"Braga",4,"N14 Bosch",27,47,20,83,48,35
9,25,2018,12,0,3,"Braga",5,"Avenida João Paulo II",39,39,0,9,9,0
9,25,2018,12,0,3,"Braga",6,"Avenida Padre Júlio Fragata",67,67,0,83,83,0
9,25,2018,12,0,3,"Braga",7,"Rua Nova Santa Cruz",23,44,21,75,39,36
9,25,2018,12,0,3,"Braga",8,"Rua Costa Gomes",0,41,41,-1,42,-43
9,25,2018,13,0,3,"Braga",1,"Avenida da Liberdade",25,25,0,124,124,0
9,25,2018,13,0,3,"Braga",2,"Avenida Central",25,25,0,124,124,0
9,25,2018,13,0,3,"Braga",3,"Rua de Caires",36,36,0,37,37,0
9,25,2018,13,0,3,"Braga",4,"N14 Bosch",32,47,15,70,48,22
9,25,2018,13,0,3,"Braga",5,"Avenida João Paulo II",39,39,0,9,9,0
9,25,2018,13,0,3,"Braga",6,"Avenida Padre Júlio Fragata",67,67,0,83,83,0
9,25,2018,13,0,3,"Braga",7,"Rua Nova Santa Cruz",6,44,38,288,39,249
9,25,2018,13,0,3,"Braga",8,"Rua Costa Gomes",0,41,41,-1,42,-43
9,25,2018,14,0,3,"Braga",1,"Avenida da Liberdade",25,25,0,124,124,0
9,25,2018,14,0,3,"Braga",2,"Avenida Central",25,25,0,124,124,0
9,25,2018,14,0,3,"Braga",3,"Rua de Caires",19,36,17,71,37,34
9,25,2018,14,0,3,"Braga",4,"N14 Bosch",36,47,11,62,48,14
9,25,2018,14,0,3,"Braga",5,"Avenida João Paulo II",39,39,0,9,9,0
9,25,2018,14,0,3,"Braga",6,"Avenida Padre Júlio Fragata",67,67,0,83,83,0
9,25,2018,14,0,3,"Braga",7,"Rua Nova Santa Cruz",44,44,0,39,39,0
9,25,2018,14,0,3,"Braga",8,"Rua Costa Gomes",0,41,41,-1,42,-43
9,25,2018,15,0,3,"Braga",1,"Avenida da Liberdade",17,25,8,182,124,58
9,25,2018,15,0,3,"Braga",2,"Avenida Central",17,25,8,182,124,58
9,25,2018,15,0,3,"Braga",3,"Rua de Caires",36,36,0,37,37,0
9,25,2018,15,0,3,"Braga",4,"N14 Bosch",47,47,0,48,48,0
9,25,2018,15,0,3,"Braga",5,"Avenida João Paulo II",39,39,0,9,9,0
9,25,2018,15,0,3,"Braga",6,"Avenida Padre Júlio Fragata",67,67,0,83,83,0
9,25,2018,15,0,3,"Braga",7,"Rua Nova Santa Cruz",32,44,12,54,39,15
9,25,2018,15,0,3,"Braga",8,"Rua Costa Gomes",0,41,41,-1,42,-43
9,25,2018,16,0,3,"Braga",1,"Avenida da Liberdade",19,25,6,163,124,39
9,25,2018,16,0,3,"Braga",2,"Avenida Central",19,25,6,163,124,39
9,25,2018,16,0,3,"Braga",3,"Rua de Caires",36,36,0,37,37,0
9,25,2018,16,0,3,"Braga",4,"N14 Bosch",47,47,0,48,48,0
9,25,2018,16,0,3,"Braga",5,"Avenida João Paulo II",39,39,0,9,9,0
9,25,2018,16,0,3,"Braga",6,"Avenida Padre Júlio Fragata",53,67,14,105,83,22
9,25,2018,16,0,3,"Braga",7,"Rua Nova Santa Cruz",23,44,21,75,39,36
9,25,2018,16,0,3,"Braga",8,"Rua Costa Gomes",0,41,41,-1,42,-43
9,25,2018,17,0,3,"Braga",1,"Avenida da Liberdade",11,25,14,282,124,158
9,25,2018,17,0,3,"Braga",2,"Avenida Central",11,25,14,282,124,158
9,25,2018,17,0,3,"Braga",3,"Rua de Caires",36,36,0,37,37,0
9,25,2018,17,0,3,"Braga",4,"N14 Bosch",12,47,35,187,48,139
9,25,2018,17,0,3,"Braga",5,"Avenida João Paulo II",29,39,10,12,9,3
9,25,2018,17,0,3,"Braga",6,"Avenida Padre Júlio Fragata",30,67,37,186,83,103
9,25,2018,17,0,3,"Braga",7,"Rua Nova Santa Cruz",4,44,40,432,39,393
9,25,2018,17,0,3,"Braga",8,"Rua Costa Gomes",0,41,41,-1,42,-43
9,25,2018,18,0,3,"Braga",1,"Avenida da Liberdade",17,25,8,182,124,58
9,25,2018,18,0,3,"Braga",2,"Avenida Central",25,25,0,124,124,0
9,25,2018,18,0,3,"Braga",3,"Rua de Caires",36,36,0,37,37,0
9,25,2018,18,0,3,"Braga",4,"N14 Bosch",14,47,33,160,48,112
9,25,2018,18,0,3,"Braga",5,"Avenida João Paulo II",5,39,34,70,9,61
9,25,2018,18,0,3,"Braga",6,"Avenida Padre Júlio Fragata",20,67,47,279,83,196
9,25,2018,18,0,3,"Braga",7,"Rua Nova Santa Cruz",13,44,31,133,39,94
9,25,2018,18,0,3,"Braga",8,"Rua Costa Gomes",0,41,41,-1,42,-43
9,25,2018,19,0,3,"Braga",1,"Avenida da Liberdade",25,25,0,124,124,0
9,25,2018,19,0,3,"Braga",2,"Avenida Central",25,25,0,124,124,0
9,25,2018,19,0,3,"Braga",3,"Rua de Caires",36,36,0,37,37,0
9,25,2018,19,0,3,"Braga",4,"N14 Bosch",30,47,17,75,48,27
9,25,2018,19,0,3,"Braga",5,"Avenida João Paulo II",28,39,11,12,9,3
9,25,2018,19,0,3,"Braga",6,"Avenida Padre Júlio Fragata",47,67,20,119,83,36
9,25,2018,19,0,3,"Braga",7,"Rua Nova Santa Cruz",16,44,28,108,39,69
9,25,2018,19,0,3,"Braga",8,"Rua Costa Gomes",0,41,41,-1,42,-43
9,25,2018,20,0,3,"Braga",1,"Avenida da Liberdade",25,25,0,124,124,0
9,25,2018,20,0,3,"Braga",2,"Avenida Central",25,25,0,124,124,0
9,25,2018,20,0,3,"Braga",3,"Rua de Caires",27,36,9,50,37,13
9,25,2018,20,0,3,"Braga",4,"N14 Bosch",47,47,0,48,48,0
9,25,2018,20,0,3,"Braga",5,"Avenida João Paulo II",39,39,0,9,9,0
9,25,2018,20,0,3,"Braga",6,"Avenida Padre Júlio Fragata",67,67,0,83,83,0
9,25,2018,20,0,3,"Braga",7,"Rua Nova Santa Cruz",44,44,0,39,39,0
9,25,2018,20,0,3,"Braga",8,"Rua Costa Gomes",0,41,41,-1,42,-43
9,25,2018,21,0,3,"Braga",1,"Avenida da Liberdade",25,25,0,124,124,0
9,25,2018,21,0,3,"Braga",2,"Avenida Central",25,25,0,124,124,0
9,25,2018,21,0,3,"Braga",3,"Rua de Caires",36,36,0,37,37,0
9,25,2018,21,0,3,"Braga",4,"N14 Bosch",47,47,0,48,48,0
9,25,2018,21,0,3,"Braga",5,"Avenida João Paulo II",39,39,0,9,9,0
9,25,2018,21,0,3,"Braga",6,"Avenida Padre Júlio Fragata",67,67,0,83,83,0
9,25,2018,21,0,3,"Braga",7,"Rua Nova Santa Cruz",44,44,0,39,39,0
9,25,2018,21,0,3,"Braga",8,"Rua Costa Gomes",0,41,41,-1,42,-43
9,25,2018,22,0,3,"Braga",1,"Avenida da Liberdade",18,25,7,172,124,48
9,25,2018,22,0,3,"Braga",2,"Avenida Central",18,25,7,172,124,48
9,25,2018,22,0,3,"Braga",3,"Rua de Caires",36,36,0,37,37,0
9,25,2018,22,0,3,"Braga",4,"N14 Bosch",47,47,0,48,48,0
9,25,2018,22,0,3,"Braga",5,"Avenida João Paulo II",39,39,0,9,9,0
9,25,2018,22,0,3,"Braga",6,"Avenida Padre Júlio Fragata",67,67,0,83,83,0
9,25,2018,22,0,3,"Braga",7,"Rua Nova Santa Cruz",44,44,0,39,39,0
9,25,2018,22,0,3,"Braga",8,"Rua Costa Gomes",0,41,41,-1,42,-43
9,25,2018,23,0,3,"Braga",1,"Avenida da Liberdade",25,25,0,124,124,0
9,25,2018,23,0,3,"Braga",2,"Avenida Central",25,25,0,124,124,0
9,25,2018,23,0,3,"Braga",3,"Rua de Caires",36,36,0,37,37,0
9,25,2018,23,0,3,"Braga",4,"N14 Bosch",47,47,0,48,48,0
9,25,2018,23,0,3,"Braga",5,"Avenida João Paulo II",39,39,0,9,9,0
9,25,2018,23,0,3,"Braga",6,"Avenida Padre Júlio Fragata",67,67,0,83,83,0
9,25,2018,23,0,3,"Braga",7,"Rua Nova Santa Cruz",44,44,0,39,39,0
9,25,2018,23,0,3,"Braga",8,"Rua Costa Gomes",0,41,41,-1,42,-43
9,26,2018,0,0,4,"Braga",1,"Avenida da Liberdade",25,25,0,124,124,0
9,26,2018,0,0,4,"Braga",2,"Avenida Central",25,25,0,124,124,0
9,26,2018,0,0,4,"Braga",3,"Rua de Caires",36,36,0,37,37,0
9,26,2018,0,0,4,"Braga",4,"N14 Bosch",47,47,0,48,48,0
9,26,2018,0,0,4,"Braga",5,"Avenida João Paulo II",39,39,0,9,9,0
9,26,2018,0,0,4,"Braga",6,"Avenida Padre Júlio Fragata",67,67,0,83,83,0
9,26,2018,0,0,4,"Braga",7,"Rua Nova Santa Cruz",44,44,0,39,39,0
9,26,2018,0,0,4,"Braga",8,"Rua Costa Gomes",0,41,41,-1,42,-43
9,26,2018,1,0,4,"Braga",1,"Avenida da Liberdade",25,25,0,124,124,0
9,26,2018,1,0,4,"Braga",2,"Avenida Central",25,25,0,124,124,0
9,26,2018,1,0,4,"Braga",3,"Rua de Caires",36,36,0,37,37,0
9,26,2018,1,0,4,"Braga",4,"N14 Bosch",47,47,0,48,48,0
9,26,2018,1,0,4,"Braga",5,"Avenida João Paulo II",39,39,0,9,9,0
9,26,2018,1,0,4,"Braga",6,"Avenida Padre Júlio Fragata",67,67,0,83,83,0
9,26,2018,1,0,4,"Braga",7,"Rua Nova Santa Cruz",44,44,0,39,39,0
9,26,2018,1,0,4,"Braga",8,"Rua Costa Gomes",0,41,41,-1,42,-43
9,26,2018,2,0,4,"Braga",1,"Avenida da Liberdade",25,25,0,124,124,0
9,26,2018,2,0,4,"Braga",2,"Avenida Central",25,25,0,124,124,0
9,26,2018,2,0,4,"Braga",3,"Rua de Caires",36,36,0,37,37,0
9,26,2018,2,0,4,"Braga",4,"N14 Bosch",47,47,0,48,48,0
9,26,2018,2,0,4,"Braga",5,"Avenida João Paulo II",39,39,0,9,9,0
9,26,2018,2,0,4,"Braga",6,"Avenida Padre Júlio Fragata",67,67,0,83,83,0
9,26,2018,2,0,4,"Braga",7,"Rua Nova Santa Cruz",44,44,0,39,39,0
9,26,2018,2,0,4,"Braga",8,"Rua Costa Gomes",0,41,41,-1,42,-43
9,26,2018,3,0,4,"Braga",1,"Avenida da Liberdade",25,25,0,124,124,0
9,26,2018,3,0,4,"Braga",2,"Avenida Central",25,25,0,124,124,0
9,26,2018,3,0,4,"Braga",3,"Rua de Caires",36,36,0,37,37,0
9,26,2018,3,0,4,"Braga",4,"N14 Bosch",47,47,0,48,48,0
9,26,2018,3,0,4,"Braga",5,"Avenida João Paulo II",39,39,0,9,9,0
9,26,2018,3,0,4,"Braga",6,"Avenida Padre Júlio Fragata",67,67,0,83,83,0
9,26,2018,3,0,4,"Braga",7,"Rua Nova Santa Cruz",44,44,0,39,39,0
9,26,2018,3,0,4,"Braga",8,"Rua Costa Gomes",0,41,41,-1,42,-43
9,26,2018,4,0,4,"Braga",1,"Avenida da Liberdade",25,25,0,124,124,0
9,26,2018,4,0,4,"Braga",2,"Avenida Central",25,25,0,124,124,0
9,26,2018,4,0,4,"Braga",3,"Rua de Caires",36,36,0,37,37,0
9,26,2018,4,0,4,"Braga",4,"N14 Bosch",47,47,0,48,48,0
9,26,2018,4,0,4,"Braga",5,"Avenida João Paulo II",39,39,0,9,9,0
9,26,2018,4,0,4,"Braga",6,"Avenida Padre Júlio Fragata",67,67,0,83,83,0
9,26,2018,4,0,4,"Braga",7,"Rua Nova Santa Cruz",44,44,0,39,39,0
9,26,2018,4,0,4,"Braga",8,"Rua Costa Gomes",0,41,41,-1,42,-43
9,26,2018,5,0,4,"Braga",1,"Avenida da Liberdade",25,25,0,124,124,0
9,26,2018,5,0,4,"Braga",2,"Avenida Central",25,25,0,124,124,0
9,26,2018,5,0,4,"Braga",3,"Rua de Caires",36,36,0,37,37,0
9,26,2018,5,0,4,"Braga",4,"N14 Bosch",47,47,0,48,48,0
9,26,2018,5,0,4,"Braga",5,"Avenida João Paulo II",39,39,0,9,9,0
9,26,2018,5,0,4,"Braga",6,"Avenida Padre Júlio Fragata",67,67,0,83,83,0
9,26,2018,5,0,4,"Braga",7,"Rua Nova Santa Cruz",44,44,0,39,39,0
9,26,2018,5,0,4,"Braga",8,"Rua Costa Gomes",0,41,41,-1,42,-43
9,26,2018,6,0,4,"Braga",1,"Avenida da Liberdade",25,25,0,124,124,0
9,26,2018,6,0,4,"Braga",2,"Avenida Central",25,25,0,124,124,0
9,26,2018,6,0,4,"Braga",3,"Rua de Caires",36,36,0,37,37,0
9,26,2018,6,0,4,"Braga",4,"N14 Bosch",47,47,0,48,48,0
9,26,2018,6,0,4,"Braga",5,"Avenida João Paulo II",39,39,0,9,9,0
9,26,2018,6,0,4,"Braga",6,"Avenida Padre Júlio Fragata",67,67,0,83,83,0
9,26,2018,6,0,4,"Braga",7,"Rua Nova Santa Cruz",44,44,0,39,39,0
9,26,2018,6,0,4,"Braga",8,"Rua Costa Gomes",0,41,41,-1,42,-43
9,26,2018,7,0,4,"Braga",1,"Avenida da Liberdade",25,25,0,124,124,0
9,26,2018,7,0,4,"Braga",2,"Avenida Central",25,25,0,124,124,0
9,26,2018,7,0,4,"Braga",3,"Rua de Caires",22,36,14,61,37,24
9,26,2018,7,0,4,"Braga",4,"N14 Bosch",30,47,17,75,48,27
9,26,2018,7,0,4,"Braga",5,"Avenida João Paulo II",39,39,0,9,9,0
9,26,2018,7,0,4,"Braga",6,"Avenida Padre Júlio Fragata",67,67,0,83,83,0
9,26,2018,7,0,4,"Braga",7,"Rua Nova Santa Cruz",44,44,0,39,39,0
9,26,2018,7,0,4,"Braga",8,"Rua Costa Gomes",0,41,41,-1,42,-43
9,26,2018,8,0,4,"Braga",1,"Avenida da Liberdade",19,25,6,163,124,39
9,26,2018,8,0,4,"Braga",2,"Avenida Central",25,25,0,124,124,0
9,26,2018,8,0,4,"Braga",3,"Rua de Caires",22,36,14,61,37,24
9,26,2018,8,0,4,"Braga",4,"N14 Bosch",26,47,21,86,48,38
9,26,2018,8,0,4,"Braga",5,"Avenida João Paulo II",29,39,10,12,9,3
9,26,2018,8,0,4,"Braga",6,"Avenida Padre Júlio Fragata",36,67,31,155,83,72
9,26,2018,8,0,4,"Braga",7,"Rua Nova Santa Cruz",18,44,26,96,39,57
9,26,2018,8,0,4,"Braga",8,"Rua Costa Gomes",0,41,41,-1,42,-43
9,26,2018,9,0,4,"Braga",1,"Avenida da Liberdade",19,25,6,163,124,39
9,26,2018,9,0,4,"Braga",2,"Avenida Central",19,25,6,163,124,39
9,26,2018,9,0,4,"Braga",3,"Rua de Caires",27,36,9,50,37,13
9,26,2018,9,0,4,"Braga",4,"N14 Bosch",47,47,0,48,48,0
9,26,2018,9,0,4,"Braga",5,"Avenida João Paulo II",39,39,0,9,9,0
9,26,2018,9,0,4,"Braga",6,"Avenida Padre Júlio Fragata",67,67,0,83,83,0
9,26,2018,9,0,4,"Braga",7,"Rua Nova Santa Cruz",16,44,28,108,39,69
9,26,2018,9,0,4,"Braga",8,"Rua Costa Gomes",0,41,41,-1,42,-43
9,26,2018,10,0,4,"Braga",1,"Avenida da Liberdade",25,25,0,124,124,0
9,26,2018,10,0,4,"Braga",2,"Avenida Central",25,25,0,124,124,0
9,26,2018,10,0,4,"Braga",3,"Rua de Caires",36,36,0,37,37,0
9,26,2018,10,0,4,"Braga",4,"N14 Bosch",32,47,15,70,48,22
9,26,2018,10,0,4,"Braga",5,"Avenida João Paulo II",39,39,0,9,9,0
9,26,2018,10,0,4,"Braga",6,"Avenida Padre Júlio Fragata",52,67,15,107,83,24
9,26,2018,10,0,4,"Braga",7,"Rua Nova Santa Cruz",21,44,23,82,39,43
9,26,2018,10,0,4,"Braga",8,"Rua Costa Gomes",0,41,41,-1,42,-43
9,26,2018,11,0,4,"Braga",1,"Avenida da Liberdade",25,25,0,124,124,0
9,26,2018,11,0,4,"Braga",2,"Avenida Central",25,25,0,124,124,0
9,26,2018,11,0,4,"Braga",3,"Rua de Caires",36,36,0,37,37,0
9,26,2018,11,0,4,"Braga",4,"N14 Bosch",47,47,0,48,48,0
9,26,2018,11,0,4,"Braga",5,"Avenida João Paulo II",39,39,0,9,9,0
9,26,2018,11,0,4,"Braga",6,"Avenida Padre Júlio Fragata",67,67,0,83,83,0
9,26,2018,11,0,4,"Braga",7,"Rua Nova Santa Cruz",44,44,0,39,39,0
9,26,2018,11,0,4,"Braga",8,"Rua Costa Gomes",0,41,41,-1,42,-43
9,26,2018,12,0,4,"Braga",1,"Avenida da Liberdade",19,25,6,163,124,39
9,26,2018,12,0,4,"Braga",2,"Avenida Central",19,25,6,163,124,39
9,26,2018,12,0,4,"Braga",3,"Rua de Caires",36,36,0,37,37,0
9,26,2018,12,0,4,"Braga",4,"N14 Bosch",36,47,11,62,48,14
9,26,2018,12,0,4,"Braga",5,"Avenida João Paulo II",27,39,12,13,9,4
9,26,2018,12,0,4,"Braga",6,"Avenida Padre Júlio Fragata",67,67,0,83,83,0
9,26,2018,12,0,4,"Braga",7,"Rua Nova Santa Cruz",10,44,34,173,39,134
9,26,2018,12,0,4,"Braga",8,"Rua Costa Gomes",0,41,41,-1,42,-43
9,26,2018,13,0,4,"Braga",1,"Avenida da Liberdade",25,25,0,124,124,0
9,26,2018,13,0,4,"Braga",2,"Avenida Central",25,25,0,124,124,0
9,26,2018,13,0,4,"Braga",3,"Rua de Caires",22,36,14,61,37,24
9,26,2018,13,0,4,"Braga",4,"N14 Bosch",36,47,11,62,48,14
9,26,2018,13,0,4,"Braga",5,"Avenida João Paulo II",39,39,0,9,9,0
9,26,2018,13,0,4,"Braga",6,"Avenida Padre Júlio Fragata",67,67,0,83,83,0
9,26,2018,13,0,4,"Braga",7,"Rua Nova Santa Cruz",18,44,26,96,39,57
9,26,2018,13,0,4,"Braga",8,"Rua Costa Gomes",0,41,41,-1,42,-43
9,26,2018,14,0,4,"Braga",1,"Avenida da Liberdade",25,25,0,124,124,0
9,26,2018,14,0,4,"Braga",2,"Avenida Central",25,25,0,124,124,0
9,26,2018,14,0,4,"Braga",3,"Rua de Caires",28,36,8,48,37,11
9,26,2018,14,0,4,"Braga",4,"N14 Bosch",31,47,16,72,48,24
9,26,2018,14,0,4,"Braga",5,"Avenida João Paulo II",39,39,0,9,9,0
9,26,2018,14,0,4,"Braga",6,"Avenida Padre Júlio Fragata",67,67,0,83,83,0
9,26,2018,14,0,4,"Braga",7,"Rua Nova Santa Cruz",44,44,0,39,39,0
9,26,2018,14,0,4,"Braga",8,"Rua Costa Gomes",0,41,41,-1,42,-43
9,26,2018,15,0,4,"Braga",1,"Avenida da Liberdade",19,25,6,163,124,39
9,26,2018,15,0,4,"Braga",2,"Avenida Central",19,25,6,163,124,39
9,26,2018,15,0,4,"Braga",3,"Rua de Caires",21,36,15,64,37,27
9,26,2018,15,0,4,"Braga",4,"N14 Bosch",34,47,13,66,48,18
9,26,2018,15,0,4,"Braga",5,"Avenida João Paulo II",39,39,0,9,9,0
9,26,2018,15,0,4,"Braga",6,"Avenida Padre Júlio Fragata",67,67,0,83,83,0
9,26,2018,15,0,4,"Braga",7,"Rua Nova Santa Cruz",27,44,17,64,39,25
9,26,2018,15,0,4,"Braga",8,"Rua Costa Gomes",0,41,41,-1,42,-43
9,26,2018,16,0,4,"Braga",1,"Avenida da Liberdade",17,25,8,182,124,58
9,26,2018,16,0,4,"Braga",2,"Avenida Central",17,25,8,182,124,58
9,26,2018,16,0,4,"Braga",3,"Rua de Caires",25,36,11,54,37,17
9,26,2018,16,0,4,"Braga",4,"N14 Bosch",31,47,16,72,48,24
9,26,2018,16,0,4,"Braga",5,"Avenida João Paulo II",39,39,0,9,9,0
9,26,2018,16,0,4,"Braga",6,"Avenida Padre Júlio Fragata",67,67,0,83,83,0
9,26,2018,16,0,4,"Braga",7,"Rua Nova Santa Cruz",27,44,17,64,39,25
9,26,2018,16,0,4,"Braga",8,"Rua Costa Gomes",0,41,41,-1,42,-43
9,26,2018,17,0,4,"Braga",1,"Avenida da Liberdade",17,25,8,182,124,58
9,26,2018,17,0,4,"Braga",2,"Avenida Central",16,25,9,194,124,70
9,26,2018,17,0,4,"Braga",3,"Rua de Caires",36,36,0,37,37,0
9,26,2018,17,0,4,"Braga",4,"N14 Bosch",16,47,31,140,48,92
9,26,2018,17,0,4,"Braga",5,"Avenida João Paulo II",7,39,32,50,9,41
9,26,2018,17,0,4,"Braga",6,"Avenida Padre Júlio Fragata",41,67,26,136,83,53
9,26,2018,17,0,4,"Braga",7,"Rua Nova Santa Cruz",16,44,28,108,39,69
9,26,2018,17,0,4,"Braga",8,"Rua Costa Gomes",0,41,41,-1,42,-43
9,26,2018,18,0,4,"Braga",1,"Avenida da Liberdade",16,25,9,194,124,70
9,26,2018,18,0,4,"Braga",2,"Avenida Central",16,25,9,194,124,70
9,26,2018,18,0,4,"Braga",3,"Rua de Caires",15,36,21,90,37,53
9,26,2018,18,0,4,"Braga",4,"N14 Bosch",22,47,25,102,48,54
9,26,2018,18,0,4,"Braga",5,"Avenida João Paulo II",39,39,0,9,9,0
9,26,2018,18,0,4,"Braga",6,"Avenida Padre Júlio Fragata",23,67,44,242,83,159
9,26,2018,18,0,4,"Braga",7,"Rua Nova Santa Cruz",18,44,26,96,39,57
9,26,2018,18,0,4,"Braga",8,"Rua Costa Gomes",0,41,41,-1,42,-43
9,26,2018,19,0,4,"Braga",1,"Avenida da Liberdade",18,25,7,172,124,48
9,26,2018,19,0,4,"Braga",2,"Avenida Central",18,25,7,172,124,48
9,26,2018,19,0,4,"Braga",3,"Rua de Caires",27,36,9,50,37,13
9,26,2018,19,0,4,"Braga",4,"N14 Bosch",47,47,0,48,48,0
9,26,2018,19,0,4,"Braga",5,"Avenida João Paulo II",31,39,8,11,9,2
9,26,2018,19,0,4,"Braga",6,"Avenida Padre Júlio Fragata",46,67,21,121,83,38
9,26,2018,19,0,4,"Braga",7,"Rua Nova Santa Cruz",33,44,11,52,39,13
9,26,2018,19,0,4,"Braga",8,"Rua Costa Gomes",0,41,41,-1,42,-43
9,26,2018,20,0,4,"Braga",1,"Avenida da Liberdade",25,25,0,124,124,0
9,26,2018,20,0,4,"Braga",2,"Avenida Central",25,25,0,124,124,0
9,26,2018,20,0,4,"Braga",3,"Rua de Caires",36,36,0,37,37,0
9,26,2018,20,0,4,"Braga",4,"N14 Bosch",47,47,0,48,48,0
9,26,2018,20,0,4,"Braga",5,"Avenida João Paulo II",39,39,0,9,9,0
9,26,2018,20,0,4,"Braga",6,"Avenida Padre Júlio Fragata",52,67,15,107,83,24
9,26,2018,20,0,4,"Braga",7,"Rua Nova Santa Cruz",18,44,26,96,39,57
9,26,2018,20,0,4,"Braga",8,"Rua Costa Gomes",0,41,41,-1,42,-43
9,26,2018,21,0,4,"Braga",1,"Avenida da Liberdade",25,25,0,124,124,0
9,26,2018,21,0,4,"Braga",2,"Avenida Central",25,25,0,124,124,0
9,26,2018,21,0,4,"Braga",3,"Rua de Caires",36,36,0,37,37,0
9,26,2018,21,0,4,"Braga",4,"N14 Bosch",47,47,0,48,48,0
9,26,2018,21,0,4,"Braga",5,"Avenida João Paulo II",39,39,0,9,9,0
9,26,2018,21,0,4,"Braga",6,"Avenida Padre Júlio Fragata",67,67,0,83,83,0
9,26,2018,21,0,4,"Braga",7,"Rua Nova Santa Cruz",34,44,10,51,39,12
9,26,2018,21,0,4,"Braga",8,"Rua Costa Gomes",0,41,41,-1,42,-43
9,26,2018,22,0,4,"Braga",1,"Avenida da Liberdade",25,25,0,124,124,0
9,26,2018,22,0,4,"Braga",2,"Avenida Central",25,25,0,124,124,0
9,26,2018,22,0,4,"Braga",3,"Rua de Caires",36,36,0,37,37,0
9,26,2018,22,0,4,"Braga",4,"N14 Bosch",47,47,0,48,48,0
9,26,2018,22,0,4,"Braga",5,"Avenida João Paulo II",39,39,0,9,9,0
9,26,2018,22,0,4,"Braga",6,"Avenida Padre Júlio Fragata",67,67,0,83,83,0
9,26,2018,22,0,4,"Braga",7,"Rua Nova Santa Cruz",44,44,0,39,39,0
9,26,2018,22,0,4,"Braga",8,"Rua Costa Gomes",0,41,41,-1,42,-43
9,26,2018,23,0,4,"Braga",1,"Avenida da Liberdade",25,25,0,124,124,0
9,26,2018,23,0,4,"Braga",2,"Avenida Central",25,25,0,124,124,0
9,26,2018,23,0,4,"Braga",3,"Rua de Caires",36,36,0,37,37,0
9,26,2018,23,0,4,"Braga",4,"N14 Bosch",47,47,0,48,48,0
9,26,2018,23,0,4,"Braga",5,"Avenida João Paulo II",39,39,0,9,9,0
9,26,2018,23,0,4,"Braga",6,"Avenida Padre Júlio Fragata",67,67,0,83,83,0
9,26,2018,23,0,4,"Braga",7,"Rua Nova Santa Cruz",44,44,0,39,39,0
9,26,2018,23,0,4,"Braga",8,"Rua Costa Gomes",0,41,41,-1,42,-43
9,27,2018,0,0,5,"Braga",1,"Avenida da Liberdade",25,25,0,124,124,0
9,27,2018,0,0,5,"Braga",2,"Avenida Central",25,25,0,124,124,0
9,27,2018,0,0,5,"Braga",3,"Rua de Caires",36,36,0,37,37,0
9,27,2018,0,0,5,"Braga",4,"N14 Bosch",47,47,0,48,48,0
9,27,2018,0,0,5,"Braga",5,"Avenida João Paulo II",39,39,0,9,9,0
9,27,2018,0,0,5,"Braga",6,"Avenida Padre Júlio Fragata",67,67,0,83,83,0
9,27,2018,0,0,5,"Braga",7,"Rua Nova Santa Cruz",44,44,0,39,39,0
9,27,2018,0,0,5,"Braga",8,"Rua Costa Gomes",0,41,41,-1,42,-43
9,27,2018,1,0,5,"Braga",1,"Avenida da Liberdade",25,25,0,124,124,0
9,27,2018,1,0,5,"Braga",2,"Avenida Central",25,25,0,124,124,0
9,27,2018,1,0,5,"Braga",3,"Rua de Caires",36,36,0,37,37,0
9,27,2018,1,0,5,"Braga",4,"N14 Bosch",47,47,0,48,48,0
9,27,2018,1,0,5,"Braga",5,"Avenida João Paulo II",39,39,0,9,9,0
9,27,2018,1,0,5,"Braga",6,"Avenida Padre Júlio Fragata",67,67,0,83,83,0
9,27,2018,1,0,5,"Braga",7,"Rua Nova Santa Cruz",44,44,0,39,39,0
9,27,2018,1,0,5,"Braga",8,"Rua Costa Gomes",0,41,41,-1,42,-43
9,27,2018,2,0,5,"Braga",1,"Avenida da Liberdade",25,25,0,124,124,0
9,27,2018,2,0,5,"Braga",2,"Avenida Central",25,25,0,124,124,0
9,27,2018,2,0,5,"Braga",3,"Rua de Caires",36,36,0,37,37,0
9,27,2018,2,0,5,"Braga",4,"N14 Bosch",47,47,0,48,48,0
9,27,2018,2,0,5,"Braga",5,"Avenida João Paulo II",39,39,0,9,9,0
9,27,2018,2,0,5,"Braga",6,"Avenida Padre Júlio Fragata",67,67,0,83,83,0
9,27,2018,2,0,5,"Braga",7,"Rua Nova Santa Cruz",44,44,0,39,39,0
9,27,2018,2,0,5,"Braga",8,"Rua Costa Gomes",0,41,41,-1,42,-43
9,27,2018,3,0,5,"Braga",1,"Avenida da Liberdade",25,25,0,124,124,0
9,27,2018,3,0,5,"Braga",2,"Avenida Central",25,25,0,124,124,0
9,27,2018,3,0,5,"Braga",3,"Rua de Caires",36,36,0,37,37,0
9,27,2018,3,0,5,"Braga",4,"N14 Bosch",47,47,0,48,48,0
9,27,2018,3,0,5,"Braga",5,"Avenida João Paulo II",39,39,0,9,9,0
9,27,2018,3,0,5,"Braga",6,"Avenida Padre Júlio Fragata",67,67,0,83,83,0
9,27,2018,3,0,5,"Braga",7,"Rua Nova Santa Cruz",44,44,0,39,39,0
9,27,2018,3,0,5,"Braga",8,"Rua Costa Gomes",0,41,41,-1,42,-43
9,27,2018,4,0,5,"Braga",1,"Avenida da Liberdade",25,25,0,124,124,0
9,27,2018,4,0,5,"Braga",2,"Avenida Central",25,25,0,124,124,0
9,27,2018,4,0,5,"Braga",3,"Rua de Caires",36,36,0,37,37,0
9,27,2018,4,0,5,"Braga",4,"N14 Bosch",47,47,0,48,48,0
9,27,2018,4,0,5,"Braga",5,"Avenida João Paulo II",39,39,0,9,9,0
9,27,2018,4,0,5,"Braga",6,"Avenida Padre Júlio Fragata",67,67,0,83,83,0
9,27,2018,4,0,5,"Braga",7,"Rua Nova Santa Cruz",44,44,0,39,39,0
9,27,2018,4,0,5,"Braga",8,"Rua Costa Gomes",0,41,41,-1,42,-43
9,27,2018,5,0,5,"Braga",1,"Avenida da Liberdade",25,25,0,124,124,0
9,27,2018,5,0,5,"Braga",2,"Avenida Central",25,25,0,124,124,0
9,27,2018,5,0,5,"Braga",3,"Rua de Caires",36,36,0,37,37,0
9,27,2018,5,0,5,"Braga",4,"N14 Bosch",47,47,0,48,48,0
9,27,2018,5,0,5,"Braga",5,"Avenida João Paulo II",39,39,0,9,9,0
9,27,2018,5,0,5,"Braga",6,"Avenida Padre Júlio Fragata",67,67,0,83,83,0
9,27,2018,5,0,5,"Braga",7,"Rua Nova Santa Cruz",44,44,0,39,39,0
9,27,2018,5,0,5,"Braga",8,"Rua Costa Gomes",0,41,41,-1,42,-43
9,27,2018,6,0,5,"Braga",1,"Avenida da Liberdade",25,25,0,124,124,0
9,27,2018,6,0,5,"Braga",2,"Avenida Central",25,25,0,124,124,0
9,27,2018,6,0,5,"Braga",3,"Rua de Caires",36,36,0,37,37,0
9,27,2018,6,0,5,"Braga",4,"N14 Bosch",47,47,0,48,48,0
9,27,2018,6,0,5,"Braga",5,"Avenida João Paulo II",39,39,0,9,9,0
9,27,2018,6,0,5,"Braga",6,"Avenida Padre Júlio Fragata",67,67,0,83,83,0
9,27,2018,6,0,5,"Braga",7,"Rua Nova Santa Cruz",44,44,0,39,39,0
9,27,2018,6,0,5,"Braga",8,"Rua Costa Gomes",0,41,41,-1,42,-43
9,27,2018,7,0,5,"Braga",1,"Avenida da Liberdade",25,25,0,124,124,0
9,27,2018,7,0,5,"Braga",2,"Avenida Central",25,25,0,124,124,0
9,27,2018,7,0,5,"Braga",3,"Rua de Caires",26,36,10,52,37,15
9,27,2018,7,0,5,"Braga",4,"N14 Bosch",32,47,15,70,48,22
9,27,2018,7,0,5,"Braga",5,"Avenida João Paulo II",39,39,0,9,9,0
9,27,2018,7,0,5,"Braga",6,"Avenida Padre Júlio Fragata",67,67,0,83,83,0
9,27,2018,7,0,5,"Braga",7,"Rua Nova Santa Cruz",44,44,0,39,39,0
9,27,2018,7,0,5,"Braga",8,"Rua Costa Gomes",0,41,41,-1,42,-43
9,27,2018,8,0,5,"Braga",1,"Avenida da Liberdade",19,25,6,163,124,39
9,27,2018,8,0,5,"Braga",2,"Avenida Central",19,25,6,163,124,39
9,27,2018,8,0,5,"Braga",3,"Rua de Caires",28,36,8,48,37,11
9,27,2018,8,0,5,"Braga",4,"N14 Bosch",31,47,16,72,48,24
9,27,2018,8,0,5,"Braga",5,"Avenida João Paulo II",19,39,20,18,9,9
9,27,2018,8,0,5,"Braga",6,"Avenida Padre Júlio Fragata",46,67,21,121,83,38
9,27,2018,8,0,5,"Braga",7,"Rua Nova Santa Cruz",17,44,27,102,39,63
9,27,2018,8,0,5,"Braga",8,"Rua Costa Gomes",0,41,41,-1,42,-43
9,27,2018,9,0,5,"Braga",1,"Avenida da Liberdade",25,25,0,124,124,0
9,27,2018,9,0,5,"Braga",2,"Avenida Central",25,25,0,124,124,0
9,27,2018,9,0,5,"Braga",3,"Rua de Caires",7,36,29,192,37,155
9,27,2018,9,0,5,"Braga",4,"N14 Bosch",31,47,16,72,48,24
9,27,2018,9,0,5,"Braga",5,"Avenida João Paulo II",39,39,0,9,9,0
9,27,2018,9,0,5,"Braga",6,"Avenida Padre Júlio Fragata",67,67,0,83,83,0
9,27,2018,9,0,5,"Braga",7,"Rua Nova Santa Cruz",30,44,14,58,39,19
9,27,2018,9,0,5,"Braga",8,"Rua Costa Gomes",0,41,41,-1,42,-43
9,27,2018,10,0,5,"Braga",1,"Avenida da Liberdade",25,25,0,124,124,0
9,27,2018,10,0,5,"Braga",2,"Avenida Central",25,25,0,124,124,0
9,27,2018,10,0,5,"Braga",3,"Rua de Caires",28,36,8,48,37,11
9,27,2018,10,0,5,"Braga",4,"N14 Bosch",47,47,0,48,48,0
9,27,2018,10,0,5,"Braga",5,"Avenida João Paulo II",39,39,0,9,9,0
9,27,2018,10,0,5,"Braga",6,"Avenida Padre Júlio Fragata",67,67,0,83,83,0
9,27,2018,10,0,5,"Braga",7,"Rua Nova Santa Cruz",44,44,0,39,39,0
9,27,2018,10,0,5,"Braga",8,"Rua Costa Gomes",0,41,41,-1,42,-43
9,27,2018,11,0,5,"Braga",1,"Avenida da Liberdade",18,25,7,172,124,48
9,27,2018,11,0,5,"Braga",2,"Avenida Central",18,25,7,172,124,48
9,27,2018,11,0,5,"Braga",3,"Rua de Caires",24,36,12,56,37,19
9,27,2018,11,0,5,"Braga",4,"N14 Bosch",47,47,0,48,48,0
9,27,2018,11,0,5,"Braga",5,"Avenida João Paulo II",39,39,0,9,9,0
9,27,2018,11,0,5,"Braga",6,"Avenida Padre Júlio Fragata",67,67,0,83,83,0
9,27,2018,11,0,5,"Braga",7,"Rua Nova Santa Cruz",44,44,0,39,39,0
9,27,2018,11,0,5,"Braga",8,"Rua Costa Gomes",0,41,41,-1,42,-43
9,27,2018,12,0,5,"Braga",1,"Avenida da Liberdade",17,25,8,182,124,58
9,27,2018,12,0,5,"Braga",2,"Avenida Central",17,25,8,182,124,58
9,27,2018,12,0,5,"Braga",3,"Rua de Caires",13,36,23,104,37,67
9,27,2018,12,0,5,"Braga",4,"N14 Bosch",36,47,11,62,48,14
9,27,2018,12,0,5,"Braga",5,"Avenida João Paulo II",39,39,0,9,9,0
9,27,2018,12,0,5,"Braga",6,"Avenida Padre Júlio Fragata",67,67,0,83,83,0
9,27,2018,12,0,5,"Braga",7,"Rua Nova Santa Cruz",11,44,33,157,39,118
9,27,2018,12,0,5,"Braga",8,"Rua Costa Gomes",0,41,41,-1,42,-43
9,27,2018,13,0,5,"Braga",1,"Avenida da Liberdade",25,25,0,124,124,0
9,27,2018,13,0,5,"Braga",2,"Avenida Central",25,25,0,124,124,0
9,27,2018,13,0,5,"Braga",3,"Rua de Caires",36,36,0,37,37,0
9,27,2018,13,0,5,"Braga",4,"N14 Bosch",33,47,14,68,48,20
9,27,2018,13,0,5,"Braga",5,"Avenida João Paulo II",39,39,0,9,9,0
9,27,2018,13,0,5,"Braga",6,"Avenida Padre Júlio Fragata",67,67,0,83,83,0
9,27,2018,13,0,5,"Braga",7,"Rua Nova Santa Cruz",6,44,38,288,39,249
9,27,2018,13,0,5,"Braga",8,"Rua Costa Gomes",0,41,41,-1,42,-43
9,27,2018,14,0,5,"Braga",1,"Avenida da Liberdade",25,25,0,124,124,0
9,27,2018,14,0,5,"Braga",2,"Avenida Central",25,25,0,124,124,0
9,27,2018,14,0,5,"Braga",3,"Rua de Caires",36,36,0,37,37,0
9,27,2018,14,0,5,"Braga",4,"N14 Bosch",36,47,11,62,48,14
9,27,2018,14,0,5,"Braga",5,"Avenida João Paulo II",39,39,0,9,9,0
9,27,2018,14,0,5,"Braga",6,"Avenida Padre Júlio Fragata",67,67,0,83,83,0
9,27,2018,14,0,5,"Braga",7,"Rua Nova Santa Cruz",30,44,14,58,39,19
9,27,2018,14,0,5,"Braga",8,"Rua Costa Gomes",0,41,41,-1,42,-43
9,27,2018,15,0,5,"Braga",1,"Avenida da Liberdade",25,25,0,124,124,0
9,27,2018,15,0,5,"Braga",2,"Avenida Central",25,25,0,124,124,0
9,27,2018,15,0,5,"Braga",3,"Rua de Caires",27,36,9,50,37,13
9,27,2018,15,0,5,"Braga",4,"N14 Bosch",47,47,0,48,48,0
9,27,2018,15,0,5,"Braga",5,"Avenida João Paulo II",28,39,11,12,9,3
9,27,2018,15,0,5,"Braga",6,"Avenida Padre Júlio Fragata",67,67,0,83,83,0
9,27,2018,15,0,5,"Braga",7,"Rua Nova Santa Cruz",28,44,16,62,39,23
9,27,2018,15,0,5,"Braga",8,"Rua Costa Gomes",0,41,41,-1,42,-43
9,27,2018,16,0,5,"Braga",1,"Avenida da Liberdade",17,25,8,182,124,58
9,27,2018,16,0,5,"Braga",2,"Avenida Central",17,25,8,182,124,58
9,27,2018,16,0,5,"Braga",3,"Rua de Caires",36,36,0,37,37,0
9,27,2018,16,0,5,"Braga",4,"N14 Bosch",33,47,14,68,48,20
9,27,2018,16,0,5,"Braga",5,"Avenida João Paulo II",29,39,10,12,9,3
9,27,2018,16,0,5,"Braga",6,"Avenida Padre Júlio Fragata",48,67,19,116,83,33
9,27,2018,16,0,5,"Braga",7,"Rua Nova Santa Cruz",25,44,19,69,39,30
9,27,2018,16,0,5,"Braga",8,"Rua Costa Gomes",0,41,41,-1,42,-43
9,27,2018,17,0,5,"Braga",1,"Avenida da Liberdade",15,25,10,207,124,83
9,27,2018,17,0,5,"Braga",2,"Avenida Central",15,25,10,207,124,83
9,27,2018,17,0,5,"Braga",3,"Rua de Caires",36,36,0,37,37,0
9,27,2018,17,0,5,"Braga",4,"N14 Bosch",11,47,36,204,48,156
9,27,2018,17,0,5,"Braga",5,"Avenida João Paulo II",25,39,14,14,9,5
9,27,2018,17,0,5,"Braga",6,"Avenida Padre Júlio Fragata",47,67,20,119,83,36
9,27,2018,17,0,5,"Braga",7,"Rua Nova Santa Cruz",14,44,30,123,39,84
9,27,2018,17,0,5,"Braga",8,"Rua Costa Gomes",0,41,41,-1,42,-43
9,27,2018,18,0,5,"Braga",1,"Avenida da Liberdade",14,25,11,221,124,97
9,27,2018,18,0,5,"Braga",2,"Avenida Central",14,25,11,221,124,97
9,27,2018,18,0,5,"Braga",3,"Rua de Caires",36,36,0,37,37,0
9,27,2018,18,0,5,"Braga",4,"N14 Bosch",21,47,26,107,48,59
9,27,2018,18,0,5,"Braga",5,"Avenida João Paulo II",10,39,29,35,9,26
9,27,2018,18,0,5,"Braga",6,"Avenida Padre Júlio Fragata",19,67,48,293,83,210
9,27,2018,18,0,5,"Braga",7,"Rua Nova Santa Cruz",20,44,24,86,39,47
9,27,2018,18,0,5,"Braga",8,"Rua Costa Gomes",0,41,41,-1,42,-43
9,27,2018,19,0,5,"Braga",1,"Avenida da Liberdade",25,25,0,124,124,0
9,27,2018,19,0,5,"Braga",2,"Avenida Central",25,25,0,124,124,0
9,27,2018,19,0,5,"Braga",3,"Rua de Caires",36,36,0,37,37,0
9,27,2018,19,0,5,"Braga",4,"N14 Bosch",47,47,0,48,48,0
9,27,2018,19,0,5,"Braga",5,"Avenida João Paulo II",39,39,0,9,9,0
9,27,2018,19,0,5,"Braga",6,"Avenida Padre Júlio Fragata",67,67,0,83,83,0
9,27,2018,19,0,5,"Braga",7,"Rua Nova Santa Cruz",14,44,30,123,39,84
9,27,2018,19,0,5,"Braga",8,"Rua Costa Gomes",0,41,41,-1,42,-43
9,27,2018,20,0,5,"Braga",1,"Avenida da Liberdade",25,25,0,124,124,0
9,27,2018,20,0,5,"Braga",2,"Avenida Central",25,25,0,124,124,0
9,27,2018,20,0,5,"Braga",3,"Rua de Caires",36,36,0,37,37,0
9,27,2018,20,0,5,"Braga",4,"N14 Bosch",47,47,0,48,48,0
9,27,2018,20,0,5,"Braga",5,"Avenida João Paulo II",39,39,0,9,9,0
9,27,2018,20,0,5,"Braga",6,"Avenida Padre Júlio Fragata",67,67,0,83,83,0
9,27,2018,20,0,5,"Braga",7,"Rua Nova Santa Cruz",44,44,0,39,39,0
9,27,2018,20,0,5,"Braga",8,"Rua Costa Gomes",0,41,41,-1,42,-43
9,27,2018,21,0,5,"Braga",1,"Avenida da Liberdade",25,25,0,124,124,0
9,27,2018,21,0,5,"Braga",2,"Avenida Central",25,25,0,124,124,0
9,27,2018,21,0,5,"Braga",3,"Rua de Caires",36,36,0,37,37,0
9,27,2018,21,0,5,"Braga",4,"N14 Bosch",47,47,0,48,48,0
9,27,2018,21,0,5,"Braga",5,"Avenida João Paulo II",27,39,12,13,9,4
9,27,2018,21,0,5,"Braga",6,"Avenida Padre Júlio Fragata",67,67,0,83,83,0
9,27,2018,21,0,5,"Braga",7,"Rua Nova Santa Cruz",44,44,0,39,39,0
9,27,2018,21,0,5,"Braga",8,"Rua Costa Gomes",0,41,41,-1,42,-43
9,27,2018,22,0,5,"Braga",1,"Avenida da Liberdade",25,25,0,124,124,0
9,27,2018,22,0,5,"Braga",2,"Avenida Central",25,25,0,124,124,0
9,27,2018,22,0,5,"Braga",3,"Rua de Caires",36,36,0,37,37,0
9,27,2018,22,0,5,"Braga",4,"N14 Bosch",47,47,0,48,48,0
9,27,2018,22,0,5,"Braga",5,"Avenida João Paulo II",39,39,0,9,9,0
9,27,2018,22,0,5,"Braga",6,"Avenida Padre Júlio Fragata",67,67,0,83,83,0
9,27,2018,22,0,5,"Braga",7,"Rua Nova Santa Cruz",44,44,0,39,39,0
9,27,2018,22,0,5,"Braga",8,"Rua Costa Gomes",0,41,41,-1,42,-43
9,27,2018,23,0,5,"Braga",1,"Avenida da Liberdade",25,25,0,124,124,0
9,27,2018,23,0,5,"Braga",2,"Avenida Central",25,25,0,124,124,0
9,27,2018,23,0,5,"Braga",3,"Rua de Caires",36,36,0,37,37,0
9,27,2018,23,0,5,"Braga",4,"N14 Bosch",47,47,0,48,48,0
9,27,2018,23,0,5,"Braga",5,"Avenida João Paulo II",39,39,0,9,9,0
9,27,2018,23,0,5,"Braga",6,"Avenida Padre Júlio Fragata",67,67,0,83,83,0
9,27,2018,23,0,5,"Braga",7,"Rua Nova Santa Cruz",44,44,0,39,39,0
9,27,2018,23,0,5,"Braga",8,"Rua Costa Gomes",0,41,41,-1,42,-43
9,28,2018,0,0,6,"Braga",1,"Avenida da Liberdade",25,25,0,124,124,0
9,28,2018,0,0,6,"Braga",2,"Avenida Central",25,25,0,124,124,0
9,28,2018,0,0,6,"Braga",3,"Rua de Caires",36,36,0,37,37,0
9,28,2018,0,0,6,"Braga",4,"N14 Bosch",47,47,0,48,48,0
9,28,2018,0,0,6,"Braga",5,"Avenida João Paulo II",39,39,0,9,9,0
9,28,2018,0,0,6,"Braga",6,"Avenida Padre Júlio Fragata",67,67,0,83,83,0
9,28,2018,0,0,6,"Braga",7,"Rua Nova Santa Cruz",44,44,0,39,39,0
9,28,2018,0,0,6,"Braga",8,"Rua Costa Gomes",0,41,41,-1,42,-43
9,28,2018,1,0,6,"Braga",1,"Avenida da Liberdade",25,25,0,124,124,0
9,28,2018,1,0,6,"Braga",2,"Avenida Central",25,25,0,124,124,0
9,28,2018,1,0,6,"Braga",3,"Rua de Caires",36,36,0,37,37,0
9,28,2018,1,0,6,"Braga",4,"N14 Bosch",47,47,0,48,48,0
9,28,2018,1,0,6,"Braga",5,"Avenida João Paulo II",39,39,0,9,9,0
9,28,2018,1,0,6,"Braga",6,"Avenida Padre Júlio Fragata",67,67,0,83,83,0
9,28,2018,1,0,6,"Braga",7,"Rua Nova Santa Cruz",44,44,0,39,39,0
9,28,2018,1,0,6,"Braga",8,"Rua Costa Gomes",0,41,41,-1,42,-43
9,28,2018,2,0,6,"Braga",1,"Avenida da Liberdade",25,25,0,124,124,0
9,28,2018,2,0,6,"Braga",2,"Avenida Central",25,25,0,124,124,0
9,28,2018,2,0,6,"Braga",3,"Rua de Caires",36,36,0,37,37,0
9,28,2018,2,0,6,"Braga",4,"N14 Bosch",47,47,0,48,48,0
9,28,2018,2,0,6,"Braga",5,"Avenida João Paulo II",39,39,0,9,9,0
9,28,2018,2,0,6,"Braga",6,"Avenida Padre Júlio Fragata",67,67,0,83,83,0
9,28,2018,2,0,6,"Braga",7,"Rua Nova Santa Cruz",44,44,0,39,39,0
9,28,2018,2,0,6,"Braga",8,"Rua Costa Gomes",0,41,41,-1,42,-43
9,28,2018,3,0,6,"Braga",1,"Avenida da Liberdade",25,25,0,124,124,0
9,28,2018,3,0,6,"Braga",2,"Avenida Central",25,25,0,124,124,0
9,28,2018,3,0,6,"Braga",3,"Rua de Caires",36,36,0,37,37,0
9,28,2018,3,0,6,"Braga",4,"N14 Bosch",47,47,0,48,48,0
9,28,2018,3,0,6,"Braga",5,"Avenida João Paulo II",39,39,0,9,9,0
9,28,2018,3,0,6,"Braga",6,"Avenida Padre Júlio Fragata",67,67,0,83,83,0
9,28,2018,3,0,6,"Braga",7,"Rua Nova Santa Cruz",44,44,0,39,39,0
9,28,2018,3,0,6,"Braga",8,"Rua Costa Gomes",0,41,41,-1,42,-43
9,28,2018,4,0,6,"Braga",1,"Avenida da Liberdade",25,25,0,124,124,0
9,28,2018,4,0,6,"Braga",2,"Avenida Central",25,25,0,124,124,0
9,28,2018,4,0,6,"Braga",3,"Rua de Caires",36,36,0,37,37,0
9,28,2018,4,0,6,"Braga",4,"N14 Bosch",47,47,0,48,48,0
9,28,2018,4,0,6,"Braga",5,"Avenida João Paulo II",39,39,0,9,9,0
9,28,2018,4,0,6,"Braga",6,"Avenida Padre Júlio Fragata",67,67,0,83,83,0
9,28,2018,4,0,6,"Braga",7,"Rua Nova Santa Cruz",44,44,0,39,39,0
9,28,2018,4,0,6,"Braga",8,"Rua Costa Gomes",0,41,41,-1,42,-43
9,28,2018,5,0,6,"Braga",1,"Avenida da Liberdade",25,25,0,124,124,0
9,28,2018,5,0,6,"Braga",2,"Avenida Central",25,25,0,124,124,0
9,28,2018,5,0,6,"Braga",3,"Rua de Caires",36,36,0,37,37,0
9,28,2018,5,0,6,"Braga",4,"N14 Bosch",47,47,0,48,48,0
9,28,2018,5,0,6,"Braga",5,"Avenida João Paulo II",39,39,0,9,9,0
9,28,2018,5,0,6,"Braga",6,"Avenida Padre Júlio Fragata",67,67,0,83,83,0
9,28,2018,5,0,6,"Braga",7,"Rua Nova Santa Cruz",44,44,0,39,39,0
9,28,2018,5,0,6,"Braga",8,"Rua Costa Gomes",0,41,41,-1,42,-43
9,28,2018,6,0,6,"Braga",1,"Avenida da Liberdade",25,25,0,124,124,0
9,28,2018,6,0,6,"Braga",2,"Avenida Central",25,25,0,124,124,0
9,28,2018,6,0,6,"Braga",3,"Rua de Caires",36,36,0,37,37,0
9,28,2018,6,0,6,"Braga",4,"N14 Bosch",47,47,0,48,48,0
9,28,2018,6,0,6,"Braga",5,"Avenida João Paulo II",39,39,0,9,9,0
9,28,2018,6,0,6,"Braga",6,"Avenida Padre Júlio Fragata",67,67,0,83,83,0
9,28,2018,6,0,6,"Braga",7,"Rua Nova Santa Cruz",44,44,0,39,39,0
9,28,2018,6,0,6,"Braga",8,"Rua Costa Gomes",0,41,41,-1,42,-43
9,28,2018,7,0,6,"Braga",1,"Avenida da Liberdade",25,25,0,124,124,0
9,28,2018,7,0,6,"Braga",2,"Avenida Central",25,25,0,124,124,0
9,28,2018,7,0,6,"Braga",3,"Rua de Caires",23,36,13,59,37,22
9,28,2018,7,0,6,"Braga",4,"N14 Bosch",30,47,17,75,48,27
9,28,2018,7,0,6,"Braga",5,"Avenida João Paulo II",39,39,0,9,9,0
9,28,2018,7,0,6,"Braga",6,"Avenida Padre Júlio Fragata",67,67,0,83,83,0
9,28,2018,7,0,6,"Braga",7,"Rua Nova Santa Cruz",44,44,0,39,39,0
9,28,2018,7,0,6,"Braga",8,"Rua Costa Gomes",0,41,41,-1,42,-43
9,28,2018,8,0,6,"Braga",1,"Avenida da Liberdade",19,25,6,163,124,39
9,28,2018,8,0,6,"Braga",2,"Avenida Central",19,25,6,163,124,39
9,28,2018,8,0,6,"Braga",3,"Rua de Caires",22,36,14,61,37,24
9,28,2018,8,0,6,"Braga",4,"N14 Bosch",22,47,25,102,48,54
9,28,2018,8,0,6,"Braga",5,"Avenida João Paulo II",16,39,23,22,9,13
9,28,2018,8,0,6,"Braga",6,"Avenida Padre Júlio Fragata",47,67,20,119,83,36
9,28,2018,8,0,6,"Braga",7,"Rua Nova Santa Cruz",17,44,27,102,39,63
9,28,2018,8,0,6,"Braga",8,"Rua Costa Gomes",0,41,41,-1,42,-43
9,28,2018,9,0,6,"Braga",1,"Avenida da Liberdade",25,25,0,124,124,0
9,28,2018,9,0,6,"Braga",2,"Avenida Central",25,25,0,124,124,0
9,28,2018,9,0,6,"Braga",3,"Rua de Caires",23,36,13,59,37,22
9,28,2018,9,0,6,"Braga",4,"N14 Bosch",34,47,13,66,48,18
9,28,2018,9,0,6,"Braga",5,"Avenida João Paulo II",23,39,16,15,9,6
9,28,2018,9,0,6,"Braga",6,"Avenida Padre Júlio Fragata",67,67,0,83,83,0
9,28,2018,9,0,6,"Braga",7,"Rua Nova Santa Cruz",44,44,0,39,39,0
9,28,2018,9,0,6,"Braga",8,"Rua Costa Gomes",0,41,41,-1,42,-43
9,28,2018,10,0,6,"Braga",1,"Avenida da Liberdade",25,25,0,124,124,0
9,28,2018,10,0,6,"Braga",2,"Avenida Central",25,25,0,124,124,0
9,28,2018,10,0,6,"Braga",3,"Rua de Caires",10,36,26,135,37,98
9,28,2018,10,0,6,"Braga",4,"N14 Bosch",30,47,17,75,48,27
9,28,2018,10,0,6,"Braga",5,"Avenida João Paulo II",39,39,0,9,9,0
9,28,2018,10,0,6,"Braga",6,"Avenida Padre Júlio Fragata",67,67,0,83,83,0
9,28,2018,10,0,6,"Braga",7,"Rua Nova Santa Cruz",44,44,0,39,39,0
9,28,2018,10,0,6,"Braga",8,"Rua Costa Gomes",0,41,41,-1,42,-43
9,28,2018,11,0,6,"Braga",1,"Avenida da Liberdade",16,25,9,194,124,70
9,28,2018,11,0,6,"Braga",2,"Avenida Central",16,25,9,194,124,70
9,28,2018,11,0,6,"Braga",3,"Rua de Caires",20,36,16,67,37,30
9,28,2018,11,0,6,"Braga",4,"N14 Bosch",30,47,17,75,48,27
9,28,2018,11,0,6,"Braga",5,"Avenida João Paulo II",39,39,0,9,9,0
9,28,2018,11,0,6,"Braga",6,"Avenida Padre Júlio Fragata",67,67,0,83,83,0
9,28,2018,11,0,6,"Braga",7,"Rua Nova Santa Cruz",24,44,20,72,39,33
9,28,2018,11,0,6,"Braga",8,"Rua Costa Gomes",0,41,41,-1,42,-43
9,28,2018,12,0,6,"Braga",1,"Avenida da Liberdade",25,25,0,124,124,0
9,28,2018,12,0,6,"Braga",2,"Avenida Central",25,25,0,124,124,0
9,28,2018,12,0,6,"Braga",3,"Rua de Caires",28,36,8,48,37,11
9,28,2018,12,0,6,"Braga",4,"N14 Bosch",34,47,13,66,48,18
9,28,2018,12,0,6,"Braga",5,"Avenida João Paulo II",39,39,0,9,9,0
9,28,2018,12,0,6,"Braga",6,"Avenida Padre Júlio Fragata",67,67,0,83,83,0
9,28,2018,12,0,6,"Braga",7,"Rua Nova Santa Cruz",6,44,38,288,39,249
9,28,2018,12,0,6,"Braga",8,"Rua Costa Gomes",0,41,41,-1,42,-43
9,28,2018,13,0,6,"Braga",1,"Avenida da Liberdade",25,25,0,124,124,0
9,28,2018,13,0,6,"Braga",2,"Avenida Central",25,25,0,124,124,0
9,28,2018,13,0,6,"Braga",3,"Rua de Caires",26,36,10,52,37,15
9,28,2018,13,0,6,"Braga",4,"N14 Bosch",23,47,24,98,48,50
9,28,2018,13,0,6,"Braga",5,"Avenida João Paulo II",39,39,0,9,9,0
9,28,2018,13,0,6,"Braga",6,"Avenida Padre Júlio Fragata",67,67,0,83,83,0
9,28,2018,13,0,6,"Braga",7,"Rua Nova Santa Cruz",12,44,32,144,39,105
9,28,2018,13,0,6,"Braga",8,"Rua Costa Gomes",0,41,41,-1,42,-43
9,28,2018,14,0,6,"Braga",1,"Avenida da Liberdade",25,25,0,124,124,0
9,28,2018,14,0,6,"Braga",2,"Avenida Central",25,25,0,124,124,0
9,28,2018,14,0,6,"Braga",3,"Rua de Caires",25,36,11,54,37,17
9,28,2018,14,0,6,"Braga",4,"N14 Bosch",20,47,27,112,48,64
9,28,2018,14,0,6,"Braga",5,"Avenida João Paulo II",29,39,10,12,9,3
9,28,2018,14,0,6,"Braga",6,"Avenida Padre Júlio Fragata",67,67,0,83,83,0
9,28,2018,14,0,6,"Braga",7,"Rua Nova Santa Cruz",44,44,0,39,39,0
9,28,2018,14,0,6,"Braga",8,"Rua Costa Gomes",0,41,41,-1,42,-43
9,28,2018,15,0,6,"Braga",1,"Avenida da Liberdade",19,25,6,163,124,39
9,28,2018,15,0,6,"Braga",2,"Avenida Central",19,25,6,163,124,39
9,28,2018,15,0,6,"Braga",3,"Rua de Caires",36,36,0,37,37,0
9,28,2018,15,0,6,"Braga",4,"N14 Bosch",33,47,14,68,48,20
9,28,2018,15,0,6,"Braga",5,"Avenida João Paulo II",39,39,0,9,9,0
9,28,2018,15,0,6,"Braga",6,"Avenida Padre Júlio Fragata",67,67,0,83,83,0
9,28,2018,15,0,6,"Braga",7,"Rua Nova Santa Cruz",44,44,0,39,39,0
9,28,2018,15,0,6,"Braga",8,"Rua Costa Gomes",0,41,41,-1,42,-43
9,28,2018,16,0,6,"Braga",1,"Avenida da Liberdade",19,25,6,163,124,39
9,28,2018,16,0,6,"Braga",2,"Avenida Central",19,25,6,163,124,39
9,28,2018,16,0,6,"Braga",3,"Rua de Caires",36,36,0,37,37,0
9,28,2018,16,0,6,"Braga",4,"N14 Bosch",24,47,23,94,48,46
9,28,2018,16,0,6,"Braga",5,"Avenida João Paulo II",15,39,24,23,9,14
9,28,2018,16,0,6,"Braga",6,"Avenida Padre Júlio Fragata",20,67,47,279,83,196
9,28,2018,16,0,6,"Braga",7,"Rua Nova Santa Cruz",32,44,12,54,39,15
9,28,2018,16,0,6,"Braga",8,"Rua Costa Gomes",0,41,41,-1,42,-43
9,28,2018,17,0,6,"Braga",1,"Avenida da Liberdade",19,25,6,163,124,39
9,28,2018,17,0,6,"Braga",2,"Avenida Central",19,25,6,163,124,39
9,28,2018,17,0,6,"Braga",3,"Rua de Caires",36,36,0,37,37,0
9,28,2018,17,0,6,"Braga",4,"N14 Bosch",13,47,34,173,48,125
9,28,2018,17,0,6,"Braga",5,"Avenida João Paulo II",23,39,16,15,9,6
9,28,2018,17,0,6,"Braga",6,"Avenida Padre Júlio Fragata",26,67,41,214,83,131
9,28,2018,17,0,6,"Braga",7,"Rua Nova Santa Cruz",6,44,38,288,39,249
9,28,2018,17,0,6,"Braga",8,"Rua Costa Gomes",0,41,41,-1,42,-43
9,28,2018,18,0,6,"Braga",1,"Avenida da Liberdade",16,25,9,194,124,70
9,28,2018,18,0,6,"Braga",2,"Avenida Central",16,25,9,194,124,70
9,28,2018,18,0,6,"Braga",3,"Rua de Caires",36,36,0,37,37,0
9,28,2018,18,0,6,"Braga",4,"N14 Bosch",18,47,29,125,48,77
9,28,2018,18,0,6,"Braga",5,"Avenida João Paulo II",21,39,18,17,9,8
9,28,2018,18,0,6,"Braga",6,"Avenida Padre Júlio Fragata",19,67,48,293,83,210
9,28,2018,18,0,6,"Braga",7,"Rua Nova Santa Cruz",33,44,11,52,39,13
9,28,2018,18,0,6,"Braga",8,"Rua Costa Gomes",0,41,41,-1,42,-43
9,28,2018,19,0,6,"Braga",1,"Avenida da Liberdade",25,25,0,124,124,0
9,28,2018,19,0,6,"Braga",2,"Avenida Central",25,25,0,124,124,0
9,28,2018,19,0,6,"Braga",3,"Rua de Caires",28,36,8,48,37,11
9,28,2018,19,0,6,"Braga",4,"N14 Bosch",16,47,31,140,48,92
9,28,2018,19,0,6,"Braga",5,"Avenida João Paulo II",28,39,11,12,9,3
9,28,2018,19,0,6,"Braga",6,"Avenida Padre Júlio Fragata",31,67,36,180,83,97
9,28,2018,19,0,6,"Braga",7,"Rua Nova Santa Cruz",20,44,24,86,39,47
9,28,2018,19,0,6,"Braga",8,"Rua Costa Gomes",0,41,41,-1,42,-43
9,28,2018,20,0,6,"Braga",1,"Avenida da Liberdade",25,25,0,124,124,0
9,28,2018,20,0,6,"Braga",2,"Avenida Central",25,25,0,124,124,0
9,28,2018,20,0,6,"Braga",3,"Rua de Caires",36,36,0,37,37,0
9,28,2018,20,0,6,"Braga",4,"N14 Bosch",34,47,13,66,48,18
9,28,2018,20,0,6,"Braga",5,"Avenida João Paulo II",39,39,0,9,9,0
9,28,2018,20,0,6,"Braga",6,"Avenida Padre Júlio Fragata",67,67,0,83,83,0
9,28,2018,20,0,6,"Braga",7,"Rua Nova Santa Cruz",21,44,23,82,39,43
9,28,2018,20,0,6,"Braga",8,"Rua Costa Gomes",0,41,41,-1,42,-43
9,28,2018,21,0,6,"Braga",1,"Avenida da Liberdade",25,25,0,124,124,0
9,28,2018,21,0,6,"Braga",2,"Avenida Central",25,25,0,124,124,0
9,28,2018,21,0,6,"Braga",3,"Rua de Caires",36,36,0,37,37,0
9,28,2018,21,0,6,"Braga",4,"N14 Bosch",47,47,0,48,48,0
9,28,2018,21,0,6,"Braga",5,"Avenida João Paulo II",39,39,0,9,9,0
9,28,2018,21,0,6,"Braga",6,"Avenida Padre Júlio Fragata",67,67,0,83,83,0
9,28,2018,21,0,6,"Braga",7,"Rua Nova Santa Cruz",44,44,0,39,39,0
9,28,2018,21,0,6,"Braga",8,"Rua Costa Gomes",0,41,41,-1,42,-43
9,28,2018,22,0,6,"Braga",1,"Avenida da Liberdade",25,25,0,124,124,0
9,28,2018,22,0,6,"Braga",2,"Avenida Central",25,25,0,124,124,0
9,28,2018,22,0,6,"Braga",3,"Rua de Caires",36,36,0,37,37,0
9,28,2018,22,0,6,"Braga",4,"N14 Bosch",47,47,0,48,48,0
9,28,2018,22,0,6,"Braga",5,"Avenida João Paulo II",39,39,0,9,9,0
9,28,2018,22,0,6,"Braga",6,"Avenida Padre Júlio Fragata",67,67,0,83,83,0
9,28,2018,22,0,6,"Braga",7,"Rua Nova Santa Cruz",44,44,0,39,39,0
9,28,2018,22,0,6,"Braga",8,"Rua Costa Gomes",0,41,41,-1,42,-43
9,28,2018,23,0,6,"Braga",1,"Avenida da Liberdade",25,25,0,124,124,0
9,28,2018,23,0,6,"Braga",2,"Avenida Central",25,25,0,124,124,0
9,28,2018,23,0,6,"Braga",3,"Rua de Caires",36,36,0,37,37,0
9,28,2018,23,0,6,"Braga",4,"N14 Bosch",47,47,0,48,48,0
9,28,2018,23,0,6,"Braga",5,"Avenida João Paulo II",39,39,0,9,9,0
9,28,2018,23,0,6,"Braga",6,"Avenida Padre Júlio Fragata",67,67,0,83,83,0
9,28,2018,23,0,6,"Braga",7,"Rua Nova Santa Cruz",44,44,0,39,39,0
9,28,2018,23,0,6,"Braga",8,"Rua Costa Gomes",0,41,41,-1,42,-43
9,29,2018,0,0,7,"Braga",1,"Avenida da Liberdade",25,25,0,124,124,0
9,29,2018,0,0,7,"Braga",2,"Avenida Central",25,25,0,124,124,0
9,29,2018,0,0,7,"Braga",3,"Rua de Caires",36,36,0,37,37,0
9,29,2018,0,0,7,"Braga",4,"N14 Bosch",47,47,0,48,48,0
9,29,2018,0,0,7,"Braga",5,"Avenida João Paulo II",39,39,0,9,9,0
9,29,2018,0,0,7,"Braga",6,"Avenida Padre Júlio Fragata",67,67,0,83,83,0
9,29,2018,0,0,7,"Braga",7,"Rua Nova Santa Cruz",44,44,0,39,39,0
9,29,2018,0,0,7,"Braga",8,"Rua Costa Gomes",0,41,41,-1,42,-43
9,29,2018,1,0,7,"Braga",1,"Avenida da Liberdade",25,25,0,124,124,0
9,29,2018,1,0,7,"Braga",2,"Avenida Central",25,25,0,124,124,0
9,29,2018,1,0,7,"Braga",3,"Rua de Caires",36,36,0,37,37,0
9,29,2018,1,0,7,"Braga",4,"N14 Bosch",47,47,0,48,48,0
9,29,2018,1,0,7,"Braga",5,"Avenida João Paulo II",39,39,0,9,9,0
9,29,2018,1,0,7,"Braga",6,"Avenida Padre Júlio Fragata",67,67,0,83,83,0
9,29,2018,1,0,7,"Braga",7,"Rua Nova Santa Cruz",44,44,0,39,39,0
9,29,2018,1,0,7,"Braga",8,"Rua Costa Gomes",0,41,41,-1,42,-43
9,29,2018,2,0,7,"Braga",1,"Avenida da Liberdade",25,25,0,124,124,0
9,29,2018,2,0,7,"Braga",2,"Avenida Central",25,25,0,124,124,0
9,29,2018,2,0,7,"Braga",3,"Rua de Caires",36,36,0,37,37,0
9,29,2018,2,0,7,"Braga",4,"N14 Bosch",47,47,0,48,48,0
9,29,2018,2,0,7,"Braga",5,"Avenida João Paulo II",39,39,0,9,9,0
9,29,2018,2,0,7,"Braga",6,"Avenida Padre Júlio Fragata",67,67,0,83,83,0
9,29,2018,2,0,7,"Braga",7,"Rua Nova Santa Cruz",44,44,0,39,39,0
9,29,2018,2,0,7,"Braga",8,"Rua Costa Gomes",0,41,41,-1,42,-43
9,29,2018,3,0,7,"Braga",1,"Avenida da Liberdade",25,25,0,124,124,0
9,29,2018,3,0,7,"Braga",2,"Avenida Central",25,25,0,124,124,0
9,29,2018,3,0,7,"Braga",3,"Rua de Caires",36,36,0,37,37,0
9,29,2018,3,0,7,"Braga",4,"N14 Bosch",47,47,0,48,48,0
9,29,2018,3,0,7,"Braga",5,"Avenida João Paulo II",39,39,0,9,9,0
9,29,2018,3,0,7,"Braga",6,"Avenida Padre Júlio Fragata",67,67,0,83,83,0
9,29,2018,3,0,7,"Braga",7,"Rua Nova Santa Cruz",44,44,0,39,39,0
9,29,2018,3,0,7,"Braga",8,"Rua Costa Gomes",0,41,41,-1,42,-43
9,29,2018,4,0,7,"Braga",1,"Avenida da Liberdade",25,25,0,124,124,0
9,29,2018,4,0,7,"Braga",2,"Avenida Central",25,25,0,124,124,0
9,29,2018,4,0,7,"Braga",3,"Rua de Caires",36,36,0,37,37,0
9,29,2018,4,0,7,"Braga",4,"N14 Bosch",47,47,0,48,48,0
9,29,2018,4,0,7,"Braga",5,"Avenida João Paulo II",39,39,0,9,9,0
9,29,2018,4,0,7,"Braga",6,"Avenida Padre Júlio Fragata",67,67,0,83,83,0
9,29,2018,4,0,7,"Braga",7,"Rua Nova Santa Cruz",44,44,0,39,39,0
9,29,2018,4,0,7,"Braga",8,"Rua Costa Gomes",0,41,41,-1,42,-43
9,29,2018,5,0,7,"Braga",1,"Avenida da Liberdade",25,25,0,124,124,0
9,29,2018,5,0,7,"Braga",2,"Avenida Central",25,25,0,124,124,0
9,29,2018,5,0,7,"Braga",3,"Rua de Caires",36,36,0,37,37,0
9,29,2018,5,0,7,"Braga",4,"N14 Bosch",47,47,0,48,48,0
9,29,2018,5,0,7,"Braga",5,"Avenida João Paulo II",39,39,0,9,9,0
9,29,2018,5,0,7,"Braga",6,"Avenida Padre Júlio Fragata",67,67,0,83,83,0
9,29,2018,5,0,7,"Braga",7,"Rua Nova Santa Cruz",44,44,0,39,39,0
9,29,2018,5,0,7,"Braga",8,"Rua Costa Gomes",0,41,41,-1,42,-43
9,29,2018,6,0,7,"Braga",1,"Avenida da Liberdade",25,25,0,124,124,0
9,29,2018,6,0,7,"Braga",2,"Avenida Central",25,25,0,124,124,0
9,29,2018,6,0,7,"Braga",3,"Rua de Caires",36,36,0,37,37,0
9,29,2018,6,0,7,"Braga",4,"N14 Bosch",47,47,0,48,48,0
9,29,2018,6,0,7,"Braga",5,"Avenida João Paulo II",29,39,10,12,9,3
9,29,2018,6,0,7,"Braga",6,"Avenida Padre Júlio Fragata",67,67,0,83,83,0
9,29,2018,6,0,7,"Braga",7,"Rua Nova Santa Cruz",44,44,0,39,39,0
9,29,2018,6,0,7,"Braga",8,"Rua Costa Gomes",0,41,41,-1,42,-43
9,29,2018,7,0,7,"Braga",1,"Avenida da Liberdade",25,25,0,124,124,0
9,29,2018,7,0,7,"Braga",2,"Avenida Central",25,25,0,124,124,0
9,29,2018,7,0,7,"Braga",3,"Rua de Caires",36,36,0,37,37,0
9,29,2018,7,0,7,"Braga",4,"N14 Bosch",47,47,0,48,48,0
9,29,2018,7,0,7,"Braga",5,"Avenida João Paulo II",39,39,0,9,9,0
9,29,2018,7,0,7,"Braga",6,"Avenida Padre Júlio Fragata",67,67,0,83,83,0
9,29,2018,7,0,7,"Braga",7,"Rua Nova Santa Cruz",44,44,0,39,39,0
9,29,2018,7,0,7,"Braga",8,"Rua Costa Gomes",0,41,41,-1,42,-43
9,29,2018,8,0,7,"Braga",1,"Avenida da Liberdade",25,25,0,124,124,0
9,29,2018,8,0,7,"Braga",2,"Avenida Central",25,25,0,124,124,0
9,29,2018,8,0,7,"Braga",3,"Rua de Caires",36,36,0,37,37,0
9,29,2018,8,0,7,"Braga",4,"N14 Bosch",47,47,0,48,48,0
9,29,2018,8,0,7,"Braga",5,"Avenida João Paulo II",39,39,0,9,9,0
9,29,2018,8,0,7,"Braga",6,"Avenida Padre Júlio Fragata",67,67,0,83,83,0
9,29,2018,8,0,7,"Braga",7,"Rua Nova Santa Cruz",44,44,0,39,39,0
9,29,2018,8,0,7,"Braga",8,"Rua Costa Gomes",0,41,41,-1,42,-43
9,29,2018,9,0,7,"Braga",1,"Avenida da Liberdade",25,25,0,124,124,0
9,29,2018,9,0,7,"Braga",2,"Avenida Central",25,25,0,124,124,0
9,29,2018,9,0,7,"Braga",3,"Rua de Caires",36,36,0,37,37,0
9,29,2018,9,0,7,"Braga",4,"N14 Bosch",37,47,10,61,48,13
9,29,2018,9,0,7,"Braga",5,"Avenida João Paulo II",39,39,0,9,9,0
9,29,2018,9,0,7,"Braga",6,"Avenida Padre Júlio Fragata",67,67,0,83,83,0
9,29,2018,9,0,7,"Braga",7,"Rua Nova Santa Cruz",44,44,0,39,39,0
9,29,2018,9,0,7,"Braga",8,"Rua Costa Gomes",0,41,41,-1,42,-43
9,29,2018,10,0,7,"Braga",1,"Avenida da Liberdade",19,25,6,163,124,39
9,29,2018,10,0,7,"Braga",2,"Avenida Central",19,25,6,163,124,39
9,29,2018,10,0,7,"Braga",3,"Rua de Caires",36,36,0,37,37,0
9,29,2018,10,0,7,"Braga",4,"N14 Bosch",47,47,0,48,48,0
9,29,2018,10,0,7,"Braga",5,"Avenida João Paulo II",39,39,0,9,9,0
9,29,2018,10,0,7,"Braga",6,"Avenida Padre Júlio Fragata",67,67,0,83,83,0
9,29,2018,10,0,7,"Braga",7,"Rua Nova Santa Cruz",44,44,0,39,39,0
9,29,2018,10,0,7,"Braga",8,"Rua Costa Gomes",0,41,41,-1,42,-43
9,29,2018,11,0,7,"Braga",1,"Avenida da Liberdade",15,25,10,207,124,83
9,29,2018,11,0,7,"Braga",2,"Avenida Central",15,25,10,207,124,83
9,29,2018,11,0,7,"Braga",3,"Rua de Caires",16,36,20,84,37,47
9,29,2018,11,0,7,"Braga",4,"N14 Bosch",47,47,0,48,48,0
9,29,2018,11,0,7,"Braga",5,"Avenida João Paulo II",39,39,0,9,9,0
9,29,2018,11,0,7,"Braga",6,"Avenida Padre Júlio Fragata",67,67,0,83,83,0
9,29,2018,11,0,7,"Braga",7,"Rua Nova Santa Cruz",44,44,0,39,39,0
9,29,2018,11,0,7,"Braga",8,"Rua Costa Gomes",0,41,41,-1,42,-43
9,29,2018,12,0,7,"Braga",1,"Avenida da Liberdade",25,25,0,124,124,0
9,29,2018,12,0,7,"Braga",2,"Avenida Central",25,25,0,124,124,0
9,29,2018,12,0,7,"Braga",3,"Rua de Caires",26,36,10,52,37,15
9,29,2018,12,0,7,"Braga",4,"N14 Bosch",47,47,0,48,48,0
9,29,2018,12,0,7,"Braga",5,"Avenida João Paulo II",39,39,0,9,9,0
9,29,2018,12,0,7,"Braga",6,"Avenida Padre Júlio Fragata",67,67,0,83,83,0
9,29,2018,12,0,7,"Braga",7,"Rua Nova Santa Cruz",30,44,14,58,39,19
9,29,2018,12,0,7,"Braga",8,"Rua Costa Gomes",0,41,41,-1,42,-43
9,29,2018,13,0,7,"Braga",1,"Avenida da Liberdade",25,25,0,124,124,0
9,29,2018,13,0,7,"Braga",2,"Avenida Central",25,25,0,124,124,0
9,29,2018,13,0,7,"Braga",3,"Rua de Caires",36,36,0,37,37,0
9,29,2018,13,0,7,"Braga",4,"N14 Bosch",47,47,0,48,48,0
9,29,2018,13,0,7,"Braga",5,"Avenida João Paulo II",39,39,0,9,9,0
9,29,2018,13,0,7,"Braga",6,"Avenida Padre Júlio Fragata",67,67,0,83,83,0
9,29,2018,13,0,7,"Braga",7,"Rua Nova Santa Cruz",44,44,0,39,39,0
9,29,2018,13,0,7,"Braga",8,"Rua Costa Gomes",0,41,41,-1,42,-43
9,29,2018,14,0,7,"Braga",1,"Avenida da Liberdade",19,25,6,163,124,39
9,29,2018,14,0,7,"Braga",2,"Avenida Central",19,25,6,163,124,39
9,29,2018,14,0,7,"Braga",3,"Rua de Caires",36,36,0,37,37,0
9,29,2018,14,0,7,"Braga",4,"N14 Bosch",47,47,0,48,48,0
9,29,2018,14,0,7,"Braga",5,"Avenida João Paulo II",39,39,0,9,9,0
9,29,2018,14,0,7,"Braga",6,"Avenida Padre Júlio Fragata",67,67,0,83,83,0
9,29,2018,14,0,7,"Braga",7,"Rua Nova Santa Cruz",44,44,0,39,39,0
9,29,2018,14,0,7,"Braga",8,"Rua Costa Gomes",0,41,41,-1,42,-43
9,29,2018,15,0,7,"Braga",1,"Avenida da Liberdade",25,25,0,124,124,0
9,29,2018,15,0,7,"Braga",2,"Avenida Central",25,25,0,124,124,0
9,29,2018,15,0,7,"Braga",3,"Rua de Caires",24,36,12,56,37,19
9,29,2018,15,0,7,"Braga",4,"N14 Bosch",47,47,0,48,48,0
9,29,2018,15,0,7,"Braga",5,"Avenida João Paulo II",39,39,0,9,9,0
9,29,2018,15,0,7,"Braga",6,"Avenida Padre Júlio Fragata",52,67,15,107,83,24
9,29,2018,15,0,7,"Braga",7,"Rua Nova Santa Cruz",44,44,0,39,39,0
9,29,2018,15,0,7,"Braga",8,"Rua Costa Gomes",0,41,41,-1,42,-43
9,29,2018,16,0,7,"Braga",1,"Avenida da Liberdade",25,25,0,124,124,0
9,29,2018,16,0,7,"Braga",2,"Avenida Central",25,25,0,124,124,0
9,29,2018,16,0,7,"Braga",3,"Rua de Caires",28,36,8,48,37,11
9,29,2018,16,0,7,"Braga",4,"N14 Bosch",47,47,0,48,48,0
9,29,2018,16,0,7,"Braga",5,"Avenida João Paulo II",39,39,0,9,9,0
9,29,2018,16,0,7,"Braga",6,"Avenida Padre Júlio Fragata",67,67,0,83,83,0
9,29,2018,16,0,7,"Braga",7,"Rua Nova Santa Cruz",44,44,0,39,39,0
9,29,2018,16,0,7,"Braga",8,"Rua Costa Gomes",0,41,41,-1,42,-43
9,29,2018,17,0,7,"Braga",1,"Avenida da Liberdade",19,25,6,163,124,39
9,29,2018,17,0,7,"Braga",2,"Avenida Central",19,25,6,163,124,39
9,29,2018,17,0,7,"Braga",3,"Rua de Caires",25,36,11,54,37,17
9,29,2018,17,0,7,"Braga",4,"N14 Bosch",47,47,0,48,48,0
9,29,2018,17,0,7,"Braga",5,"Avenida João Paulo II",39,39,0,9,9,0
9,29,2018,17,0,7,"Braga",6,"Avenida Padre Júlio Fragata",67,67,0,83,83,0
9,29,2018,17,0,7,"Braga",7,"Rua Nova Santa Cruz",44,44,0,39,39,0
9,29,2018,17,0,7,"Braga",8,"Rua Costa Gomes",0,41,41,-1,42,-43
9,29,2018,18,0,7,"Braga",1,"Avenida da Liberdade",25,25,0,124,124,0
9,29,2018,18,0,7,"Braga",2,"Avenida Central",25,25,0,124,124,0
9,29,2018,18,0,7,"Braga",3,"Rua de Caires",36,36,0,37,37,0
9,29,2018,18,0,7,"Braga",4,"N14 Bosch",29,47,18,77,48,29
9,29,2018,18,0,7,"Braga",5,"Avenida João Paulo II",39,39,0,9,9,0
9,29,2018,18,0,7,"Braga",6,"Avenida Padre Júlio Fragata",52,67,15,107,83,24
9,29,2018,18,0,7,"Braga",7,"Rua Nova Santa Cruz",44,44,0,39,39,0
9,29,2018,18,0,7,"Braga",8,"Rua Costa Gomes",0,41,41,-1,42,-43
9,29,2018,19,0,7,"Braga",1,"Avenida da Liberdade",25,25,0,124,124,0
9,29,2018,19,0,7,"Braga",2,"Avenida Central",25,25,0,124,124,0
9,29,2018,19,0,7,"Braga",3,"Rua de Caires",22,36,14,61,37,24
9,29,2018,19,0,7,"Braga",4,"N14 Bosch",16,47,31,140,48,92
9,29,2018,19,0,7,"Braga",5,"Avenida João Paulo II",39,39,0,9,9,0
9,29,2018,19,0,7,"Braga",6,"Avenida Padre Júlio Fragata",67,67,0,83,83,0
9,29,2018,19,0,7,"Braga",7,"Rua Nova Santa Cruz",44,44,0,39,39,0
9,29,2018,19,0,7,"Braga",8,"Rua Costa Gomes",0,41,41,-1,42,-43
9,29,2018,20,0,7,"Braga",1,"Avenida da Liberdade",25,25,0,124,124,0
9,29,2018,20,0,7,"Braga",2,"Avenida Central",25,25,0,124,124,0
9,29,2018,20,0,7,"Braga",3,"Rua de Caires",28,36,8,48,37,11
9,29,2018,20,0,7,"Braga",4,"N14 Bosch",29,47,18,77,48,29
9,29,2018,20,0,7,"Braga",5,"Avenida João Paulo II",39,39,0,9,9,0
9,29,2018,20,0,7,"Braga",6,"Avenida Padre Júlio Fragata",67,67,0,83,83,0
9,29,2018,20,0,7,"Braga",7,"Rua Nova Santa Cruz",44,44,0,39,39,0
9,29,2018,20,0,7,"Braga",8,"Rua Costa Gomes",0,41,41,-1,42,-43
9,29,2018,21,0,7,"Braga",1,"Avenida da Liberdade",25,25,0,124,124,0
9,29,2018,21,0,7,"Braga",2,"Avenida Central",25,25,0,124,124,0
9,29,2018,21,0,7,"Braga",3,"Rua de Caires",36,36,0,37,37,0
9,29,2018,21,0,7,"Braga",4,"N14 Bosch",47,47,0,48,48,0
9,29,2018,21,0,7,"Braga",5,"Avenida João Paulo II",39,39,0,9,9,0
9,29,2018,21,0,7,"Braga",6,"Avenida Padre Júlio Fragata",51,67,16,109,83,26
9,29,2018,21,0,7,"Braga",7,"Rua Nova Santa Cruz",44,44,0,39,39,0
9,29,2018,21,0,7,"Braga",8,"Rua Costa Gomes",0,41,41,-1,42,-43
9,29,2018,22,0,7,"Braga",1,"Avenida da Liberdade",25,25,0,124,124,0
9,29,2018,22,0,7,"Braga",2,"Avenida Central",25,25,0,124,124,0
9,29,2018,22,0,7,"Braga",3,"Rua de Caires",36,36,0,37,37,0
9,29,2018,22,0,7,"Braga",4,"N14 Bosch",47,47,0,48,48,0
9,29,2018,22,0,7,"Braga",5,"Avenida João Paulo II",39,39,0,9,9,0
9,29,2018,22,0,7,"Braga",6,"Avenida Padre Júlio Fragata",53,67,14,105,83,22
9,29,2018,22,0,7,"Braga",7,"Rua Nova Santa Cruz",44,44,0,39,39,0
9,29,2018,22,0,7,"Braga",8,"Rua Costa Gomes",0,41,41,-1,42,-43
9,29,2018,23,0,7,"Braga",1,"Avenida da Liberdade",25,25,0,124,124,0
9,29,2018,23,0,7,"Braga",2,"Avenida Central",25,25,0,124,124,0
9,29,2018,23,0,7,"Braga",3,"Rua de Caires",36,36,0,37,37,0
9,29,2018,23,0,7,"Braga",4,"N14 Bosch",9,47,38,250,48,202
9,29,2018,23,0,7,"Braga",5,"Avenida João Paulo II",39,39,0,9,9,0
9,29,2018,23,0,7,"Braga",6,"Avenida Padre Júlio Fragata",67,67,0,83,83,0
9,29,2018,23,0,7,"Braga",7,"Rua Nova Santa Cruz",33,44,11,52,39,13
9,29,2018,23,0,7,"Braga",8,"Rua Costa Gomes",0,41,41,-1,42,-43
9,30,2018,0,0,8,"Braga",1,"Avenida da Liberdade",25,25,0,124,124,0
9,30,2018,0,0,8,"Braga",2,"Avenida Central",25,25,0,124,124,0
9,30,2018,0,0,8,"Braga",3,"Rua de Caires",36,36,0,37,37,0
9,30,2018,0,0,8,"Braga",4,"N14 Bosch",47,47,0,48,48,0
9,30,2018,0,0,8,"Braga",5,"Avenida João Paulo II",39,39,0,9,9,0
9,30,2018,0,0,8,"Braga",6,"Avenida Padre Júlio Fragata",67,67,0,83,83,0
9,30,2018,0,0,8,"Braga",7,"Rua Nova Santa Cruz",44,44,0,39,39,0
9,30,2018,0,0,8,"Braga",8,"Rua Costa Gomes",0,41,41,-1,42,-43
9,30,2018,1,0,8,"Braga",1,"Avenida da Liberdade",19,25,6,163,124,39
9,30,2018,1,0,8,"Braga",2,"Avenida Central",19,25,6,163,124,39
9,30,2018,1,0,8,"Braga",3,"Rua de Caires",36,36,0,37,37,0
9,30,2018,1,0,8,"Braga",4,"N14 Bosch",47,47,0,48,48,0
9,30,2018,1,0,8,"Braga",5,"Avenida João Paulo II",39,39,0,9,9,0
9,30,2018,1,0,8,"Braga",6,"Avenida Padre Júlio Fragata",67,67,0,83,83,0
9,30,2018,1,0,8,"Braga",7,"Rua Nova Santa Cruz",44,44,0,39,39,0
9,30,2018,1,0,8,"Braga",8,"Rua Costa Gomes",0,41,41,-1,42,-43
9,30,2018,2,0,8,"Braga",1,"Avenida da Liberdade",25,25,0,124,124,0
9,30,2018,2,0,8,"Braga",2,"Avenida Central",25,25,0,124,124,0
9,30,2018,2,0,8,"Braga",3,"Rua de Caires",36,36,0,37,37,0
9,30,2018,2,0,8,"Braga",4,"N14 Bosch",47,47,0,48,48,0
9,30,2018,2,0,8,"Braga",5,"Avenida João Paulo II",39,39,0,9,9,0
9,30,2018,2,0,8,"Braga",6,"Avenida Padre Júlio Fragata",67,67,0,83,83,0
9,30,2018,2,0,8,"Braga",7,"Rua Nova Santa Cruz",44,44,0,39,39,0
9,30,2018,2,0,8,"Braga",8,"Rua Costa Gomes",0,41,41,-1,42,-43
9,30,2018,3,0,8,"Braga",1,"Avenida da Liberdade",25,25,0,124,124,0
9,30,2018,3,0,8,"Braga",2,"Avenida Central",25,25,0,124,124,0
9,30,2018,3,0,8,"Braga",3,"Rua de Caires",36,36,0,37,37,0
9,30,2018,3,0,8,"Braga",4,"N14 Bosch",47,47,0,48,48,0
9,30,2018,3,0,8,"Braga",5,"Avenida João Paulo II",39,39,0,9,9,0
9,30,2018,3,0,8,"Braga",6,"Avenida Padre Júlio Fragata",67,67,0,83,83,0
9,30,2018,3,0,8,"Braga",7,"Rua Nova Santa Cruz",44,44,0,39,39,0
9,30,2018,3,0,8,"Braga",8,"Rua Costa Gomes",0,41,41,-1,42,-43
9,30,2018,4,0,8,"Braga",1,"Avenida da Liberdade",25,25,0,124,124,0
9,30,2018,4,0,8,"Braga",2,"Avenida Central",25,25,0,124,124,0
9,30,2018,4,0,8,"Braga",3,"Rua de Caires",36,36,0,37,37,0
9,30,2018,4,0,8,"Braga",4,"N14 Bosch",47,47,0,48,48,0
9,30,2018,4,0,8,"Braga",5,"Avenida João Paulo II",39,39,0,9,9,0
9,30,2018,4,0,8,"Braga",6,"Avenida Padre Júlio Fragata",67,67,0,83,83,0
9,30,2018,4,0,8,"Braga",7,"Rua Nova Santa Cruz",44,44,0,39,39,0
9,30,2018,4,0,8,"Braga",8,"Rua Costa Gomes",0,41,41,-1,42,-43
9,30,2018,5,0,8,"Braga",1,"Avenida da Liberdade",25,25,0,124,124,0
9,30,2018,5,0,8,"Braga",2,"Avenida Central",25,25,0,124,124,0
9,30,2018,5,0,8,"Braga",3,"Rua de Caires",36,36,0,37,37,0
9,30,2018,5,0,8,"Braga",4,"N14 Bosch",47,47,0,48,48,0
9,30,2018,5,0,8,"Braga",5,"Avenida João Paulo II",39,39,0,9,9,0
9,30,2018,5,0,8,"Braga",6,"Avenida Padre Júlio Fragata",67,67,0,83,83,0
9,30,2018,5,0,8,"Braga",7,"Rua Nova Santa Cruz",44,44,0,39,39,0
9,30,2018,5,0,8,"Braga",8,"Rua Costa Gomes",0,41,41,-1,42,-43
9,30,2018,6,0,8,"Braga",1,"Avenida da Liberdade",25,25,0,124,124,0
9,30,2018,6,0,8,"Braga",2,"Avenida Central",25,25,0,124,124,0
9,30,2018,6,0,8,"Braga",3,"Rua de Caires",36,36,0,37,37,0
9,30,2018,6,0,8,"Braga",4,"N14 Bosch",47,47,0,48,48,0
9,30,2018,6,0,8,"Braga",5,"Avenida João Paulo II",39,39,0,9,9,0
9,30,2018,6,0,8,"Braga",6,"Avenida Padre Júlio Fragata",67,67,0,83,83,0
9,30,2018,6,0,8,"Braga",7,"Rua Nova Santa Cruz",44,44,0,39,39,0
9,30,2018,6,0,8,"Braga",8,"Rua Costa Gomes",0,41,41,-1,42,-43
9,30,2018,7,0,8,"Braga",1,"Avenida da Liberdade",25,25,0,124,124,0
9,30,2018,7,0,8,"Braga",2,"Avenida Central",25,25,0,124,124,0
9,30,2018,7,0,8,"Braga",3,"Rua de Caires",36,36,0,37,37,0
9,30,2018,7,0,8,"Braga",4,"N14 Bosch",47,47,0,48,48,0
9,30,2018,7,0,8,"Braga",5,"Avenida João Paulo II",39,39,0,9,9,0
9,30,2018,7,0,8,"Braga",6,"Avenida Padre Júlio Fragata",67,67,0,83,83,0
9,30,2018,7,0,8,"Braga",7,"Rua Nova Santa Cruz",44,44,0,39,39,0
9,30,2018,7,0,8,"Braga",8,"Rua Costa Gomes",0,41,41,-1,42,-43
9,30,2018,8,0,8,"Braga",1,"Avenida da Liberdade",25,25,0,124,124,0
9,30,2018,8,0,8,"Braga",2,"Avenida Central",25,25,0,124,124,0
9,30,2018,8,0,8,"Braga",3,"Rua de Caires",36,36,0,37,37,0
9,30,2018,8,0,8,"Braga",4,"N14 Bosch",47,47,0,48,48,0
9,30,2018,8,0,8,"Braga",5,"Avenida João Paulo II",39,39,0,9,9,0
9,30,2018,8,0,8,"Braga",6,"Avenida Padre Júlio Fragata",67,67,0,83,83,0
9,30,2018,8,0,8,"Braga",7,"Rua Nova Santa Cruz",44,44,0,39,39,0
9,30,2018,8,0,8,"Braga",8,"Rua Costa Gomes",0,41,41,-1,42,-43
9,30,2018,9,0,8,"Braga",5,"Avenida João Paulo II",39,39,0,9,9,0
9,30,2018,9,0,8,"Braga",6,"Avenida Padre Júlio Fragata",67,67,0,83,83,0
9,30,2018,9,0,8,"Braga",7,"Rua Nova Santa Cruz",44,44,0,39,39,0
9,30,2018,9,0,8,"Braga",8,"Rua Costa Gomes",0,41,41,-1,42,-43
9,30,2018,9,0,8,"Braga",1,"Avenida da Liberdade",25,25,0,124,124,0
9,30,2018,9,0,8,"Braga",2,"Avenida Central",25,25,0,124,124,0
9,30,2018,9,0,8,"Braga",3,"Rua de Caires",36,36,0,37,37,0
9,30,2018,9,0,8,"Braga",4,"N14 Bosch",47,47,0,48,48,0
9,30,2018,10,0,8,"Braga",1,"Avenida da Liberdade",25,25,0,124,124,0
9,30,2018,10,0,8,"Braga",2,"Avenida Central",25,25,0,124,124,0
9,30,2018,10,0,8,"Braga",3,"Rua de Caires",25,36,11,54,37,17
9,30,2018,10,0,8,"Braga",4,"N14 Bosch",47,47,0,48,48,0
9,30,2018,10,0,8,"Braga",5,"Avenida João Paulo II",39,39,0,9,9,0
9,30,2018,10,0,8,"Braga",6,"Avenida Padre Júlio Fragata",67,67,0,83,83,0
9,30,2018,10,0,8,"Braga",7,"Rua Nova Santa Cruz",44,44,0,39,39,0
9,30,2018,10,0,8,"Braga",8,"Rua Costa Gomes",0,41,41,-1,42,-43
9,30,2018,11,0,8,"Braga",1,"Avenida da Liberdade",25,25,0,124,124,0
9,30,2018,11,0,8,"Braga",2,"Avenida Central",25,25,0,124,124,0
9,30,2018,11,0,8,"Braga",3,"Rua de Caires",36,36,0,37,37,0
9,30,2018,11,0,8,"Braga",4,"N14 Bosch",37,47,10,61,48,13
9,30,2018,11,0,8,"Braga",5,"Avenida João Paulo II",39,39,0,9,9,0
9,30,2018,11,0,8,"Braga",6,"Avenida Padre Júlio Fragata",67,67,0,83,83,0
9,30,2018,11,0,8,"Braga",7,"Rua Nova Santa Cruz",44,44,0,39,39,0
9,30,2018,11,0,8,"Braga",8,"Rua Costa Gomes",0,41,41,-1,42,-43
9,30,2018,12,0,8,"Braga",1,"Avenida da Liberdade",25,25,0,124,124,0
9,30,2018,12,0,8,"Braga",2,"Avenida Central",25,25,0,124,124,0
9,30,2018,12,0,8,"Braga",3,"Rua de Caires",9,36,27,150,37,113
9,30,2018,12,0,8,"Braga",4,"N14 Bosch",47,47,0,48,48,0
9,30,2018,12,0,8,"Braga",5,"Avenida João Paulo II",39,39,0,9,9,0
9,30,2018,12,0,8,"Braga",6,"Avenida Padre Júlio Fragata",67,67,0,83,83,0
9,30,2018,12,0,8,"Braga",7,"Rua Nova Santa Cruz",44,44,0,39,39,0
9,30,2018,12,0,8,"Braga",8,"Rua Costa Gomes",0,41,41,-1,42,-43
9,30,2018,13,0,8,"Braga",1,"Avenida da Liberdade",25,25,0,124,124,0
9,30,2018,13,0,8,"Braga",2,"Avenida Central",25,25,0,124,124,0
9,30,2018,13,0,8,"Braga",3,"Rua de Caires",36,36,0,37,37,0
9,30,2018,13,0,8,"Braga",4,"N14 Bosch",47,47,0,48,48,0
9,30,2018,13,0,8,"Braga",5,"Avenida João Paulo II",39,39,0,9,9,0
9,30,2018,13,0,8,"Braga",6,"Avenida Padre Júlio Fragata",67,67,0,83,83,0
9,30,2018,13,0,8,"Braga",7,"Rua Nova Santa Cruz",44,44,0,39,39,0
9,30,2018,13,0,8,"Braga",8,"Rua Costa Gomes",0,41,41,-1,42,-43
9,30,2018,14,0,8,"Braga",1,"Avenida da Liberdade",19,25,6,163,124,39
9,30,2018,14,0,8,"Braga",2,"Avenida Central",25,25,0,124,124,0
9,30,2018,14,0,8,"Braga",3,"Rua de Caires",36,36,0,37,37,0
9,30,2018,14,0,8,"Braga",4,"N14 Bosch",47,47,0,48,48,0
9,30,2018,14,0,8,"Braga",5,"Avenida João Paulo II",39,39,0,9,9,0
9,30,2018,14,0,8,"Braga",6,"Avenida Padre Júlio Fragata",67,67,0,83,83,0
9,30,2018,14,0,8,"Braga",7,"Rua Nova Santa Cruz",44,44,0,39,39,0
9,30,2018,14,0,8,"Braga",8,"Rua Costa Gomes",0,41,41,-1,42,-43
9,30,2018,15,0,8,"Braga",1,"Avenida da Liberdade",25,25,0,124,124,0
9,30,2018,15,0,8,"Braga",2,"Avenida Central",25,25,0,124,124,0
9,30,2018,15,0,8,"Braga",3,"Rua de Caires",36,36,0,37,37,0
9,30,2018,15,0,8,"Braga",4,"N14 Bosch",30,47,17,75,48,27
9,30,2018,15,0,8,"Braga",5,"Avenida João Paulo II",39,39,0,9,9,0
9,30,2018,15,0,8,"Braga",6,"Avenida Padre Júlio Fragata",67,67,0,83,83,0
9,30,2018,15,0,8,"Braga",7,"Rua Nova Santa Cruz",44,44,0,39,39,0
9,30,2018,15,0,8,"Braga",8,"Rua Costa Gomes",0,41,41,-1,42,-43
9,30,2018,16,0,8,"Braga",1,"Avenida da Liberdade",25,25,0,124,124,0
9,30,2018,16,0,8,"Braga",2,"Avenida Central",25,25,0,124,124,0
9,30,2018,16,0,8,"Braga",3,"Rua de Caires",6,36,30,224,37,187
9,30,2018,16,0,8,"Braga",4,"N14 Bosch",47,47,0,48,48,0
9,30,2018,16,0,8,"Braga",5,"Avenida João Paulo II",17,39,22,21,9,12
9,30,2018,16,0,8,"Braga",6,"Avenida Padre Júlio Fragata",67,67,0,83,83,0
9,30,2018,16,0,8,"Braga",7,"Rua Nova Santa Cruz",16,44,28,108,39,69
9,30,2018,16,0,8,"Braga",8,"Rua Costa Gomes",0,41,41,-1,42,-43
9,30,2018,17,0,8,"Braga",1,"Avenida da Liberdade",25,25,0,124,124,0
9,30,2018,17,0,8,"Braga",2,"Avenida Central",25,25,0,124,124,0
9,30,2018,17,0,8,"Braga",3,"Rua de Caires",28,36,8,48,37,11
9,30,2018,17,0,8,"Braga",4,"N14 Bosch",47,47,0,48,48,0
9,30,2018,17,0,8,"Braga",5,"Avenida João Paulo II",39,39,0,9,9,0
9,30,2018,17,0,8,"Braga",6,"Avenida Padre Júlio Fragata",67,67,0,83,83,0
9,30,2018,17,0,8,"Braga",7,"Rua Nova Santa Cruz",44,44,0,39,39,0
9,30,2018,17,0,8,"Braga",8,"Rua Costa Gomes",0,41,41,-1,42,-43
9,30,2018,18,0,8,"Braga",1,"Avenida da Liberdade",25,25,0,124,124,0
9,30,2018,18,0,8,"Braga",2,"Avenida Central",25,25,0,124,124,0
9,30,2018,18,0,8,"Braga",3,"Rua de Caires",36,36,0,37,37,0
9,30,2018,18,0,8,"Braga",4,"N14 Bosch",47,47,0,48,48,0
9,30,2018,18,0,8,"Braga",5,"Avenida João Paulo II",20,39,19,17,9,8
9,30,2018,18,0,8,"Braga",6,"Avenida Padre Júlio Fragata",34,67,33,164,83,81
9,30,2018,18,0,8,"Braga",7,"Rua Nova Santa Cruz",44,44,0,39,39,0
9,30,2018,18,0,8,"Braga",8,"Rua Costa Gomes",0,41,41,-1,42,-43
9,30,2018,19,0,8,"Braga",1,"Avenida da Liberdade",19,25,6,163,124,39
9,30,2018,19,0,8,"Braga",2,"Avenida Central",19,25,6,163,124,39
9,30,2018,19,0,8,"Braga",3,"Rua de Caires",36,36,0,37,37,0
9,30,2018,19,0,8,"Braga",4,"N14 Bosch",47,47,0,48,48,0
9,30,2018,19,0,8,"Braga",5,"Avenida João Paulo II",22,39,17,16,9,7
9,30,2018,19,0,8,"Braga",6,"Avenida Padre Júlio Fragata",67,67,0,83,83,0
9,30,2018,19,0,8,"Braga",7,"Rua Nova Santa Cruz",44,44,0,39,39,0
9,30,2018,19,0,8,"Braga",8,"Rua Costa Gomes",0,41,41,-1,42,-43
9,30,2018,20,0,8,"Braga",1,"Avenida da Liberdade",25,25,0,124,124,0
9,30,2018,20,0,8,"Braga",2,"Avenida Central",25,25,0,124,124,0
9,30,2018,20,0,8,"Braga",3,"Rua de Caires",36,36,0,37,37,0
9,30,2018,20,0,8,"Braga",4,"N14 Bosch",47,47,0,48,48,0
9,30,2018,20,0,8,"Braga",5,"Avenida João Paulo II",39,39,0,9,9,0
9,30,2018,20,0,8,"Braga",6,"Avenida Padre Júlio Fragata",67,67,0,83,83,0
9,30,2018,20,0,8,"Braga",7,"Rua Nova Santa Cruz",44,44,0,39,39,0
9,30,2018,20,0,8,"Braga",8,"Rua Costa Gomes",0,41,41,-1,42,-43
9,30,2018,21,0,8,"Braga",1,"Avenida da Liberdade",25,25,0,124,124,0
9,30,2018,21,0,8,"Braga",2,"Avenida Central",25,25,0,124,124,0
9,30,2018,21,0,8,"Braga",3,"Rua de Caires",36,36,0,37,37,0
9,30,2018,21,0,8,"Braga",4,"N14 Bosch",47,47,0,48,48,0
9,30,2018,21,0,8,"Braga",5,"Avenida João Paulo II",39,39,0,9,9,0
9,30,2018,21,0,8,"Braga",6,"Avenida Padre Júlio Fragata",67,67,0,83,83,0
9,30,2018,21,0,8,"Braga",7,"Rua Nova Santa Cruz",44,44,0,39,39,0
9,30,2018,21,0,8,"Braga",8,"Rua Costa Gomes",0,41,41,-1,42,-43
9,30,2018,22,0,8,"Braga",1,"Avenida da Liberdade",25,25,0,124,124,0
9,30,2018,22,0,8,"Braga",2,"Avenida Central",25,25,0,124,124,0
9,30,2018,22,0,8,"Braga",3,"Rua de Caires",36,36,0,37,37,0
9,30,2018,22,0,8,"Braga",4,"N14 Bosch",47,47,0,48,48,0
9,30,2018,22,0,8,"Braga",5,"Avenida João Paulo II",39,39,0,9,9,0
9,30,2018,22,0,8,"Braga",6,"Avenida Padre Júlio Fragata",67,67,0,83,83,0
9,30,2018,22,0,8,"Braga",7,"Rua Nova Santa Cruz",44,44,0,39,39,0
9,30,2018,22,0,8,"Braga",8,"Rua Costa Gomes",0,41,41,-1,42,-43
9,30,2018,23,0,8,"Braga",1,"Avenida da Liberdade",25,25,0,124,124,0
9,30,2018,23,0,8,"Braga",2,"Avenida Central",25,25,0,124,124,0
9,30,2018,23,0,8,"Braga",3,"Rua de Caires",36,36,0,37,37,0
9,30,2018,23,0,8,"Braga",4,"N14 Bosch",47,47,0,48,48,0
9,30,2018,23,0,8,"Braga",5,"Avenida João Paulo II",39,39,0,9,9,0
9,30,2018,23,0,8,"Braga",6,"Avenida Padre Júlio Fragata",67,67,0,83,83,0
9,30,2018,23,0,8,"Braga",7,"Rua Nova Santa Cruz",44,44,0,39,39,0
9,30,2018,23,0,8,"Braga",8,"Rua Costa Gomes",0,41,41,-1,42,-43
10,1,2018,0,0,2,"Braga",1,"Avenida da Liberdade",25,25,0,124,124,0
10,1,2018,0,0,2,"Braga",2,"Avenida Central",25,25,0,124,124,0
10,1,2018,0,0,2,"Braga",3,"Rua de Caires",36,36,0,37,37,0
10,1,2018,0,0,2,"Braga",4,"N14 Bosch",47,47,0,48,48,0
10,1,2018,0,0,2,"Braga",5,"Avenida João Paulo II",39,39,0,9,9,0
10,1,2018,0,0,2,"Braga",6,"Avenida Padre Júlio Fragata",67,67,0,83,83,0
10,1,2018,0,0,2,"Braga",7,"Rua Nova Santa Cruz",44,44,0,39,39,0
10,1,2018,0,0,2,"Braga",8,"Rua Costa Gomes",0,41,41,-1,42,-43
10,1,2018,1,0,2,"Braga",1,"Avenida da Liberdade",25,25,0,124,124,0
10,1,2018,1,0,2,"Braga",2,"Avenida Central",25,25,0,124,124,0
10,1,2018,1,0,2,"Braga",3,"Rua de Caires",36,36,0,37,37,0
10,1,2018,1,0,2,"Braga",4,"N14 Bosch",47,47,0,48,48,0
10,1,2018,1,0,2,"Braga",5,"Avenida João Paulo II",39,39,0,9,9,0
10,1,2018,1,0,2,"Braga",6,"Avenida Padre Júlio Fragata",67,67,0,83,83,0
10,1,2018,1,0,2,"Braga",7,"Rua Nova Santa Cruz",44,44,0,39,39,0
10,1,2018,1,0,2,"Braga",8,"Rua Costa Gomes",0,41,41,-1,42,-43
10,1,2018,2,0,2,"Braga",1,"Avenida da Liberdade",25,25,0,124,124,0
10,1,2018,2,0,2,"Braga",2,"Avenida Central",25,25,0,124,124,0
10,1,2018,2,0,2,"Braga",3,"Rua de Caires",36,36,0,37,37,0
10,1,2018,2,0,2,"Braga",4,"N14 Bosch",47,47,0,48,48,0
10,1,2018,2,0,2,"Braga",5,"Avenida João Paulo II",39,39,0,9,9,0
10,1,2018,2,0,2,"Braga",6,"Avenida Padre Júlio Fragata",67,67,0,83,83,0
10,1,2018,2,0,2,"Braga",7,"Rua Nova Santa Cruz",44,44,0,39,39,0
10,1,2018,2,0,2,"Braga",8,"Rua Costa Gomes",0,41,41,-1,42,-43
10,1,2018,3,0,2,"Braga",1,"Avenida da Liberdade",25,25,0,124,124,0
10,1,2018,3,0,2,"Braga",2,"Avenida Central",25,25,0,124,124,0
10,1,2018,3,0,2,"Braga",3,"Rua de Caires",36,36,0,37,37,0
10,1,2018,3,0,2,"Braga",4,"N14 Bosch",47,47,0,48,48,0
10,1,2018,3,0,2,"Braga",5,"Avenida João Paulo II",39,39,0,9,9,0
10,1,2018,3,0,2,"Braga",6,"Avenida Padre Júlio Fragata",67,67,0,83,83,0
10,1,2018,3,0,2,"Braga",7,"Rua Nova Santa Cruz",44,44,0,39,39,0
10,1,2018,3,0,2,"Braga",8,"Rua Costa Gomes",0,41,41,-1,42,-43
10,1,2018,4,0,2,"Braga",1,"Avenida da Liberdade",25,25,0,124,124,0
10,1,2018,4,0,2,"Braga",2,"Avenida Central",25,25,0,124,124,0
10,1,2018,4,0,2,"Braga",3,"Rua de Caires",36,36,0,37,37,0
10,1,2018,4,0,2,"Braga",4,"N14 Bosch",47,47,0,48,48,0
10,1,2018,4,0,2,"Braga",5,"Avenida João Paulo II",39,39,0,9,9,0
10,1,2018,4,0,2,"Braga",6,"Avenida Padre Júlio Fragata",67,67,0,83,83,0
10,1,2018,4,0,2,"Braga",7,"Rua Nova Santa Cruz",44,44,0,39,39,0
10,1,2018,4,0,2,"Braga",8,"Rua Costa Gomes",0,41,41,-1,42,-43
10,1,2018,5,0,2,"Braga",1,"Avenida da Liberdade",25,25,0,124,124,0
10,1,2018,5,0,2,"Braga",2,"Avenida Central",25,25,0,124,124,0
10,1,2018,5,0,2,"Braga",3,"Rua de Caires",20,36,16,67,37,30
10,1,2018,5,0,2,"Braga",4,"N14 Bosch",47,47,0,48,48,0
10,1,2018,5,0,2,"Braga",5,"Avenida João Paulo II",39,39,0,9,9,0
10,1,2018,5,0,2,"Braga",6,"Avenida Padre Júlio Fragata",67,67,0,83,83,0
10,1,2018,5,0,2,"Braga",7,"Rua Nova Santa Cruz",44,44,0,39,39,0
10,1,2018,5,0,2,"Braga",8,"Rua Costa Gomes",0,41,41,-1,42,-43
10,1,2018,6,0,2,"Braga",1,"Avenida da Liberdade",25,25,0,124,124,0
10,1,2018,6,0,2,"Braga",2,"Avenida Central",25,25,0,124,124,0
10,1,2018,6,0,2,"Braga",3,"Rua de Caires",36,36,0,37,37,0
10,1,2018,6,0,2,"Braga",4,"N14 Bosch",47,47,0,48,48,0
10,1,2018,6,0,2,"Braga",5,"Avenida João Paulo II",39,39,0,9,9,0
10,1,2018,6,0,2,"Braga",6,"Avenida Padre Júlio Fragata",67,67,0,83,83,0
10,1,2018,6,0,2,"Braga",7,"Rua Nova Santa Cruz",44,44,0,39,39,0
10,1,2018,6,0,2,"Braga",8,"Rua Costa Gomes",0,41,41,-1,42,-43
10,1,2018,7,0,2,"Braga",1,"Avenida da Liberdade",25,25,0,124,124,0
10,1,2018,7,0,2,"Braga",2,"Avenida Central",25,25,0,124,124,0
10,1,2018,7,0,2,"Braga",3,"Rua de Caires",20,36,16,67,37,30
10,1,2018,7,0,2,"Braga",4,"N14 Bosch",36,47,11,62,48,14
10,1,2018,7,0,2,"Braga",5,"Avenida João Paulo II",39,39,0,9,9,0
10,1,2018,7,0,2,"Braga",6,"Avenida Padre Júlio Fragata",67,67,0,83,83,0
10,1,2018,7,0,2,"Braga",7,"Rua Nova Santa Cruz",30,44,14,58,39,19
10,1,2018,7,0,2,"Braga",8,"Rua Costa Gomes",0,41,41,-1,42,-43
10,1,2018,8,0,2,"Braga",1,"Avenida da Liberdade",16,25,9,194,124,70
10,1,2018,8,0,2,"Braga",2,"Avenida Central",16,25,9,194,124,70
10,1,2018,8,0,2,"Braga",3,"Rua de Caires",25,36,11,54,37,17
10,1,2018,8,0,2,"Braga",4,"N14 Bosch",28,47,19,80,48,32
10,1,2018,8,0,2,"Braga",5,"Avenida João Paulo II",39,39,0,9,9,0
10,1,2018,8,0,2,"Braga",6,"Avenida Padre Júlio Fragata",41,67,26,136,83,53
10,1,2018,8,0,2,"Braga",7,"Rua Nova Santa Cruz",3,44,41,576,39,537
10,1,2018,8,0,2,"Braga",8,"Rua Costa Gomes",0,41,41,-1,42,-43
10,1,2018,9,0,2,"Braga",1,"Avenida da Liberdade",25,25,0,124,124,0
10,1,2018,9,0,2,"Braga",2,"Avenida Central",25,25,0,124,124,0
10,1,2018,9,0,2,"Braga",3,"Rua de Caires",27,36,9,50,37,13
10,1,2018,9,0,2,"Braga",4,"N14 Bosch",25,47,22,90,48,42
10,1,2018,9,0,2,"Braga",5,"Avenida João Paulo II",39,39,0,9,9,0
10,1,2018,9,0,2,"Braga",6,"Avenida Padre Júlio Fragata",67,67,0,83,83,0
10,1,2018,9,0,2,"Braga",7,"Rua Nova Santa Cruz",44,44,0,39,39,0
10,1,2018,9,0,2,"Braga",8,"Rua Costa Gomes",0,41,41,-1,42,-43
10,1,2018,10,0,2,"Braga",1,"Avenida da Liberdade",25,25,0,124,124,0
10,1,2018,10,0,2,"Braga",2,"Avenida Central",25,25,0,124,124,0
10,1,2018,10,0,2,"Braga",3,"Rua de Caires",25,36,11,54,37,17
10,1,2018,10,0,2,"Braga",4,"N14 Bosch",36,47,11,62,48,14
10,1,2018,10,0,2,"Braga",5,"Avenida João Paulo II",30,39,9,12,9,3
10,1,2018,10,0,2,"Braga",6,"Avenida Padre Júlio Fragata",67,67,0,83,83,0
10,1,2018,10,0,2,"Braga",7,"Rua Nova Santa Cruz",28,44,16,62,39,23
10,1,2018,10,0,2,"Braga",8,"Rua Costa Gomes",0,41,41,-1,42,-43
10,1,2018,11,0,2,"Braga",1,"Avenida da Liberdade",25,25,0,124,124,0
10,1,2018,11,0,2,"Braga",2,"Avenida Central",25,25,0,124,124,0
10,1,2018,11,0,2,"Braga",3,"Rua de Caires",36,36,0,37,37,0
10,1,2018,11,0,2,"Braga",4,"N14 Bosch",47,47,0,48,48,0
10,1,2018,11,0,2,"Braga",5,"Avenida João Paulo II",25,39,14,14,9,5
10,1,2018,11,0,2,"Braga",6,"Avenida Padre Júlio Fragata",67,67,0,83,83,0
10,1,2018,11,0,2,"Braga",7,"Rua Nova Santa Cruz",44,44,0,39,39,0
10,1,2018,11,0,2,"Braga",8,"Rua Costa Gomes",0,41,41,-1,42,-43
10,1,2018,12,0,2,"Braga",1,"Avenida da Liberdade",25,25,0,124,124,0
10,1,2018,12,0,2,"Braga",2,"Avenida Central",25,25,0,124,124,0
10,1,2018,12,0,2,"Braga",3,"Rua de Caires",36,36,0,37,37,0
10,1,2018,12,0,2,"Braga",4,"N14 Bosch",5,47,42,449,48,401
10,1,2018,12,0,2,"Braga",5,"Avenida João Paulo II",39,39,0,9,9,0
10,1,2018,12,0,2,"Braga",6,"Avenida Padre Júlio Fragata",67,67,0,83,83,0
10,1,2018,12,0,2,"Braga",7,"Rua Nova Santa Cruz",16,44,28,108,39,69
10,1,2018,12,0,2,"Braga",8,"Rua Costa Gomes",0,41,41,-1,42,-43
10,1,2018,13,0,2,"Braga",1,"Avenida da Liberdade",19,25,6,163,124,39
10,1,2018,13,0,2,"Braga",2,"Avenida Central",19,25,6,163,124,39
10,1,2018,13,0,2,"Braga",3,"Rua de Caires",27,36,9,50,37,13
10,1,2018,13,0,2,"Braga",4,"N14 Bosch",32,47,15,70,48,22
10,1,2018,13,0,2,"Braga",5,"Avenida João Paulo II",39,39,0,9,9,0
10,1,2018,13,0,2,"Braga",6,"Avenida Padre Júlio Fragata",67,67,0,83,83,0
10,1,2018,13,0,2,"Braga",7,"Rua Nova Santa Cruz",13,44,31,133,39,94
10,1,2018,13,0,2,"Braga",8,"Rua Costa Gomes",0,41,41,-1,42,-43
10,1,2018,14,0,2,"Braga",1,"Avenida da Liberdade",19,25,6,163,124,39
10,1,2018,14,0,2,"Braga",2,"Avenida Central",19,25,6,163,124,39
10,1,2018,14,0,2,"Braga",3,"Rua de Caires",21,36,15,64,37,27
10,1,2018,14,0,2,"Braga",4,"N14 Bosch",22,47,25,102,48,54
10,1,2018,14,0,2,"Braga",5,"Avenida João Paulo II",39,39,0,9,9,0
10,1,2018,14,0,2,"Braga",6,"Avenida Padre Júlio Fragata",67,67,0,83,83,0
10,1,2018,14,0,2,"Braga",7,"Rua Nova Santa Cruz",44,44,0,39,39,0
10,1,2018,14,0,2,"Braga",8,"Rua Costa Gomes",0,41,41,-1,42,-43
10,1,2018,15,0,2,"Braga",1,"Avenida da Liberdade",25,25,0,124,124,0
10,1,2018,15,0,2,"Braga",2,"Avenida Central",25,25,0,124,124,0
10,1,2018,15,0,2,"Braga",3,"Rua de Caires",36,36,0,37,37,0
10,1,2018,15,0,2,"Braga",4,"N14 Bosch",47,47,0,48,48,0
10,1,2018,15,0,2,"Braga",5,"Avenida João Paulo II",29,39,10,12,9,3
10,1,2018,15,0,2,"Braga",6,"Avenida Padre Júlio Fragata",67,67,0,83,83,0
10,1,2018,15,0,2,"Braga",7,"Rua Nova Santa Cruz",33,44,11,52,39,13
10,1,2018,15,0,2,"Braga",8,"Rua Costa Gomes",0,41,41,-1,42,-43
10,1,2018,16,0,2,"Braga",1,"Avenida da Liberdade",19,25,6,163,124,39
10,1,2018,16,0,2,"Braga",2,"Avenida Central",19,25,6,163,124,39
10,1,2018,16,0,2,"Braga",3,"Rua de Caires",13,36,23,104,37,67
10,1,2018,16,0,2,"Braga",4,"N14 Bosch",32,47,15,70,48,22
10,1,2018,16,0,2,"Braga",5,"Avenida João Paulo II",39,39,0,9,9,0
10,1,2018,16,0,2,"Braga",6,"Avenida Padre Júlio Fragata",67,67,0,83,83,0
10,1,2018,16,0,2,"Braga",7,"Rua Nova Santa Cruz",14,44,30,123,39,84
10,1,2018,16,0,2,"Braga",8,"Rua Costa Gomes",0,41,41,-1,42,-43
10,1,2018,17,0,2,"Braga",1,"Avenida da Liberdade",11,25,14,282,124,158
10,1,2018,17,0,2,"Braga",2,"Avenida Central",11,25,14,282,124,158
10,1,2018,17,0,2,"Braga",3,"Rua de Caires",23,36,13,59,37,22
10,1,2018,17,0,2,"Braga",4,"N14 Bosch",16,47,31,140,48,92
10,1,2018,17,0,2,"Braga",5,"Avenida João Paulo II",26,39,13,13,9,4
10,1,2018,17,0,2,"Braga",6,"Avenida Padre Júlio Fragata",37,67,30,151,83,68
10,1,2018,17,0,2,"Braga",7,"Rua Nova Santa Cruz",3,44,41,576,39,537
10,1,2018,17,0,2,"Braga",8,"Rua Costa Gomes",0,41,41,-1,42,-43
10,1,2018,18,0,2,"Braga",1,"Avenida da Liberdade",6,25,19,517,124,393
10,1,2018,18,0,2,"Braga",2,"Avenida Central",6,25,19,517,124,393
10,1,2018,18,0,2,"Braga",3,"Rua de Caires",24,36,12,56,37,19
10,1,2018,18,0,2,"Braga",4,"N14 Bosch",33,47,14,68,48,20
10,1,2018,18,0,2,"Braga",5,"Avenida João Paulo II",22,39,17,16,9,7
10,1,2018,18,0,2,"Braga",6,"Avenida Padre Júlio Fragata",17,67,50,328,83,245
10,1,2018,18,0,2,"Braga",7,"Rua Nova Santa Cruz",12,44,32,144,39,105
10,1,2018,18,0,2,"Braga",8,"Rua Costa Gomes",0,41,41,-1,42,-43
10,1,2018,19,0,2,"Braga",1,"Avenida da Liberdade",25,25,0,124,124,0
10,1,2018,19,0,2,"Braga",2,"Avenida Central",25,25,0,124,124,0
10,1,2018,19,0,2,"Braga",3,"Rua de Caires",28,36,8,48,37,11
10,1,2018,19,0,2,"Braga",4,"N14 Bosch",47,47,0,48,48,0
10,1,2018,19,0,2,"Braga",5,"Avenida João Paulo II",39,39,0,9,9,0
10,1,2018,19,0,2,"Braga",6,"Avenida Padre Júlio Fragata",52,67,15,107,83,24
10,1,2018,19,0,2,"Braga",7,"Rua Nova Santa Cruz",6,44,38,288,39,249
10,1,2018,19,0,2,"Braga",8,"Rua Costa Gomes",0,41,41,-1,42,-43
10,1,2018,20,0,2,"Braga",1,"Avenida da Liberdade",25,25,0,124,124,0
10,1,2018,20,0,2,"Braga",2,"Avenida Central",25,25,0,124,124,0
10,1,2018,20,0,2,"Braga",3,"Rua de Caires",36,36,0,37,37,0
10,1,2018,20,0,2,"Braga",4,"N14 Bosch",47,47,0,48,48,0
10,1,2018,20,0,2,"Braga",5,"Avenida João Paulo II",21,39,18,17,9,8
10,1,2018,20,0,2,"Braga",6,"Avenida Padre Júlio Fragata",67,67,0,83,83,0
10,1,2018,20,0,2,"Braga",7,"Rua Nova Santa Cruz",44,44,0,39,39,0
10,1,2018,20,0,2,"Braga",8,"Rua Costa Gomes",0,41,41,-1,42,-43
10,1,2018,21,0,2,"Braga",1,"Avenida da Liberdade",25,25,0,124,124,0
10,1,2018,21,0,2,"Braga",2,"Avenida Central",25,25,0,124,124,0
10,1,2018,21,0,2,"Braga",3,"Rua de Caires",36,36,0,37,37,0
10,1,2018,21,0,2,"Braga",4,"N14 Bosch",47,47,0,48,48,0
10,1,2018,21,0,2,"Braga",5,"Avenida João Paulo II",39,39,0,9,9,0
10,1,2018,21,0,2,"Braga",6,"Avenida Padre Júlio Fragata",67,67,0,83,83,0
10,1,2018,21,0,2,"Braga",7,"Rua Nova Santa Cruz",44,44,0,39,39,0
10,1,2018,21,0,2,"Braga",8,"Rua Costa Gomes",0,41,41,-1,42,-43
10,1,2018,22,0,2,"Braga",1,"Avenida da Liberdade",25,25,0,124,124,0
10,1,2018,22,0,2,"Braga",2,"Avenida Central",25,25,0,124,124,0
10,1,2018,22,0,2,"Braga",3,"Rua de Caires",36,36,0,37,37,0
10,1,2018,22,0,2,"Braga",4,"N14 Bosch",47,47,0,48,48,0
10,1,2018,22,0,2,"Braga",5,"Avenida João Paulo II",39,39,0,9,9,0
10,1,2018,22,0,2,"Braga",6,"Avenida Padre Júlio Fragata",67,67,0,83,83,0
10,1,2018,22,0,2,"Braga",7,"Rua Nova Santa Cruz",44,44,0,39,39,0
10,1,2018,22,0,2,"Braga",8,"Rua Costa Gomes",0,41,41,-1,42,-43
10,1,2018,23,0,2,"Braga",1,"Avenida da Liberdade",25,25,0,124,124,0
10,1,2018,23,0,2,"Braga",2,"Avenida Central",25,25,0,124,124,0
10,1,2018,23,0,2,"Braga",3,"Rua de Caires",36,36,0,37,37,0
10,1,2018,23,0,2,"Braga",4,"N14 Bosch",47,47,0,48,48,0
10,1,2018,23,0,2,"Braga",5,"Avenida João Paulo II",39,39,0,9,9,0
10,1,2018,23,0,2,"Braga",6,"Avenida Padre Júlio Fragata",67,67,0,83,83,0
10,1,2018,23,0,2,"Braga",7,"Rua Nova Santa Cruz",44,44,0,39,39,0
10,1,2018,23,0,2,"Braga",8,"Rua Costa Gomes",0,41,41,-1,42,-43
10,2,2018,0,0,3,"Braga",1,"Avenida da Liberdade",25,25,0,124,124,0
10,2,2018,0,0,3,"Braga",2,"Avenida Central",25,25,0,124,124,0
10,2,2018,0,0,3,"Braga",3,"Rua de Caires",36,36,0,37,37,0
10,2,2018,0,0,3,"Braga",4,"N14 Bosch",47,47,0,48,48,0
10,2,2018,0,0,3,"Braga",5,"Avenida João Paulo II",39,39,0,9,9,0
10,2,2018,0,0,3,"Braga",6,"Avenida Padre Júlio Fragata",67,67,0,83,83,0
10,2,2018,0,0,3,"Braga",7,"Rua Nova Santa Cruz",44,44,0,39,39,0
10,2,2018,0,0,3,"Braga",8,"Rua Costa Gomes",0,41,41,-1,42,-43
10,2,2018,1,0,3,"Braga",1,"Avenida da Liberdade",25,25,0,124,124,0
10,2,2018,1,0,3,"Braga",2,"Avenida Central",25,25,0,124,124,0
10,2,2018,1,0,3,"Braga",3,"Rua de Caires",36,36,0,37,37,0
10,2,2018,1,0,3,"Braga",4,"N14 Bosch",47,47,0,48,48,0
10,2,2018,1,0,3,"Braga",5,"Avenida João Paulo II",39,39,0,9,9,0
10,2,2018,1,0,3,"Braga",6,"Avenida Padre Júlio Fragata",67,67,0,83,83,0
10,2,2018,1,0,3,"Braga",7,"Rua Nova Santa Cruz",44,44,0,39,39,0
10,2,2018,1,0,3,"Braga",8,"Rua Costa Gomes",0,41,41,-1,42,-43
10,2,2018,2,0,3,"Braga",1,"Avenida da Liberdade",25,25,0,124,124,0
10,2,2018,2,0,3,"Braga",2,"Avenida Central",25,25,0,124,124,0
10,2,2018,2,0,3,"Braga",3,"Rua de Caires",36,36,0,37,37,0
10,2,2018,2,0,3,"Braga",4,"N14 Bosch",47,47,0,48,48,0
10,2,2018,2,0,3,"Braga",5,"Avenida João Paulo II",39,39,0,9,9,0
10,2,2018,2,0,3,"Braga",6,"Avenida Padre Júlio Fragata",67,67,0,83,83,0
10,2,2018,2,0,3,"Braga",7,"Rua Nova Santa Cruz",44,44,0,39,39,0
10,2,2018,2,0,3,"Braga",8,"Rua Costa Gomes",0,41,41,-1,42,-43
10,2,2018,3,0,3,"Braga",1,"Avenida da Liberdade",25,25,0,124,124,0
10,2,2018,3,0,3,"Braga",2,"Avenida Central",25,25,0,124,124,0
10,2,2018,3,0,3,"Braga",3,"Rua de Caires",36,36,0,37,37,0
10,2,2018,3,0,3,"Braga",4,"N14 Bosch",47,47,0,48,48,0
10,2,2018,3,0,3,"Braga",5,"Avenida João Paulo II",39,39,0,9,9,0
10,2,2018,3,0,3,"Braga",6,"Avenida Padre Júlio Fragata",67,67,0,83,83,0
10,2,2018,3,0,3,"Braga",7,"Rua Nova Santa Cruz",44,44,0,39,39,0
10,2,2018,3,0,3,"Braga",8,"Rua Costa Gomes",0,41,41,-1,42,-43
10,2,2018,4,0,3,"Braga",1,"Avenida da Liberdade",25,25,0,124,124,0
10,2,2018,4,0,3,"Braga",2,"Avenida Central",25,25,0,124,124,0
10,2,2018,4,0,3,"Braga",3,"Rua de Caires",36,36,0,37,37,0
10,2,2018,4,0,3,"Braga",4,"N14 Bosch",47,47,0,48,48,0
10,2,2018,4,0,3,"Braga",5,"Avenida João Paulo II",39,39,0,9,9,0
10,2,2018,4,0,3,"Braga",6,"Avenida Padre Júlio Fragata",67,67,0,83,83,0
10,2,2018,4,0,3,"Braga",7,"Rua Nova Santa Cruz",44,44,0,39,39,0
10,2,2018,4,0,3,"Braga",8,"Rua Costa Gomes",0,41,41,-1,42,-43
10,2,2018,5,0,3,"Braga",1,"Avenida da Liberdade",25,25,0,124,124,0
10,2,2018,5,0,3,"Braga",2,"Avenida Central",25,25,0,124,124,0
10,2,2018,5,0,3,"Braga",3,"Rua de Caires",36,36,0,37,37,0
10,2,2018,5,0,3,"Braga",4,"N14 Bosch",47,47,0,48,48,0
10,2,2018,5,0,3,"Braga",5,"Avenida João Paulo II",39,39,0,9,9,0
10,2,2018,5,0,3,"Braga",6,"Avenida Padre Júlio Fragata",67,67,0,83,83,0
10,2,2018,5,0,3,"Braga",7,"Rua Nova Santa Cruz",44,44,0,39,39,0
10,2,2018,5,0,3,"Braga",8,"Rua Costa Gomes",0,41,41,-1,42,-43
10,2,2018,6,0,3,"Braga",1,"Avenida da Liberdade",25,25,0,124,124,0
10,2,2018,6,0,3,"Braga",2,"Avenida Central",25,25,0,124,124,0
10,2,2018,6,0,3,"Braga",3,"Rua de Caires",36,36,0,37,37,0
10,2,2018,6,0,3,"Braga",4,"N14 Bosch",47,47,0,48,48,0
10,2,2018,6,0,3,"Braga",5,"Avenida João Paulo II",39,39,0,9,9,0
10,2,2018,6,0,3,"Braga",6,"Avenida Padre Júlio Fragata",67,67,0,83,83,0
10,2,2018,6,0,3,"Braga",7,"Rua Nova Santa Cruz",44,44,0,39,39,0
10,2,2018,6,0,3,"Braga",8,"Rua Costa Gomes",0,41,41,-1,42,-43
10,2,2018,7,0,3,"Braga",1,"Avenida da Liberdade",25,25,0,124,124,0
10,2,2018,7,0,3,"Braga",2,"Avenida Central",25,25,0,124,124,0
10,2,2018,7,0,3,"Braga",3,"Rua de Caires",26,36,10,52,37,15
10,2,2018,7,0,3,"Braga",4,"N14 Bosch",47,47,0,48,48,0
10,2,2018,7,0,3,"Braga",5,"Avenida João Paulo II",39,39,0,9,9,0
10,2,2018,7,0,3,"Braga",6,"Avenida Padre Júlio Fragata",67,67,0,83,83,0
10,2,2018,7,0,3,"Braga",7,"Rua Nova Santa Cruz",44,44,0,39,39,0
10,2,2018,7,0,3,"Braga",8,"Rua Costa Gomes",0,41,41,-1,42,-43
10,2,2018,8,0,3,"Braga",1,"Avenida da Liberdade",25,25,0,124,124,0
10,2,2018,8,0,3,"Braga",2,"Avenida Central",25,25,0,124,124,0
10,2,2018,8,0,3,"Braga",3,"Rua de Caires",25,36,11,54,37,17
10,2,2018,8,0,3,"Braga",4,"N14 Bosch",22,47,25,102,48,54
10,2,2018,8,0,3,"Braga",5,"Avenida João Paulo II",39,39,0,9,9,0
10,2,2018,8,0,3,"Braga",6,"Avenida Padre Júlio Fragata",35,67,32,159,83,76
10,2,2018,8,0,3,"Braga",7,"Rua Nova Santa Cruz",16,44,28,108,39,69
10,2,2018,8,0,3,"Braga",8,"Rua Costa Gomes",0,41,41,-1,42,-43
10,2,2018,9,0,3,"Braga",1,"Avenida da Liberdade",25,25,0,124,124,0
10,2,2018,9,0,3,"Braga",2,"Avenida Central",25,25,0,124,124,0
10,2,2018,9,0,3,"Braga",3,"Rua de Caires",15,36,21,90,37,53
10,2,2018,9,0,3,"Braga",4,"N14 Bosch",33,47,14,68,48,20
10,2,2018,9,0,3,"Braga",5,"Avenida João Paulo II",39,39,0,9,9,0
10,2,2018,9,0,3,"Braga",6,"Avenida Padre Júlio Fragata",67,67,0,83,83,0
10,2,2018,9,0,3,"Braga",7,"Rua Nova Santa Cruz",44,44,0,39,39,0
10,2,2018,9,0,3,"Braga",8,"Rua Costa Gomes",0,41,41,-1,42,-43
10,2,2018,10,0,3,"Braga",1,"Avenida da Liberdade",15,25,10,207,124,83
10,2,2018,10,0,3,"Braga",2,"Avenida Central",15,25,10,207,124,83
10,2,2018,10,0,3,"Braga",3,"Rua de Caires",25,36,11,54,37,17
10,2,2018,10,0,3,"Braga",4,"N14 Bosch",22,47,25,102,48,54
10,2,2018,10,0,3,"Braga",5,"Avenida João Paulo II",39,39,0,9,9,0
10,2,2018,10,0,3,"Braga",6,"Avenida Padre Júlio Fragata",67,67,0,83,83,0
10,2,2018,10,0,3,"Braga",7,"Rua Nova Santa Cruz",17,44,27,102,39,63
10,2,2018,10,0,3,"Braga",8,"Rua Costa Gomes",0,41,41,-1,42,-43
10,2,2018,11,0,3,"Braga",1,"Avenida da Liberdade",16,25,9,194,124,70
10,2,2018,11,0,3,"Braga",2,"Avenida Central",17,25,8,182,124,58
10,2,2018,11,0,3,"Braga",3,"Rua de Caires",36,36,0,37,37,0
10,2,2018,11,0,3,"Braga",4,"N14 Bosch",28,47,19,80,48,32
10,2,2018,11,0,3,"Braga",5,"Avenida João Paulo II",39,39,0,9,9,0
10,2,2018,11,0,3,"Braga",6,"Avenida Padre Júlio Fragata",67,67,0,83,83,0
10,2,2018,11,0,3,"Braga",7,"Rua Nova Santa Cruz",33,44,11,52,39,13
10,2,2018,11,0,3,"Braga",8,"Rua Costa Gomes",0,41,41,-1,42,-43
10,2,2018,12,0,3,"Braga",1,"Avenida da Liberdade",25,25,0,124,124,0
10,2,2018,12,0,3,"Braga",2,"Avenida Central",25,25,0,124,124,0
10,2,2018,12,0,3,"Braga",3,"Rua de Caires",26,36,10,52,37,15
10,2,2018,12,0,3,"Braga",4,"N14 Bosch",32,47,15,70,48,22
10,2,2018,12,0,3,"Braga",5,"Avenida João Paulo II",39,39,0,9,9,0
10,2,2018,12,0,3,"Braga",6,"Avenida Padre Júlio Fragata",67,67,0,83,83,0
10,2,2018,12,0,3,"Braga",7,"Rua Nova Santa Cruz",19,44,25,91,39,52
10,2,2018,12,0,3,"Braga",8,"Rua Costa Gomes",0,41,41,-1,42,-43
10,2,2018,13,0,3,"Braga",1,"Avenida da Liberdade",25,25,0,124,124,0
10,2,2018,13,0,3,"Braga",2,"Avenida Central",25,25,0,124,124,0
10,2,2018,13,0,3,"Braga",3,"Rua de Caires",36,36,0,37,37,0
10,2,2018,13,0,3,"Braga",4,"N14 Bosch",18,47,29,125,48,77
10,2,2018,13,0,3,"Braga",5,"Avenida João Paulo II",39,39,0,9,9,0
10,2,2018,13,0,3,"Braga",6,"Avenida Padre Júlio Fragata",67,67,0,83,83,0
10,2,2018,13,0,3,"Braga",7,"Rua Nova Santa Cruz",6,44,38,288,39,249
10,2,2018,13,0,3,"Braga",8,"Rua Costa Gomes",0,41,41,-1,42,-43
10,2,2018,14,0,3,"Braga",1,"Avenida da Liberdade",25,25,0,124,124,0
10,2,2018,14,0,3,"Braga",2,"Avenida Central",25,25,0,124,124,0
10,2,2018,14,0,3,"Braga",3,"Rua de Caires",19,36,17,71,37,34
10,2,2018,14,0,3,"Braga",4,"N14 Bosch",23,47,24,98,48,50
10,2,2018,14,0,3,"Braga",5,"Avenida João Paulo II",39,39,0,9,9,0
10,2,2018,14,0,3,"Braga",6,"Avenida Padre Júlio Fragata",67,67,0,83,83,0
10,2,2018,14,0,3,"Braga",7,"Rua Nova Santa Cruz",29,44,15,60,39,21
10,2,2018,14,0,3,"Braga",8,"Rua Costa Gomes",0,41,41,-1,42,-43
10,2,2018,15,0,3,"Braga",1,"Avenida da Liberdade",16,25,9,194,124,70
10,2,2018,15,0,3,"Braga",2,"Avenida Central",16,25,9,194,124,70
10,2,2018,15,0,3,"Braga",3,"Rua de Caires",21,36,15,64,37,27
10,2,2018,15,0,3,"Braga",4,"N14 Bosch",47,47,0,48,48,0
10,2,2018,15,0,3,"Braga",5,"Avenida João Paulo II",39,39,0,9,9,0
10,2,2018,15,0,3,"Braga",6,"Avenida Padre Júlio Fragata",67,67,0,83,83,0
10,2,2018,15,0,3,"Braga",7,"Rua Nova Santa Cruz",44,44,0,39,39,0
10,2,2018,15,0,3,"Braga",8,"Rua Costa Gomes",0,41,41,-1,42,-43
10,2,2018,16,0,3,"Braga",1,"Avenida da Liberdade",17,25,8,182,124,58
10,2,2018,16,0,3,"Braga",2,"Avenida Central",16,25,9,194,124,70
10,2,2018,16,0,3,"Braga",3,"Rua de Caires",22,36,14,61,37,24
10,2,2018,16,0,3,"Braga",4,"N14 Bosch",47,47,0,48,48,0
10,2,2018,16,0,3,"Braga",5,"Avenida João Paulo II",39,39,0,9,9,0
10,2,2018,16,0,3,"Braga",6,"Avenida Padre Júlio Fragata",67,67,0,83,83,0
10,2,2018,16,0,3,"Braga",7,"Rua Nova Santa Cruz",25,44,19,69,39,30
10,2,2018,16,0,3,"Braga",8,"Rua Costa Gomes",0,41,41,-1,42,-43
10,2,2018,17,0,3,"Braga",1,"Avenida da Liberdade",14,25,11,221,124,97
10,2,2018,17,0,3,"Braga",2,"Avenida Central",14,25,11,221,124,97
10,2,2018,17,0,3,"Braga",3,"Rua de Caires",28,36,8,48,37,11
10,2,2018,17,0,3,"Braga",4,"N14 Bosch",20,47,27,112,48,64
10,2,2018,17,0,3,"Braga",5,"Avenida João Paulo II",6,39,33,58,9,49
10,2,2018,17,0,3,"Braga",6,"Avenida Padre Júlio Fragata",11,67,56,507,83,424
10,2,2018,17,0,3,"Braga",7,"Rua Nova Santa Cruz",4,44,40,432,39,393
10,2,2018,17,0,3,"Braga",8,"Rua Costa Gomes",0,41,41,-1,42,-43
10,2,2018,18,0,3,"Braga",1,"Avenida da Liberdade",18,25,7,172,124,48
10,2,2018,18,0,3,"Braga",2,"Avenida Central",18,25,7,172,124,48
10,2,2018,18,0,3,"Braga",3,"Rua de Caires",4,36,32,337,37,300
10,2,2018,18,0,3,"Braga",4,"N14 Bosch",10,47,37,225,48,177
10,2,2018,18,0,3,"Braga",5,"Avenida João Paulo II",8,39,31,44,9,35
10,2,2018,18,0,3,"Braga",6,"Avenida Padre Júlio Fragata",17,67,50,328,83,245
10,2,2018,18,0,3,"Braga",7,"Rua Nova Santa Cruz",5,44,39,346,39,307
10,2,2018,18,0,3,"Braga",8,"Rua Costa Gomes",0,41,41,-1,42,-43
10,2,2018,19,0,3,"Braga",1,"Avenida da Liberdade",25,25,0,124,124,0
10,2,2018,19,0,3,"Braga",2,"Avenida Central",25,25,0,124,124,0
10,2,2018,19,0,3,"Braga",3,"Rua de Caires",24,36,12,56,37,19
10,2,2018,19,0,3,"Braga",4,"N14 Bosch",47,47,0,48,48,0
10,2,2018,19,0,3,"Braga",5,"Avenida João Paulo II",30,39,9,12,9,3
10,2,2018,19,0,3,"Braga",6,"Avenida Padre Júlio Fragata",52,67,15,107,83,24
10,2,2018,19,0,3,"Braga",7,"Rua Nova Santa Cruz",6,44,38,288,39,249
10,2,2018,19,0,3,"Braga",8,"Rua Costa Gomes",0,41,41,-1,42,-43
10,2,2018,20,0,3,"Braga",1,"Avenida da Liberdade",19,25,6,163,124,39
10,2,2018,20,0,3,"Braga",2,"Avenida Central",19,25,6,163,124,39
10,2,2018,20,0,3,"Braga",3,"Rua de Caires",36,36,0,37,37,0
10,2,2018,20,0,3,"Braga",4,"N14 Bosch",47,47,0,48,48,0
10,2,2018,20,0,3,"Braga",5,"Avenida João Paulo II",29,39,10,12,9,3
10,2,2018,20,0,3,"Braga",6,"Avenida Padre Júlio Fragata",67,67,0,83,83,0
10,2,2018,20,0,3,"Braga",7,"Rua Nova Santa Cruz",33,44,11,52,39,13
10,2,2018,20,0,3,"Braga",8,"Rua Costa Gomes",0,41,41,-1,42,-43
10,2,2018,21,0,3,"Braga",1,"Avenida da Liberdade",25,25,0,124,124,0
10,2,2018,21,0,3,"Braga",2,"Avenida Central",25,25,0,124,124,0
10,2,2018,21,0,3,"Braga",3,"Rua de Caires",36,36,0,37,37,0
10,2,2018,21,0,3,"Braga",4,"N14 Bosch",47,47,0,48,48,0
10,2,2018,21,0,3,"Braga",5,"Avenida João Paulo II",39,39,0,9,9,0
10,2,2018,21,0,3,"Braga",6,"Avenida Padre Júlio Fragata",67,67,0,83,83,0
10,2,2018,21,0,3,"Braga",7,"Rua Nova Santa Cruz",30,44,14,58,39,19
10,2,2018,21,0,3,"Braga",8,"Rua Costa Gomes",0,41,41,-1,42,-43
10,2,2018,22,0,3,"Braga",1,"Avenida da Liberdade",25,25,0,124,124,0
10,2,2018,22,0,3,"Braga",2,"Avenida Central",25,25,0,124,124,0
10,2,2018,22,0,3,"Braga",3,"Rua de Caires",36,36,0,37,37,0
10,2,2018,22,0,3,"Braga",4,"N14 Bosch",47,47,0,48,48,0
10,2,2018,22,0,3,"Braga",5,"Avenida João Paulo II",39,39,0,9,9,0
10,2,2018,22,0,3,"Braga",6,"Avenida Padre Júlio Fragata",67,67,0,83,83,0
10,2,2018,22,0,3,"Braga",7,"Rua Nova Santa Cruz",44,44,0,39,39,0
10,2,2018,22,0,3,"Braga",8,"Rua Costa Gomes",0,41,41,-1,42,-43
10,2,2018,23,0,3,"Braga",1,"Avenida da Liberdade",25,25,0,124,124,0
10,2,2018,23,0,3,"Braga",2,"Avenida Central",25,25,0,124,124,0
10,2,2018,23,0,3,"Braga",3,"Rua de Caires",36,36,0,37,37,0
10,2,2018,23,0,3,"Braga",4,"N14 Bosch",47,47,0,48,48,0
10,2,2018,23,0,3,"Braga",5,"Avenida João Paulo II",39,39,0,9,9,0
10,2,2018,23,0,3,"Braga",6,"Avenida Padre Júlio Fragata",67,67,0,83,83,0
10,2,2018,23,0,3,"Braga",7,"Rua Nova Santa Cruz",44,44,0,39,39,0
10,2,2018,23,0,3,"Braga",8,"Rua Costa Gomes",0,41,41,-1,42,-43
10,3,2018,0,0,4,"Braga",1,"Avenida da Liberdade",25,25,0,124,124,0
10,3,2018,0,0,4,"Braga",2,"Avenida Central",25,25,0,124,124,0
10,3,2018,0,0,4,"Braga",3,"Rua de Caires",36,36,0,37,37,0
10,3,2018,0,0,4,"Braga",4,"N14 Bosch",47,47,0,48,48,0
10,3,2018,0,0,4,"Braga",5,"Avenida João Paulo II",39,39,0,9,9,0
10,3,2018,0,0,4,"Braga",6,"Avenida Padre Júlio Fragata",67,67,0,83,83,0
10,3,2018,0,0,4,"Braga",7,"Rua Nova Santa Cruz",44,44,0,39,39,0
10,3,2018,0,0,4,"Braga",8,"Rua Costa Gomes",0,41,41,-1,42,-43
10,3,2018,1,0,4,"Braga",1,"Avenida da Liberdade",25,25,0,124,124,0
10,3,2018,1,0,4,"Braga",2,"Avenida Central",25,25,0,124,124,0
10,3,2018,1,0,4,"Braga",3,"Rua de Caires",36,36,0,37,37,0
10,3,2018,1,0,4,"Braga",4,"N14 Bosch",47,47,0,48,48,0
10,3,2018,1,0,4,"Braga",5,"Avenida João Paulo II",39,39,0,9,9,0
10,3,2018,1,0,4,"Braga",6,"Avenida Padre Júlio Fragata",67,67,0,83,83,0
10,3,2018,1,0,4,"Braga",7,"Rua Nova Santa Cruz",44,44,0,39,39,0
10,3,2018,1,0,4,"Braga",8,"Rua Costa Gomes",0,41,41,-1,42,-43
10,3,2018,2,0,4,"Braga",1,"Avenida da Liberdade",25,25,0,124,124,0
10,3,2018,2,0,4,"Braga",2,"Avenida Central",25,25,0,124,124,0
10,3,2018,2,0,4,"Braga",3,"Rua de Caires",36,36,0,37,37,0
10,3,2018,2,0,4,"Braga",4,"N14 Bosch",47,47,0,48,48,0
10,3,2018,2,0,4,"Braga",5,"Avenida João Paulo II",39,39,0,9,9,0
10,3,2018,2,0,4,"Braga",6,"Avenida Padre Júlio Fragata",67,67,0,83,83,0
10,3,2018,2,0,4,"Braga",7,"Rua Nova Santa Cruz",44,44,0,39,39,0
10,3,2018,2,0,4,"Braga",8,"Rua Costa Gomes",0,41,41,-1,42,-43
10,3,2018,3,0,4,"Braga",1,"Avenida da Liberdade",25,25,0,124,124,0
10,3,2018,3,0,4,"Braga",2,"Avenida Central",25,25,0,124,124,0
10,3,2018,3,0,4,"Braga",3,"Rua de Caires",36,36,0,37,37,0
10,3,2018,3,0,4,"Braga",4,"N14 Bosch",47,47,0,48,48,0
10,3,2018,3,0,4,"Braga",5,"Avenida João Paulo II",39,39,0,9,9,0
10,3,2018,3,0,4,"Braga",6,"Avenida Padre Júlio Fragata",67,67,0,83,83,0
10,3,2018,3,0,4,"Braga",7,"Rua Nova Santa Cruz",44,44,0,39,39,0
10,3,2018,3,0,4,"Braga",8,"Rua Costa Gomes",0,41,41,-1,42,-43
10,3,2018,4,0,4,"Braga",1,"Avenida da Liberdade",25,25,0,124,124,0
10,3,2018,4,0,4,"Braga",2,"Avenida Central",25,25,0,124,124,0
10,3,2018,4,0,4,"Braga",3,"Rua de Caires",36,36,0,37,37,0
10,3,2018,4,0,4,"Braga",4,"N14 Bosch",47,47,0,48,48,0
10,3,2018,4,0,4,"Braga",5,"Avenida João Paulo II",39,39,0,9,9,0
10,3,2018,4,0,4,"Braga",6,"Avenida Padre Júlio Fragata",67,67,0,83,83,0
10,3,2018,4,0,4,"Braga",7,"Rua Nova Santa Cruz",44,44,0,39,39,0
10,3,2018,4,0,4,"Braga",8,"Rua Costa Gomes",0,41,41,-1,42,-43
10,3,2018,5,0,4,"Braga",1,"Avenida da Liberdade",25,25,0,124,124,0
10,3,2018,5,0,4,"Braga",2,"Avenida Central",25,25,0,124,124,0
10,3,2018,5,0,4,"Braga",3,"Rua de Caires",36,36,0,37,37,0
10,3,2018,5,0,4,"Braga",4,"N14 Bosch",47,47,0,48,48,0
10,3,2018,5,0,4,"Braga",5,"Avenida João Paulo II",39,39,0,9,9,0
10,3,2018,5,0,4,"Braga",6,"Avenida Padre Júlio Fragata",67,67,0,83,83,0
10,3,2018,5,0,4,"Braga",7,"Rua Nova Santa Cruz",44,44,0,39,39,0
10,3,2018,5,0,4,"Braga",8,"Rua Costa Gomes",0,41,41,-1,42,-43
10,3,2018,6,0,4,"Braga",1,"Avenida da Liberdade",25,25,0,124,124,0
10,3,2018,6,0,4,"Braga",2,"Avenida Central",25,25,0,124,124,0
10,3,2018,6,0,4,"Braga",3,"Rua de Caires",36,36,0,37,37,0
10,3,2018,6,0,4,"Braga",4,"N14 Bosch",47,47,0,48,48,0
10,3,2018,6,0,4,"Braga",5,"Avenida João Paulo II",39,39,0,9,9,0
10,3,2018,6,0,4,"Braga",6,"Avenida Padre Júlio Fragata",67,67,0,83,83,0
10,3,2018,6,0,4,"Braga",7,"Rua Nova Santa Cruz",44,44,0,39,39,0
10,3,2018,6,0,4,"Braga",8,"Rua Costa Gomes",0,41,41,-1,42,-43
10,3,2018,7,0,4,"Braga",1,"Avenida da Liberdade",25,25,0,124,124,0
10,3,2018,7,0,4,"Braga",2,"Avenida Central",25,25,0,124,124,0
10,3,2018,7,0,4,"Braga",3,"Rua de Caires",21,36,15,64,37,27
10,3,2018,7,0,4,"Braga",4,"N14 Bosch",35,47,12,64,48,16
10,3,2018,7,0,4,"Braga",5,"Avenida João Paulo II",39,39,0,9,9,0
10,3,2018,7,0,4,"Braga",6,"Avenida Padre Júlio Fragata",67,67,0,83,83,0
10,3,2018,7,0,4,"Braga",7,"Rua Nova Santa Cruz",44,44,0,39,39,0
10,3,2018,7,0,4,"Braga",8,"Rua Costa Gomes",0,41,41,-1,42,-43
10,3,2018,8,0,4,"Braga",1,"Avenida da Liberdade",25,25,0,124,124,0
10,3,2018,8,0,4,"Braga",2,"Avenida Central",25,25,0,124,124,0
10,3,2018,8,0,4,"Braga",3,"Rua de Caires",22,36,14,61,37,24
10,3,2018,8,0,4,"Braga",4,"N14 Bosch",23,47,24,98,48,50
10,3,2018,8,0,4,"Braga",5,"Avenida João Paulo II",39,39,0,9,9,0
10,3,2018,8,0,4,"Braga",6,"Avenida Padre Júlio Fragata",30,67,37,186,83,103
10,3,2018,8,0,4,"Braga",7,"Rua Nova Santa Cruz",2,44,42,864,39,825
10,3,2018,8,0,4,"Braga",8,"Rua Costa Gomes",0,41,41,-1,42,-43
10,3,2018,9,0,4,"Braga",1,"Avenida da Liberdade",25,25,0,124,124,0
10,3,2018,9,0,4,"Braga",2,"Avenida Central",25,25,0,124,124,0
10,3,2018,9,0,4,"Braga",3,"Rua de Caires",36,36,0,37,37,0
10,3,2018,9,0,4,"Braga",4,"N14 Bosch",25,47,22,90,48,42
10,3,2018,9,0,4,"Braga",5,"Avenida João Paulo II",39,39,0,9,9,0
10,3,2018,9,0,4,"Braga",6,"Avenida Padre Júlio Fragata",67,67,0,83,83,0
10,3,2018,9,0,4,"Braga",7,"Rua Nova Santa Cruz",44,44,0,39,39,0
10,3,2018,9,0,4,"Braga",8,"Rua Costa Gomes",0,41,41,-1,42,-43
10,3,2018,10,0,4,"Braga",1,"Avenida da Liberdade",25,25,0,124,124,0
10,3,2018,10,0,4,"Braga",2,"Avenida Central",25,25,0,124,124,0
10,3,2018,10,0,4,"Braga",3,"Rua de Caires",25,36,11,54,37,17
10,3,2018,10,0,4,"Braga",4,"N14 Bosch",28,47,19,80,48,32
10,3,2018,10,0,4,"Braga",5,"Avenida João Paulo II",39,39,0,9,9,0
10,3,2018,10,0,4,"Braga",6,"Avenida Padre Júlio Fragata",67,67,0,83,83,0
10,3,2018,10,0,4,"Braga",7,"Rua Nova Santa Cruz",19,44,25,91,39,52
10,3,2018,10,0,4,"Braga",8,"Rua Costa Gomes",0,41,41,-1,42,-43
10,3,2018,11,0,4,"Braga",1,"Avenida da Liberdade",17,25,8,182,124,58
10,3,2018,11,0,4,"Braga",2,"Avenida Central",17,25,8,182,124,58
10,3,2018,11,0,4,"Braga",3,"Rua de Caires",36,36,0,37,37,0
10,3,2018,11,0,4,"Braga",4,"N14 Bosch",30,47,17,75,48,27
10,3,2018,11,0,4,"Braga",5,"Avenida João Paulo II",39,39,0,9,9,0
10,3,2018,11,0,4,"Braga",6,"Avenida Padre Júlio Fragata",67,67,0,83,83,0
10,3,2018,11,0,4,"Braga",7,"Rua Nova Santa Cruz",25,44,19,69,39,30
10,3,2018,11,0,4,"Braga",8,"Rua Costa Gomes",0,41,41,-1,42,-43
10,3,2018,12,0,4,"Braga",1,"Avenida da Liberdade",25,25,0,124,124,0
10,3,2018,12,0,4,"Braga",2,"Avenida Central",25,25,0,124,124,0
10,3,2018,12,0,4,"Braga",3,"Rua de Caires",28,36,8,48,37,11
10,3,2018,12,0,4,"Braga",4,"N14 Bosch",16,47,31,140,48,92
10,3,2018,12,0,4,"Braga",5,"Avenida João Paulo II",39,39,0,9,9,0
10,3,2018,12,0,4,"Braga",6,"Avenida Padre Júlio Fragata",67,67,0,83,83,0
10,3,2018,12,0,4,"Braga",7,"Rua Nova Santa Cruz",16,44,28,108,39,69
10,3,2018,12,0,4,"Braga",8,"Rua Costa Gomes",0,41,41,-1,42,-43
10,3,2018,13,0,4,"Braga",1,"Avenida da Liberdade",25,25,0,124,124,0
10,3,2018,13,0,4,"Braga",2,"Avenida Central",25,25,0,124,124,0
10,3,2018,13,0,4,"Braga",3,"Rua de Caires",36,36,0,37,37,0
10,3,2018,13,0,4,"Braga",4,"N14 Bosch",21,47,26,107,48,59
10,3,2018,13,0,4,"Braga",5,"Avenida João Paulo II",39,39,0,9,9,0
10,3,2018,13,0,4,"Braga",6,"Avenida Padre Júlio Fragata",67,67,0,83,83,0
10,3,2018,13,0,4,"Braga",7,"Rua Nova Santa Cruz",17,44,27,102,39,63
10,3,2018,13,0,4,"Braga",8,"Rua Costa Gomes",0,41,41,-1,42,-43
10,3,2018,14,0,4,"Braga",1,"Avenida da Liberdade",25,25,0,124,124,0
10,3,2018,14,0,4,"Braga",2,"Avenida Central",25,25,0,124,124,0
10,3,2018,14,0,4,"Braga",3,"Rua de Caires",21,36,15,64,37,27
10,3,2018,14,0,4,"Braga",4,"N14 Bosch",34,47,13,66,48,18
10,3,2018,14,0,4,"Braga",5,"Avenida João Paulo II",39,39,0,9,9,0
10,3,2018,14,0,4,"Braga",6,"Avenida Padre Júlio Fragata",53,67,14,105,83,22
10,3,2018,14,0,4,"Braga",7,"Rua Nova Santa Cruz",44,44,0,39,39,0
10,3,2018,14,0,4,"Braga",8,"Rua Costa Gomes",0,41,41,-1,42,-43
10,3,2018,15,0,4,"Braga",1,"Avenida da Liberdade",17,25,8,182,124,58
10,3,2018,15,0,4,"Braga",2,"Avenida Central",17,25,8,182,124,58
10,3,2018,15,0,4,"Braga",3,"Rua de Caires",28,36,8,48,37,11
10,3,2018,15,0,4,"Braga",4,"N14 Bosch",47,47,0,48,48,0
10,3,2018,15,0,4,"Braga",5,"Avenida João Paulo II",31,39,8,11,9,2
10,3,2018,15,0,4,"Braga",6,"Avenida Padre Júlio Fragata",67,67,0,83,83,0
10,3,2018,15,0,4,"Braga",7,"Rua Nova Santa Cruz",26,44,18,66,39,27
10,3,2018,15,0,4,"Braga",8,"Rua Costa Gomes",0,41,41,-1,42,-43
10,3,2018,16,0,4,"Braga",1,"Avenida da Liberdade",19,25,6,163,124,39
10,3,2018,16,0,4,"Braga",2,"Avenida Central",19,25,6,163,124,39
10,3,2018,16,0,4,"Braga",3,"Rua de Caires",24,36,12,56,37,19
10,3,2018,16,0,4,"Braga",4,"N14 Bosch",21,47,26,107,48,59
10,3,2018,16,0,4,"Braga",5,"Avenida João Paulo II",39,39,0,9,9,0
10,3,2018,16,0,4,"Braga",6,"Avenida Padre Júlio Fragata",67,67,0,83,83,0
10,3,2018,16,0,4,"Braga",7,"Rua Nova Santa Cruz",31,44,13,56,39,17
10,3,2018,16,0,4,"Braga",8,"Rua Costa Gomes",0,41,41,-1,42,-43
10,3,2018,17,0,4,"Braga",1,"Avenida da Liberdade",11,25,14,282,124,158
10,3,2018,17,0,4,"Braga",2,"Avenida Central",11,25,14,282,124,158
10,3,2018,17,0,4,"Braga",3,"Rua de Caires",26,36,10,52,37,15
10,3,2018,17,0,4,"Braga",4,"N14 Bosch",18,47,29,125,48,77
10,3,2018,17,0,4,"Braga",5,"Avenida João Paulo II",39,39,0,9,9,0
10,3,2018,17,0,4,"Braga",6,"Avenida Padre Júlio Fragata",36,67,31,155,83,72
10,3,2018,17,0,4,"Braga",7,"Rua Nova Santa Cruz",26,44,18,66,39,27
10,3,2018,17,0,4,"Braga",8,"Rua Costa Gomes",0,41,41,-1,42,-43
10,3,2018,18,0,4,"Braga",1,"Avenida da Liberdade",19,25,6,163,124,39
10,3,2018,18,0,4,"Braga",2,"Avenida Central",19,25,6,163,124,39
10,3,2018,18,0,4,"Braga",3,"Rua de Caires",19,36,17,71,37,34
10,3,2018,18,0,4,"Braga",4,"N14 Bosch",30,47,17,75,48,27
10,3,2018,18,0,4,"Braga",5,"Avenida João Paulo II",10,39,29,35,9,26
10,3,2018,18,0,4,"Braga",6,"Avenida Padre Júlio Fragata",19,67,48,293,83,210
10,3,2018,18,0,4,"Braga",7,"Rua Nova Santa Cruz",44,44,0,39,39,0
10,3,2018,18,0,4,"Braga",8,"Rua Costa Gomes",0,41,41,-1,42,-43
10,3,2018,19,0,4,"Braga",1,"Avenida da Liberdade",25,25,0,124,124,0
10,3,2018,19,0,4,"Braga",2,"Avenida Central",25,25,0,124,124,0
10,3,2018,19,0,4,"Braga",3,"Rua de Caires",36,36,0,37,37,0
10,3,2018,19,0,4,"Braga",4,"N14 Bosch",33,47,14,68,48,20
10,3,2018,19,0,4,"Braga",5,"Avenida João Paulo II",30,39,9,12,9,3
10,3,2018,19,0,4,"Braga",6,"Avenida Padre Júlio Fragata",52,67,15,107,83,24
10,3,2018,19,0,4,"Braga",7,"Rua Nova Santa Cruz",44,44,0,39,39,0
10,3,2018,19,0,4,"Braga",8,"Rua Costa Gomes",0,41,41,-1,42,-43
10,3,2018,20,0,4,"Braga",1,"Avenida da Liberdade",25,25,0,124,124,0
10,3,2018,20,0,4,"Braga",2,"Avenida Central",25,25,0,124,124,0
10,3,2018,20,0,4,"Braga",3,"Rua de Caires",36,36,0,37,37,0
10,3,2018,20,0,4,"Braga",4,"N14 Bosch",47,47,0,48,48,0
10,3,2018,20,0,4,"Braga",5,"Avenida João Paulo II",39,39,0,9,9,0
10,3,2018,20,0,4,"Braga",6,"Avenida Padre Júlio Fragata",67,67,0,83,83,0
10,3,2018,20,0,4,"Braga",7,"Rua Nova Santa Cruz",27,44,17,64,39,25
10,3,2018,20,0,4,"Braga",8,"Rua Costa Gomes",0,41,41,-1,42,-43
10,3,2018,21,0,4,"Braga",1,"Avenida da Liberdade",25,25,0,124,124,0
10,3,2018,21,0,4,"Braga",2,"Avenida Central",25,25,0,124,124,0
10,3,2018,21,0,4,"Braga",3,"Rua de Caires",36,36,0,37,37,0
10,3,2018,21,0,4,"Braga",4,"N14 Bosch",47,47,0,48,48,0
10,3,2018,21,0,4,"Braga",5,"Avenida João Paulo II",39,39,0,9,9,0
10,3,2018,21,0,4,"Braga",6,"Avenida Padre Júlio Fragata",67,67,0,83,83,0
10,3,2018,21,0,4,"Braga",7,"Rua Nova Santa Cruz",21,44,23,82,39,43
10,3,2018,21,0,4,"Braga",8,"Rua Costa Gomes",0,41,41,-1,42,-43
10,3,2018,22,0,4,"Braga",1,"Avenida da Liberdade",25,25,0,124,124,0
10,3,2018,22,0,4,"Braga",2,"Avenida Central",25,25,0,124,124,0
10,3,2018,22,0,4,"Braga",3,"Rua de Caires",36,36,0,37,37,0
10,3,2018,22,0,4,"Braga",4,"N14 Bosch",47,47,0,48,48,0
10,3,2018,22,0,4,"Braga",5,"Avenida João Paulo II",39,39,0,9,9,0
10,3,2018,22,0,4,"Braga",6,"Avenida Padre Júlio Fragata",67,67,0,83,83,0
10,3,2018,22,0,4,"Braga",7,"Rua Nova Santa Cruz",44,44,0,39,39,0
10,3,2018,22,0,4,"Braga",8,"Rua Costa Gomes",0,41,41,-1,42,-43
10,3,2018,23,0,4,"Braga",1,"Avenida da Liberdade",25,25,0,124,124,0
10,3,2018,23,0,4,"Braga",2,"Avenida Central",25,25,0,124,124,0
10,3,2018,23,0,4,"Braga",3,"Rua de Caires",36,36,0,37,37,0
10,3,2018,23,0,4,"Braga",4,"N14 Bosch",47,47,0,48,48,0
10,3,2018,23,0,4,"Braga",5,"Avenida João Paulo II",30,39,9,12,9,3
10,3,2018,23,0,4,"Braga",6,"Avenida Padre Júlio Fragata",67,67,0,83,83,0
10,3,2018,23,0,4,"Braga",7,"Rua Nova Santa Cruz",44,44,0,39,39,0
10,3,2018,23,0,4,"Braga",8,"Rua Costa Gomes",0,41,41,-1,42,-43
10,4,2018,0,0,5,"Braga",1,"Avenida da Liberdade",25,25,0,124,124,0
10,4,2018,0,0,5,"Braga",2,"Avenida Central",25,25,0,124,124,0
10,4,2018,0,0,5,"Braga",3,"Rua de Caires",36,36,0,37,37,0
10,4,2018,0,0,5,"Braga",4,"N14 Bosch",47,47,0,48,48,0
10,4,2018,0,0,5,"Braga",5,"Avenida João Paulo II",39,39,0,9,9,0
10,4,2018,0,0,5,"Braga",6,"Avenida Padre Júlio Fragata",67,67,0,83,83,0
10,4,2018,0,0,5,"Braga",7,"Rua Nova Santa Cruz",44,44,0,39,39,0
10,4,2018,0,0,5,"Braga",8,"Rua Costa Gomes",0,41,41,-1,42,-43
10,4,2018,1,0,5,"Braga",1,"Avenida da Liberdade",25,25,0,124,124,0
10,4,2018,1,0,5,"Braga",2,"Avenida Central",25,25,0,124,124,0
10,4,2018,1,0,5,"Braga",3,"Rua de Caires",36,36,0,37,37,0
10,4,2018,1,0,5,"Braga",4,"N14 Bosch",47,47,0,48,48,0
10,4,2018,1,0,5,"Braga",5,"Avenida João Paulo II",39,39,0,9,9,0
10,4,2018,1,0,5,"Braga",6,"Avenida Padre Júlio Fragata",67,67,0,83,83,0
10,4,2018,1,0,5,"Braga",7,"Rua Nova Santa Cruz",44,44,0,39,39,0
10,4,2018,1,0,5,"Braga",8,"Rua Costa Gomes",0,41,41,-1,42,-43
10,4,2018,2,0,5,"Braga",1,"Avenida da Liberdade",25,25,0,124,124,0
10,4,2018,2,0,5,"Braga",2,"Avenida Central",25,25,0,124,124,0
10,4,2018,2,0,5,"Braga",3,"Rua de Caires",36,36,0,37,37,0
10,4,2018,2,0,5,"Braga",4,"N14 Bosch",47,47,0,48,48,0
10,4,2018,2,0,5,"Braga",5,"Avenida João Paulo II",39,39,0,9,9,0
10,4,2018,2,0,5,"Braga",6,"Avenida Padre Júlio Fragata",67,67,0,83,83,0
10,4,2018,2,0,5,"Braga",7,"Rua Nova Santa Cruz",44,44,0,39,39,0
10,4,2018,2,0,5,"Braga",8,"Rua Costa Gomes",0,41,41,-1,42,-43
10,4,2018,3,0,5,"Braga",1,"Avenida da Liberdade",25,25,0,124,124,0
10,4,2018,3,0,5,"Braga",2,"Avenida Central",25,25,0,124,124,0
10,4,2018,3,0,5,"Braga",3,"Rua de Caires",36,36,0,37,37,0
10,4,2018,3,0,5,"Braga",4,"N14 Bosch",47,47,0,48,48,0
10,4,2018,3,0,5,"Braga",5,"Avenida João Paulo II",39,39,0,9,9,0
10,4,2018,3,0,5,"Braga",6,"Avenida Padre Júlio Fragata",67,67,0,83,83,0
10,4,2018,3,0,5,"Braga",7,"Rua Nova Santa Cruz",44,44,0,39,39,0
10,4,2018,3,0,5,"Braga",8,"Rua Costa Gomes",0,41,41,-1,42,-43
10,4,2018,4,0,5,"Braga",1,"Avenida da Liberdade",25,25,0,124,124,0
10,4,2018,4,0,5,"Braga",2,"Avenida Central",25,25,0,124,124,0
10,4,2018,4,0,5,"Braga",3,"Rua de Caires",36,36,0,37,37,0
10,4,2018,4,0,5,"Braga",4,"N14 Bosch",47,47,0,48,48,0
10,4,2018,4,0,5,"Braga",5,"Avenida João Paulo II",39,39,0,9,9,0
10,4,2018,4,0,5,"Braga",6,"Avenida Padre Júlio Fragata",67,67,0,83,83,0
10,4,2018,4,0,5,"Braga",7,"Rua Nova Santa Cruz",44,44,0,39,39,0
10,4,2018,4,0,5,"Braga",8,"Rua Costa Gomes",0,41,41,-1,42,-43
10,4,2018,5,0,5,"Braga",1,"Avenida da Liberdade",25,25,0,124,124,0
10,4,2018,5,0,5,"Braga",2,"Avenida Central",25,25,0,124,124,0
10,4,2018,5,0,5,"Braga",3,"Rua de Caires",36,36,0,37,37,0
10,4,2018,5,0,5,"Braga",4,"N14 Bosch",47,47,0,48,48,0
10,4,2018,5,0,5,"Braga",5,"Avenida João Paulo II",39,39,0,9,9,0
10,4,2018,5,0,5,"Braga",6,"Avenida Padre Júlio Fragata",67,67,0,83,83,0
10,4,2018,5,0,5,"Braga",7,"Rua Nova Santa Cruz",44,44,0,39,39,0
10,4,2018,5,0,5,"Braga",8,"Rua Costa Gomes",0,41,41,-1,42,-43
10,4,2018,6,0,5,"Braga",1,"Avenida da Liberdade",25,25,0,124,124,0
10,4,2018,6,0,5,"Braga",2,"Avenida Central",25,25,0,124,124,0
10,4,2018,6,0,5,"Braga",3,"Rua de Caires",36,36,0,37,37,0
10,4,2018,6,0,5,"Braga",4,"N14 Bosch",47,47,0,48,48,0
10,4,2018,6,0,5,"Braga",5,"Avenida João Paulo II",39,39,0,9,9,0
10,4,2018,6,0,5,"Braga",6,"Avenida Padre Júlio Fragata",67,67,0,83,83,0
10,4,2018,6,0,5,"Braga",7,"Rua Nova Santa Cruz",44,44,0,39,39,0
10,4,2018,6,0,5,"Braga",8,"Rua Costa Gomes",0,41,41,-1,42,-43
10,4,2018,7,0,5,"Braga",1,"Avenida da Liberdade",25,25,0,124,124,0
10,4,2018,7,0,5,"Braga",2,"Avenida Central",25,25,0,124,124,0
10,4,2018,7,0,5,"Braga",3,"Rua de Caires",21,36,15,64,37,27
10,4,2018,7,0,5,"Braga",4,"N14 Bosch",47,47,0,48,48,0
10,4,2018,7,0,5,"Braga",5,"Avenida João Paulo II",39,39,0,9,9,0
10,4,2018,7,0,5,"Braga",6,"Avenida Padre Júlio Fragata",67,67,0,83,83,0
10,4,2018,7,0,5,"Braga",7,"Rua Nova Santa Cruz",44,44,0,39,39,0
10,4,2018,7,0,5,"Braga",8,"Rua Costa Gomes",0,41,41,-1,42,-43
10,4,2018,8,0,5,"Braga",1,"Avenida da Liberdade",16,25,9,194,124,70
10,4,2018,8,0,5,"Braga",2,"Avenida Central",15,25,10,207,124,83
10,4,2018,8,0,5,"Braga",3,"Rua de Caires",26,36,10,52,37,15
10,4,2018,8,0,5,"Braga",4,"N14 Bosch",28,47,19,80,48,32
10,4,2018,8,0,5,"Braga",5,"Avenida João Paulo II",31,39,8,11,9,2
10,4,2018,8,0,5,"Braga",6,"Avenida Padre Júlio Fragata",36,67,31,155,83,72
10,4,2018,8,0,5,"Braga",7,"Rua Nova Santa Cruz",11,44,33,157,39,118
10,4,2018,8,0,5,"Braga",8,"Rua Costa Gomes",0,41,41,-1,42,-43
10,4,2018,9,0,5,"Braga",1,"Avenida da Liberdade",16,25,9,194,124,70
10,4,2018,9,0,5,"Braga",2,"Avenida Central",16,25,9,194,124,70
10,4,2018,9,0,5,"Braga",3,"Rua de Caires",26,36,10,52,37,15
10,4,2018,9,0,5,"Braga",4,"N14 Bosch",28,47,19,80,48,32
10,4,2018,9,0,5,"Braga",5,"Avenida João Paulo II",39,39,0,9,9,0
10,4,2018,9,0,5,"Braga",6,"Avenida Padre Júlio Fragata",67,67,0,83,83,0
10,4,2018,9,0,5,"Braga",7,"Rua Nova Santa Cruz",44,44,0,39,39,0
10,4,2018,9,0,5,"Braga",8,"Rua Costa Gomes",0,41,41,-1,42,-43
10,4,2018,10,0,5,"Braga",1,"Avenida da Liberdade",19,25,6,163,124,39
10,4,2018,10,0,5,"Braga",2,"Avenida Central",19,25,6,163,124,39
10,4,2018,10,0,5,"Braga",3,"Rua de Caires",28,36,8,48,37,11
10,4,2018,10,0,5,"Braga",4,"N14 Bosch",47,47,0,48,48,0
10,4,2018,10,0,5,"Braga",5,"Avenida João Paulo II",26,39,13,13,9,4
10,4,2018,10,0,5,"Braga",6,"Avenida Padre Júlio Fragata",67,67,0,83,83,0
10,4,2018,10,0,5,"Braga",7,"Rua Nova Santa Cruz",31,44,13,56,39,17
10,4,2018,10,0,5,"Braga",8,"Rua Costa Gomes",0,41,41,-1,42,-43
10,4,2018,11,0,5,"Braga",1,"Avenida da Liberdade",25,25,0,124,124,0
10,4,2018,11,0,5,"Braga",2,"Avenida Central",25,25,0,124,124,0
10,4,2018,11,0,5,"Braga",3,"Rua de Caires",19,36,17,71,37,34
10,4,2018,11,0,5,"Braga",4,"N14 Bosch",27,47,20,83,48,35
10,4,2018,11,0,5,"Braga",5,"Avenida João Paulo II",31,39,8,11,9,2
10,4,2018,11,0,5,"Braga",6,"Avenida Padre Júlio Fragata",67,67,0,83,83,0
10,4,2018,11,0,5,"Braga",7,"Rua Nova Santa Cruz",44,44,0,39,39,0
10,4,2018,11,0,5,"Braga",8,"Rua Costa Gomes",0,41,41,-1,42,-43
10,4,2018,12,0,5,"Braga",1,"Avenida da Liberdade",19,25,6,163,124,39
10,4,2018,12,0,5,"Braga",2,"Avenida Central",19,25,6,163,124,39
10,4,2018,12,0,5,"Braga",3,"Rua de Caires",27,36,9,50,37,13
10,4,2018,12,0,5,"Braga",4,"N14 Bosch",29,47,18,77,48,29
10,4,2018,12,0,5,"Braga",5,"Avenida João Paulo II",39,39,0,9,9,0
10,4,2018,12,0,5,"Braga",6,"Avenida Padre Júlio Fragata",67,67,0,83,83,0
10,4,2018,12,0,5,"Braga",7,"Rua Nova Santa Cruz",13,44,31,133,39,94
10,4,2018,12,0,5,"Braga",8,"Rua Costa Gomes",0,41,41,-1,42,-43
10,4,2018,13,0,5,"Braga",1,"Avenida da Liberdade",25,25,0,124,124,0
10,4,2018,13,0,5,"Braga",2,"Avenida Central",25,25,0,124,124,0
10,4,2018,13,0,5,"Braga",3,"Rua de Caires",36,36,0,37,37,0
10,4,2018,13,0,5,"Braga",4,"N14 Bosch",23,47,24,98,48,50
10,4,2018,13,0,5,"Braga",5,"Avenida João Paulo II",29,39,10,12,9,3
10,4,2018,13,0,5,"Braga",6,"Avenida Padre Júlio Fragata",67,67,0,83,83,0
10,4,2018,13,0,5,"Braga",7,"Rua Nova Santa Cruz",20,44,24,86,39,47
10,4,2018,13,0,5,"Braga",8,"Rua Costa Gomes",0,41,41,-1,42,-43
10,4,2018,14,0,5,"Braga",1,"Avenida da Liberdade",19,25,6,163,124,39
10,4,2018,14,0,5,"Braga",2,"Avenida Central",19,25,6,163,124,39
10,4,2018,14,0,5,"Braga",3,"Rua de Caires",28,36,8,48,37,11
10,4,2018,14,0,5,"Braga",4,"N14 Bosch",29,47,18,77,48,29
10,4,2018,14,0,5,"Braga",5,"Avenida João Paulo II",39,39,0,9,9,0
10,4,2018,14,0,5,"Braga",6,"Avenida Padre Júlio Fragata",52,67,15,107,83,24
10,4,2018,14,0,5,"Braga",7,"Rua Nova Santa Cruz",30,44,14,58,39,19
10,4,2018,14,0,5,"Braga",8,"Rua Costa Gomes",0,41,41,-1,42,-43
10,4,2018,15,0,5,"Braga",1,"Avenida da Liberdade",25,25,0,124,124,0
10,4,2018,15,0,5,"Braga",2,"Avenida Central",25,25,0,124,124,0
10,4,2018,15,0,5,"Braga",3,"Rua de Caires",25,36,11,54,37,17
10,4,2018,15,0,5,"Braga",4,"N14 Bosch",20,47,27,112,48,64
10,4,2018,15,0,5,"Braga",5,"Avenida João Paulo II",39,39,0,9,9,0
10,4,2018,15,0,5,"Braga",6,"Avenida Padre Júlio Fragata",67,67,0,83,83,0
10,4,2018,15,0,5,"Braga",7,"Rua Nova Santa Cruz",22,44,22,79,39,40
10,4,2018,15,0,5,"Braga",8,"Rua Costa Gomes",0,41,41,-1,42,-43
10,4,2018,16,0,5,"Braga",1,"Avenida da Liberdade",19,25,6,163,124,39
10,4,2018,16,0,5,"Braga",2,"Avenida Central",19,25,6,163,124,39
10,4,2018,16,0,5,"Braga",3,"Rua de Caires",36,36,0,37,37,0
10,4,2018,16,0,5,"Braga",4,"N14 Bosch",25,47,22,90,48,42
10,4,2018,16,0,5,"Braga",5,"Avenida João Paulo II",19,39,20,18,9,9
10,4,2018,16,0,5,"Braga",6,"Avenida Padre Júlio Fragata",67,67,0,83,83,0
10,4,2018,16,0,5,"Braga",7,"Rua Nova Santa Cruz",16,44,28,108,39,69
10,4,2018,16,0,5,"Braga",8,"Rua Costa Gomes",0,41,41,-1,42,-43
10,4,2018,17,0,5,"Braga",1,"Avenida da Liberdade",11,25,14,282,124,158
10,4,2018,17,0,5,"Braga",2,"Avenida Central",11,25,14,282,124,158
10,4,2018,17,0,5,"Braga",3,"Rua de Caires",16,36,20,84,37,47
10,4,2018,17,0,5,"Braga",4,"N14 Bosch",22,47,25,102,48,54
10,4,2018,17,0,5,"Braga",5,"Avenida João Paulo II",11,39,28,32,9,23
10,4,2018,17,0,5,"Braga",6,"Avenida Padre Júlio Fragata",29,67,38,192,83,109
10,4,2018,17,0,5,"Braga",7,"Rua Nova Santa Cruz",3,44,41,576,39,537
10,4,2018,17,0,5,"Braga",8,"Rua Costa Gomes",0,41,41,-1,42,-43
10,4,2018,18,0,5,"Braga",1,"Avenida da Liberdade",5,25,20,620,124,496
10,4,2018,18,0,5,"Braga",2,"Avenida Central",5,25,20,620,124,496
10,4,2018,18,0,5,"Braga",3,"Rua de Caires",26,36,10,52,37,15
10,4,2018,18,0,5,"Braga",4,"N14 Bosch",17,47,30,132,48,84
10,4,2018,18,0,5,"Braga",5,"Avenida João Paulo II",39,39,0,9,9,0
10,4,2018,18,0,5,"Braga",6,"Avenida Padre Júlio Fragata",15,67,52,372,83,289
10,4,2018,18,0,5,"Braga",7,"Rua Nova Santa Cruz",5,44,39,346,39,307
10,4,2018,18,0,5,"Braga",8,"Rua Costa Gomes",0,41,41,-1,42,-43
10,4,2018,19,0,5,"Braga",1,"Avenida da Liberdade",14,25,11,221,124,97
10,4,2018,19,0,5,"Braga",2,"Avenida Central",14,25,11,221,124,97
10,4,2018,19,0,5,"Braga",3,"Rua de Caires",36,36,0,37,37,0
10,4,2018,19,0,5,"Braga",4,"N14 Bosch",24,47,23,94,48,46
10,4,2018,19,0,5,"Braga",5,"Avenida João Paulo II",4,39,35,87,9,78
10,4,2018,19,0,5,"Braga",6,"Avenida Padre Júlio Fragata",7,67,60,796,83,713
10,4,2018,19,0,5,"Braga",7,"Rua Nova Santa Cruz",5,44,39,346,39,307
10,4,2018,19,0,5,"Braga",8,"Rua Costa Gomes",0,41,41,-1,42,-43
10,4,2018,20,0,5,"Braga",1,"Avenida da Liberdade",25,25,0,124,124,0
10,4,2018,20,0,5,"Braga",2,"Avenida Central",25,25,0,124,124,0
10,4,2018,20,0,5,"Braga",3,"Rua de Caires",36,36,0,37,37,0
10,4,2018,20,0,5,"Braga",4,"N14 Bosch",47,47,0,48,48,0
10,4,2018,20,0,5,"Braga",5,"Avenida João Paulo II",39,39,0,9,9,0
10,4,2018,20,0,5,"Braga",6,"Avenida Padre Júlio Fragata",67,67,0,83,83,0
10,4,2018,20,0,5,"Braga",7,"Rua Nova Santa Cruz",7,44,37,247,39,208
10,4,2018,20,0,5,"Braga",8,"Rua Costa Gomes",0,41,41,-1,42,-43
10,4,2018,21,0,5,"Braga",1,"Avenida da Liberdade",25,25,0,124,124,0
10,4,2018,21,0,5,"Braga",2,"Avenida Central",25,25,0,124,124,0
10,4,2018,21,0,5,"Braga",3,"Rua de Caires",26,36,10,52,37,15
10,4,2018,21,0,5,"Braga",4,"N14 Bosch",47,47,0,48,48,0
10,4,2018,21,0,5,"Braga",5,"Avenida João Paulo II",39,39,0,9,9,0
10,4,2018,21,0,5,"Braga",6,"Avenida Padre Júlio Fragata",67,67,0,83,83,0
10,4,2018,21,0,5,"Braga",7,"Rua Nova Santa Cruz",44,44,0,39,39,0
10,4,2018,21,0,5,"Braga",8,"Rua Costa Gomes",0,41,41,-1,42,-43
10,4,2018,22,0,5,"Braga",1,"Avenida da Liberdade",25,25,0,124,124,0
10,4,2018,22,0,5,"Braga",2,"Avenida Central",25,25,0,124,124,0
10,4,2018,22,0,5,"Braga",3,"Rua de Caires",36,36,0,37,37,0
10,4,2018,22,0,5,"Braga",4,"N14 Bosch",47,47,0,48,48,0
10,4,2018,22,0,5,"Braga",5,"Avenida João Paulo II",30,39,9,12,9,3
10,4,2018,22,0,5,"Braga",6,"Avenida Padre Júlio Fragata",67,67,0,83,83,0
10,4,2018,22,0,5,"Braga",7,"Rua Nova Santa Cruz",27,44,17,64,39,25
10,4,2018,22,0,5,"Braga",8,"Rua Costa Gomes",0,41,41,-1,42,-43
10,4,2018,23,0,5,"Braga",1,"Avenida da Liberdade",25,25,0,124,124,0
10,4,2018,23,0,5,"Braga",2,"Avenida Central",25,25,0,124,124,0
10,4,2018,23,0,5,"Braga",3,"Rua de Caires",36,36,0,37,37,0
10,4,2018,23,0,5,"Braga",4,"N14 Bosch",47,47,0,48,48,0
10,4,2018,23,0,5,"Braga",5,"Avenida João Paulo II",39,39,0,9,9,0
10,4,2018,23,0,5,"Braga",6,"Avenida Padre Júlio Fragata",67,67,0,83,83,0
10,4,2018,23,0,5,"Braga",7,"Rua Nova Santa Cruz",44,44,0,39,39,0
10,4,2018,23,0,5,"Braga",8,"Rua Costa Gomes",0,41,41,-1,42,-43
10,5,2018,0,0,6,"Braga",1,"Avenida da Liberdade",25,25,0,124,124,0
10,5,2018,0,0,6,"Braga",2,"Avenida Central",25,25,0,124,124,0
10,5,2018,0,0,6,"Braga",3,"Rua de Caires",36,36,0,37,37,0
10,5,2018,0,0,6,"Braga",4,"N14 Bosch",47,47,0,48,48,0
10,5,2018,0,0,6,"Braga",5,"Avenida João Paulo II",39,39,0,9,9,0
10,5,2018,0,0,6,"Braga",6,"Avenida Padre Júlio Fragata",67,67,0,83,83,0
10,5,2018,0,0,6,"Braga",7,"Rua Nova Santa Cruz",32,44,12,54,39,15
10,5,2018,0,0,6,"Braga",8,"Rua Costa Gomes",0,41,41,-1,42,-43
10,5,2018,1,0,6,"Braga",1,"Avenida da Liberdade",25,25,0,124,124,0
10,5,2018,1,0,6,"Braga",2,"Avenida Central",25,25,0,124,124,0
10,5,2018,1,0,6,"Braga",3,"Rua de Caires",36,36,0,37,37,0
10,5,2018,1,0,6,"Braga",4,"N14 Bosch",47,47,0,48,48,0
10,5,2018,1,0,6,"Braga",5,"Avenida João Paulo II",39,39,0,9,9,0
10,5,2018,1,0,6,"Braga",6,"Avenida Padre Júlio Fragata",38,67,29,147,83,64
10,5,2018,1,0,6,"Braga",7,"Rua Nova Santa Cruz",44,44,0,39,39,0
10,5,2018,1,0,6,"Braga",8,"Rua Costa Gomes",0,41,41,-1,42,-43
10,5,2018,2,0,6,"Braga",1,"Avenida da Liberdade",25,25,0,124,124,0
10,5,2018,2,0,6,"Braga",2,"Avenida Central",25,25,0,124,124,0
10,5,2018,2,0,6,"Braga",3,"Rua de Caires",36,36,0,37,37,0
10,5,2018,2,0,6,"Braga",4,"N14 Bosch",47,47,0,48,48,0
10,5,2018,2,0,6,"Braga",5,"Avenida João Paulo II",39,39,0,9,9,0
10,5,2018,2,0,6,"Braga",6,"Avenida Padre Júlio Fragata",67,67,0,83,83,0
10,5,2018,2,0,6,"Braga",7,"Rua Nova Santa Cruz",44,44,0,39,39,0
10,5,2018,2,0,6,"Braga",8,"Rua Costa Gomes",0,41,41,-1,42,-43
10,5,2018,3,0,6,"Braga",1,"Avenida da Liberdade",25,25,0,124,124,0
10,5,2018,3,0,6,"Braga",2,"Avenida Central",25,25,0,124,124,0
10,5,2018,3,0,6,"Braga",3,"Rua de Caires",36,36,0,37,37,0
10,5,2018,3,0,6,"Braga",4,"N14 Bosch",47,47,0,48,48,0
10,5,2018,3,0,6,"Braga",5,"Avenida João Paulo II",39,39,0,9,9,0
10,5,2018,3,0,6,"Braga",6,"Avenida Padre Júlio Fragata",67,67,0,83,83,0
10,5,2018,3,0,6,"Braga",7,"Rua Nova Santa Cruz",44,44,0,39,39,0
10,5,2018,3,0,6,"Braga",8,"Rua Costa Gomes",0,41,41,-1,42,-43
10,5,2018,4,0,6,"Braga",1,"Avenida da Liberdade",25,25,0,124,124,0
10,5,2018,4,0,6,"Braga",2,"Avenida Central",25,25,0,124,124,0
10,5,2018,4,0,6,"Braga",3,"Rua de Caires",36,36,0,37,37,0
10,5,2018,4,0,6,"Braga",4,"N14 Bosch",47,47,0,48,48,0
10,5,2018,4,0,6,"Braga",5,"Avenida João Paulo II",39,39,0,9,9,0
10,5,2018,4,0,6,"Braga",6,"Avenida Padre Júlio Fragata",67,67,0,83,83,0
10,5,2018,4,0,6,"Braga",7,"Rua Nova Santa Cruz",44,44,0,39,39,0
10,5,2018,4,0,6,"Braga",8,"Rua Costa Gomes",0,41,41,-1,42,-43
10,5,2018,5,0,6,"Braga",1,"Avenida da Liberdade",25,25,0,124,124,0
10,5,2018,5,0,6,"Braga",2,"Avenida Central",25,25,0,124,124,0
10,5,2018,5,0,6,"Braga",3,"Rua de Caires",36,36,0,37,37,0
10,5,2018,5,0,6,"Braga",4,"N14 Bosch",47,47,0,48,48,0
10,5,2018,5,0,6,"Braga",5,"Avenida João Paulo II",39,39,0,9,9,0
10,5,2018,5,0,6,"Braga",6,"Avenida Padre Júlio Fragata",67,67,0,83,83,0
10,5,2018,5,0,6,"Braga",7,"Rua Nova Santa Cruz",32,44,12,54,39,15
10,5,2018,5,0,6,"Braga",8,"Rua Costa Gomes",0,41,41,-1,42,-43
10,5,2018,6,0,6,"Braga",1,"Avenida da Liberdade",25,25,0,124,124,0
10,5,2018,6,0,6,"Braga",2,"Avenida Central",25,25,0,124,124,0
10,5,2018,6,0,6,"Braga",3,"Rua de Caires",36,36,0,37,37,0
10,5,2018,6,0,6,"Braga",4,"N14 Bosch",47,47,0,48,48,0
10,5,2018,6,0,6,"Braga",5,"Avenida João Paulo II",39,39,0,9,9,0
10,5,2018,6,0,6,"Braga",6,"Avenida Padre Júlio Fragata",67,67,0,83,83,0
10,5,2018,6,0,6,"Braga",7,"Rua Nova Santa Cruz",44,44,0,39,39,0
10,5,2018,6,0,6,"Braga",8,"Rua Costa Gomes",0,41,41,-1,42,-43
10,5,2018,7,0,6,"Braga",1,"Avenida da Liberdade",25,25,0,124,124,0
10,5,2018,7,0,6,"Braga",2,"Avenida Central",25,25,0,124,124,0
10,5,2018,7,0,6,"Braga",3,"Rua de Caires",36,36,0,37,37,0
10,5,2018,7,0,6,"Braga",4,"N14 Bosch",47,47,0,48,48,0
10,5,2018,7,0,6,"Braga",5,"Avenida João Paulo II",39,39,0,9,9,0
10,5,2018,7,0,6,"Braga",6,"Avenida Padre Júlio Fragata",67,67,0,83,83,0
10,5,2018,7,0,6,"Braga",7,"Rua Nova Santa Cruz",26,44,18,66,39,27
10,5,2018,7,0,6,"Braga",8,"Rua Costa Gomes",0,41,41,-1,42,-43
10,5,2018,8,0,6,"Braga",1,"Avenida da Liberdade",25,25,0,124,124,0
10,5,2018,8,0,6,"Braga",2,"Avenida Central",25,25,0,124,124,0
10,5,2018,8,0,6,"Braga",3,"Rua de Caires",36,36,0,37,37,0
10,5,2018,8,0,6,"Braga",4,"N14 Bosch",47,47,0,48,48,0
10,5,2018,8,0,6,"Braga",5,"Avenida João Paulo II",39,39,0,9,9,0
10,5,2018,8,0,6,"Braga",6,"Avenida Padre Júlio Fragata",67,67,0,83,83,0
10,5,2018,8,0,6,"Braga",7,"Rua Nova Santa Cruz",44,44,0,39,39,0
10,5,2018,8,0,6,"Braga",8,"Rua Costa Gomes",0,41,41,-1,42,-43
10,5,2018,9,0,6,"Braga",1,"Avenida da Liberdade",25,25,0,124,124,0
10,5,2018,9,0,6,"Braga",2,"Avenida Central",25,25,0,124,124,0
10,5,2018,9,0,6,"Braga",3,"Rua de Caires",26,36,10,52,37,15
10,5,2018,9,0,6,"Braga",4,"N14 Bosch",47,47,0,48,48,0
10,5,2018,9,0,6,"Braga",5,"Avenida João Paulo II",39,39,0,9,9,0
10,5,2018,9,0,6,"Braga",6,"Avenida Padre Júlio Fragata",67,67,0,83,83,0
10,5,2018,9,0,6,"Braga",7,"Rua Nova Santa Cruz",44,44,0,39,39,0
10,5,2018,9,0,6,"Braga",8,"Rua Costa Gomes",0,41,41,-1,42,-43
10,5,2018,10,0,6,"Braga",1,"Avenida da Liberdade",25,25,0,124,124,0
10,5,2018,10,0,6,"Braga",2,"Avenida Central",25,25,0,124,124,0
10,5,2018,10,0,6,"Braga",3,"Rua de Caires",36,36,0,37,37,0
10,5,2018,10,0,6,"Braga",4,"N14 Bosch",47,47,0,48,48,0
10,5,2018,10,0,6,"Braga",5,"Avenida João Paulo II",39,39,0,9,9,0
10,5,2018,10,0,6,"Braga",6,"Avenida Padre Júlio Fragata",67,67,0,83,83,0
10,5,2018,10,0,6,"Braga",7,"Rua Nova Santa Cruz",44,44,0,39,39,0
10,5,2018,10,0,6,"Braga",8,"Rua Costa Gomes",0,41,41,-1,42,-43
10,5,2018,11,0,6,"Braga",1,"Avenida da Liberdade",25,25,0,124,124,0
10,5,2018,11,0,6,"Braga",2,"Avenida Central",25,25,0,124,124,0
10,5,2018,11,0,6,"Braga",3,"Rua de Caires",36,36,0,37,37,0
10,5,2018,11,0,6,"Braga",4,"N14 Bosch",47,47,0,48,48,0
10,5,2018,11,0,6,"Braga",5,"Avenida João Paulo II",39,39,0,9,9,0
10,5,2018,11,0,6,"Braga",6,"Avenida Padre Júlio Fragata",67,67,0,83,83,0
10,5,2018,11,0,6,"Braga",7,"Rua Nova Santa Cruz",44,44,0,39,39,0
10,5,2018,11,0,6,"Braga",8,"Rua Costa Gomes",0,41,41,-1,42,-43
10,5,2018,12,0,6,"Braga",1,"Avenida da Liberdade",25,25,0,124,124,0
10,5,2018,12,0,6,"Braga",2,"Avenida Central",25,25,0,124,124,0
10,5,2018,12,0,6,"Braga",3,"Rua de Caires",36,36,0,37,37,0
10,5,2018,12,0,6,"Braga",4,"N14 Bosch",47,47,0,48,48,0
10,5,2018,12,0,6,"Braga",5,"Avenida João Paulo II",30,39,9,12,9,3
10,5,2018,12,0,6,"Braga",6,"Avenida Padre Júlio Fragata",67,67,0,83,83,0
10,5,2018,12,0,6,"Braga",7,"Rua Nova Santa Cruz",44,44,0,39,39,0
10,5,2018,12,0,6,"Braga",8,"Rua Costa Gomes",0,41,41,-1,42,-43
10,5,2018,13,0,6,"Braga",1,"Avenida da Liberdade",25,25,0,124,124,0
10,5,2018,13,0,6,"Braga",2,"Avenida Central",25,25,0,124,124,0
10,5,2018,13,0,6,"Braga",3,"Rua de Caires",36,36,0,37,37,0
10,5,2018,13,0,6,"Braga",4,"N14 Bosch",47,47,0,48,48,0
10,5,2018,13,0,6,"Braga",5,"Avenida João Paulo II",39,39,0,9,9,0
10,5,2018,13,0,6,"Braga",6,"Avenida Padre Júlio Fragata",67,67,0,83,83,0
10,5,2018,13,0,6,"Braga",7,"Rua Nova Santa Cruz",44,44,0,39,39,0
10,5,2018,13,0,6,"Braga",8,"Rua Costa Gomes",0,41,41,-1,42,-43
10,5,2018,14,0,6,"Braga",1,"Avenida da Liberdade",15,25,10,207,124,83
10,5,2018,14,0,6,"Braga",2,"Avenida Central",15,25,10,207,124,83
10,5,2018,14,0,6,"Braga",3,"Rua de Caires",36,36,0,37,37,0
10,5,2018,14,0,6,"Braga",4,"N14 Bosch",47,47,0,48,48,0
10,5,2018,14,0,6,"Braga",5,"Avenida João Paulo II",14,39,25,25,9,16
10,5,2018,14,0,6,"Braga",6,"Avenida Padre Júlio Fragata",67,67,0,83,83,0
10,5,2018,14,0,6,"Braga",7,"Rua Nova Santa Cruz",44,44,0,39,39,0
10,5,2018,14,0,6,"Braga",8,"Rua Costa Gomes",0,41,41,-1,42,-43
10,5,2018,15,0,6,"Braga",1,"Avenida da Liberdade",25,25,0,124,124,0
10,5,2018,15,0,6,"Braga",2,"Avenida Central",25,25,0,124,124,0
10,5,2018,15,0,6,"Braga",3,"Rua de Caires",36,36,0,37,37,0
10,5,2018,15,0,6,"Braga",4,"N14 Bosch",47,47,0,48,48,0
10,5,2018,15,0,6,"Braga",5,"Avenida João Paulo II",21,39,18,17,9,8
10,5,2018,15,0,6,"Braga",6,"Avenida Padre Júlio Fragata",52,67,15,107,83,24
10,5,2018,15,0,6,"Braga",7,"Rua Nova Santa Cruz",44,44,0,39,39,0
10,5,2018,15,0,6,"Braga",8,"Rua Costa Gomes",0,41,41,-1,42,-43
10,5,2018,16,0,6,"Braga",1,"Avenida da Liberdade",25,25,0,124,124,0
10,5,2018,16,0,6,"Braga",2,"Avenida Central",25,25,0,124,124,0
10,5,2018,16,0,6,"Braga",3,"Rua de Caires",22,36,14,61,37,24
10,5,2018,16,0,6,"Braga",4,"N14 Bosch",47,47,0,48,48,0
10,5,2018,16,0,6,"Braga",5,"Avenida João Paulo II",39,39,0,9,9,0
10,5,2018,16,0,6,"Braga",6,"Avenida Padre Júlio Fragata",67,67,0,83,83,0
10,5,2018,16,0,6,"Braga",7,"Rua Nova Santa Cruz",44,44,0,39,39,0
10,5,2018,16,0,6,"Braga",8,"Rua Costa Gomes",0,41,41,-1,42,-43
10,5,2018,17,0,6,"Braga",1,"Avenida da Liberdade",25,25,0,124,124,0
10,5,2018,17,0,6,"Braga",2,"Avenida Central",25,25,0,124,124,0
10,5,2018,17,0,6,"Braga",3,"Rua de Caires",36,36,0,37,37,0
10,5,2018,17,0,6,"Braga",4,"N14 Bosch",47,47,0,48,48,0
10,5,2018,17,0,6,"Braga",5,"Avenida João Paulo II",39,39,0,9,9,0
10,5,2018,17,0,6,"Braga",6,"Avenida Padre Júlio Fragata",49,67,18,114,83,31
10,5,2018,17,0,6,"Braga",7,"Rua Nova Santa Cruz",44,44,0,39,39,0
10,5,2018,17,0,6,"Braga",8,"Rua Costa Gomes",0,41,41,-1,42,-43
10,5,2018,18,0,6,"Braga",1,"Avenida da Liberdade",25,25,0,124,124,0
10,5,2018,18,0,6,"Braga",2,"Avenida Central",25,25,0,124,124,0
10,5,2018,18,0,6,"Braga",3,"Rua de Caires",36,36,0,37,37,0
10,5,2018,18,0,6,"Braga",4,"N14 Bosch",47,47,0,48,48,0
10,5,2018,18,0,6,"Braga",5,"Avenida João Paulo II",24,39,15,15,9,6
10,5,2018,18,0,6,"Braga",6,"Avenida Padre Júlio Fragata",37,67,30,151,83,68
10,5,2018,18,0,6,"Braga",7,"Rua Nova Santa Cruz",44,44,0,39,39,0
10,5,2018,18,0,6,"Braga",8,"Rua Costa Gomes",0,41,41,-1,42,-43
10,5,2018,19,0,6,"Braga",1,"Avenida da Liberdade",25,25,0,124,124,0
10,5,2018,19,0,6,"Braga",2,"Avenida Central",25,25,0,124,124,0
10,5,2018,19,0,6,"Braga",3,"Rua de Caires",36,36,0,37,37,0
10,5,2018,19,0,6,"Braga",4,"N14 Bosch",47,47,0,48,48,0
10,5,2018,19,0,6,"Braga",5,"Avenida João Paulo II",27,39,12,13,9,4
10,5,2018,19,0,6,"Braga",6,"Avenida Padre Júlio Fragata",67,67,0,83,83,0
10,5,2018,19,0,6,"Braga",7,"Rua Nova Santa Cruz",28,44,16,62,39,23
10,5,2018,19,0,6,"Braga",8,"Rua Costa Gomes",0,41,41,-1,42,-43
10,5,2018,20,0,6,"Braga",1,"Avenida da Liberdade",25,25,0,124,124,0
10,5,2018,20,0,6,"Braga",2,"Avenida Central",25,25,0,124,124,0
10,5,2018,20,0,6,"Braga",3,"Rua de Caires",36,36,0,37,37,0
10,5,2018,20,0,6,"Braga",4,"N14 Bosch",47,47,0,48,48,0
10,5,2018,20,0,6,"Braga",5,"Avenida João Paulo II",39,39,0,9,9,0
10,5,2018,20,0,6,"Braga",6,"Avenida Padre Júlio Fragata",49,67,18,114,83,31
10,5,2018,20,0,6,"Braga",7,"Rua Nova Santa Cruz",44,44,0,39,39,0
10,5,2018,20,0,6,"Braga",8,"Rua Costa Gomes",0,41,41,-1,42,-43
10,5,2018,21,0,6,"Braga",1,"Avenida da Liberdade",25,25,0,124,124,0
10,5,2018,21,0,6,"Braga",2,"Avenida Central",25,25,0,124,124,0
10,5,2018,21,0,6,"Braga",3,"Rua de Caires",36,36,0,37,37,0
10,5,2018,21,0,6,"Braga",4,"N14 Bosch",47,47,0,48,48,0
10,5,2018,21,0,6,"Braga",5,"Avenida João Paulo II",39,39,0,9,9,0
10,5,2018,21,0,6,"Braga",6,"Avenida Padre Júlio Fragata",67,67,0,83,83,0
10,5,2018,21,0,6,"Braga",7,"Rua Nova Santa Cruz",44,44,0,39,39,0
10,5,2018,21,0,6,"Braga",8,"Rua Costa Gomes",0,41,41,-1,42,-43
10,5,2018,22,0,6,"Braga",1,"Avenida da Liberdade",25,25,0,124,124,0
10,5,2018,22,0,6,"Braga",2,"Avenida Central",25,25,0,124,124,0
10,5,2018,22,0,6,"Braga",3,"Rua de Caires",36,36,0,37,37,0
10,5,2018,22,0,6,"Braga",4,"N14 Bosch",47,47,0,48,48,0
10,5,2018,22,0,6,"Braga",5,"Avenida João Paulo II",39,39,0,9,9,0
10,5,2018,22,0,6,"Braga",6,"Avenida Padre Júlio Fragata",67,67,0,83,83,0
10,5,2018,22,0,6,"Braga",7,"Rua Nova Santa Cruz",44,44,0,39,39,0
10,5,2018,22,0,6,"Braga",8,"Rua Costa Gomes",0,41,41,-1,42,-43
10,5,2018,23,0,6,"Braga",1,"Avenida da Liberdade",25,25,0,124,124,0
10,5,2018,23,0,6,"Braga",2,"Avenida Central",25,25,0,124,124,0
10,5,2018,23,0,6,"Braga",3,"Rua de Caires",36,36,0,37,37,0
10,5,2018,23,0,6,"Braga",4,"N14 Bosch",47,47,0,48,48,0
10,5,2018,23,0,6,"Braga",5,"Avenida João Paulo II",39,39,0,9,9,0
10,5,2018,23,0,6,"Braga",6,"Avenida Padre Júlio Fragata",67,67,0,83,83,0
10,5,2018,23,0,6,"Braga",7,"Rua Nova Santa Cruz",44,44,0,39,39,0
10,5,2018,23,0,6,"Braga",8,"Rua Costa Gomes",0,41,41,-1,42,-43
10,6,2018,0,0,7,"Braga",1,"Avenida da Liberdade",25,25,0,124,124,0
10,6,2018,0,0,7,"Braga",2,"Avenida Central",25,25,0,124,124,0
10,6,2018,0,0,7,"Braga",3,"Rua de Caires",36,36,0,37,37,0
10,6,2018,0,0,7,"Braga",4,"N14 Bosch",47,47,0,48,48,0
10,6,2018,0,0,7,"Braga",5,"Avenida João Paulo II",39,39,0,9,9,0
10,6,2018,0,0,7,"Braga",6,"Avenida Padre Júlio Fragata",67,67,0,83,83,0
10,6,2018,0,0,7,"Braga",7,"Rua Nova Santa Cruz",29,44,15,60,39,21
10,6,2018,0,0,7,"Braga",8,"Rua Costa Gomes",0,41,41,-1,42,-43
10,6,2018,1,0,7,"Braga",1,"Avenida da Liberdade",25,25,0,124,124,0
10,6,2018,1,0,7,"Braga",2,"Avenida Central",25,25,0,124,124,0
10,6,2018,1,0,7,"Braga",3,"Rua de Caires",36,36,0,37,37,0
10,6,2018,1,0,7,"Braga",4,"N14 Bosch",47,47,0,48,48,0
10,6,2018,1,0,7,"Braga",5,"Avenida João Paulo II",39,39,0,9,9,0
10,6,2018,1,0,7,"Braga",6,"Avenida Padre Júlio Fragata",67,67,0,83,83,0
10,6,2018,1,0,7,"Braga",7,"Rua Nova Santa Cruz",44,44,0,39,39,0
10,6,2018,1,0,7,"Braga",8,"Rua Costa Gomes",0,41,41,-1,42,-43
10,6,2018,2,0,7,"Braga",1,"Avenida da Liberdade",25,25,0,124,124,0
10,6,2018,2,0,7,"Braga",2,"Avenida Central",25,25,0,124,124,0
10,6,2018,2,0,7,"Braga",3,"Rua de Caires",36,36,0,37,37,0
10,6,2018,2,0,7,"Braga",4,"N14 Bosch",47,47,0,48,48,0
10,6,2018,2,0,7,"Braga",5,"Avenida João Paulo II",39,39,0,9,9,0
10,6,2018,2,0,7,"Braga",6,"Avenida Padre Júlio Fragata",67,67,0,83,83,0
10,6,2018,2,0,7,"Braga",7,"Rua Nova Santa Cruz",44,44,0,39,39,0
10,6,2018,2,0,7,"Braga",8,"Rua Costa Gomes",0,41,41,-1,42,-43
10,6,2018,3,0,7,"Braga",1,"Avenida da Liberdade",25,25,0,124,124,0
10,6,2018,3,0,7,"Braga",2,"Avenida Central",25,25,0,124,124,0
10,6,2018,3,0,7,"Braga",3,"Rua de Caires",36,36,0,37,37,0
10,6,2018,3,0,7,"Braga",4,"N14 Bosch",47,47,0,48,48,0
10,6,2018,3,0,7,"Braga",5,"Avenida João Paulo II",39,39,0,9,9,0
10,6,2018,3,0,7,"Braga",6,"Avenida Padre Júlio Fragata",67,67,0,83,83,0
10,6,2018,3,0,7,"Braga",7,"Rua Nova Santa Cruz",44,44,0,39,39,0
10,6,2018,3,0,7,"Braga",8,"Rua Costa Gomes",0,41,41,-1,42,-43
10,6,2018,4,0,7,"Braga",1,"Avenida da Liberdade",25,25,0,124,124,0
10,6,2018,4,0,7,"Braga",2,"Avenida Central",25,25,0,124,124,0
10,6,2018,4,0,7,"Braga",3,"Rua de Caires",36,36,0,37,37,0
10,6,2018,4,0,7,"Braga",4,"N14 Bosch",47,47,0,48,48,0
10,6,2018,4,0,7,"Braga",5,"Avenida João Paulo II",39,39,0,9,9,0
10,6,2018,4,0,7,"Braga",6,"Avenida Padre Júlio Fragata",67,67,0,83,83,0
10,6,2018,4,0,7,"Braga",7,"Rua Nova Santa Cruz",44,44,0,39,39,0
10,6,2018,4,0,7,"Braga",8,"Rua Costa Gomes",0,41,41,-1,42,-43
10,6,2018,5,0,7,"Braga",1,"Avenida da Liberdade",25,25,0,124,124,0
10,6,2018,5,0,7,"Braga",2,"Avenida Central",25,25,0,124,124,0
10,6,2018,5,0,7,"Braga",3,"Rua de Caires",36,36,0,37,37,0
10,6,2018,5,0,7,"Braga",4,"N14 Bosch",47,47,0,48,48,0
10,6,2018,5,0,7,"Braga",5,"Avenida João Paulo II",39,39,0,9,9,0
10,6,2018,5,0,7,"Braga",6,"Avenida Padre Júlio Fragata",67,67,0,83,83,0
10,6,2018,5,0,7,"Braga",7,"Rua Nova Santa Cruz",44,44,0,39,39,0
10,6,2018,5,0,7,"Braga",8,"Rua Costa Gomes",0,41,41,-1,42,-43
10,6,2018,6,0,7,"Braga",1,"Avenida da Liberdade",25,25,0,124,124,0
10,6,2018,6,0,7,"Braga",2,"Avenida Central",25,25,0,124,124,0
10,6,2018,6,0,7,"Braga",3,"Rua de Caires",36,36,0,37,37,0
10,6,2018,6,0,7,"Braga",4,"N14 Bosch",47,47,0,48,48,0
10,6,2018,6,0,7,"Braga",5,"Avenida João Paulo II",39,39,0,9,9,0
10,6,2018,6,0,7,"Braga",6,"Avenida Padre Júlio Fragata",67,67,0,83,83,0
10,6,2018,6,0,7,"Braga",7,"Rua Nova Santa Cruz",44,44,0,39,39,0
10,6,2018,6,0,7,"Braga",8,"Rua Costa Gomes",0,41,41,-1,42,-43
10,6,2018,7,0,7,"Braga",1,"Avenida da Liberdade",19,25,6,163,124,39
10,6,2018,7,0,7,"Braga",2,"Avenida Central",19,25,6,163,124,39
10,6,2018,7,0,7,"Braga",3,"Rua de Caires",36,36,0,37,37,0
10,6,2018,7,0,7,"Braga",4,"N14 Bosch",47,47,0,48,48,0
10,6,2018,7,0,7,"Braga",5,"Avenida João Paulo II",39,39,0,9,9,0
10,6,2018,7,0,7,"Braga",6,"Avenida Padre Júlio Fragata",67,67,0,83,83,0
10,6,2018,7,0,7,"Braga",7,"Rua Nova Santa Cruz",34,44,10,51,39,12
10,6,2018,7,0,7,"Braga",8,"Rua Costa Gomes",0,41,41,-1,42,-43
10,6,2018,8,0,7,"Braga",1,"Avenida da Liberdade",25,25,0,124,124,0
10,6,2018,8,0,7,"Braga",2,"Avenida Central",25,25,0,124,124,0
10,6,2018,8,0,7,"Braga",3,"Rua de Caires",17,36,19,79,37,42
10,6,2018,8,0,7,"Braga",4,"N14 Bosch",47,47,0,48,48,0
10,6,2018,8,0,7,"Braga",5,"Avenida João Paulo II",39,39,0,9,9,0
10,6,2018,8,0,7,"Braga",6,"Avenida Padre Júlio Fragata",67,67,0,83,83,0
10,6,2018,8,0,7,"Braga",7,"Rua Nova Santa Cruz",44,44,0,39,39,0
10,6,2018,8,0,7,"Braga",8,"Rua Costa Gomes",0,41,41,-1,42,-43
10,6,2018,9,0,7,"Braga",1,"Avenida da Liberdade",25,25,0,124,124,0
10,6,2018,9,0,7,"Braga",2,"Avenida Central",25,25,0,124,124,0
10,6,2018,9,0,7,"Braga",3,"Rua de Caires",26,36,10,52,37,15
10,6,2018,9,0,7,"Braga",4,"N14 Bosch",47,47,0,48,48,0
10,6,2018,9,0,7,"Braga",5,"Avenida João Paulo II",39,39,0,9,9,0
10,6,2018,9,0,7,"Braga",6,"Avenida Padre Júlio Fragata",67,67,0,83,83,0
10,6,2018,9,0,7,"Braga",7,"Rua Nova Santa Cruz",44,44,0,39,39,0
10,6,2018,9,0,7,"Braga",8,"Rua Costa Gomes",0,41,41,-1,42,-43
10,6,2018,10,0,7,"Braga",1,"Avenida da Liberdade",25,25,0,124,124,0
10,6,2018,10,0,7,"Braga",2,"Avenida Central",25,25,0,124,124,0
10,6,2018,10,0,7,"Braga",3,"Rua de Caires",23,36,13,59,37,22
10,6,2018,10,0,7,"Braga",4,"N14 Bosch",35,47,12,64,48,16
10,6,2018,10,0,7,"Braga",5,"Avenida João Paulo II",39,39,0,9,9,0
10,6,2018,10,0,7,"Braga",6,"Avenida Padre Júlio Fragata",67,67,0,83,83,0
10,6,2018,10,0,7,"Braga",7,"Rua Nova Santa Cruz",44,44,0,39,39,0
10,6,2018,10,0,7,"Braga",8,"Rua Costa Gomes",0,41,41,-1,42,-43
10,6,2018,11,0,7,"Braga",1,"Avenida da Liberdade",25,25,0,124,124,0
10,6,2018,11,0,7,"Braga",2,"Avenida Central",18,25,7,172,124,48
10,6,2018,11,0,7,"Braga",3,"Rua de Caires",36,36,0,37,37,0
10,6,2018,11,0,7,"Braga",4,"N14 Bosch",29,47,18,77,48,29
10,6,2018,11,0,7,"Braga",5,"Avenida João Paulo II",39,39,0,9,9,0
10,6,2018,11,0,7,"Braga",6,"Avenida Padre Júlio Fragata",67,67,0,83,83,0
10,6,2018,11,0,7,"Braga",7,"Rua Nova Santa Cruz",44,44,0,39,39,0
10,6,2018,11,0,7,"Braga",8,"Rua Costa Gomes",0,41,41,-1,42,-43
10,6,2018,12,0,7,"Braga",1,"Avenida da Liberdade",25,25,0,124,124,0
10,6,2018,12,0,7,"Braga",2,"Avenida Central",25,25,0,124,124,0
10,6,2018,12,0,7,"Braga",3,"Rua de Caires",36,36,0,37,37,0
10,6,2018,12,0,7,"Braga",4,"N14 Bosch",47,47,0,48,48,0
10,6,2018,12,0,7,"Braga",5,"Avenida João Paulo II",39,39,0,9,9,0
10,6,2018,12,0,7,"Braga",6,"Avenida Padre Júlio Fragata",67,67,0,83,83,0
10,6,2018,12,0,7,"Braga",7,"Rua Nova Santa Cruz",44,44,0,39,39,0
10,6,2018,12,0,7,"Braga",8,"Rua Costa Gomes",0,41,41,-1,42,-43
10,6,2018,13,0,7,"Braga",1,"Avenida da Liberdade",25,25,0,124,124,0
10,6,2018,13,0,7,"Braga",2,"Avenida Central",25,25,0,124,124,0
10,6,2018,13,0,7,"Braga",3,"Rua de Caires",36,36,0,37,37,0
10,6,2018,13,0,7,"Braga",4,"N14 Bosch",37,47,10,61,48,13
10,6,2018,13,0,7,"Braga",5,"Avenida João Paulo II",39,39,0,9,9,0
10,6,2018,13,0,7,"Braga",6,"Avenida Padre Júlio Fragata",67,67,0,83,83,0
10,6,2018,13,0,7,"Braga",7,"Rua Nova Santa Cruz",44,44,0,39,39,0
10,6,2018,13,0,7,"Braga",8,"Rua Costa Gomes",0,41,41,-1,42,-43
10,6,2018,14,0,7,"Braga",1,"Avenida da Liberdade",19,25,6,163,124,39
10,6,2018,14,0,7,"Braga",2,"Avenida Central",18,25,7,172,124,48
10,6,2018,14,0,7,"Braga",3,"Rua de Caires",24,36,12,56,37,19
10,6,2018,14,0,7,"Braga",4,"N14 Bosch",47,47,0,48,48,0
10,6,2018,14,0,7,"Braga",5,"Avenida João Paulo II",39,39,0,9,9,0
10,6,2018,14,0,7,"Braga",6,"Avenida Padre Júlio Fragata",67,67,0,83,83,0
10,6,2018,14,0,7,"Braga",7,"Rua Nova Santa Cruz",44,44,0,39,39,0
10,6,2018,14,0,7,"Braga",8,"Rua Costa Gomes",0,41,41,-1,42,-43
10,6,2018,15,0,7,"Braga",1,"Avenida da Liberdade",25,25,0,124,124,0
10,6,2018,15,0,7,"Braga",2,"Avenida Central",25,25,0,124,124,0
10,6,2018,15,0,7,"Braga",3,"Rua de Caires",23,36,13,59,37,22
10,6,2018,15,0,7,"Braga",4,"N14 Bosch",33,47,14,68,48,20
10,6,2018,15,0,7,"Braga",5,"Avenida João Paulo II",27,39,12,13,9,4
10,6,2018,15,0,7,"Braga",6,"Avenida Padre Júlio Fragata",48,67,19,116,83,33
10,6,2018,15,0,7,"Braga",7,"Rua Nova Santa Cruz",44,44,0,39,39,0
10,6,2018,15,0,7,"Braga",8,"Rua Costa Gomes",0,41,41,-1,42,-43
10,6,2018,16,0,7,"Braga",1,"Avenida da Liberdade",19,25,6,163,124,39
10,6,2018,16,0,7,"Braga",2,"Avenida Central",19,25,6,163,124,39
10,6,2018,16,0,7,"Braga",3,"Rua de Caires",36,36,0,37,37,0
10,6,2018,16,0,7,"Braga",4,"N14 Bosch",35,47,12,64,48,16
10,6,2018,16,0,7,"Braga",5,"Avenida João Paulo II",39,39,0,9,9,0
10,6,2018,16,0,7,"Braga",6,"Avenida Padre Júlio Fragata",67,67,0,83,83,0
10,6,2018,16,0,7,"Braga",7,"Rua Nova Santa Cruz",32,44,12,54,39,15
10,6,2018,16,0,7,"Braga",8,"Rua Costa Gomes",0,41,41,-1,42,-43
10,6,2018,17,0,7,"Braga",1,"Avenida da Liberdade",25,25,0,124,124,0
10,6,2018,17,0,7,"Braga",2,"Avenida Central",25,25,0,124,124,0
10,6,2018,17,0,7,"Braga",3,"Rua de Caires",36,36,0,37,37,0
10,6,2018,17,0,7,"Braga",4,"N14 Bosch",32,47,15,70,48,22
10,6,2018,17,0,7,"Braga",5,"Avenida João Paulo II",28,39,11,12,9,3
10,6,2018,17,0,7,"Braga",6,"Avenida Padre Júlio Fragata",67,67,0,83,83,0
10,6,2018,17,0,7,"Braga",7,"Rua Nova Santa Cruz",44,44,0,39,39,0
10,6,2018,17,0,7,"Braga",8,"Rua Costa Gomes",0,41,41,-1,42,-43
10,6,2018,18,0,7,"Braga",1,"Avenida da Liberdade",25,25,0,124,124,0
10,6,2018,18,0,7,"Braga",2,"Avenida Central",25,25,0,124,124,0
10,6,2018,18,0,7,"Braga",3,"Rua de Caires",24,36,12,56,37,19
10,6,2018,18,0,7,"Braga",4,"N14 Bosch",47,47,0,48,48,0
10,6,2018,18,0,7,"Braga",5,"Avenida João Paulo II",16,39,23,22,9,13
10,6,2018,18,0,7,"Braga",6,"Avenida Padre Júlio Fragata",27,67,40,206,83,123
10,6,2018,18,0,7,"Braga",7,"Rua Nova Santa Cruz",44,44,0,39,39,0
10,6,2018,18,0,7,"Braga",8,"Rua Costa Gomes",0,41,41,-1,42,-43
10,6,2018,19,0,7,"Braga",1,"Avenida da Liberdade",16,25,9,194,124,70
10,6,2018,19,0,7,"Braga",2,"Avenida Central",16,25,9,194,124,70
10,6,2018,19,0,7,"Braga",3,"Rua de Caires",36,36,0,37,37,0
10,6,2018,19,0,7,"Braga",4,"N14 Bosch",47,47,0,48,48,0
10,6,2018,19,0,7,"Braga",5,"Avenida João Paulo II",13,39,26,27,9,18
10,6,2018,19,0,7,"Braga",6,"Avenida Padre Júlio Fragata",34,67,33,164,83,81
10,6,2018,19,0,7,"Braga",7,"Rua Nova Santa Cruz",44,44,0,39,39,0
10,6,2018,19,0,7,"Braga",8,"Rua Costa Gomes",0,41,41,-1,42,-43
10,6,2018,20,0,7,"Braga",1,"Avenida da Liberdade",25,25,0,124,124,0
10,6,2018,20,0,7,"Braga",2,"Avenida Central",25,25,0,124,124,0
10,6,2018,20,0,7,"Braga",3,"Rua de Caires",36,36,0,37,37,0
10,6,2018,20,0,7,"Braga",4,"N14 Bosch",47,47,0,48,48,0
10,6,2018,20,0,7,"Braga",5,"Avenida João Paulo II",30,39,9,12,9,3
10,6,2018,20,0,7,"Braga",6,"Avenida Padre Júlio Fragata",67,67,0,83,83,0
10,6,2018,20,0,7,"Braga",7,"Rua Nova Santa Cruz",34,44,10,51,39,12
10,6,2018,20,0,7,"Braga",8,"Rua Costa Gomes",0,41,41,-1,42,-43
10,6,2018,21,0,7,"Braga",1,"Avenida da Liberdade",25,25,0,124,124,0
10,6,2018,21,0,7,"Braga",2,"Avenida Central",25,25,0,124,124,0
10,6,2018,21,0,7,"Braga",3,"Rua de Caires",36,36,0,37,37,0
10,6,2018,21,0,7,"Braga",4,"N14 Bosch",37,47,10,61,48,13
10,6,2018,21,0,7,"Braga",5,"Avenida João Paulo II",39,39,0,9,9,0
10,6,2018,21,0,7,"Braga",6,"Avenida Padre Júlio Fragata",49,67,18,114,83,31
10,6,2018,21,0,7,"Braga",7,"Rua Nova Santa Cruz",44,44,0,39,39,0
10,6,2018,21,0,7,"Braga",8,"Rua Costa Gomes",0,41,41,-1,42,-43
10,6,2018,22,0,7,"Braga",1,"Avenida da Liberdade",25,25,0,124,124,0
10,6,2018,22,0,7,"Braga",2,"Avenida Central",25,25,0,124,124,0
10,6,2018,22,0,7,"Braga",3,"Rua de Caires",36,36,0,37,37,0
10,6,2018,22,0,7,"Braga",4,"N14 Bosch",47,47,0,48,48,0
10,6,2018,22,0,7,"Braga",5,"Avenida João Paulo II",39,39,0,9,9,0
10,6,2018,22,0,7,"Braga",6,"Avenida Padre Júlio Fragata",67,67,0,83,83,0
10,6,2018,22,0,7,"Braga",7,"Rua Nova Santa Cruz",23,44,21,75,39,36
10,6,2018,22,0,7,"Braga",8,"Rua Costa Gomes",0,41,41,-1,42,-43
10,6,2018,23,0,7,"Braga",1,"Avenida da Liberdade",25,25,0,124,124,0
10,6,2018,23,0,7,"Braga",2,"Avenida Central",25,25,0,124,124,0
10,6,2018,23,0,7,"Braga",3,"Rua de Caires",36,36,0,37,37,0
10,6,2018,23,0,7,"Braga",4,"N14 Bosch",47,47,0,48,48,0
10,6,2018,23,0,7,"Braga",5,"Avenida João Paulo II",39,39,0,9,9,0
10,6,2018,23,0,7,"Braga",6,"Avenida Padre Júlio Fragata",48,67,19,116,83,33
10,6,2018,23,0,7,"Braga",7,"Rua Nova Santa Cruz",19,44,25,91,39,52
10,6,2018,23,0,7,"Braga",8,"Rua Costa Gomes",0,41,41,-1,42,-43
10,7,2018,0,0,8,"Braga",1,"Avenida da Liberdade",25,25,0,124,124,0
10,7,2018,0,0,8,"Braga",2,"Avenida Central",25,25,0,124,124,0
10,7,2018,0,0,8,"Braga",3,"Rua de Caires",36,36,0,37,37,0
10,7,2018,0,0,8,"Braga",4,"N14 Bosch",47,47,0,48,48,0
10,7,2018,0,0,8,"Braga",5,"Avenida João Paulo II",39,39,0,9,9,0
10,7,2018,0,0,8,"Braga",6,"Avenida Padre Júlio Fragata",67,67,0,83,83,0
10,7,2018,0,0,8,"Braga",7,"Rua Nova Santa Cruz",44,44,0,39,39,0
10,7,2018,0,0,8,"Braga",8,"Rua Costa Gomes",0,41,41,-1,42,-43
10,7,2018,1,0,8,"Braga",1,"Avenida da Liberdade",25,25,0,124,124,0
10,7,2018,1,0,8,"Braga",2,"Avenida Central",25,25,0,124,124,0
10,7,2018,1,0,8,"Braga",3,"Rua de Caires",36,36,0,37,37,0
10,7,2018,1,0,8,"Braga",4,"N14 Bosch",47,47,0,48,48,0
10,7,2018,1,0,8,"Braga",5,"Avenida João Paulo II",39,39,0,9,9,0
10,7,2018,1,0,8,"Braga",6,"Avenida Padre Júlio Fragata",67,67,0,83,83,0
10,7,2018,1,0,8,"Braga",7,"Rua Nova Santa Cruz",44,44,0,39,39,0
10,7,2018,1,0,8,"Braga",8,"Rua Costa Gomes",0,41,41,-1,42,-43
10,7,2018,2,0,8,"Braga",1,"Avenida da Liberdade",18,25,7,172,124,48
10,7,2018,2,0,8,"Braga",2,"Avenida Central",18,25,7,172,124,48
10,7,2018,2,0,8,"Braga",3,"Rua de Caires",36,36,0,37,37,0
10,7,2018,2,0,8,"Braga",4,"N14 Bosch",47,47,0,48,48,0
10,7,2018,2,0,8,"Braga",5,"Avenida João Paulo II",39,39,0,9,9,0
10,7,2018,2,0,8,"Braga",6,"Avenida Padre Júlio Fragata",50,67,17,111,83,28
10,7,2018,2,0,8,"Braga",7,"Rua Nova Santa Cruz",44,44,0,39,39,0
10,7,2018,2,0,8,"Braga",8,"Rua Costa Gomes",0,41,41,-1,42,-43
10,7,2018,3,0,8,"Braga",1,"Avenida da Liberdade",25,25,0,124,124,0
10,7,2018,3,0,8,"Braga",2,"Avenida Central",25,25,0,124,124,0
10,7,2018,3,0,8,"Braga",3,"Rua de Caires",36,36,0,37,37,0
10,7,2018,3,0,8,"Braga",4,"N14 Bosch",47,47,0,48,48,0
10,7,2018,3,0,8,"Braga",5,"Avenida João Paulo II",39,39,0,9,9,0
10,7,2018,3,0,8,"Braga",6,"Avenida Padre Júlio Fragata",67,67,0,83,83,0
10,7,2018,3,0,8,"Braga",7,"Rua Nova Santa Cruz",32,44,12,54,39,15
10,7,2018,3,0,8,"Braga",8,"Rua Costa Gomes",0,41,41,-1,42,-43
10,7,2018,4,0,8,"Braga",1,"Avenida da Liberdade",25,25,0,124,124,0
10,7,2018,4,0,8,"Braga",2,"Avenida Central",25,25,0,124,124,0
10,7,2018,4,0,8,"Braga",3,"Rua de Caires",36,36,0,37,37,0
10,7,2018,4,0,8,"Braga",4,"N14 Bosch",47,47,0,48,48,0
10,7,2018,4,0,8,"Braga",5,"Avenida João Paulo II",39,39,0,9,9,0
10,7,2018,4,0,8,"Braga",6,"Avenida Padre Júlio Fragata",67,67,0,83,83,0
10,7,2018,4,0,8,"Braga",7,"Rua Nova Santa Cruz",44,44,0,39,39,0
10,7,2018,4,0,8,"Braga",8,"Rua Costa Gomes",0,41,41,-1,42,-43
10,7,2018,5,0,8,"Braga",1,"Avenida da Liberdade",25,25,0,124,124,0
10,7,2018,5,0,8,"Braga",2,"Avenida Central",25,25,0,124,124,0
10,7,2018,5,0,8,"Braga",3,"Rua de Caires",36,36,0,37,37,0
10,7,2018,5,0,8,"Braga",4,"N14 Bosch",47,47,0,48,48,0
10,7,2018,5,0,8,"Braga",5,"Avenida João Paulo II",39,39,0,9,9,0
10,7,2018,5,0,8,"Braga",6,"Avenida Padre Júlio Fragata",67,67,0,83,83,0
10,7,2018,5,0,8,"Braga",7,"Rua Nova Santa Cruz",44,44,0,39,39,0
10,7,2018,5,0,8,"Braga",8,"Rua Costa Gomes",0,41,41,-1,42,-43
10,7,2018,6,0,8,"Braga",1,"Avenida da Liberdade",25,25,0,124,124,0
10,7,2018,6,0,8,"Braga",2,"Avenida Central",25,25,0,124,124,0
10,7,2018,6,0,8,"Braga",3,"Rua de Caires",36,36,0,37,37,0
10,7,2018,6,0,8,"Braga",4,"N14 Bosch",47,47,0,48,48,0
10,7,2018,6,0,8,"Braga",5,"Avenida João Paulo II",39,39,0,9,9,0
10,7,2018,6,0,8,"Braga",6,"Avenida Padre Júlio Fragata",67,67,0,83,83,0
10,7,2018,6,0,8,"Braga",7,"Rua Nova Santa Cruz",44,44,0,39,39,0
10,7,2018,6,0,8,"Braga",8,"Rua Costa Gomes",0,41,41,-1,42,-43
10,7,2018,7,0,8,"Braga",1,"Avenida da Liberdade",25,25,0,124,124,0
10,7,2018,7,0,8,"Braga",2,"Avenida Central",25,25,0,124,124,0
10,7,2018,7,0,8,"Braga",3,"Rua de Caires",36,36,0,37,37,0
10,7,2018,7,0,8,"Braga",4,"N14 Bosch",47,47,0,48,48,0
10,7,2018,7,0,8,"Braga",5,"Avenida João Paulo II",39,39,0,9,9,0
10,7,2018,7,0,8,"Braga",6,"Avenida Padre Júlio Fragata",67,67,0,83,83,0
10,7,2018,7,0,8,"Braga",7,"Rua Nova Santa Cruz",44,44,0,39,39,0
10,7,2018,7,0,8,"Braga",8,"Rua Costa Gomes",0,41,41,-1,42,-43
10,7,2018,8,0,8,"Braga",1,"Avenida da Liberdade",25,25,0,124,124,0
10,7,2018,8,0,8,"Braga",2,"Avenida Central",25,25,0,124,124,0
10,7,2018,8,0,8,"Braga",3,"Rua de Caires",36,36,0,37,37,0
10,7,2018,8,0,8,"Braga",4,"N14 Bosch",47,47,0,48,48,0
10,7,2018,8,0,8,"Braga",5,"Avenida João Paulo II",39,39,0,9,9,0
10,7,2018,8,0,8,"Braga",6,"Avenida Padre Júlio Fragata",67,67,0,83,83,0
10,7,2018,8,0,8,"Braga",7,"Rua Nova Santa Cruz",44,44,0,39,39,0
10,7,2018,8,0,8,"Braga",8,"Rua Costa Gomes",0,41,41,-1,42,-43
10,7,2018,9,0,8,"Braga",1,"Avenida da Liberdade",25,25,0,124,124,0
10,7,2018,9,0,8,"Braga",2,"Avenida Central",25,25,0,124,124,0
10,7,2018,9,0,8,"Braga",3,"Rua de Caires",36,36,0,37,37,0
10,7,2018,9,0,8,"Braga",4,"N14 Bosch",47,47,0,48,48,0
10,7,2018,9,0,8,"Braga",5,"Avenida João Paulo II",39,39,0,9,9,0
10,7,2018,9,0,8,"Braga",6,"Avenida Padre Júlio Fragata",67,67,0,83,83,0
10,7,2018,9,0,8,"Braga",7,"Rua Nova Santa Cruz",44,44,0,39,39,0
10,7,2018,9,0,8,"Braga",8,"Rua Costa Gomes",0,41,41,-1,42,-43
10,7,2018,10,0,8,"Braga",1,"Avenida da Liberdade",25,25,0,124,124,0
10,7,2018,10,0,8,"Braga",2,"Avenida Central",25,25,0,124,124,0
10,7,2018,10,0,8,"Braga",3,"Rua de Caires",36,36,0,37,37,0
10,7,2018,10,0,8,"Braga",4,"N14 Bosch",47,47,0,48,48,0
10,7,2018,10,0,8,"Braga",5,"Avenida João Paulo II",39,39,0,9,9,0
10,7,2018,10,0,8,"Braga",6,"Avenida Padre Júlio Fragata",67,67,0,83,83,0
10,7,2018,10,0,8,"Braga",7,"Rua Nova Santa Cruz",44,44,0,39,39,0
10,7,2018,10,0,8,"Braga",8,"Rua Costa Gomes",0,41,41,-1,42,-43
10,7,2018,11,0,8,"Braga",1,"Avenida da Liberdade",25,25,0,124,124,0
10,7,2018,11,0,8,"Braga",2,"Avenida Central",25,25,0,124,124,0
10,7,2018,11,0,8,"Braga",3,"Rua de Caires",36,36,0,37,37,0
10,7,2018,11,0,8,"Braga",4,"N14 Bosch",32,47,15,70,48,22
10,7,2018,11,0,8,"Braga",5,"Avenida João Paulo II",29,39,10,12,9,3
10,7,2018,11,0,8,"Braga",6,"Avenida Padre Júlio Fragata",67,67,0,83,83,0
10,7,2018,11,0,8,"Braga",7,"Rua Nova Santa Cruz",44,44,0,39,39,0
10,7,2018,11,0,8,"Braga",8,"Rua Costa Gomes",0,41,41,-1,42,-43
10,7,2018,12,0,8,"Braga",1,"Avenida da Liberdade",25,25,0,124,124,0
10,7,2018,12,0,8,"Braga",2,"Avenida Central",25,25,0,124,124,0
10,7,2018,12,0,8,"Braga",3,"Rua de Caires",28,36,8,48,37,11
10,7,2018,12,0,8,"Braga",4,"N14 Bosch",33,47,14,68,48,20
10,7,2018,12,0,8,"Braga",5,"Avenida João Paulo II",39,39,0,9,9,0
10,7,2018,12,0,8,"Braga",6,"Avenida Padre Júlio Fragata",67,67,0,83,83,0
10,7,2018,12,0,8,"Braga",7,"Rua Nova Santa Cruz",44,44,0,39,39,0
10,7,2018,12,0,8,"Braga",8,"Rua Costa Gomes",0,41,41,-1,42,-43
10,7,2018,13,0,8,"Braga",1,"Avenida da Liberdade",25,25,0,124,124,0
10,7,2018,13,0,8,"Braga",2,"Avenida Central",25,25,0,124,124,0
10,7,2018,13,0,8,"Braga",3,"Rua de Caires",36,36,0,37,37,0
10,7,2018,13,0,8,"Braga",4,"N14 Bosch",47,47,0,48,48,0
10,7,2018,13,0,8,"Braga",5,"Avenida João Paulo II",39,39,0,9,9,0
10,7,2018,13,0,8,"Braga",6,"Avenida Padre Júlio Fragata",67,67,0,83,83,0
10,7,2018,13,0,8,"Braga",7,"Rua Nova Santa Cruz",44,44,0,39,39,0
10,7,2018,13,0,8,"Braga",8,"Rua Costa Gomes",0,41,41,-1,42,-43
10,7,2018,14,0,8,"Braga",1,"Avenida da Liberdade",25,25,0,124,124,0
10,7,2018,14,0,8,"Braga",2,"Avenida Central",25,25,0,124,124,0
10,7,2018,14,0,8,"Braga",3,"Rua de Caires",36,36,0,37,37,0
10,7,2018,14,0,8,"Braga",4,"N14 Bosch",47,47,0,48,48,0
10,7,2018,14,0,8,"Braga",5,"Avenida João Paulo II",39,39,0,9,9,0
10,7,2018,14,0,8,"Braga",6,"Avenida Padre Júlio Fragata",51,67,16,109,83,26
10,7,2018,14,0,8,"Braga",7,"Rua Nova Santa Cruz",44,44,0,39,39,0
10,7,2018,14,0,8,"Braga",8,"Rua Costa Gomes",0,41,41,-1,42,-43
10,7,2018,15,0,8,"Braga",1,"Avenida da Liberdade",25,25,0,124,124,0
10,7,2018,15,0,8,"Braga",2,"Avenida Central",25,25,0,124,124,0
10,7,2018,15,0,8,"Braga",3,"Rua de Caires",36,36,0,37,37,0
10,7,2018,15,0,8,"Braga",4,"N14 Bosch",47,47,0,48,48,0
10,7,2018,15,0,8,"Braga",5,"Avenida João Paulo II",39,39,0,9,9,0
10,7,2018,15,0,8,"Braga",6,"Avenida Padre Júlio Fragata",47,67,20,119,83,36
10,7,2018,15,0,8,"Braga",7,"Rua Nova Santa Cruz",44,44,0,39,39,0
10,7,2018,15,0,8,"Braga",8,"Rua Costa Gomes",0,41,41,-1,42,-43
10,7,2018,16,0,8,"Braga",1,"Avenida da Liberdade",25,25,0,124,124,0
10,7,2018,16,0,8,"Braga",2,"Avenida Central",25,25,0,124,124,0
10,7,2018,16,0,8,"Braga",3,"Rua de Caires",12,36,24,112,37,75
10,7,2018,16,0,8,"Braga",4,"N14 Bosch",47,47,0,48,48,0
10,7,2018,16,0,8,"Braga",5,"Avenida João Paulo II",39,39,0,9,9,0
10,7,2018,16,0,8,"Braga",6,"Avenida Padre Júlio Fragata",52,67,15,107,83,24
10,7,2018,16,0,8,"Braga",7,"Rua Nova Santa Cruz",44,44,0,39,39,0
10,7,2018,16,0,8,"Braga",8,"Rua Costa Gomes",0,41,41,-1,42,-43
10,7,2018,17,0,8,"Braga",1,"Avenida da Liberdade",25,25,0,124,124,0
10,7,2018,17,0,8,"Braga",2,"Avenida Central",25,25,0,124,124,0
10,7,2018,17,0,8,"Braga",3,"Rua de Caires",36,36,0,37,37,0
10,7,2018,17,0,8,"Braga",4,"N14 Bosch",47,47,0,48,48,0
10,7,2018,17,0,8,"Braga",5,"Avenida João Paulo II",39,39,0,9,9,0
10,7,2018,17,0,8,"Braga",6,"Avenida Padre Júlio Fragata",52,67,15,107,83,24
10,7,2018,17,0,8,"Braga",7,"Rua Nova Santa Cruz",44,44,0,39,39,0
10,7,2018,17,0,8,"Braga",8,"Rua Costa Gomes",0,41,41,-1,42,-43
10,7,2018,18,0,8,"Braga",1,"Avenida da Liberdade",25,25,0,124,124,0
10,7,2018,18,0,8,"Braga",2,"Avenida Central",25,25,0,124,124,0
10,7,2018,18,0,8,"Braga",3,"Rua de Caires",36,36,0,37,37,0
10,7,2018,18,0,8,"Braga",4,"N14 Bosch",47,47,0,48,48,0
10,7,2018,18,0,8,"Braga",5,"Avenida João Paulo II",39,39,0,9,9,0
10,7,2018,18,0,8,"Braga",6,"Avenida Padre Júlio Fragata",52,67,15,107,83,24
10,7,2018,18,0,8,"Braga",7,"Rua Nova Santa Cruz",44,44,0,39,39,0
10,7,2018,18,0,8,"Braga",8,"Rua Costa Gomes",0,41,41,-1,42,-43
10,7,2018,19,0,8,"Braga",1,"Avenida da Liberdade",25,25,0,124,124,0
10,7,2018,19,0,8,"Braga",2,"Avenida Central",25,25,0,124,124,0
10,7,2018,19,0,8,"Braga",3,"Rua de Caires",36,36,0,37,37,0
10,7,2018,19,0,8,"Braga",4,"N14 Bosch",47,47,0,48,48,0
10,7,2018,19,0,8,"Braga",5,"Avenida João Paulo II",39,39,0,9,9,0
10,7,2018,19,0,8,"Braga",6,"Avenida Padre Júlio Fragata",67,67,0,83,83,0
10,7,2018,19,0,8,"Braga",7,"Rua Nova Santa Cruz",44,44,0,39,39,0
10,7,2018,19,0,8,"Braga",8,"Rua Costa Gomes",0,41,41,-1,42,-43
10,7,2018,20,0,8,"Braga",1,"Avenida da Liberdade",25,25,0,124,124,0
10,7,2018,20,0,8,"Braga",2,"Avenida Central",25,25,0,124,124,0
10,7,2018,20,0,8,"Braga",3,"Rua de Caires",28,36,8,48,37,11
10,7,2018,20,0,8,"Braga",4,"N14 Bosch",47,47,0,48,48,0
10,7,2018,20,0,8,"Braga",5,"Avenida João Paulo II",30,39,9,12,9,3
10,7,2018,20,0,8,"Braga",6,"Avenida Padre Júlio Fragata",67,67,0,83,83,0
10,7,2018,20,0,8,"Braga",7,"Rua Nova Santa Cruz",44,44,0,39,39,0
10,7,2018,20,0,8,"Braga",8,"Rua Costa Gomes",0,41,41,-1,42,-43
10,7,2018,21,0,8,"Braga",1,"Avenida da Liberdade",25,25,0,124,124,0
10,7,2018,21,0,8,"Braga",2,"Avenida Central",25,25,0,124,124,0
10,7,2018,21,0,8,"Braga",3,"Rua de Caires",36,36,0,37,37,0
10,7,2018,21,0,8,"Braga",4,"N14 Bosch",47,47,0,48,48,0
10,7,2018,21,0,8,"Braga",5,"Avenida João Paulo II",39,39,0,9,9,0
10,7,2018,21,0,8,"Braga",6,"Avenida Padre Júlio Fragata",50,67,17,111,83,28
10,7,2018,21,0,8,"Braga",7,"Rua Nova Santa Cruz",44,44,0,39,39,0
10,7,2018,21,0,8,"Braga",8,"Rua Costa Gomes",0,41,41,-1,42,-43
10,7,2018,22,0,8,"Braga",1,"Avenida da Liberdade",25,25,0,124,124,0
10,7,2018,22,0,8,"Braga",2,"Avenida Central",25,25,0,124,124,0
10,7,2018,22,0,8,"Braga",3,"Rua de Caires",36,36,0,37,37,0
10,7,2018,22,0,8,"Braga",4,"N14 Bosch",47,47,0,48,48,0
10,7,2018,22,0,8,"Braga",5,"Avenida João Paulo II",39,39,0,9,9,0
10,7,2018,22,0,8,"Braga",6,"Avenida Padre Júlio Fragata",67,67,0,83,83,0
10,7,2018,22,0,8,"Braga",7,"Rua Nova Santa Cruz",44,44,0,39,39,0
10,7,2018,22,0,8,"Braga",8,"Rua Costa Gomes",0,41,41,-1,42,-43
10,7,2018,23,0,8,"Braga",1,"Avenida da Liberdade",25,25,0,124,124,0
10,7,2018,23,0,8,"Braga",2,"Avenida Central",25,25,0,124,124,0
10,7,2018,23,0,8,"Braga",3,"Rua de Caires",36,36,0,37,37,0
10,7,2018,23,0,8,"Braga",4,"N14 Bosch",47,47,0,48,48,0
10,7,2018,23,0,8,"Braga",5,"Avenida João Paulo II",39,39,0,9,9,0
10,7,2018,23,0,8,"Braga",6,"Avenida Padre Júlio Fragata",67,67,0,83,83,0
10,7,2018,23,0,8,"Braga",7,"Rua Nova Santa Cruz",44,44,0,39,39,0
10,7,2018,23,0,8,"Braga",8,"Rua Costa Gomes",0,41,41,-1,42,-43
10,8,2018,0,0,2,"Braga",1,"Avenida da Liberdade",25,25,0,124,124,0
10,8,2018,0,0,2,"Braga",2,"Avenida Central",25,25,0,124,124,0
10,8,2018,0,0,2,"Braga",3,"Rua de Caires",36,36,0,37,37,0
10,8,2018,0,0,2,"Braga",4,"N14 Bosch",47,47,0,48,48,0
10,8,2018,0,0,2,"Braga",5,"Avenida João Paulo II",39,39,0,9,9,0
10,8,2018,0,0,2,"Braga",6,"Avenida Padre Júlio Fragata",67,67,0,83,83,0
10,8,2018,0,0,2,"Braga",7,"Rua Nova Santa Cruz",44,44,0,39,39,0
10,8,2018,0,0,2,"Braga",8,"Rua Costa Gomes",0,41,41,-1,42,-43
10,8,2018,1,0,2,"Braga",1,"Avenida da Liberdade",25,25,0,124,124,0
10,8,2018,1,0,2,"Braga",2,"Avenida Central",25,25,0,124,124,0
10,8,2018,1,0,2,"Braga",3,"Rua de Caires",36,36,0,37,37,0
10,8,2018,1,0,2,"Braga",4,"N14 Bosch",47,47,0,48,48,0
10,8,2018,1,0,2,"Braga",5,"Avenida João Paulo II",39,39,0,9,9,0
10,8,2018,1,0,2,"Braga",6,"Avenida Padre Júlio Fragata",67,67,0,83,83,0
10,8,2018,1,0,2,"Braga",7,"Rua Nova Santa Cruz",44,44,0,39,39,0
10,8,2018,1,0,2,"Braga",8,"Rua Costa Gomes",0,41,41,-1,42,-43
10,8,2018,2,0,2,"Braga",1,"Avenida da Liberdade",25,25,0,124,124,0
10,8,2018,2,0,2,"Braga",2,"Avenida Central",25,25,0,124,124,0
10,8,2018,2,0,2,"Braga",3,"Rua de Caires",36,36,0,37,37,0
10,8,2018,2,0,2,"Braga",4,"N14 Bosch",47,47,0,48,48,0
10,8,2018,2,0,2,"Braga",5,"Avenida João Paulo II",39,39,0,9,9,0
10,8,2018,2,0,2,"Braga",6,"Avenida Padre Júlio Fragata",67,67,0,83,83,0
10,8,2018,2,0,2,"Braga",7,"Rua Nova Santa Cruz",44,44,0,39,39,0
10,8,2018,2,0,2,"Braga",8,"Rua Costa Gomes",0,41,41,-1,42,-43
10,8,2018,3,0,2,"Braga",1,"Avenida da Liberdade",25,25,0,124,124,0
10,8,2018,3,0,2,"Braga",2,"Avenida Central",25,25,0,124,124,0
10,8,2018,3,0,2,"Braga",3,"Rua de Caires",36,36,0,37,37,0
10,8,2018,3,0,2,"Braga",4,"N14 Bosch",47,47,0,48,48,0
10,8,2018,3,0,2,"Braga",5,"Avenida João Paulo II",39,39,0,9,9,0
10,8,2018,3,0,2,"Braga",6,"Avenida Padre Júlio Fragata",67,67,0,83,83,0
10,8,2018,3,0,2,"Braga",7,"Rua Nova Santa Cruz",44,44,0,39,39,0
10,8,2018,3,0,2,"Braga",8,"Rua Costa Gomes",0,41,41,-1,42,-43
10,8,2018,4,0,2,"Braga",1,"Avenida da Liberdade",25,25,0,124,124,0
10,8,2018,4,0,2,"Braga",2,"Avenida Central",25,25,0,124,124,0
10,8,2018,4,0,2,"Braga",3,"Rua de Caires",36,36,0,37,37,0
10,8,2018,4,0,2,"Braga",4,"N14 Bosch",47,47,0,48,48,0
10,8,2018,4,0,2,"Braga",5,"Avenida João Paulo II",39,39,0,9,9,0
10,8,2018,4,0,2,"Braga",6,"Avenida Padre Júlio Fragata",67,67,0,83,83,0
10,8,2018,4,0,2,"Braga",7,"Rua Nova Santa Cruz",44,44,0,39,39,0
10,8,2018,4,0,2,"Braga",8,"Rua Costa Gomes",0,41,41,-1,42,-43
10,8,2018,5,0,2,"Braga",1,"Avenida da Liberdade",25,25,0,124,124,0
10,8,2018,5,0,2,"Braga",2,"Avenida Central",25,25,0,124,124,0
10,8,2018,5,0,2,"Braga",3,"Rua de Caires",36,36,0,37,37,0
10,8,2018,5,0,2,"Braga",4,"N14 Bosch",47,47,0,48,48,0
10,8,2018,5,0,2,"Braga",5,"Avenida João Paulo II",39,39,0,9,9,0
10,8,2018,5,0,2,"Braga",6,"Avenida Padre Júlio Fragata",67,67,0,83,83,0
10,8,2018,5,0,2,"Braga",7,"Rua Nova Santa Cruz",44,44,0,39,39,0
10,8,2018,5,0,2,"Braga",8,"Rua Costa Gomes",0,41,41,-1,42,-43
10,8,2018,6,0,2,"Braga",1,"Avenida da Liberdade",25,25,0,124,124,0
10,8,2018,6,0,2,"Braga",2,"Avenida Central",25,25,0,124,124,0
10,8,2018,6,0,2,"Braga",3,"Rua de Caires",36,36,0,37,37,0
10,8,2018,6,0,2,"Braga",4,"N14 Bosch",47,47,0,48,48,0
10,8,2018,6,0,2,"Braga",5,"Avenida João Paulo II",39,39,0,9,9,0
10,8,2018,6,0,2,"Braga",6,"Avenida Padre Júlio Fragata",67,67,0,83,83,0
10,8,2018,6,0,2,"Braga",7,"Rua Nova Santa Cruz",44,44,0,39,39,0
10,8,2018,6,0,2,"Braga",8,"Rua Costa Gomes",0,41,41,-1,42,-43
10,8,2018,7,0,2,"Braga",1,"Avenida da Liberdade",25,25,0,124,124,0
10,8,2018,7,0,2,"Braga",2,"Avenida Central",25,25,0,124,124,0
10,8,2018,7,0,2,"Braga",3,"Rua de Caires",25,36,11,54,37,17
10,8,2018,7,0,2,"Braga",4,"N14 Bosch",47,47,0,48,48,0
10,8,2018,7,0,2,"Braga",5,"Avenida João Paulo II",39,39,0,9,9,0
10,8,2018,7,0,2,"Braga",6,"Avenida Padre Júlio Fragata",67,67,0,83,83,0
10,8,2018,7,0,2,"Braga",7,"Rua Nova Santa Cruz",16,44,28,108,39,69
10,8,2018,7,0,2,"Braga",8,"Rua Costa Gomes",0,41,41,-1,42,-43
10,8,2018,8,0,2,"Braga",1,"Avenida da Liberdade",25,25,0,124,124,0
10,8,2018,8,0,2,"Braga",2,"Avenida Central",25,25,0,124,124,0
10,8,2018,8,0,2,"Braga",3,"Rua de Caires",23,36,13,59,37,22
10,8,2018,8,0,2,"Braga",4,"N14 Bosch",31,47,16,72,48,24
10,8,2018,8,0,2,"Braga",5,"Avenida João Paulo II",8,39,31,44,9,35
10,8,2018,8,0,2,"Braga",6,"Avenida Padre Júlio Fragata",35,67,32,159,83,76
10,8,2018,8,0,2,"Braga",7,"Rua Nova Santa Cruz",16,44,28,108,39,69
10,8,2018,8,0,2,"Braga",8,"Rua Costa Gomes",0,41,41,-1,42,-43
10,8,2018,9,0,2,"Braga",1,"Avenida da Liberdade",25,25,0,124,124,0
10,8,2018,9,0,2,"Braga",2,"Avenida Central",25,25,0,124,124,0
10,8,2018,9,0,2,"Braga",3,"Rua de Caires",23,36,13,59,37,22
10,8,2018,9,0,2,"Braga",4,"N14 Bosch",36,47,11,62,48,14
10,8,2018,9,0,2,"Braga",5,"Avenida João Paulo II",30,39,9,12,9,3
10,8,2018,9,0,2,"Braga",6,"Avenida Padre Júlio Fragata",67,67,0,83,83,0
10,8,2018,9,0,2,"Braga",7,"Rua Nova Santa Cruz",44,44,0,39,39,0
10,8,2018,9,0,2,"Braga",8,"Rua Costa Gomes",0,41,41,-1,42,-43
10,8,2018,10,0,2,"Braga",1,"Avenida da Liberdade",25,25,0,124,124,0
10,8,2018,10,0,2,"Braga",2,"Avenida Central",25,25,0,124,124,0
10,8,2018,10,0,2,"Braga",3,"Rua de Caires",24,36,12,56,37,19
10,8,2018,10,0,2,"Braga",4,"N14 Bosch",31,47,16,72,48,24
10,8,2018,10,0,2,"Braga",5,"Avenida João Paulo II",39,39,0,9,9,0
10,8,2018,10,0,2,"Braga",6,"Avenida Padre Júlio Fragata",67,67,0,83,83,0
10,8,2018,10,0,2,"Braga",7,"Rua Nova Santa Cruz",21,44,23,82,39,43
10,8,2018,10,0,2,"Braga",8,"Rua Costa Gomes",0,41,41,-1,42,-43
10,8,2018,11,0,2,"Braga",1,"Avenida da Liberdade",25,25,0,124,124,0
10,8,2018,11,0,2,"Braga",2,"Avenida Central",25,25,0,124,124,0
10,8,2018,11,0,2,"Braga",3,"Rua de Caires",26,36,10,52,37,15
10,8,2018,11,0,2,"Braga",4,"N14 Bosch",34,47,13,66,48,18
10,8,2018,11,0,2,"Braga",5,"Avenida João Paulo II",39,39,0,9,9,0
10,8,2018,11,0,2,"Braga",6,"Avenida Padre Júlio Fragata",67,67,0,83,83,0
10,8,2018,11,0,2,"Braga",7,"Rua Nova Santa Cruz",34,44,10,51,39,12
10,8,2018,11,0,2,"Braga",8,"Rua Costa Gomes",0,41,41,-1,42,-43
10,8,2018,12,0,2,"Braga",1,"Avenida da Liberdade",25,25,0,124,124,0
10,8,2018,12,0,2,"Braga",2,"Avenida Central",25,25,0,124,124,0
10,8,2018,12,0,2,"Braga",3,"Rua de Caires",25,36,11,54,37,17
10,8,2018,12,0,2,"Braga",4,"N14 Bosch",11,47,36,204,48,156
10,8,2018,12,0,2,"Braga",5,"Avenida João Paulo II",39,39,0,9,9,0
10,8,2018,12,0,2,"Braga",6,"Avenida Padre Júlio Fragata",67,67,0,83,83,0
10,8,2018,12,0,2,"Braga",7,"Rua Nova Santa Cruz",20,44,24,86,39,47
10,8,2018,12,0,2,"Braga",8,"Rua Costa Gomes",0,41,41,-1,42,-43
10,8,2018,13,0,2,"Braga",1,"Avenida da Liberdade",25,25,0,124,124,0
10,8,2018,13,0,2,"Braga",2,"Avenida Central",25,25,0,124,124,0
10,8,2018,13,0,2,"Braga",3,"Rua de Caires",26,36,10,52,37,15
10,8,2018,13,0,2,"Braga",4,"N14 Bosch",17,47,30,132,48,84
10,8,2018,13,0,2,"Braga",5,"Avenida João Paulo II",39,39,0,9,9,0
10,8,2018,13,0,2,"Braga",6,"Avenida Padre Júlio Fragata",67,67,0,83,83,0
10,8,2018,13,0,2,"Braga",7,"Rua Nova Santa Cruz",30,44,14,58,39,19
10,8,2018,13,0,2,"Braga",8,"Rua Costa Gomes",0,41,41,-1,42,-43
10,8,2018,14,0,2,"Braga",1,"Avenida da Liberdade",25,25,0,124,124,0
10,8,2018,14,0,2,"Braga",2,"Avenida Central",25,25,0,124,124,0
10,8,2018,14,0,2,"Braga",3,"Rua de Caires",26,36,10,52,37,15
10,8,2018,14,0,2,"Braga",4,"N14 Bosch",32,47,15,70,48,22
10,8,2018,14,0,2,"Braga",5,"Avenida João Paulo II",39,39,0,9,9,0
10,8,2018,14,0,2,"Braga",6,"Avenida Padre Júlio Fragata",67,67,0,83,83,0
10,8,2018,14,0,2,"Braga",7,"Rua Nova Santa Cruz",44,44,0,39,39,0
10,8,2018,14,0,2,"Braga",8,"Rua Costa Gomes",0,41,41,-1,42,-43
10,8,2018,15,0,2,"Braga",1,"Avenida da Liberdade",19,25,6,163,124,39
10,8,2018,15,0,2,"Braga",2,"Avenida Central",19,25,6,163,124,39
10,8,2018,15,0,2,"Braga",3,"Rua de Caires",18,36,18,75,37,38
10,8,2018,15,0,2,"Braga",4,"N14 Bosch",28,47,19,80,48,32
10,8,2018,15,0,2,"Braga",5,"Avenida João Paulo II",28,39,11,12,9,3
10,8,2018,15,0,2,"Braga",6,"Avenida Padre Júlio Fragata",67,67,0,83,83,0
10,8,2018,15,0,2,"Braga",7,"Rua Nova Santa Cruz",21,44,23,82,39,43
10,8,2018,15,0,2,"Braga",8,"Rua Costa Gomes",0,41,41,-1,42,-43
10,8,2018,16,0,2,"Braga",1,"Avenida da Liberdade",16,25,9,194,124,70
10,8,2018,16,0,2,"Braga",2,"Avenida Central",16,25,9,194,124,70
10,8,2018,16,0,2,"Braga",3,"Rua de Caires",25,36,11,54,37,17
10,8,2018,16,0,2,"Braga",4,"N14 Bosch",21,47,26,107,48,59
10,8,2018,16,0,2,"Braga",5,"Avenida João Paulo II",39,39,0,9,9,0
10,8,2018,16,0,2,"Braga",6,"Avenida Padre Júlio Fragata",67,67,0,83,83,0
10,8,2018,16,0,2,"Braga",7,"Rua Nova Santa Cruz",26,44,18,66,39,27
10,8,2018,16,0,2,"Braga",8,"Rua Costa Gomes",0,41,41,-1,42,-43
10,8,2018,17,0,2,"Braga",1,"Avenida da Liberdade",15,25,10,207,124,83
10,8,2018,17,0,2,"Braga",2,"Avenida Central",15,25,10,207,124,83
10,8,2018,17,0,2,"Braga",3,"Rua de Caires",26,36,10,52,37,15
10,8,2018,17,0,2,"Braga",4,"N14 Bosch",12,47,35,187,48,139
10,8,2018,17,0,2,"Braga",5,"Avenida João Paulo II",39,39,0,9,9,0
10,8,2018,17,0,2,"Braga",6,"Avenida Padre Júlio Fragata",31,67,36,180,83,97
10,8,2018,17,0,2,"Braga",7,"Rua Nova Santa Cruz",5,44,39,346,39,307
10,8,2018,17,0,2,"Braga",8,"Rua Costa Gomes",0,41,41,-1,42,-43
10,8,2018,18,0,2,"Braga",1,"Avenida da Liberdade",8,25,17,387,124,263
10,8,2018,18,0,2,"Braga",2,"Avenida Central",8,25,17,387,124,263
10,8,2018,18,0,2,"Braga",3,"Rua de Caires",26,36,10,52,37,15
10,8,2018,18,0,2,"Braga",4,"N14 Bosch",29,47,18,77,48,29
10,8,2018,18,0,2,"Braga",5,"Avenida João Paulo II",5,39,34,70,9,61
10,8,2018,18,0,2,"Braga",6,"Avenida Padre Júlio Fragata",20,67,47,279,83,196
10,8,2018,18,0,2,"Braga",7,"Rua Nova Santa Cruz",16,44,28,108,39,69
10,8,2018,18,0,2,"Braga",8,"Rua Costa Gomes",0,41,41,-1,42,-43
10,8,2018,19,0,2,"Braga",1,"Avenida da Liberdade",25,25,0,124,124,0
10,8,2018,19,0,2,"Braga",2,"Avenida Central",25,25,0,124,124,0
10,8,2018,19,0,2,"Braga",3,"Rua de Caires",36,36,0,37,37,0
10,8,2018,19,0,2,"Braga",4,"N14 Bosch",31,47,16,72,48,24
10,8,2018,19,0,2,"Braga",5,"Avenida João Paulo II",29,39,10,12,9,3
10,8,2018,19,0,2,"Braga",6,"Avenida Padre Júlio Fragata",52,67,15,107,83,24
10,8,2018,19,0,2,"Braga",7,"Rua Nova Santa Cruz",8,44,36,216,39,177
10,8,2018,19,0,2,"Braga",8,"Rua Costa Gomes",0,41,41,-1,42,-43
10,8,2018,20,0,2,"Braga",1,"Avenida da Liberdade",25,25,0,124,124,0
10,8,2018,20,0,2,"Braga",2,"Avenida Central",25,25,0,124,124,0
10,8,2018,20,0,2,"Braga",3,"Rua de Caires",36,36,0,37,37,0
10,8,2018,20,0,2,"Braga",4,"N14 Bosch",47,47,0,48,48,0
10,8,2018,20,0,2,"Braga",5,"Avenida João Paulo II",39,39,0,9,9,0
10,8,2018,20,0,2,"Braga",6,"Avenida Padre Júlio Fragata",67,67,0,83,83,0
10,8,2018,20,0,2,"Braga",7,"Rua Nova Santa Cruz",44,44,0,39,39,0
10,8,2018,20,0,2,"Braga",8,"Rua Costa Gomes",0,41,41,-1,42,-43
10,8,2018,21,0,2,"Braga",1,"Avenida da Liberdade",25,25,0,124,124,0
10,8,2018,21,0,2,"Braga",2,"Avenida Central",25,25,0,124,124,0
10,8,2018,21,0,2,"Braga",3,"Rua de Caires",36,36,0,37,37,0
10,8,2018,21,0,2,"Braga",4,"N14 Bosch",47,47,0,48,48,0
10,8,2018,21,0,2,"Braga",5,"Avenida João Paulo II",39,39,0,9,9,0
10,8,2018,21,0,2,"Braga",6,"Avenida Padre Júlio Fragata",67,67,0,83,83,0
10,8,2018,21,0,2,"Braga",7,"Rua Nova Santa Cruz",44,44,0,39,39,0
10,8,2018,21,0,2,"Braga",8,"Rua Costa Gomes",0,41,41,-1,42,-43
10,8,2018,22,0,2,"Braga",1,"Avenida da Liberdade",25,25,0,124,124,0
10,8,2018,22,0,2,"Braga",2,"Avenida Central",25,25,0,124,124,0
10,8,2018,22,0,2,"Braga",3,"Rua de Caires",36,36,0,37,37,0
10,8,2018,22,0,2,"Braga",4,"N14 Bosch",47,47,0,48,48,0
10,8,2018,22,0,2,"Braga",5,"Avenida João Paulo II",39,39,0,9,9,0
10,8,2018,22,0,2,"Braga",6,"Avenida Padre Júlio Fragata",67,67,0,83,83,0
10,8,2018,22,0,2,"Braga",7,"Rua Nova Santa Cruz",44,44,0,39,39,0
10,8,2018,22,0,2,"Braga",8,"Rua Costa Gomes",0,41,41,-1,42,-43
10,8,2018,23,0,2,"Braga",1,"Avenida da Liberdade",25,25,0,124,124,0
10,8,2018,23,0,2,"Braga",2,"Avenida Central",25,25,0,124,124,0
10,8,2018,23,0,2,"Braga",3,"Rua de Caires",36,36,0,37,37,0
10,8,2018,23,0,2,"Braga",4,"N14 Bosch",47,47,0,48,48,0
10,8,2018,23,0,2,"Braga",5,"Avenida João Paulo II",39,39,0,9,9,0
10,8,2018,23,0,2,"Braga",6,"Avenida Padre Júlio Fragata",67,67,0,83,83,0
10,8,2018,23,0,2,"Braga",7,"Rua Nova Santa Cruz",44,44,0,39,39,0
10,8,2018,23,0,2,"Braga",8,"Rua Costa Gomes",0,41,41,-1,42,-43
10,9,2018,0,0,3,"Braga",1,"Avenida da Liberdade",25,25,0,124,124,0
10,9,2018,0,0,3,"Braga",2,"Avenida Central",25,25,0,124,124,0
10,9,2018,0,0,3,"Braga",3,"Rua de Caires",36,36,0,37,37,0
10,9,2018,0,0,3,"Braga",4,"N14 Bosch",47,47,0,48,48,0
10,9,2018,0,0,3,"Braga",5,"Avenida João Paulo II",39,39,0,9,9,0
10,9,2018,0,0,3,"Braga",6,"Avenida Padre Júlio Fragata",67,67,0,83,83,0
10,9,2018,0,0,3,"Braga",7,"Rua Nova Santa Cruz",44,44,0,39,39,0
10,9,2018,0,0,3,"Braga",8,"Rua Costa Gomes",0,41,41,-1,42,-43
10,9,2018,1,0,3,"Braga",1,"Avenida da Liberdade",25,25,0,124,124,0
10,9,2018,1,0,3,"Braga",2,"Avenida Central",25,25,0,124,124,0
10,9,2018,1,0,3,"Braga",3,"Rua de Caires",36,36,0,37,37,0
10,9,2018,1,0,3,"Braga",4,"N14 Bosch",47,47,0,48,48,0
10,9,2018,1,0,3,"Braga",5,"Avenida João Paulo II",39,39,0,9,9,0
10,9,2018,1,0,3,"Braga",6,"Avenida Padre Júlio Fragata",67,67,0,83,83,0
10,9,2018,1,0,3,"Braga",7,"Rua Nova Santa Cruz",44,44,0,39,39,0
10,9,2018,1,0,3,"Braga",8,"Rua Costa Gomes",0,41,41,-1,42,-43
10,9,2018,2,0,3,"Braga",1,"Avenida da Liberdade",25,25,0,124,124,0
10,9,2018,2,0,3,"Braga",2,"Avenida Central",25,25,0,124,124,0
10,9,2018,2,0,3,"Braga",3,"Rua de Caires",36,36,0,37,37,0
10,9,2018,2,0,3,"Braga",4,"N14 Bosch",47,47,0,48,48,0
10,9,2018,2,0,3,"Braga",5,"Avenida João Paulo II",39,39,0,9,9,0
10,9,2018,2,0,3,"Braga",6,"Avenida Padre Júlio Fragata",67,67,0,83,83,0
10,9,2018,2,0,3,"Braga",7,"Rua Nova Santa Cruz",44,44,0,39,39,0
10,9,2018,2,0,3,"Braga",8,"Rua Costa Gomes",0,41,41,-1,42,-43
10,9,2018,3,0,3,"Braga",1,"Avenida da Liberdade",25,25,0,124,124,0
10,9,2018,3,0,3,"Braga",2,"Avenida Central",25,25,0,124,124,0
10,9,2018,3,0,3,"Braga",3,"Rua de Caires",36,36,0,37,37,0
10,9,2018,3,0,3,"Braga",4,"N14 Bosch",47,47,0,48,48,0
10,9,2018,3,0,3,"Braga",5,"Avenida João Paulo II",39,39,0,9,9,0
10,9,2018,3,0,3,"Braga",6,"Avenida Padre Júlio Fragata",67,67,0,83,83,0
10,9,2018,3,0,3,"Braga",7,"Rua Nova Santa Cruz",44,44,0,39,39,0
10,9,2018,3,0,3,"Braga",8,"Rua Costa Gomes",0,41,41,-1,42,-43
10,9,2018,4,0,3,"Braga",1,"Avenida da Liberdade",25,25,0,124,124,0
10,9,2018,4,0,3,"Braga",2,"Avenida Central",25,25,0,124,124,0
10,9,2018,4,0,3,"Braga",3,"Rua de Caires",36,36,0,37,37,0
10,9,2018,4,0,3,"Braga",4,"N14 Bosch",47,47,0,48,48,0
10,9,2018,4,0,3,"Braga",5,"Avenida João Paulo II",39,39,0,9,9,0
10,9,2018,4,0,3,"Braga",6,"Avenida Padre Júlio Fragata",67,67,0,83,83,0
10,9,2018,4,0,3,"Braga",7,"Rua Nova Santa Cruz",44,44,0,39,39,0
10,9,2018,4,0,3,"Braga",8,"Rua Costa Gomes",0,41,41,-1,42,-43
10,9,2018,5,0,3,"Braga",1,"Avenida da Liberdade",25,25,0,124,124,0
10,9,2018,5,0,3,"Braga",2,"Avenida Central",25,25,0,124,124,0
10,9,2018,5,0,3,"Braga",3,"Rua de Caires",36,36,0,37,37,0
10,9,2018,5,0,3,"Braga",4,"N14 Bosch",47,47,0,48,48,0
10,9,2018,5,0,3,"Braga",5,"Avenida João Paulo II",39,39,0,9,9,0
10,9,2018,5,0,3,"Braga",6,"Avenida Padre Júlio Fragata",67,67,0,83,83,0
10,9,2018,5,0,3,"Braga",7,"Rua Nova Santa Cruz",44,44,0,39,39,0
10,9,2018,5,0,3,"Braga",8,"Rua Costa Gomes",0,41,41,-1,42,-43
10,9,2018,6,0,3,"Braga",1,"Avenida da Liberdade",25,25,0,124,124,0
10,9,2018,6,0,3,"Braga",2,"Avenida Central",25,25,0,124,124,0
10,9,2018,6,0,3,"Braga",3,"Rua de Caires",36,36,0,37,37,0
10,9,2018,6,0,3,"Braga",4,"N14 Bosch",47,47,0,48,48,0
10,9,2018,6,0,3,"Braga",5,"Avenida João Paulo II",39,39,0,9,9,0
10,9,2018,6,0,3,"Braga",6,"Avenida Padre Júlio Fragata",67,67,0,83,83,0
10,9,2018,6,0,3,"Braga",7,"Rua Nova Santa Cruz",44,44,0,39,39,0
10,9,2018,6,0,3,"Braga",8,"Rua Costa Gomes",0,41,41,-1,42,-43
10,9,2018,7,0,3,"Braga",1,"Avenida da Liberdade",25,25,0,124,124,0
10,9,2018,7,0,3,"Braga",2,"Avenida Central",25,25,0,124,124,0
10,9,2018,7,0,3,"Braga",3,"Rua de Caires",25,36,11,54,37,17
10,9,2018,7,0,3,"Braga",4,"N14 Bosch",47,47,0,48,48,0
10,9,2018,7,0,3,"Braga",5,"Avenida João Paulo II",39,39,0,9,9,0
10,9,2018,7,0,3,"Braga",6,"Avenida Padre Júlio Fragata",67,67,0,83,83,0
10,9,2018,7,0,3,"Braga",7,"Rua Nova Santa Cruz",44,44,0,39,39,0
10,9,2018,7,0,3,"Braga",8,"Rua Costa Gomes",0,41,41,-1,42,-43
10,9,2018,8,0,3,"Braga",1,"Avenida da Liberdade",18,25,7,172,124,48
10,9,2018,8,0,3,"Braga",2,"Avenida Central",18,25,7,172,124,48
10,9,2018,8,0,3,"Braga",3,"Rua de Caires",36,36,0,37,37,0
10,9,2018,8,0,3,"Braga",4,"N14 Bosch",32,47,15,70,48,22
10,9,2018,8,0,3,"Braga",5,"Avenida João Paulo II",30,39,9,12,9,3
10,9,2018,8,0,3,"Braga",6,"Avenida Padre Júlio Fragata",67,67,0,83,83,0
10,9,2018,8,0,3,"Braga",7,"Rua Nova Santa Cruz",10,44,34,173,39,134
10,9,2018,8,0,3,"Braga",8,"Rua Costa Gomes",0,41,41,-1,42,-43
10,9,2018,9,0,3,"Braga",1,"Avenida da Liberdade",25,25,0,124,124,0
10,9,2018,9,0,3,"Braga",2,"Avenida Central",25,25,0,124,124,0
10,9,2018,9,0,3,"Braga",3,"Rua de Caires",26,36,10,52,37,15
10,9,2018,9,0,3,"Braga",4,"N14 Bosch",30,47,17,75,48,27
10,9,2018,9,0,3,"Braga",5,"Avenida João Paulo II",39,39,0,9,9,0
10,9,2018,9,0,3,"Braga",6,"Avenida Padre Júlio Fragata",67,67,0,83,83,0
10,9,2018,9,0,3,"Braga",7,"Rua Nova Santa Cruz",34,44,10,51,39,12
10,9,2018,9,0,3,"Braga",8,"Rua Costa Gomes",0,41,41,-1,42,-43
10,9,2018,10,0,3,"Braga",1,"Avenida da Liberdade",25,25,0,124,124,0
10,9,2018,10,0,3,"Braga",2,"Avenida Central",25,25,0,124,124,0
10,9,2018,10,0,3,"Braga",3,"Rua de Caires",16,36,20,84,37,47
10,9,2018,10,0,3,"Braga",4,"N14 Bosch",37,47,10,61,48,13
10,9,2018,10,0,3,"Braga",5,"Avenida João Paulo II",39,39,0,9,9,0
10,9,2018,10,0,3,"Braga",6,"Avenida Padre Júlio Fragata",67,67,0,83,83,0
10,9,2018,10,0,3,"Braga",7,"Rua Nova Santa Cruz",29,44,15,60,39,21
10,9,2018,10,0,3,"Braga",8,"Rua Costa Gomes",0,41,41,-1,42,-43
10,9,2018,11,0,3,"Braga",1,"Avenida da Liberdade",25,25,0,124,124,0
10,9,2018,11,0,3,"Braga",2,"Avenida Central",25,25,0,124,124,0
10,9,2018,11,0,3,"Braga",3,"Rua de Caires",23,36,13,59,37,22
10,9,2018,11,0,3,"Braga",4,"N14 Bosch",33,47,14,68,48,20
10,9,2018,11,0,3,"Braga",5,"Avenida João Paulo II",39,39,0,9,9,0
10,9,2018,11,0,3,"Braga",6,"Avenida Padre Júlio Fragata",67,67,0,83,83,0
10,9,2018,11,0,3,"Braga",7,"Rua Nova Santa Cruz",44,44,0,39,39,0
10,9,2018,11,0,3,"Braga",8,"Rua Costa Gomes",0,41,41,-1,42,-43
10,9,2018,12,0,3,"Braga",1,"Avenida da Liberdade",18,25,7,172,124,48
10,9,2018,12,0,3,"Braga",2,"Avenida Central",18,25,7,172,124,48
10,9,2018,12,0,3,"Braga",3,"Rua de Caires",23,36,13,59,37,22
10,9,2018,12,0,3,"Braga",4,"N14 Bosch",27,47,20,83,48,35
10,9,2018,12,0,3,"Braga",5,"Avenida João Paulo II",39,39,0,9,9,0
10,9,2018,12,0,3,"Braga",6,"Avenida Padre Júlio Fragata",67,67,0,83,83,0
10,9,2018,12,0,3,"Braga",7,"Rua Nova Santa Cruz",32,44,12,54,39,15
10,9,2018,12,0,3,"Braga",8,"Rua Costa Gomes",0,41,41,-1,42,-43
10,9,2018,13,0,3,"Braga",1,"Avenida da Liberdade",25,25,0,124,124,0
10,9,2018,13,0,3,"Braga",2,"Avenida Central",25,25,0,124,124,0
10,9,2018,13,0,3,"Braga",3,"Rua de Caires",25,36,11,54,37,17
10,9,2018,13,0,3,"Braga",4,"N14 Bosch",16,47,31,140,48,92
10,9,2018,13,0,3,"Braga",5,"Avenida João Paulo II",39,39,0,9,9,0
10,9,2018,13,0,3,"Braga",6,"Avenida Padre Júlio Fragata",67,67,0,83,83,0
10,9,2018,13,0,3,"Braga",7,"Rua Nova Santa Cruz",6,44,38,288,39,249
10,9,2018,13,0,3,"Braga",8,"Rua Costa Gomes",0,41,41,-1,42,-43
10,9,2018,14,0,3,"Braga",1,"Avenida da Liberdade",16,25,9,194,124,70
10,9,2018,14,0,3,"Braga",2,"Avenida Central",16,25,9,194,124,70
10,9,2018,14,0,3,"Braga",3,"Rua de Caires",36,36,0,37,37,0
10,9,2018,14,0,3,"Braga",4,"N14 Bosch",33,47,14,68,48,20
10,9,2018,14,0,3,"Braga",5,"Avenida João Paulo II",39,39,0,9,9,0
10,9,2018,14,0,3,"Braga",6,"Avenida Padre Júlio Fragata",67,67,0,83,83,0
10,9,2018,14,0,3,"Braga",7,"Rua Nova Santa Cruz",35,44,9,49,39,10
10,9,2018,14,0,3,"Braga",8,"Rua Costa Gomes",0,41,41,-1,42,-43
10,9,2018,15,0,3,"Braga",1,"Avenida da Liberdade",11,25,14,282,124,158
10,9,2018,15,0,3,"Braga",2,"Avenida Central",11,25,14,282,124,158
10,9,2018,15,0,3,"Braga",3,"Rua de Caires",26,36,10,52,37,15
10,9,2018,15,0,3,"Braga",4,"N14 Bosch",28,47,19,80,48,32
10,9,2018,15,0,3,"Braga",5,"Avenida João Paulo II",39,39,0,9,9,0
10,9,2018,15,0,3,"Braga",6,"Avenida Padre Júlio Fragata",67,67,0,83,83,0
10,9,2018,15,0,3,"Braga",7,"Rua Nova Santa Cruz",34,44,10,51,39,12
10,9,2018,15,0,3,"Braga",8,"Rua Costa Gomes",0,41,41,-1,42,-43
10,9,2018,16,0,3,"Braga",1,"Avenida da Liberdade",20,25,5,155,124,31
10,9,2018,16,0,3,"Braga",2,"Avenida Central",20,25,5,155,124,31
10,9,2018,16,0,3,"Braga",3,"Rua de Caires",22,36,14,61,37,24
10,9,2018,16,0,3,"Braga",4,"N14 Bosch",23,47,24,98,48,50
10,9,2018,16,0,3,"Braga",5,"Avenida João Paulo II",39,39,0,9,9,0
10,9,2018,16,0,3,"Braga",6,"Avenida Padre Júlio Fragata",67,67,0,83,83,0
10,9,2018,16,0,3,"Braga",7,"Rua Nova Santa Cruz",23,44,21,75,39,36
10,9,2018,16,0,3,"Braga",8,"Rua Costa Gomes",0,41,41,-1,42,-43
10,9,2018,17,0,3,"Braga",1,"Avenida da Liberdade",12,25,13,258,124,134
10,9,2018,17,0,3,"Braga",2,"Avenida Central",12,25,13,258,124,134
10,9,2018,17,0,3,"Braga",3,"Rua de Caires",28,36,8,48,37,11
10,9,2018,17,0,3,"Braga",4,"N14 Bosch",13,47,34,173,48,125
10,9,2018,17,0,3,"Braga",5,"Avenida João Paulo II",3,39,36,116,9,107
10,9,2018,17,0,3,"Braga",6,"Avenida Padre Júlio Fragata",8,67,59,697,83,614
10,9,2018,17,0,3,"Braga",7,"Rua Nova Santa Cruz",6,44,38,288,39,249
10,9,2018,17,0,3,"Braga",8,"Rua Costa Gomes",0,41,41,-1,42,-43
10,9,2018,18,0,3,"Braga",1,"Avenida da Liberdade",16,25,9,194,124,70
10,9,2018,18,0,3,"Braga",2,"Avenida Central",16,25,9,194,124,70
10,9,2018,18,0,3,"Braga",3,"Rua de Caires",27,36,9,50,37,13
10,9,2018,18,0,3,"Braga",4,"N14 Bosch",12,47,35,187,48,139
10,9,2018,18,0,3,"Braga",5,"Avenida João Paulo II",18,39,21,19,9,10
10,9,2018,18,0,3,"Braga",6,"Avenida Padre Júlio Fragata",22,67,45,253,83,170
10,9,2018,18,0,3,"Braga",7,"Rua Nova Santa Cruz",7,44,37,247,39,208
10,9,2018,18,0,3,"Braga",8,"Rua Costa Gomes",0,41,41,-1,42,-43
10,9,2018,19,0,3,"Braga",1,"Avenida da Liberdade",25,25,0,124,124,0
10,9,2018,19,0,3,"Braga",2,"Avenida Central",25,25,0,124,124,0
10,9,2018,19,0,3,"Braga",3,"Rua de Caires",25,36,11,54,37,17
10,9,2018,19,0,3,"Braga",4,"N14 Bosch",33,47,14,68,48,20
10,9,2018,19,0,3,"Braga",5,"Avenida João Paulo II",39,39,0,9,9,0
10,9,2018,19,0,3,"Braga",6,"Avenida Padre Júlio Fragata",49,67,18,114,83,31
10,9,2018,19,0,3,"Braga",7,"Rua Nova Santa Cruz",10,44,34,173,39,134
10,9,2018,19,0,3,"Braga",8,"Rua Costa Gomes",0,41,41,-1,42,-43
10,9,2018,20,0,3,"Braga",1,"Avenida da Liberdade",25,25,0,124,124,0
10,9,2018,20,0,3,"Braga",2,"Avenida Central",25,25,0,124,124,0
10,9,2018,20,0,3,"Braga",3,"Rua de Caires",36,36,0,37,37,0
10,9,2018,20,0,3,"Braga",4,"N14 Bosch",47,47,0,48,48,0
10,9,2018,20,0,3,"Braga",5,"Avenida João Paulo II",39,39,0,9,9,0
10,9,2018,20,0,3,"Braga",6,"Avenida Padre Júlio Fragata",67,67,0,83,83,0
10,9,2018,20,0,3,"Braga",7,"Rua Nova Santa Cruz",29,44,15,60,39,21
10,9,2018,20,0,3,"Braga",8,"Rua Costa Gomes",0,41,41,-1,42,-43
10,9,2018,21,0,3,"Braga",1,"Avenida da Liberdade",25,25,0,124,124,0
10,9,2018,21,0,3,"Braga",2,"Avenida Central",25,25,0,124,124,0
10,9,2018,21,0,3,"Braga",3,"Rua de Caires",36,36,0,37,37,0
10,9,2018,21,0,3,"Braga",4,"N14 Bosch",47,47,0,48,48,0
10,9,2018,21,0,3,"Braga",5,"Avenida João Paulo II",39,39,0,9,9,0
10,9,2018,21,0,3,"Braga",6,"Avenida Padre Júlio Fragata",67,67,0,83,83,0
10,9,2018,21,0,3,"Braga",7,"Rua Nova Santa Cruz",44,44,0,39,39,0
10,9,2018,21,0,3,"Braga",8,"Rua Costa Gomes",0,41,41,-1,42,-43
10,9,2018,22,0,3,"Braga",1,"Avenida da Liberdade",25,25,0,124,124,0
10,9,2018,22,0,3,"Braga",2,"Avenida Central",25,25,0,124,124,0
10,9,2018,22,0,3,"Braga",3,"Rua de Caires",36,36,0,37,37,0
10,9,2018,22,0,3,"Braga",4,"N14 Bosch",47,47,0,48,48,0
10,9,2018,22,0,3,"Braga",5,"Avenida João Paulo II",39,39,0,9,9,0
10,9,2018,22,0,3,"Braga",6,"Avenida Padre Júlio Fragata",67,67,0,83,83,0
10,9,2018,22,0,3,"Braga",7,"Rua Nova Santa Cruz",44,44,0,39,39,0
10,9,2018,22,0,3,"Braga",8,"Rua Costa Gomes",0,41,41,-1,42,-43
10,9,2018,23,0,3,"Braga",1,"Avenida da Liberdade",25,25,0,124,124,0
10,9,2018,23,0,3,"Braga",2,"Avenida Central",25,25,0,124,124,0
10,9,2018,23,0,3,"Braga",3,"Rua de Caires",36,36,0,37,37,0
10,9,2018,23,0,3,"Braga",4,"N14 Bosch",47,47,0,48,48,0
10,9,2018,23,0,3,"Braga",5,"Avenida João Paulo II",39,39,0,9,9,0
10,9,2018,23,0,3,"Braga",6,"Avenida Padre Júlio Fragata",67,67,0,83,83,0
10,9,2018,23,0,3,"Braga",7,"Rua Nova Santa Cruz",44,44,0,39,39,0
10,9,2018,23,0,3,"Braga",8,"Rua Costa Gomes",0,41,41,-1,42,-43
10,10,2018,0,0,4,"Braga",1,"Avenida da Liberdade",25,25,0,124,124,0
10,10,2018,0,0,4,"Braga",2,"Avenida Central",25,25,0,124,124,0
10,10,2018,0,0,4,"Braga",3,"Rua de Caires",36,36,0,37,37,0
10,10,2018,0,0,4,"Braga",4,"N14 Bosch",47,47,0,48,48,0
10,10,2018,0,0,4,"Braga",5,"Avenida João Paulo II",39,39,0,9,9,0
10,10,2018,0,0,4,"Braga",6,"Avenida Padre Júlio Fragata",67,67,0,83,83,0
10,10,2018,0,0,4,"Braga",7,"Rua Nova Santa Cruz",44,44,0,39,39,0
10,10,2018,0,0,4,"Braga",8,"Rua Costa Gomes",0,41,41,-1,42,-43
10,10,2018,1,0,4,"Braga",1,"Avenida da Liberdade",25,25,0,124,124,0
10,10,2018,1,0,4,"Braga",2,"Avenida Central",25,25,0,124,124,0
10,10,2018,1,0,4,"Braga",3,"Rua de Caires",36,36,0,37,37,0
10,10,2018,1,0,4,"Braga",4,"N14 Bosch",47,47,0,48,48,0
10,10,2018,1,0,4,"Braga",5,"Avenida João Paulo II",39,39,0,9,9,0
10,10,2018,1,0,4,"Braga",6,"Avenida Padre Júlio Fragata",67,67,0,83,83,0
10,10,2018,1,0,4,"Braga",7,"Rua Nova Santa Cruz",44,44,0,39,39,0
10,10,2018,1,0,4,"Braga",8,"Rua Costa Gomes",0,41,41,-1,42,-43
10,10,2018,2,0,4,"Braga",1,"Avenida da Liberdade",25,25,0,124,124,0
10,10,2018,2,0,4,"Braga",2,"Avenida Central",25,25,0,124,124,0
10,10,2018,2,0,4,"Braga",3,"Rua de Caires",36,36,0,37,37,0
10,10,2018,2,0,4,"Braga",4,"N14 Bosch",47,47,0,48,48,0
10,10,2018,2,0,4,"Braga",5,"Avenida João Paulo II",39,39,0,9,9,0
10,10,2018,2,0,4,"Braga",6,"Avenida Padre Júlio Fragata",67,67,0,83,83,0
10,10,2018,2,0,4,"Braga",7,"Rua Nova Santa Cruz",44,44,0,39,39,0
10,10,2018,2,0,4,"Braga",8,"Rua Costa Gomes",0,41,41,-1,42,-43
10,10,2018,3,0,4,"Braga",1,"Avenida da Liberdade",25,25,0,124,124,0
10,10,2018,3,0,4,"Braga",2,"Avenida Central",25,25,0,124,124,0
10,10,2018,3,0,4,"Braga",3,"Rua de Caires",36,36,0,37,37,0
10,10,2018,3,0,4,"Braga",4,"N14 Bosch",47,47,0,48,48,0
10,10,2018,3,0,4,"Braga",5,"Avenida João Paulo II",39,39,0,9,9,0
10,10,2018,3,0,4,"Braga",6,"Avenida Padre Júlio Fragata",67,67,0,83,83,0
10,10,2018,3,0,4,"Braga",7,"Rua Nova Santa Cruz",44,44,0,39,39,0
10,10,2018,3,0,4,"Braga",8,"Rua Costa Gomes",0,41,41,-1,42,-43
10,10,2018,4,0,4,"Braga",1,"Avenida da Liberdade",25,25,0,124,124,0
10,10,2018,4,0,4,"Braga",2,"Avenida Central",25,25,0,124,124,0
10,10,2018,4,0,4,"Braga",3,"Rua de Caires",36,36,0,37,37,0
10,10,2018,4,0,4,"Braga",4,"N14 Bosch",47,47,0,48,48,0
10,10,2018,4,0,4,"Braga",5,"Avenida João Paulo II",39,39,0,9,9,0
10,10,2018,4,0,4,"Braga",6,"Avenida Padre Júlio Fragata",67,67,0,83,83,0
10,10,2018,4,0,4,"Braga",7,"Rua Nova Santa Cruz",44,44,0,39,39,0
10,10,2018,4,0,4,"Braga",8,"Rua Costa Gomes",0,41,41,-1,42,-43
10,10,2018,5,0,4,"Braga",1,"Avenida da Liberdade",25,25,0,124,124,0
10,10,2018,5,0,4,"Braga",2,"Avenida Central",25,25,0,124,124,0
10,10,2018,5,0,4,"Braga",3,"Rua de Caires",36,36,0,37,37,0
10,10,2018,5,0,4,"Braga",4,"N14 Bosch",47,47,0,48,48,0
10,10,2018,5,0,4,"Braga",5,"Avenida João Paulo II",39,39,0,9,9,0
10,10,2018,5,0,4,"Braga",6,"Avenida Padre Júlio Fragata",67,67,0,83,83,0
10,10,2018,5,0,4,"Braga",7,"Rua Nova Santa Cruz",44,44,0,39,39,0
10,10,2018,5,0,4,"Braga",8,"Rua Costa Gomes",0,41,41,-1,42,-43
10,10,2018,6,0,4,"Braga",1,"Avenida da Liberdade",25,25,0,124,124,0
10,10,2018,6,0,4,"Braga",2,"Avenida Central",25,25,0,124,124,0
10,10,2018,6,0,4,"Braga",3,"Rua de Caires",36,36,0,37,37,0
10,10,2018,6,0,4,"Braga",4,"N14 Bosch",47,47,0,48,48,0
10,10,2018,6,0,4,"Braga",5,"Avenida João Paulo II",39,39,0,9,9,0
10,10,2018,6,0,4,"Braga",6,"Avenida Padre Júlio Fragata",67,67,0,83,83,0
10,10,2018,6,0,4,"Braga",7,"Rua Nova Santa Cruz",44,44,0,39,39,0
10,10,2018,6,0,4,"Braga",8,"Rua Costa Gomes",0,41,41,-1,42,-43
10,10,2018,7,0,4,"Braga",1,"Avenida da Liberdade",25,25,0,124,124,0
10,10,2018,7,0,4,"Braga",2,"Avenida Central",25,25,0,124,124,0
10,10,2018,7,0,4,"Braga",3,"Rua de Caires",36,36,0,37,37,0
10,10,2018,7,0,4,"Braga",4,"N14 Bosch",47,47,0,48,48,0
10,10,2018,7,0,4,"Braga",5,"Avenida João Paulo II",39,39,0,9,9,0
10,10,2018,7,0,4,"Braga",6,"Avenida Padre Júlio Fragata",67,67,0,83,83,0
10,10,2018,7,0,4,"Braga",7,"Rua Nova Santa Cruz",44,44,0,39,39,0
10,10,2018,7,0,4,"Braga",8,"Rua Costa Gomes",0,41,41,-1,42,-43
10,10,2018,8,0,4,"Braga",1,"Avenida da Liberdade",16,25,9,194,124,70
10,10,2018,8,0,4,"Braga",2,"Avenida Central",14,25,11,221,124,97
10,10,2018,8,0,4,"Braga",3,"Rua de Caires",21,36,15,64,37,27
10,10,2018,8,0,4,"Braga",4,"N14 Bosch",9,47,38,250,48,202
10,10,2018,8,0,4,"Braga",5,"Avenida João Paulo II",39,39,0,9,9,0
10,10,2018,8,0,4,"Braga",6,"Avenida Padre Júlio Fragata",37,67,30,151,83,68
10,10,2018,8,0,4,"Braga",7,"Rua Nova Santa Cruz",6,44,38,288,39,249
10,10,2018,8,0,4,"Braga",8,"Rua Costa Gomes",0,41,41,-1,42,-43
10,10,2018,9,0,4,"Braga",1,"Avenida da Liberdade",25,25,0,124,124,0
10,10,2018,9,0,4,"Braga",2,"Avenida Central",25,25,0,124,124,0
10,10,2018,9,0,4,"Braga",3,"Rua de Caires",15,36,21,90,37,53
10,10,2018,9,0,4,"Braga",4,"N14 Bosch",36,47,11,62,48,14
10,10,2018,9,0,4,"Braga",5,"Avenida João Paulo II",39,39,0,9,9,0
10,10,2018,9,0,4,"Braga",6,"Avenida Padre Júlio Fragata",67,67,0,83,83,0
10,10,2018,9,0,4,"Braga",7,"Rua Nova Santa Cruz",30,44,14,58,39,19
10,10,2018,9,0,4,"Braga",8,"Rua Costa Gomes",0,41,41,-1,42,-43
10,10,2018,10,0,4,"Braga",1,"Avenida da Liberdade",25,25,0,124,124,0
10,10,2018,10,0,4,"Braga",2,"Avenida Central",25,25,0,124,124,0
10,10,2018,10,0,4,"Braga",3,"Rua de Caires",22,36,14,61,37,24
10,10,2018,10,0,4,"Braga",4,"N14 Bosch",36,47,11,62,48,14
10,10,2018,10,0,4,"Braga",5,"Avenida João Paulo II",39,39,0,9,9,0
10,10,2018,10,0,4,"Braga",6,"Avenida Padre Júlio Fragata",67,67,0,83,83,0
10,10,2018,10,0,4,"Braga",7,"Rua Nova Santa Cruz",32,44,12,54,39,15
10,10,2018,10,0,4,"Braga",8,"Rua Costa Gomes",0,41,41,-1,42,-43
10,10,2018,11,0,4,"Braga",1,"Avenida da Liberdade",25,25,0,124,124,0
10,10,2018,11,0,4,"Braga",2,"Avenida Central",25,25,0,124,124,0
10,10,2018,11,0,4,"Braga",3,"Rua de Caires",27,36,9,50,37,13
10,10,2018,11,0,4,"Braga",4,"N14 Bosch",19,47,28,118,48,70
10,10,2018,11,0,4,"Braga",5,"Avenida João Paulo II",20,39,19,17,9,8
10,10,2018,11,0,4,"Braga",6,"Avenida Padre Júlio Fragata",67,67,0,83,83,0
10,10,2018,11,0,4,"Braga",7,"Rua Nova Santa Cruz",23,44,21,75,39,36
10,10,2018,11,0,4,"Braga",8,"Rua Costa Gomes",0,41,41,-1,42,-43
10,10,2018,12,0,4,"Braga",1,"Avenida da Liberdade",25,25,0,124,124,0
10,10,2018,12,0,4,"Braga",2,"Avenida Central",25,25,0,124,124,0
10,10,2018,12,0,4,"Braga",3,"Rua de Caires",28,36,8,48,37,11
10,10,2018,12,0,4,"Braga",4,"N14 Bosch",29,47,18,77,48,29
10,10,2018,12,0,4,"Braga",5,"Avenida João Paulo II",39,39,0,9,9,0
10,10,2018,12,0,4,"Braga",6,"Avenida Padre Júlio Fragata",67,67,0,83,83,0
10,10,2018,12,0,4,"Braga",7,"Rua Nova Santa Cruz",4,44,40,432,39,393
10,10,2018,12,0,4,"Braga",8,"Rua Costa Gomes",0,41,41,-1,42,-43
10,10,2018,13,0,4,"Braga",1,"Avenida da Liberdade",19,25,6,163,124,39
10,10,2018,13,0,4,"Braga",2,"Avenida Central",19,25,6,163,124,39
10,10,2018,13,0,4,"Braga",3,"Rua de Caires",36,36,0,37,37,0
10,10,2018,13,0,4,"Braga",4,"N14 Bosch",19,47,28,118,48,70
10,10,2018,13,0,4,"Braga",5,"Avenida João Paulo II",39,39,0,9,9,0
10,10,2018,13,0,4,"Braga",6,"Avenida Padre Júlio Fragata",67,67,0,83,83,0
10,10,2018,13,0,4,"Braga",7,"Rua Nova Santa Cruz",12,44,32,144,39,105
10,10,2018,13,0,4,"Braga",8,"Rua Costa Gomes",0,41,41,-1,42,-43
10,10,2018,14,0,4,"Braga",1,"Avenida da Liberdade",25,25,0,124,124,0
10,10,2018,14,0,4,"Braga",2,"Avenida Central",25,25,0,124,124,0
10,10,2018,14,0,4,"Braga",3,"Rua de Caires",25,36,11,54,37,17
10,10,2018,14,0,4,"Braga",4,"N14 Bosch",35,47,12,64,48,16
10,10,2018,14,0,4,"Braga",5,"Avenida João Paulo II",39,39,0,9,9,0
10,10,2018,14,0,4,"Braga",6,"Avenida Padre Júlio Fragata",67,67,0,83,83,0
10,10,2018,14,0,4,"Braga",7,"Rua Nova Santa Cruz",26,44,18,66,39,27
10,10,2018,14,0,4,"Braga",8,"Rua Costa Gomes",0,41,41,-1,42,-43
10,10,2018,15,0,4,"Braga",1,"Avenida da Liberdade",25,25,0,124,124,0
10,10,2018,15,0,4,"Braga",2,"Avenida Central",25,25,0,124,124,0
10,10,2018,15,0,4,"Braga",3,"Rua de Caires",22,36,14,61,37,24
10,10,2018,15,0,4,"Braga",4,"N14 Bosch",36,47,11,62,48,14
10,10,2018,15,0,4,"Braga",5,"Avenida João Paulo II",39,39,0,9,9,0
10,10,2018,15,0,4,"Braga",6,"Avenida Padre Júlio Fragata",67,67,0,83,83,0
10,10,2018,15,0,4,"Braga",7,"Rua Nova Santa Cruz",32,44,12,54,39,15
10,10,2018,15,0,4,"Braga",8,"Rua Costa Gomes",0,41,41,-1,42,-43
10,10,2018,16,0,4,"Braga",1,"Avenida da Liberdade",18,25,7,172,124,48
10,10,2018,16,0,4,"Braga",2,"Avenida Central",18,25,7,172,124,48
10,10,2018,16,0,4,"Braga",3,"Rua de Caires",24,36,12,56,37,19
10,10,2018,16,0,4,"Braga",4,"N14 Bosch",30,47,17,75,48,27
10,10,2018,16,0,4,"Braga",5,"Avenida João Paulo II",39,39,0,9,9,0
10,10,2018,16,0,4,"Braga",6,"Avenida Padre Júlio Fragata",67,67,0,83,83,0
10,10,2018,16,0,4,"Braga",7,"Rua Nova Santa Cruz",27,44,17,64,39,25
10,10,2018,16,0,4,"Braga",8,"Rua Costa Gomes",0,41,41,-1,42,-43
10,10,2018,17,0,4,"Braga",1,"Avenida da Liberdade",15,25,10,207,124,83
10,10,2018,17,0,4,"Braga",2,"Avenida Central",15,25,10,207,124,83
10,10,2018,17,0,4,"Braga",3,"Rua de Caires",28,36,8,48,37,11
10,10,2018,17,0,4,"Braga",4,"N14 Bosch",24,47,23,94,48,46
10,10,2018,17,0,4,"Braga",5,"Avenida João Paulo II",39,39,0,9,9,0
10,10,2018,17,0,4,"Braga",6,"Avenida Padre Júlio Fragata",35,67,32,159,83,76
10,10,2018,17,0,4,"Braga",7,"Rua Nova Santa Cruz",9,44,35,192,39,153
10,10,2018,17,0,4,"Braga",8,"Rua Costa Gomes",0,41,41,-1,42,-43
10,10,2018,18,0,4,"Braga",1,"Avenida da Liberdade",15,25,10,207,124,83
10,10,2018,18,0,4,"Braga",2,"Avenida Central",15,25,10,207,124,83
10,10,2018,18,0,4,"Braga",3,"Rua de Caires",36,36,0,37,37,0
10,10,2018,18,0,4,"Braga",4,"N14 Bosch",10,47,37,225,48,177
10,10,2018,18,0,4,"Braga",5,"Avenida João Paulo II",20,39,19,17,9,8
10,10,2018,18,0,4,"Braga",6,"Avenida Padre Júlio Fragata",27,67,40,206,83,123
10,10,2018,18,0,4,"Braga",7,"Rua Nova Santa Cruz",44,44,0,39,39,0
10,10,2018,18,0,4,"Braga",8,"Rua Costa Gomes",0,41,41,-1,42,-43
10,10,2018,19,0,4,"Braga",1,"Avenida da Liberdade",19,25,6,163,124,39
10,10,2018,19,0,4,"Braga",2,"Avenida Central",19,25,6,163,124,39
10,10,2018,19,0,4,"Braga",3,"Rua de Caires",36,36,0,37,37,0
10,10,2018,19,0,4,"Braga",4,"N14 Bosch",47,47,0,48,48,0
10,10,2018,19,0,4,"Braga",5,"Avenida João Paulo II",25,39,14,14,9,5
10,10,2018,19,0,4,"Braga",6,"Avenida Padre Júlio Fragata",53,67,14,105,83,22
10,10,2018,19,0,4,"Braga",7,"Rua Nova Santa Cruz",32,44,12,54,39,15
10,10,2018,19,0,4,"Braga",8,"Rua Costa Gomes",0,41,41,-1,42,-43
10,10,2018,20,0,4,"Braga",1,"Avenida da Liberdade",25,25,0,124,124,0
10,10,2018,20,0,4,"Braga",2,"Avenida Central",25,25,0,124,124,0
10,10,2018,20,0,4,"Braga",3,"Rua de Caires",16,36,20,84,37,47
10,10,2018,20,0,4,"Braga",4,"N14 Bosch",47,47,0,48,48,0
10,10,2018,20,0,4,"Braga",5,"Avenida João Paulo II",39,39,0,9,9,0
10,10,2018,20,0,4,"Braga",6,"Avenida Padre Júlio Fragata",67,67,0,83,83,0
10,10,2018,20,0,4,"Braga",7,"Rua Nova Santa Cruz",33,44,11,52,39,13
10,10,2018,20,0,4,"Braga",8,"Rua Costa Gomes",0,41,41,-1,42,-43
10,10,2018,21,0,4,"Braga",1,"Avenida da Liberdade",25,25,0,124,124,0
10,10,2018,21,0,4,"Braga",2,"Avenida Central",25,25,0,124,124,0
10,10,2018,21,0,4,"Braga",3,"Rua de Caires",36,36,0,37,37,0
10,10,2018,21,0,4,"Braga",4,"N14 Bosch",47,47,0,48,48,0
10,10,2018,21,0,4,"Braga",5,"Avenida João Paulo II",39,39,0,9,9,0
10,10,2018,21,0,4,"Braga",6,"Avenida Padre Júlio Fragata",67,67,0,83,83,0
10,10,2018,21,0,4,"Braga",7,"Rua Nova Santa Cruz",30,44,14,58,39,19
10,10,2018,21,0,4,"Braga",8,"Rua Costa Gomes",0,41,41,-1,42,-43
10,10,2018,22,0,4,"Braga",1,"Avenida da Liberdade",25,25,0,124,124,0
10,10,2018,22,0,4,"Braga",2,"Avenida Central",25,25,0,124,124,0
10,10,2018,22,0,4,"Braga",3,"Rua de Caires",36,36,0,37,37,0
10,10,2018,22,0,4,"Braga",4,"N14 Bosch",47,47,0,48,48,0
10,10,2018,22,0,4,"Braga",5,"Avenida João Paulo II",39,39,0,9,9,0
10,10,2018,22,0,4,"Braga",6,"Avenida Padre Júlio Fragata",67,67,0,83,83,0
10,10,2018,22,0,4,"Braga",7,"Rua Nova Santa Cruz",44,44,0,39,39,0
10,10,2018,22,0,4,"Braga",8,"Rua Costa Gomes",0,41,41,-1,42,-43
10,10,2018,23,0,4,"Braga",1,"Avenida da Liberdade",25,25,0,124,124,0
10,10,2018,23,0,4,"Braga",2,"Avenida Central",25,25,0,124,124,0
10,10,2018,23,0,4,"Braga",3,"Rua de Caires",36,36,0,37,37,0
10,10,2018,23,0,4,"Braga",4,"N14 Bosch",47,47,0,48,48,0
10,10,2018,23,0,4,"Braga",5,"Avenida João Paulo II",39,39,0,9,9,0
10,10,2018,23,0,4,"Braga",6,"Avenida Padre Júlio Fragata",67,67,0,83,83,0
10,10,2018,23,0,4,"Braga",7,"Rua Nova Santa Cruz",44,44,0,39,39,0
10,10,2018,23,0,4,"Braga",8,"Rua Costa Gomes",0,41,41,-1,42,-43
10,11,2018,0,0,5,"Braga",1,"Avenida da Liberdade",25,25,0,124,124,0
10,11,2018,0,0,5,"Braga",2,"Avenida Central",25,25,0,124,124,0
10,11,2018,0,0,5,"Braga",3,"Rua de Caires",36,36,0,37,37,0
10,11,2018,0,0,5,"Braga",4,"N14 Bosch",47,47,0,48,48,0
10,11,2018,0,0,5,"Braga",5,"Avenida João Paulo II",39,39,0,9,9,0
10,11,2018,0,0,5,"Braga",6,"Avenida Padre Júlio Fragata",67,67,0,83,83,0
10,11,2018,0,0,5,"Braga",7,"Rua Nova Santa Cruz",44,44,0,39,39,0
10,11,2018,0,0,5,"Braga",8,"Rua Costa Gomes",0,41,41,-1,42,-43
10,11,2018,1,0,5,"Braga",1,"Avenida da Liberdade",25,25,0,124,124,0
10,11,2018,1,0,5,"Braga",2,"Avenida Central",25,25,0,124,124,0
10,11,2018,1,0,5,"Braga",3,"Rua de Caires",36,36,0,37,37,0
10,11,2018,1,0,5,"Braga",4,"N14 Bosch",47,47,0,48,48,0
10,11,2018,1,0,5,"Braga",5,"Avenida João Paulo II",39,39,0,9,9,0
10,11,2018,1,0,5,"Braga",6,"Avenida Padre Júlio Fragata",67,67,0,83,83,0
10,11,2018,1,0,5,"Braga",7,"Rua Nova Santa Cruz",44,44,0,39,39,0
10,11,2018,1,0,5,"Braga",8,"Rua Costa Gomes",0,41,41,-1,42,-43
10,11,2018,2,0,5,"Braga",1,"Avenida da Liberdade",25,25,0,124,124,0
10,11,2018,2,0,5,"Braga",2,"Avenida Central",25,25,0,124,124,0
10,11,2018,2,0,5,"Braga",3,"Rua de Caires",36,36,0,37,37,0
10,11,2018,2,0,5,"Braga",4,"N14 Bosch",47,47,0,48,48,0
10,11,2018,2,0,5,"Braga",5,"Avenida João Paulo II",39,39,0,9,9,0
10,11,2018,2,0,5,"Braga",6,"Avenida Padre Júlio Fragata",67,67,0,83,83,0
10,11,2018,2,0,5,"Braga",7,"Rua Nova Santa Cruz",44,44,0,39,39,0
10,11,2018,2,0,5,"Braga",8,"Rua Costa Gomes",0,41,41,-1,42,-43
10,11,2018,3,0,5,"Braga",1,"Avenida da Liberdade",25,25,0,124,124,0
10,11,2018,3,0,5,"Braga",2,"Avenida Central",25,25,0,124,124,0
10,11,2018,3,0,5,"Braga",3,"Rua de Caires",36,36,0,37,37,0
10,11,2018,3,0,5,"Braga",4,"N14 Bosch",47,47,0,48,48,0
10,11,2018,3,0,5,"Braga",5,"Avenida João Paulo II",39,39,0,9,9,0
10,11,2018,3,0,5,"Braga",6,"Avenida Padre Júlio Fragata",67,67,0,83,83,0
10,11,2018,3,0,5,"Braga",7,"Rua Nova Santa Cruz",44,44,0,39,39,0
10,11,2018,3,0,5,"Braga",8,"Rua Costa Gomes",0,41,41,-1,42,-43
10,11,2018,4,0,5,"Braga",1,"Avenida da Liberdade",25,25,0,124,124,0
10,11,2018,4,0,5,"Braga",2,"Avenida Central",25,25,0,124,124,0
10,11,2018,4,0,5,"Braga",3,"Rua de Caires",36,36,0,37,37,0
10,11,2018,4,0,5,"Braga",4,"N14 Bosch",47,47,0,48,48,0
10,11,2018,4,0,5,"Braga",5,"Avenida João Paulo II",39,39,0,9,9,0
10,11,2018,4,0,5,"Braga",6,"Avenida Padre Júlio Fragata",67,67,0,83,83,0
10,11,2018,4,0,5,"Braga",7,"Rua Nova Santa Cruz",44,44,0,39,39,0
10,11,2018,4,0,5,"Braga",8,"Rua Costa Gomes",0,41,41,-1,42,-43
10,11,2018,5,0,5,"Braga",1,"Avenida da Liberdade",25,25,0,124,124,0
10,11,2018,5,0,5,"Braga",2,"Avenida Central",25,25,0,124,124,0
10,11,2018,5,0,5,"Braga",3,"Rua de Caires",36,36,0,37,37,0
10,11,2018,5,0,5,"Braga",4,"N14 Bosch",47,47,0,48,48,0
10,11,2018,5,0,5,"Braga",5,"Avenida João Paulo II",39,39,0,9,9,0
10,11,2018,5,0,5,"Braga",6,"Avenida Padre Júlio Fragata",67,67,0,83,83,0
10,11,2018,5,0,5,"Braga",7,"Rua Nova Santa Cruz",44,44,0,39,39,0
10,11,2018,5,0,5,"Braga",8,"Rua Costa Gomes",0,41,41,-1,42,-43
10,11,2018,6,0,5,"Braga",1,"Avenida da Liberdade",25,25,0,124,124,0
10,11,2018,6,0,5,"Braga",2,"Avenida Central",25,25,0,124,124,0
10,11,2018,6,0,5,"Braga",3,"Rua de Caires",26,36,10,52,37,15
10,11,2018,6,0,5,"Braga",4,"N14 Bosch",47,47,0,48,48,0
10,11,2018,6,0,5,"Braga",5,"Avenida João Paulo II",39,39,0,9,9,0
10,11,2018,6,0,5,"Braga",6,"Avenida Padre Júlio Fragata",67,67,0,83,83,0
10,11,2018,6,0,5,"Braga",7,"Rua Nova Santa Cruz",44,44,0,39,39,0
10,11,2018,6,0,5,"Braga",8,"Rua Costa Gomes",0,41,41,-1,42,-43
10,11,2018,7,0,5,"Braga",1,"Avenida da Liberdade",25,25,0,124,124,0
10,11,2018,7,0,5,"Braga",2,"Avenida Central",25,25,0,124,124,0
10,11,2018,7,0,5,"Braga",3,"Rua de Caires",36,36,0,37,37,0
10,11,2018,7,0,5,"Braga",4,"N14 Bosch",26,47,21,86,48,38
10,11,2018,7,0,5,"Braga",5,"Avenida João Paulo II",39,39,0,9,9,0
10,11,2018,7,0,5,"Braga",6,"Avenida Padre Júlio Fragata",67,67,0,83,83,0
10,11,2018,7,0,5,"Braga",7,"Rua Nova Santa Cruz",44,44,0,39,39,0
10,11,2018,7,0,5,"Braga",8,"Rua Costa Gomes",0,41,41,-1,42,-43
10,11,2018,8,0,5,"Braga",1,"Avenida da Liberdade",15,25,10,207,124,83
10,11,2018,8,0,5,"Braga",2,"Avenida Central",15,25,10,207,124,83
10,11,2018,8,0,5,"Braga",3,"Rua de Caires",18,36,18,75,37,38
10,11,2018,8,0,5,"Braga",4,"N14 Bosch",47,47,0,48,48,0
10,11,2018,8,0,5,"Braga",5,"Avenida João Paulo II",15,39,24,23,9,14
10,11,2018,8,0,5,"Braga",6,"Avenida Padre Júlio Fragata",28,67,39,199,83,116
10,11,2018,8,0,5,"Braga",7,"Rua Nova Santa Cruz",14,44,30,123,39,84
10,11,2018,8,0,5,"Braga",8,"Rua Costa Gomes",0,41,41,-1,42,-43
10,11,2018,9,0,5,"Braga",1,"Avenida da Liberdade",25,25,0,124,124,0
10,11,2018,9,0,5,"Braga",2,"Avenida Central",25,25,0,124,124,0
10,11,2018,9,0,5,"Braga",3,"Rua de Caires",22,36,14,61,37,24
10,11,2018,9,0,5,"Braga",4,"N14 Bosch",47,47,0,48,48,0
10,11,2018,9,0,5,"Braga",5,"Avenida João Paulo II",28,39,11,12,9,3
10,11,2018,9,0,5,"Braga",6,"Avenida Padre Júlio Fragata",67,67,0,83,83,0
10,11,2018,9,0,5,"Braga",7,"Rua Nova Santa Cruz",31,44,13,56,39,17
10,11,2018,9,0,5,"Braga",8,"Rua Costa Gomes",0,41,41,-1,42,-43
10,11,2018,10,0,5,"Braga",1,"Avenida da Liberdade",19,25,6,163,124,39
10,11,2018,10,0,5,"Braga",2,"Avenida Central",19,25,6,163,124,39
10,11,2018,10,0,5,"Braga",3,"Rua de Caires",36,36,0,37,37,0
10,11,2018,10,0,5,"Braga",4,"N14 Bosch",36,47,11,62,48,14
10,11,2018,10,0,5,"Braga",5,"Avenida João Paulo II",39,39,0,9,9,0
10,11,2018,10,0,5,"Braga",6,"Avenida Padre Júlio Fragata",67,67,0,83,83,0
10,11,2018,10,0,5,"Braga",7,"Rua Nova Santa Cruz",32,44,12,54,39,15
10,11,2018,10,0,5,"Braga",8,"Rua Costa Gomes",0,41,41,-1,42,-43
10,11,2018,11,0,5,"Braga",1,"Avenida da Liberdade",15,25,10,207,124,83
10,11,2018,11,0,5,"Braga",2,"Avenida Central",15,25,10,207,124,83
10,11,2018,11,0,5,"Braga",3,"Rua de Caires",36,36,0,37,37,0
10,11,2018,11,0,5,"Braga",4,"N14 Bosch",36,47,11,62,48,14
10,11,2018,11,0,5,"Braga",5,"Avenida João Paulo II",39,39,0,9,9,0
10,11,2018,11,0,5,"Braga",6,"Avenida Padre Júlio Fragata",67,67,0,83,83,0
10,11,2018,11,0,5,"Braga",7,"Rua Nova Santa Cruz",32,44,12,54,39,15
10,11,2018,11,0,5,"Braga",8,"Rua Costa Gomes",0,41,41,-1,42,-43
10,11,2018,12,0,5,"Braga",1,"Avenida da Liberdade",25,25,0,124,124,0
10,11,2018,12,0,5,"Braga",2,"Avenida Central",25,25,0,124,124,0
10,11,2018,12,0,5,"Braga",3,"Rua de Caires",21,36,15,64,37,27
10,11,2018,12,0,5,"Braga",4,"N14 Bosch",13,47,34,173,48,125
10,11,2018,12,0,5,"Braga",5,"Avenida João Paulo II",39,39,0,9,9,0
10,11,2018,12,0,5,"Braga",6,"Avenida Padre Júlio Fragata",67,67,0,83,83,0
10,11,2018,12,0,5,"Braga",7,"Rua Nova Santa Cruz",4,44,40,432,39,393
10,11,2018,12,0,5,"Braga",8,"Rua Costa Gomes",0,41,41,-1,42,-43
10,11,2018,13,0,5,"Braga",1,"Avenida da Liberdade",25,25,0,124,124,0
10,11,2018,13,0,5,"Braga",2,"Avenida Central",25,25,0,124,124,0
10,11,2018,13,0,5,"Braga",3,"Rua de Caires",22,36,14,61,37,24
10,11,2018,13,0,5,"Braga",4,"N14 Bosch",26,47,21,86,48,38
10,11,2018,13,0,5,"Braga",5,"Avenida João Paulo II",39,39,0,9,9,0
10,11,2018,13,0,5,"Braga",6,"Avenida Padre Júlio Fragata",45,67,22,124,83,41
10,11,2018,13,0,5,"Braga",7,"Rua Nova Santa Cruz",15,44,29,115,39,76
10,11,2018,13,0,5,"Braga",8,"Rua Costa Gomes",0,41,41,-1,42,-43
10,11,2018,14,0,5,"Braga",1,"Avenida da Liberdade",25,25,0,124,124,0
10,11,2018,14,0,5,"Braga",2,"Avenida Central",25,25,0,124,124,0
10,11,2018,14,0,5,"Braga",3,"Rua de Caires",23,36,13,59,37,22
10,11,2018,14,0,5,"Braga",4,"N14 Bosch",22,47,25,102,48,54
10,11,2018,14,0,5,"Braga",5,"Avenida João Paulo II",39,39,0,9,9,0
10,11,2018,14,0,5,"Braga",6,"Avenida Padre Júlio Fragata",14,67,53,398,83,315
10,11,2018,14,0,5,"Braga",7,"Rua Nova Santa Cruz",44,44,0,39,39,0
10,11,2018,14,0,5,"Braga",8,"Rua Costa Gomes",0,41,41,-1,42,-43
10,11,2018,15,0,5,"Braga",1,"Avenida da Liberdade",19,25,6,163,124,39
10,11,2018,15,0,5,"Braga",2,"Avenida Central",19,25,6,163,124,39
10,11,2018,15,0,5,"Braga",3,"Rua de Caires",21,36,15,64,37,27
10,11,2018,15,0,5,"Braga",4,"N14 Bosch",22,47,25,102,48,54
10,11,2018,15,0,5,"Braga",5,"Avenida João Paulo II",39,39,0,9,9,0
10,11,2018,15,0,5,"Braga",6,"Avenida Padre Júlio Fragata",29,67,38,192,83,109
10,11,2018,15,0,5,"Braga",7,"Rua Nova Santa Cruz",33,44,11,52,39,13
10,11,2018,15,0,5,"Braga",8,"Rua Costa Gomes",0,41,41,-1,42,-43
10,11,2018,16,0,5,"Braga",1,"Avenida da Liberdade",19,25,6,163,124,39
10,11,2018,16,0,5,"Braga",2,"Avenida Central",19,25,6,163,124,39
10,11,2018,16,0,5,"Braga",3,"Rua de Caires",27,36,9,50,37,13
10,11,2018,16,0,5,"Braga",4,"N14 Bosch",24,47,23,94,48,46
10,11,2018,16,0,5,"Braga",5,"Avenida João Paulo II",39,39,0,9,9,0
10,11,2018,16,0,5,"Braga",6,"Avenida Padre Júlio Fragata",67,67,0,83,83,0
10,11,2018,16,0,5,"Braga",7,"Rua Nova Santa Cruz",21,44,23,82,39,43
10,11,2018,16,0,5,"Braga",8,"Rua Costa Gomes",0,41,41,-1,42,-43
10,11,2018,17,0,5,"Braga",1,"Avenida da Liberdade",14,25,11,221,124,97
10,11,2018,17,0,5,"Braga",2,"Avenida Central",14,25,11,221,124,97
10,11,2018,17,0,5,"Braga",3,"Rua de Caires",22,36,14,61,37,24
10,11,2018,17,0,5,"Braga",4,"N14 Bosch",13,47,34,173,48,125
10,11,2018,17,0,5,"Braga",5,"Avenida João Paulo II",39,39,0,9,9,0
10,11,2018,17,0,5,"Braga",6,"Avenida Padre Júlio Fragata",28,67,39,199,83,116
10,11,2018,17,0,5,"Braga",7,"Rua Nova Santa Cruz",13,44,31,133,39,94
10,11,2018,17,0,5,"Braga",8,"Rua Costa Gomes",0,41,41,-1,42,-43
10,11,2018,18,0,5,"Braga",1,"Avenida da Liberdade",8,25,17,387,124,263
10,11,2018,18,0,5,"Braga",2,"Avenida Central",8,25,17,387,124,263
10,11,2018,18,0,5,"Braga",3,"Rua de Caires",18,36,18,75,37,38
10,11,2018,18,0,5,"Braga",4,"N14 Bosch",15,47,32,150,48,102
10,11,2018,18,0,5,"Braga",5,"Avenida João Paulo II",39,39,0,9,9,0
10,11,2018,18,0,5,"Braga",6,"Avenida Padre Júlio Fragata",30,67,37,186,83,103
10,11,2018,18,0,5,"Braga",7,"Rua Nova Santa Cruz",15,44,29,115,39,76
10,11,2018,18,0,5,"Braga",8,"Rua Costa Gomes",0,41,41,-1,42,-43
10,11,2018,19,0,5,"Braga",1,"Avenida da Liberdade",25,25,0,124,124,0
10,11,2018,19,0,5,"Braga",2,"Avenida Central",25,25,0,124,124,0
10,11,2018,19,0,5,"Braga",3,"Rua de Caires",36,36,0,37,37,0
10,11,2018,19,0,5,"Braga",4,"N14 Bosch",34,47,13,66,48,18
10,11,2018,19,0,5,"Braga",5,"Avenida João Paulo II",39,39,0,9,9,0
10,11,2018,19,0,5,"Braga",6,"Avenida Padre Júlio Fragata",67,67,0,83,83,0
10,11,2018,19,0,5,"Braga",7,"Rua Nova Santa Cruz",34,44,10,51,39,12
10,11,2018,19,0,5,"Braga",8,"Rua Costa Gomes",0,41,41,-1,42,-43
10,11,2018,20,0,5,"Braga",1,"Avenida da Liberdade",25,25,0,124,124,0
10,11,2018,20,0,5,"Braga",2,"Avenida Central",25,25,0,124,124,0
10,11,2018,20,0,5,"Braga",3,"Rua de Caires",36,36,0,37,37,0
10,11,2018,20,0,5,"Braga",4,"N14 Bosch",47,47,0,48,48,0
10,11,2018,20,0,5,"Braga",5,"Avenida João Paulo II",39,39,0,9,9,0
10,11,2018,20,0,5,"Braga",6,"Avenida Padre Júlio Fragata",67,67,0,83,83,0
10,11,2018,20,0,5,"Braga",7,"Rua Nova Santa Cruz",44,44,0,39,39,0
10,11,2018,20,0,5,"Braga",8,"Rua Costa Gomes",0,41,41,-1,42,-43
10,11,2018,21,0,5,"Braga",1,"Avenida da Liberdade",25,25,0,124,124,0
10,11,2018,21,0,5,"Braga",2,"Avenida Central",25,25,0,124,124,0
10,11,2018,21,0,5,"Braga",3,"Rua de Caires",36,36,0,37,37,0
10,11,2018,21,0,5,"Braga",4,"N14 Bosch",47,47,0,48,48,0
10,11,2018,21,0,5,"Braga",5,"Avenida João Paulo II",39,39,0,9,9,0
10,11,2018,21,0,5,"Braga",6,"Avenida Padre Júlio Fragata",67,67,0,83,83,0
10,11,2018,21,0,5,"Braga",7,"Rua Nova Santa Cruz",32,44,12,54,39,15
10,11,2018,21,0,5,"Braga",8,"Rua Costa Gomes",0,41,41,-1,42,-43
10,11,2018,22,0,5,"Braga",1,"Avenida da Liberdade",25,25,0,124,124,0
10,11,2018,22,0,5,"Braga",2,"Avenida Central",25,25,0,124,124,0
10,11,2018,22,0,5,"Braga",3,"Rua de Caires",14,36,22,96,37,59
10,11,2018,22,0,5,"Braga",4,"N14 Bosch",47,47,0,48,48,0
10,11,2018,22,0,5,"Braga",5,"Avenida João Paulo II",39,39,0,9,9,0
10,11,2018,22,0,5,"Braga",6,"Avenida Padre Júlio Fragata",67,67,0,83,83,0
10,11,2018,22,0,5,"Braga",7,"Rua Nova Santa Cruz",44,44,0,39,39,0
10,11,2018,22,0,5,"Braga",8,"Rua Costa Gomes",0,41,41,-1,42,-43
10,11,2018,23,0,5,"Braga",1,"Avenida da Liberdade",25,25,0,124,124,0
10,11,2018,23,0,5,"Braga",2,"Avenida Central",25,25,0,124,124,0
10,11,2018,23,0,5,"Braga",3,"Rua de Caires",36,36,0,37,37,0
10,11,2018,23,0,5,"Braga",4,"N14 Bosch",47,47,0,48,48,0
10,11,2018,23,0,5,"Braga",5,"Avenida João Paulo II",39,39,0,9,9,0
10,11,2018,23,0,5,"Braga",6,"Avenida Padre Júlio Fragata",67,67,0,83,83,0
10,11,2018,23,0,5,"Braga",7,"Rua Nova Santa Cruz",28,44,16,62,39,23
10,11,2018,23,0,5,"Braga",8,"Rua Costa Gomes",0,41,41,-1,42,-43
10,12,2018,0,0,6,"Braga",1,"Avenida da Liberdade",25,25,0,124,124,0
10,12,2018,0,0,6,"Braga",2,"Avenida Central",25,25,0,124,124,0
10,12,2018,0,0,6,"Braga",3,"Rua de Caires",36,36,0,37,37,0
10,12,2018,0,0,6,"Braga",4,"N14 Bosch",47,47,0,48,48,0
10,12,2018,0,0,6,"Braga",5,"Avenida João Paulo II",39,39,0,9,9,0
10,12,2018,0,0,6,"Braga",6,"Avenida Padre Júlio Fragata",67,67,0,83,83,0
10,12,2018,0,0,6,"Braga",7,"Rua Nova Santa Cruz",44,44,0,39,39,0
10,12,2018,0,0,6,"Braga",8,"Rua Costa Gomes",0,41,41,-1,42,-43
10,12,2018,1,0,6,"Braga",1,"Avenida da Liberdade",25,25,0,124,124,0
10,12,2018,1,0,6,"Braga",2,"Avenida Central",25,25,0,124,124,0
10,12,2018,1,0,6,"Braga",3,"Rua de Caires",36,36,0,37,37,0
10,12,2018,1,0,6,"Braga",4,"N14 Bosch",47,47,0,48,48,0
10,12,2018,1,0,6,"Braga",5,"Avenida João Paulo II",39,39,0,9,9,0
10,12,2018,1,0,6,"Braga",6,"Avenida Padre Júlio Fragata",67,67,0,83,83,0
10,12,2018,1,0,6,"Braga",7,"Rua Nova Santa Cruz",44,44,0,39,39,0
10,12,2018,1,0,6,"Braga",8,"Rua Costa Gomes",0,41,41,-1,42,-43
10,12,2018,2,0,6,"Braga",1,"Avenida da Liberdade",25,25,0,124,124,0
10,12,2018,2,0,6,"Braga",2,"Avenida Central",25,25,0,124,124,0
10,12,2018,2,0,6,"Braga",3,"Rua de Caires",36,36,0,37,37,0
10,12,2018,2,0,6,"Braga",4,"N14 Bosch",47,47,0,48,48,0
10,12,2018,2,0,6,"Braga",5,"Avenida João Paulo II",39,39,0,9,9,0
10,12,2018,2,0,6,"Braga",6,"Avenida Padre Júlio Fragata",67,67,0,83,83,0
10,12,2018,2,0,6,"Braga",7,"Rua Nova Santa Cruz",44,44,0,39,39,0
10,12,2018,2,0,6,"Braga",8,"Rua Costa Gomes",0,41,41,-1,42,-43
10,12,2018,3,0,6,"Braga",1,"Avenida da Liberdade",25,25,0,124,124,0
10,12,2018,3,0,6,"Braga",2,"Avenida Central",25,25,0,124,124,0
10,12,2018,3,0,6,"Braga",3,"Rua de Caires",36,36,0,37,37,0
10,12,2018,3,0,6,"Braga",4,"N14 Bosch",47,47,0,48,48,0
10,12,2018,3,0,6,"Braga",5,"Avenida João Paulo II",39,39,0,9,9,0
10,12,2018,3,0,6,"Braga",6,"Avenida Padre Júlio Fragata",67,67,0,83,83,0
10,12,2018,3,0,6,"Braga",7,"Rua Nova Santa Cruz",44,44,0,39,39,0
10,12,2018,3,0,6,"Braga",8,"Rua Costa Gomes",0,41,41,-1,42,-43
10,12,2018,4,0,6,"Braga",1,"Avenida da Liberdade",25,25,0,124,124,0
10,12,2018,4,0,6,"Braga",2,"Avenida Central",25,25,0,124,124,0
10,12,2018,4,0,6,"Braga",3,"Rua de Caires",36,36,0,37,37,0
10,12,2018,4,0,6,"Braga",4,"N14 Bosch",47,47,0,48,48,0
10,12,2018,4,0,6,"Braga",5,"Avenida João Paulo II",39,39,0,9,9,0
10,12,2018,4,0,6,"Braga",6,"Avenida Padre Júlio Fragata",67,67,0,83,83,0
10,12,2018,4,0,6,"Braga",7,"Rua Nova Santa Cruz",44,44,0,39,39,0
10,12,2018,4,0,6,"Braga",8,"Rua Costa Gomes",0,41,41,-1,42,-43
10,12,2018,5,0,6,"Braga",1,"Avenida da Liberdade",25,25,0,124,124,0
10,12,2018,5,0,6,"Braga",2,"Avenida Central",25,25,0,124,124,0
10,12,2018,5,0,6,"Braga",3,"Rua de Caires",36,36,0,37,37,0
10,12,2018,5,0,6,"Braga",4,"N14 Bosch",47,47,0,48,48,0
10,12,2018,5,0,6,"Braga",5,"Avenida João Paulo II",39,39,0,9,9,0
10,12,2018,5,0,6,"Braga",6,"Avenida Padre Júlio Fragata",67,67,0,83,83,0
10,12,2018,5,0,6,"Braga",7,"Rua Nova Santa Cruz",44,44,0,39,39,0
10,12,2018,5,0,6,"Braga",8,"Rua Costa Gomes",0,41,41,-1,42,-43
10,12,2018,6,0,6,"Braga",1,"Avenida da Liberdade",25,25,0,124,124,0
10,12,2018,6,0,6,"Braga",2,"Avenida Central",25,25,0,124,124,0
10,12,2018,6,0,6,"Braga",3,"Rua de Caires",36,36,0,37,37,0
10,12,2018,6,0,6,"Braga",4,"N14 Bosch",47,47,0,48,48,0
10,12,2018,6,0,6,"Braga",5,"Avenida João Paulo II",39,39,0,9,9,0
10,12,2018,6,0,6,"Braga",6,"Avenida Padre Júlio Fragata",67,67,0,83,83,0
10,12,2018,6,0,6,"Braga",7,"Rua Nova Santa Cruz",44,44,0,39,39,0
10,12,2018,6,0,6,"Braga",8,"Rua Costa Gomes",0,41,41,-1,42,-43
10,12,2018,7,0,6,"Braga",1,"Avenida da Liberdade",25,25,0,124,124,0
10,12,2018,7,0,6,"Braga",2,"Avenida Central",25,25,0,124,124,0
10,12,2018,7,0,6,"Braga",3,"Rua de Caires",24,36,12,56,37,19
10,12,2018,7,0,6,"Braga",4,"N14 Bosch",35,47,12,64,48,16
10,12,2018,7,0,6,"Braga",5,"Avenida João Paulo II",39,39,0,9,9,0
10,12,2018,7,0,6,"Braga",6,"Avenida Padre Júlio Fragata",67,67,0,83,83,0
10,12,2018,7,0,6,"Braga",7,"Rua Nova Santa Cruz",27,44,17,64,39,25
10,12,2018,7,0,6,"Braga",8,"Rua Costa Gomes",0,41,41,-1,42,-43
10,12,2018,8,0,6,"Braga",1,"Avenida da Liberdade",16,25,9,194,124,70
10,12,2018,8,0,6,"Braga",2,"Avenida Central",16,25,9,194,124,70
10,12,2018,8,0,6,"Braga",3,"Rua de Caires",22,36,14,61,37,24
10,12,2018,8,0,6,"Braga",4,"N14 Bosch",27,47,20,83,48,35
10,12,2018,8,0,6,"Braga",5,"Avenida João Paulo II",39,39,0,9,9,0
10,12,2018,8,0,6,"Braga",6,"Avenida Padre Júlio Fragata",39,67,28,143,83,60
10,12,2018,8,0,6,"Braga",7,"Rua Nova Santa Cruz",8,44,36,216,39,177
10,12,2018,8,0,6,"Braga",8,"Rua Costa Gomes",0,41,41,-1,42,-43
10,12,2018,9,0,6,"Braga",1,"Avenida da Liberdade",25,25,0,124,124,0
10,12,2018,9,0,6,"Braga",2,"Avenida Central",25,25,0,124,124,0
10,12,2018,9,0,6,"Braga",3,"Rua de Caires",25,36,11,54,37,17
10,12,2018,9,0,6,"Braga",4,"N14 Bosch",33,47,14,68,48,20
10,12,2018,9,0,6,"Braga",5,"Avenida João Paulo II",26,39,13,13,9,4
10,12,2018,9,0,6,"Braga",6,"Avenida Padre Júlio Fragata",67,67,0,83,83,0
10,12,2018,9,0,6,"Braga",7,"Rua Nova Santa Cruz",28,44,16,62,39,23
10,12,2018,9,0,6,"Braga",8,"Rua Costa Gomes",0,41,41,-1,42,-43
10,12,2018,10,0,6,"Braga",1,"Avenida da Liberdade",25,25,0,124,124,0
10,12,2018,10,0,6,"Braga",2,"Avenida Central",25,25,0,124,124,0
10,12,2018,10,0,6,"Braga",3,"Rua de Caires",28,36,8,48,37,11
10,12,2018,10,0,6,"Braga",4,"N14 Bosch",21,47,26,107,48,59
10,12,2018,10,0,6,"Braga",5,"Avenida João Paulo II",39,39,0,9,9,0
10,12,2018,10,0,6,"Braga",6,"Avenida Padre Júlio Fragata",67,67,0,83,83,0
10,12,2018,10,0,6,"Braga",7,"Rua Nova Santa Cruz",44,44,0,39,39,0
10,12,2018,10,0,6,"Braga",8,"Rua Costa Gomes",0,41,41,-1,42,-43
10,12,2018,11,0,6,"Braga",1,"Avenida da Liberdade",25,25,0,124,124,0
10,12,2018,11,0,6,"Braga",2,"Avenida Central",25,25,0,124,124,0
10,12,2018,11,0,6,"Braga",3,"Rua de Caires",36,36,0,37,37,0
10,12,2018,11,0,6,"Braga",4,"N14 Bosch",31,47,16,72,48,24
10,12,2018,11,0,6,"Braga",5,"Avenida João Paulo II",39,39,0,9,9,0
10,12,2018,11,0,6,"Braga",6,"Avenida Padre Júlio Fragata",67,67,0,83,83,0
10,12,2018,11,0,6,"Braga",7,"Rua Nova Santa Cruz",44,44,0,39,39,0
10,12,2018,11,0,6,"Braga",8,"Rua Costa Gomes",0,41,41,-1,42,-43
10,12,2018,12,0,6,"Braga",1,"Avenida da Liberdade",19,25,6,163,124,39
10,12,2018,12,0,6,"Braga",2,"Avenida Central",18,25,7,172,124,48
10,12,2018,12,0,6,"Braga",3,"Rua de Caires",36,36,0,37,37,0
10,12,2018,12,0,6,"Braga",4,"N14 Bosch",17,47,30,132,48,84
10,12,2018,12,0,6,"Braga",5,"Avenida João Paulo II",39,39,0,9,9,0
10,12,2018,12,0,6,"Braga",6,"Avenida Padre Júlio Fragata",67,67,0,83,83,0
10,12,2018,12,0,6,"Braga",7,"Rua Nova Santa Cruz",5,44,39,346,39,307
10,12,2018,12,0,6,"Braga",8,"Rua Costa Gomes",0,41,41,-1,42,-43
10,12,2018,13,0,6,"Braga",1,"Avenida da Liberdade",25,25,0,124,124,0
10,12,2018,13,0,6,"Braga",2,"Avenida Central",25,25,0,124,124,0
10,12,2018,13,0,6,"Braga",3,"Rua de Caires",20,36,16,67,37,30
10,12,2018,13,0,6,"Braga",4,"N14 Bosch",13,47,34,173,48,125
10,12,2018,13,0,6,"Braga",5,"Avenida João Paulo II",39,39,0,9,9,0
10,12,2018,13,0,6,"Braga",6,"Avenida Padre Júlio Fragata",67,67,0,83,83,0
10,12,2018,13,0,6,"Braga",7,"Rua Nova Santa Cruz",12,44,32,144,39,105
10,12,2018,13,0,6,"Braga",8,"Rua Costa Gomes",0,41,41,-1,42,-43
10,12,2018,14,0,6,"Braga",1,"Avenida da Liberdade",25,25,0,124,124,0
10,12,2018,14,0,6,"Braga",2,"Avenida Central",25,25,0,124,124,0
10,12,2018,14,0,6,"Braga",3,"Rua de Caires",23,36,13,59,37,22
10,12,2018,14,0,6,"Braga",4,"N14 Bosch",32,47,15,70,48,22
10,12,2018,14,0,6,"Braga",5,"Avenida João Paulo II",39,39,0,9,9,0
10,12,2018,14,0,6,"Braga",6,"Avenida Padre Júlio Fragata",67,67,0,83,83,0
10,12,2018,14,0,6,"Braga",7,"Rua Nova Santa Cruz",44,44,0,39,39,0
10,12,2018,14,0,6,"Braga",8,"Rua Costa Gomes",0,41,41,-1,42,-43
10,12,2018,15,0,6,"Braga",1,"Avenida da Liberdade",25,25,0,124,124,0
10,12,2018,15,0,6,"Braga",2,"Avenida Central",25,25,0,124,124,0
10,12,2018,15,0,6,"Braga",3,"Rua de Caires",36,36,0,37,37,0
10,12,2018,15,0,6,"Braga",4,"N14 Bosch",28,47,19,80,48,32
10,12,2018,15,0,6,"Braga",5,"Avenida João Paulo II",30,39,9,12,9,3
10,12,2018,15,0,6,"Braga",6,"Avenida Padre Júlio Fragata",67,67,0,83,83,0
10,12,2018,15,0,6,"Braga",7,"Rua Nova Santa Cruz",44,44,0,39,39,0
10,12,2018,15,0,6,"Braga",8,"Rua Costa Gomes",0,41,41,-1,42,-43
10,12,2018,16,0,6,"Braga",1,"Avenida da Liberdade",18,25,7,172,124,48
10,12,2018,16,0,6,"Braga",2,"Avenida Central",18,25,7,172,124,48
10,12,2018,16,0,6,"Braga",3,"Rua de Caires",36,36,0,37,37,0
10,12,2018,16,0,6,"Braga",4,"N14 Bosch",24,47,23,94,48,46
10,12,2018,16,0,6,"Braga",5,"Avenida João Paulo II",39,39,0,9,9,0
10,12,2018,16,0,6,"Braga",6,"Avenida Padre Júlio Fragata",40,67,27,139,83,56
10,12,2018,16,0,6,"Braga",7,"Rua Nova Santa Cruz",15,44,29,115,39,76
10,12,2018,16,0,6,"Braga",8,"Rua Costa Gomes",0,41,41,-1,42,-43
10,12,2018,17,0,6,"Braga",1,"Avenida da Liberdade",7,25,18,443,124,319
10,12,2018,17,0,6,"Braga",2,"Avenida Central",7,25,18,443,124,319
10,12,2018,17,0,6,"Braga",3,"Rua de Caires",24,36,12,56,37,19
10,12,2018,17,0,6,"Braga",4,"N14 Bosch",12,47,35,187,48,139
10,12,2018,17,0,6,"Braga",5,"Avenida João Paulo II",22,39,17,16,9,7
10,12,2018,17,0,6,"Braga",6,"Avenida Padre Júlio Fragata",23,67,44,242,83,159
10,12,2018,17,0,6,"Braga",7,"Rua Nova Santa Cruz",14,44,30,123,39,84
10,12,2018,17,0,6,"Braga",8,"Rua Costa Gomes",0,41,41,-1,42,-43
10,12,2018,18,0,6,"Braga",1,"Avenida da Liberdade",17,25,8,182,124,58
10,12,2018,18,0,6,"Braga",2,"Avenida Central",17,25,8,182,124,58
10,12,2018,18,0,6,"Braga",3,"Rua de Caires",26,36,10,52,37,15
10,12,2018,18,0,6,"Braga",4,"N14 Bosch",14,47,33,160,48,112
10,12,2018,18,0,6,"Braga",5,"Avenida João Paulo II",39,39,0,9,9,0
10,12,2018,18,0,6,"Braga",6,"Avenida Padre Júlio Fragata",48,67,19,116,83,33
10,12,2018,18,0,6,"Braga",7,"Rua Nova Santa Cruz",25,44,19,69,39,30
10,12,2018,18,0,6,"Braga",8,"Rua Costa Gomes",0,41,41,-1,42,-43
10,12,2018,19,0,6,"Braga",1,"Avenida da Liberdade",25,25,0,124,124,0
10,12,2018,19,0,6,"Braga",2,"Avenida Central",25,25,0,124,124,0
10,12,2018,19,0,6,"Braga",3,"Rua de Caires",36,36,0,37,37,0
10,12,2018,19,0,6,"Braga",4,"N14 Bosch",31,47,16,72,48,24
10,12,2018,19,0,6,"Braga",5,"Avenida João Paulo II",30,39,9,12,9,3
10,12,2018,19,0,6,"Braga",6,"Avenida Padre Júlio Fragata",32,67,35,174,83,91
10,12,2018,19,0,6,"Braga",7,"Rua Nova Santa Cruz",19,44,25,91,39,52
10,12,2018,19,0,6,"Braga",8,"Rua Costa Gomes",0,41,41,-1,42,-43
10,12,2018,20,0,6,"Braga",1,"Avenida da Liberdade",25,25,0,124,124,0
10,12,2018,20,0,6,"Braga",2,"Avenida Central",25,25,0,124,124,0
10,12,2018,20,0,6,"Braga",3,"Rua de Caires",36,36,0,37,37,0
10,12,2018,20,0,6,"Braga",4,"N14 Bosch",47,47,0,48,48,0
10,12,2018,20,0,6,"Braga",5,"Avenida João Paulo II",39,39,0,9,9,0
10,12,2018,20,0,6,"Braga",6,"Avenida Padre Júlio Fragata",67,67,0,83,83,0
10,12,2018,20,0,6,"Braga",7,"Rua Nova Santa Cruz",28,44,16,62,39,23
10,12,2018,20,0,6,"Braga",8,"Rua Costa Gomes",0,41,41,-1,42,-43
10,12,2018,21,0,6,"Braga",1,"Avenida da Liberdade",25,25,0,124,124,0
10,12,2018,21,0,6,"Braga",2,"Avenida Central",25,25,0,124,124,0
10,12,2018,21,0,6,"Braga",3,"Rua de Caires",36,36,0,37,37,0
10,12,2018,21,0,6,"Braga",4,"N14 Bosch",47,47,0,48,48,0
10,12,2018,21,0,6,"Braga",5,"Avenida João Paulo II",39,39,0,9,9,0
10,12,2018,21,0,6,"Braga",6,"Avenida Padre Júlio Fragata",67,67,0,83,83,0
10,12,2018,21,0,6,"Braga",7,"Rua Nova Santa Cruz",44,44,0,39,39,0
10,12,2018,21,0,6,"Braga",8,"Rua Costa Gomes",0,41,41,-1,42,-43
10,12,2018,22,0,6,"Braga",1,"Avenida da Liberdade",25,25,0,124,124,0
10,12,2018,22,0,6,"Braga",2,"Avenida Central",25,25,0,124,124,0
10,12,2018,22,0,6,"Braga",3,"Rua de Caires",36,36,0,37,37,0
10,12,2018,22,0,6,"Braga",4,"N14 Bosch",47,47,0,48,48,0
10,12,2018,22,0,6,"Braga",5,"Avenida João Paulo II",39,39,0,9,9,0
10,12,2018,22,0,6,"Braga",6,"Avenida Padre Júlio Fragata",67,67,0,83,83,0
10,12,2018,22,0,6,"Braga",7,"Rua Nova Santa Cruz",44,44,0,39,39,0
10,12,2018,22,0,6,"Braga",8,"Rua Costa Gomes",0,41,41,-1,42,-43
10,12,2018,23,0,6,"Braga",1,"Avenida da Liberdade",25,25,0,124,124,0
10,12,2018,23,0,6,"Braga",2,"Avenida Central",25,25,0,124,124,0
10,12,2018,23,0,6,"Braga",3,"Rua de Caires",36,36,0,37,37,0
10,12,2018,23,0,6,"Braga",4,"N14 Bosch",47,47,0,48,48,0
10,12,2018,23,0,6,"Braga",5,"Avenida João Paulo II",39,39,0,9,9,0
10,12,2018,23,0,6,"Braga",6,"Avenida Padre Júlio Fragata",67,67,0,83,83,0
10,12,2018,23,0,6,"Braga",7,"Rua Nova Santa Cruz",44,44,0,39,39,0
10,12,2018,23,0,6,"Braga",8,"Rua Costa Gomes",0,41,41,-1,42,-43
10,13,2018,0,0,7,"Braga",1,"Avenida da Liberdade",25,25,0,124,124,0
10,13,2018,0,0,7,"Braga",2,"Avenida Central",25,25,0,124,124,0
10,13,2018,0,0,7,"Braga",3,"Rua de Caires",36,36,0,37,37,0
10,13,2018,0,0,7,"Braga",4,"N14 Bosch",47,47,0,48,48,0
10,13,2018,0,0,7,"Braga",5,"Avenida João Paulo II",39,39,0,9,9,0
10,13,2018,0,0,7,"Braga",6,"Avenida Padre Júlio Fragata",67,67,0,83,83,0
10,13,2018,0,0,7,"Braga",7,"Rua Nova Santa Cruz",44,44,0,39,39,0
10,13,2018,0,0,7,"Braga",8,"Rua Costa Gomes",0,41,41,-1,42,-43
10,13,2018,1,0,7,"Braga",1,"Avenida da Liberdade",25,25,0,124,124,0
10,13,2018,1,0,7,"Braga",2,"Avenida Central",25,25,0,124,124,0
10,13,2018,1,0,7,"Braga",3,"Rua de Caires",36,36,0,37,37,0
10,13,2018,1,0,7,"Braga",4,"N14 Bosch",47,47,0,48,48,0
10,13,2018,1,0,7,"Braga",5,"Avenida João Paulo II",39,39,0,9,9,0
10,13,2018,1,0,7,"Braga",6,"Avenida Padre Júlio Fragata",67,67,0,83,83,0
10,13,2018,1,0,7,"Braga",7,"Rua Nova Santa Cruz",44,44,0,39,39,0
10,13,2018,1,0,7,"Braga",8,"Rua Costa Gomes",0,41,41,-1,42,-43
10,13,2018,2,0,7,"Braga",1,"Avenida da Liberdade",25,25,0,124,124,0
10,13,2018,2,0,7,"Braga",2,"Avenida Central",25,25,0,124,124,0
10,13,2018,2,0,7,"Braga",3,"Rua de Caires",36,36,0,37,37,0
10,13,2018,2,0,7,"Braga",4,"N14 Bosch",47,47,0,48,48,0
10,13,2018,2,0,7,"Braga",5,"Avenida João Paulo II",39,39,0,9,9,0
10,13,2018,2,0,7,"Braga",6,"Avenida Padre Júlio Fragata",67,67,0,83,83,0
10,13,2018,2,0,7,"Braga",7,"Rua Nova Santa Cruz",44,44,0,39,39,0
10,13,2018,2,0,7,"Braga",8,"Rua Costa Gomes",0,41,41,-1,42,-43
10,13,2018,3,0,7,"Braga",1,"Avenida da Liberdade",25,25,0,124,124,0
10,13,2018,3,0,7,"Braga",2,"Avenida Central",25,25,0,124,124,0
10,13,2018,3,0,7,"Braga",3,"Rua de Caires",36,36,0,37,37,0
10,13,2018,3,0,7,"Braga",4,"N14 Bosch",47,47,0,48,48,0
10,13,2018,3,0,7,"Braga",5,"Avenida João Paulo II",39,39,0,9,9,0
10,13,2018,3,0,7,"Braga",6,"Avenida Padre Júlio Fragata",67,67,0,83,83,0
10,13,2018,3,0,7,"Braga",7,"Rua Nova Santa Cruz",44,44,0,39,39,0
10,13,2018,3,0,7,"Braga",8,"Rua Costa Gomes",0,41,41,-1,42,-43
10,13,2018,4,0,7,"Braga",1,"Avenida da Liberdade",25,25,0,124,124,0
10,13,2018,4,0,7,"Braga",2,"Avenida Central",25,25,0,124,124,0
10,13,2018,4,0,7,"Braga",3,"Rua de Caires",36,36,0,37,37,0
10,13,2018,4,0,7,"Braga",4,"N14 Bosch",47,47,0,48,48,0
10,13,2018,4,0,7,"Braga",5,"Avenida João Paulo II",39,39,0,9,9,0
10,13,2018,4,0,7,"Braga",6,"Avenida Padre Júlio Fragata",67,67,0,83,83,0
10,13,2018,4,0,7,"Braga",7,"Rua Nova Santa Cruz",44,44,0,39,39,0
10,13,2018,4,0,7,"Braga",8,"Rua Costa Gomes",0,41,41,-1,42,-43
10,13,2018,5,0,7,"Braga",1,"Avenida da Liberdade",25,25,0,124,124,0
10,13,2018,5,0,7,"Braga",2,"Avenida Central",25,25,0,124,124,0
10,13,2018,5,0,7,"Braga",3,"Rua de Caires",36,36,0,37,37,0
10,13,2018,5,0,7,"Braga",4,"N14 Bosch",47,47,0,48,48,0
10,13,2018,5,0,7,"Braga",5,"Avenida João Paulo II",39,39,0,9,9,0
10,13,2018,5,0,7,"Braga",6,"Avenida Padre Júlio Fragata",67,67,0,83,83,0
10,13,2018,5,0,7,"Braga",7,"Rua Nova Santa Cruz",44,44,0,39,39,0
10,13,2018,5,0,7,"Braga",8,"Rua Costa Gomes",0,41,41,-1,42,-43
10,13,2018,6,0,7,"Braga",1,"Avenida da Liberdade",25,25,0,124,124,0
10,13,2018,6,0,7,"Braga",2,"Avenida Central",25,25,0,124,124,0
10,13,2018,6,0,7,"Braga",3,"Rua de Caires",36,36,0,37,37,0
10,13,2018,6,0,7,"Braga",4,"N14 Bosch",47,47,0,48,48,0
10,13,2018,6,0,7,"Braga",5,"Avenida João Paulo II",39,39,0,9,9,0
10,13,2018,6,0,7,"Braga",6,"Avenida Padre Júlio Fragata",67,67,0,83,83,0
10,13,2018,6,0,7,"Braga",7,"Rua Nova Santa Cruz",44,44,0,39,39,0
10,13,2018,6,0,7,"Braga",8,"Rua Costa Gomes",0,41,41,-1,42,-43
10,13,2018,7,0,7,"Braga",1,"Avenida da Liberdade",25,25,0,124,124,0
10,13,2018,7,0,7,"Braga",2,"Avenida Central",25,25,0,124,124,0
10,13,2018,7,0,7,"Braga",3,"Rua de Caires",36,36,0,37,37,0
10,13,2018,7,0,7,"Braga",4,"N14 Bosch",47,47,0,48,48,0
10,13,2018,7,0,7,"Braga",5,"Avenida João Paulo II",39,39,0,9,9,0
10,13,2018,7,0,7,"Braga",6,"Avenida Padre Júlio Fragata",67,67,0,83,83,0
10,13,2018,7,0,7,"Braga",7,"Rua Nova Santa Cruz",44,44,0,39,39,0
10,13,2018,7,0,7,"Braga",8,"Rua Costa Gomes",0,41,41,-1,42,-43
10,13,2018,8,0,7,"Braga",1,"Avenida da Liberdade",25,25,0,124,124,0
10,13,2018,8,0,7,"Braga",2,"Avenida Central",25,25,0,124,124,0
10,13,2018,8,0,7,"Braga",3,"Rua de Caires",36,36,0,37,37,0
10,13,2018,8,0,7,"Braga",4,"N14 Bosch",47,47,0,48,48,0
10,13,2018,8,0,7,"Braga",5,"Avenida João Paulo II",39,39,0,9,9,0
10,13,2018,8,0,7,"Braga",6,"Avenida Padre Júlio Fragata",67,67,0,83,83,0
10,13,2018,8,0,7,"Braga",7,"Rua Nova Santa Cruz",44,44,0,39,39,0
10,13,2018,8,0,7,"Braga",8,"Rua Costa Gomes",0,41,41,-1,42,-43
10,13,2018,9,0,7,"Braga",1,"Avenida da Liberdade",25,25,0,124,124,0
10,13,2018,9,0,7,"Braga",2,"Avenida Central",25,25,0,124,124,0
10,13,2018,9,0,7,"Braga",3,"Rua de Caires",36,36,0,37,37,0
10,13,2018,9,0,7,"Braga",4,"N14 Bosch",47,47,0,48,48,0
10,13,2018,9,0,7,"Braga",5,"Avenida João Paulo II",39,39,0,9,9,0
10,13,2018,9,0,7,"Braga",6,"Avenida Padre Júlio Fragata",67,67,0,83,83,0
10,13,2018,9,0,7,"Braga",7,"Rua Nova Santa Cruz",44,44,0,39,39,0
10,13,2018,9,0,7,"Braga",8,"Rua Costa Gomes",0,41,41,-1,42,-43
10,13,2018,10,0,7,"Braga",1,"Avenida da Liberdade",25,25,0,124,124,0
10,13,2018,10,0,7,"Braga",2,"Avenida Central",25,25,0,124,124,0
10,13,2018,10,0,7,"Braga",3,"Rua de Caires",28,36,8,48,37,11
10,13,2018,10,0,7,"Braga",4,"N14 Bosch",47,47,0,48,48,0
10,13,2018,10,0,7,"Braga",5,"Avenida João Paulo II",29,39,10,12,9,3
10,13,2018,10,0,7,"Braga",6,"Avenida Padre Júlio Fragata",67,67,0,83,83,0
10,13,2018,10,0,7,"Braga",7,"Rua Nova Santa Cruz",44,44,0,39,39,0
10,13,2018,10,0,7,"Braga",8,"Rua Costa Gomes",0,41,41,-1,42,-43
10,13,2018,11,0,7,"Braga",1,"Avenida da Liberdade",25,25,0,124,124,0
10,13,2018,11,0,7,"Braga",2,"Avenida Central",25,25,0,124,124,0
10,13,2018,11,0,7,"Braga",3,"Rua de Caires",12,36,24,112,37,75
10,13,2018,11,0,7,"Braga",4,"N14 Bosch",28,47,19,80,48,32
10,13,2018,11,0,7,"Braga",5,"Avenida João Paulo II",39,39,0,9,9,0
10,13,2018,11,0,7,"Braga",6,"Avenida Padre Júlio Fragata",67,67,0,83,83,0
10,13,2018,11,0,7,"Braga",7,"Rua Nova Santa Cruz",44,44,0,39,39,0
10,13,2018,11,0,7,"Braga",8,"Rua Costa Gomes",0,41,41,-1,42,-43
10,13,2018,12,0,7,"Braga",1,"Avenida da Liberdade",25,25,0,124,124,0
10,13,2018,12,0,7,"Braga",2,"Avenida Central",25,25,0,124,124,0
10,13,2018,12,0,7,"Braga",3,"Rua de Caires",36,36,0,37,37,0
10,13,2018,12,0,7,"Braga",4,"N14 Bosch",47,47,0,48,48,0
10,13,2018,12,0,7,"Braga",5,"Avenida João Paulo II",39,39,0,9,9,0
10,13,2018,12,0,7,"Braga",6,"Avenida Padre Júlio Fragata",67,67,0,83,83,0
10,13,2018,12,0,7,"Braga",7,"Rua Nova Santa Cruz",44,44,0,39,39,0
10,13,2018,12,0,7,"Braga",8,"Rua Costa Gomes",0,41,41,-1,42,-43
10,13,2018,13,0,7,"Braga",1,"Avenida da Liberdade",25,25,0,124,124,0
10,13,2018,13,0,7,"Braga",2,"Avenida Central",25,25,0,124,124,0
10,13,2018,13,0,7,"Braga",3,"Rua de Caires",24,36,12,56,37,19
10,13,2018,13,0,7,"Braga",4,"N14 Bosch",47,47,0,48,48,0
10,13,2018,13,0,7,"Braga",5,"Avenida João Paulo II",39,39,0,9,9,0
10,13,2018,13,0,7,"Braga",6,"Avenida Padre Júlio Fragata",67,67,0,83,83,0
10,13,2018,13,0,7,"Braga",7,"Rua Nova Santa Cruz",44,44,0,39,39,0
10,13,2018,13,0,7,"Braga",8,"Rua Costa Gomes",0,41,41,-1,42,-43
10,13,2018,14,0,7,"Braga",1,"Avenida da Liberdade",25,25,0,124,124,0
10,13,2018,14,0,7,"Braga",2,"Avenida Central",25,25,0,124,124,0
10,13,2018,14,0,7,"Braga",3,"Rua de Caires",36,36,0,37,37,0
10,13,2018,14,0,7,"Braga",4,"N14 Bosch",47,47,0,48,48,0
10,13,2018,14,0,7,"Braga",5,"Avenida João Paulo II",15,39,24,23,9,14
10,13,2018,14,0,7,"Braga",6,"Avenida Padre Júlio Fragata",67,67,0,83,83,0
10,13,2018,14,0,7,"Braga",7,"Rua Nova Santa Cruz",44,44,0,39,39,0
10,13,2018,14,0,7,"Braga",8,"Rua Costa Gomes",0,41,41,-1,42,-43
10,13,2018,15,0,7,"Braga",1,"Avenida da Liberdade",18,25,7,172,124,48
10,13,2018,15,0,7,"Braga",2,"Avenida Central",25,25,0,124,124,0
10,13,2018,15,0,7,"Braga",3,"Rua de Caires",27,36,9,50,37,13
10,13,2018,15,0,7,"Braga",4,"N14 Bosch",37,47,10,61,48,13
10,13,2018,15,0,7,"Braga",5,"Avenida João Paulo II",6,39,33,58,9,49
10,13,2018,15,0,7,"Braga",6,"Avenida Padre Júlio Fragata",67,67,0,83,83,0
10,13,2018,15,0,7,"Braga",7,"Rua Nova Santa Cruz",44,44,0,39,39,0
10,13,2018,15,0,7,"Braga",8,"Rua Costa Gomes",0,41,41,-1,42,-43
10,13,2018,16,0,7,"Braga",1,"Avenida da Liberdade",18,25,7,172,124,48
10,13,2018,16,0,7,"Braga",2,"Avenida Central",18,25,7,172,124,48
10,13,2018,16,0,7,"Braga",3,"Rua de Caires",36,36,0,37,37,0
10,13,2018,16,0,7,"Braga",4,"N14 Bosch",47,47,0,48,48,0
10,13,2018,16,0,7,"Braga",5,"Avenida João Paulo II",10,39,29,35,9,26
10,13,2018,16,0,7,"Braga",6,"Avenida Padre Júlio Fragata",67,67,0,83,83,0
10,13,2018,16,0,7,"Braga",7,"Rua Nova Santa Cruz",44,44,0,39,39,0
10,13,2018,16,0,7,"Braga",8,"Rua Costa Gomes",0,41,41,-1,42,-43
10,13,2018,17,0,7,"Braga",1,"Avenida da Liberdade",25,25,0,124,124,0
10,13,2018,17,0,7,"Braga",2,"Avenida Central",25,25,0,124,124,0
10,13,2018,17,0,7,"Braga",3,"Rua de Caires",27,36,9,50,37,13
10,13,2018,17,0,7,"Braga",4,"N14 Bosch",36,47,11,62,48,14
10,13,2018,17,0,7,"Braga",5,"Avenida João Paulo II",39,39,0,9,9,0
10,13,2018,17,0,7,"Braga",6,"Avenida Padre Júlio Fragata",67,67,0,83,83,0
10,13,2018,17,0,7,"Braga",7,"Rua Nova Santa Cruz",44,44,0,39,39,0
10,13,2018,17,0,7,"Braga",8,"Rua Costa Gomes",0,41,41,-1,42,-43
10,13,2018,18,0,7,"Braga",1,"Avenida da Liberdade",25,25,0,124,124,0
10,13,2018,18,0,7,"Braga",2,"Avenida Central",25,25,0,124,124,0
10,13,2018,18,0,7,"Braga",3,"Rua de Caires",25,36,11,54,37,17
10,13,2018,18,0,7,"Braga",4,"N14 Bosch",47,47,0,48,48,0
10,13,2018,18,0,7,"Braga",5,"Avenida João Paulo II",39,39,0,9,9,0
10,13,2018,18,0,7,"Braga",6,"Avenida Padre Júlio Fragata",50,67,17,111,83,28
10,13,2018,18,0,7,"Braga",7,"Rua Nova Santa Cruz",44,44,0,39,39,0
10,13,2018,18,0,7,"Braga",8,"Rua Costa Gomes",0,41,41,-1,42,-43
10,13,2018,19,0,7,"Braga",1,"Avenida da Liberdade",25,25,0,124,124,0
10,13,2018,19,0,7,"Braga",2,"Avenida Central",25,25,0,124,124,0
10,13,2018,19,0,7,"Braga",3,"Rua de Caires",27,36,9,50,37,13
10,13,2018,19,0,7,"Braga",4,"N14 Bosch",47,47,0,48,48,0
10,13,2018,19,0,7,"Braga",5,"Avenida João Paulo II",39,39,0,9,9,0
10,13,2018,19,0,7,"Braga",6,"Avenida Padre Júlio Fragata",67,67,0,83,83,0
10,13,2018,19,0,7,"Braga",7,"Rua Nova Santa Cruz",44,44,0,39,39,0
10,13,2018,19,0,7,"Braga",8,"Rua Costa Gomes",0,41,41,-1,42,-43
10,13,2018,20,0,7,"Braga",1,"Avenida da Liberdade",25,25,0,124,124,0
10,13,2018,20,0,7,"Braga",2,"Avenida Central",25,25,0,124,124,0
10,13,2018,20,0,7,"Braga",3,"Rua de Caires",36,36,0,37,37,0
10,13,2018,20,0,7,"Braga",4,"N14 Bosch",47,47,0,48,48,0
10,13,2018,20,0,7,"Braga",5,"Avenida João Paulo II",39,39,0,9,9,0
10,13,2018,20,0,7,"Braga",6,"Avenida Padre Júlio Fragata",67,67,0,83,83,0
10,13,2018,20,0,7,"Braga",7,"Rua Nova Santa Cruz",44,44,0,39,39,0
10,13,2018,20,0,7,"Braga",8,"Rua Costa Gomes",0,41,41,-1,42,-43
10,13,2018,21,0,7,"Braga",1,"Avenida da Liberdade",25,25,0,124,124,0
10,13,2018,21,0,7,"Braga",2,"Avenida Central",25,25,0,124,124,0
10,13,2018,21,0,7,"Braga",3,"Rua de Caires",36,36,0,37,37,0
10,13,2018,21,0,7,"Braga",4,"N14 Bosch",34,47,13,66,48,18
10,13,2018,21,0,7,"Braga",5,"Avenida João Paulo II",39,39,0,9,9,0
10,13,2018,21,0,7,"Braga",6,"Avenida Padre Júlio Fragata",47,67,20,119,83,36
10,13,2018,21,0,7,"Braga",7,"Rua Nova Santa Cruz",44,44,0,39,39,0
10,13,2018,21,0,7,"Braga",8,"Rua Costa Gomes",0,41,41,-1,42,-43
10,13,2018,22,0,7,"Braga",1,"Avenida da Liberdade",25,25,0,124,124,0
10,13,2018,22,0,7,"Braga",2,"Avenida Central",25,25,0,124,124,0
10,13,2018,22,0,7,"Braga",3,"Rua de Caires",36,36,0,37,37,0
10,13,2018,22,0,7,"Braga",4,"N14 Bosch",47,47,0,48,48,0
10,13,2018,22,0,7,"Braga",5,"Avenida João Paulo II",39,39,0,9,9,0
10,13,2018,22,0,7,"Braga",6,"Avenida Padre Júlio Fragata",48,67,19,116,83,33
10,13,2018,22,0,7,"Braga",7,"Rua Nova Santa Cruz",44,44,0,39,39,0
10,13,2018,22,0,7,"Braga",8,"Rua Costa Gomes",0,41,41,-1,42,-43
10,13,2018,23,0,7,"Braga",1,"Avenida da Liberdade",25,25,0,124,124,0
10,13,2018,23,0,7,"Braga",2,"Avenida Central",25,25,0,124,124,0
10,13,2018,23,0,7,"Braga",3,"Rua de Caires",36,36,0,37,37,0
10,13,2018,23,0,7,"Braga",4,"N14 Bosch",47,47,0,48,48,0
10,13,2018,23,0,7,"Braga",5,"Avenida João Paulo II",39,39,0,9,9,0
10,13,2018,23,0,7,"Braga",6,"Avenida Padre Júlio Fragata",49,67,18,114,83,31
10,13,2018,23,0,7,"Braga",7,"Rua Nova Santa Cruz",44,44,0,39,39,0
10,13,2018,23,0,7,"Braga",8,"Rua Costa Gomes",0,41,41,-1,42,-43
10,14,2018,0,0,8,"Braga",1,"Avenida da Liberdade",25,25,0,124,124,0
10,14,2018,0,0,8,"Braga",2,"Avenida Central",25,25,0,124,124,0
10,14,2018,0,0,8,"Braga",3,"Rua de Caires",36,36,0,37,37,0
10,14,2018,0,0,8,"Braga",4,"N14 Bosch",47,47,0,48,48,0
10,14,2018,0,0,8,"Braga",5,"Avenida João Paulo II",39,39,0,9,9,0
10,14,2018,0,0,8,"Braga",6,"Avenida Padre Júlio Fragata",67,67,0,83,83,0
10,14,2018,0,0,8,"Braga",7,"Rua Nova Santa Cruz",44,44,0,39,39,0
10,14,2018,0,0,8,"Braga",8,"Rua Costa Gomes",0,41,41,-1,42,-43
10,14,2018,1,0,8,"Braga",1,"Avenida da Liberdade",25,25,0,124,124,0
10,14,2018,1,0,8,"Braga",2,"Avenida Central",25,25,0,124,124,0
10,14,2018,1,0,8,"Braga",3,"Rua de Caires",36,36,0,37,37,0
10,14,2018,1,0,8,"Braga",4,"N14 Bosch",47,47,0,48,48,0
10,14,2018,1,0,8,"Braga",5,"Avenida João Paulo II",39,39,0,9,9,0
10,14,2018,1,0,8,"Braga",6,"Avenida Padre Júlio Fragata",67,67,0,83,83,0
10,14,2018,1,0,8,"Braga",7,"Rua Nova Santa Cruz",44,44,0,39,39,0
10,14,2018,1,0,8,"Braga",8,"Rua Costa Gomes",0,41,41,-1,42,-43
10,14,2018,2,0,8,"Braga",1,"Avenida da Liberdade",25,25,0,124,124,0
10,14,2018,2,0,8,"Braga",2,"Avenida Central",25,25,0,124,124,0
10,14,2018,2,0,8,"Braga",3,"Rua de Caires",36,36,0,37,37,0
10,14,2018,2,0,8,"Braga",4,"N14 Bosch",47,47,0,48,48,0
10,14,2018,2,0,8,"Braga",5,"Avenida João Paulo II",39,39,0,9,9,0
10,14,2018,2,0,8,"Braga",6,"Avenida Padre Júlio Fragata",67,67,0,83,83,0
10,14,2018,2,0,8,"Braga",7,"Rua Nova Santa Cruz",44,44,0,39,39,0
10,14,2018,2,0,8,"Braga",8,"Rua Costa Gomes",0,41,41,-1,42,-43
10,14,2018,3,0,8,"Braga",1,"Avenida da Liberdade",25,25,0,124,124,0
10,14,2018,3,0,8,"Braga",2,"Avenida Central",25,25,0,124,124,0
10,14,2018,3,0,8,"Braga",3,"Rua de Caires",36,36,0,37,37,0
10,14,2018,3,0,8,"Braga",4,"N14 Bosch",47,47,0,48,48,0
10,14,2018,3,0,8,"Braga",5,"Avenida João Paulo II",39,39,0,9,9,0
10,14,2018,3,0,8,"Braga",6,"Avenida Padre Júlio Fragata",67,67,0,83,83,0
10,14,2018,3,0,8,"Braga",7,"Rua Nova Santa Cruz",44,44,0,39,39,0
10,14,2018,3,0,8,"Braga",8,"Rua Costa Gomes",0,41,41,-1,42,-43
10,14,2018,4,0,8,"Braga",1,"Avenida da Liberdade",25,25,0,124,124,0
10,14,2018,4,0,8,"Braga",2,"Avenida Central",25,25,0,124,124,0
10,14,2018,4,0,8,"Braga",3,"Rua de Caires",36,36,0,37,37,0
10,14,2018,4,0,8,"Braga",4,"N14 Bosch",47,47,0,48,48,0
10,14,2018,4,0,8,"Braga",5,"Avenida João Paulo II",39,39,0,9,9,0
10,14,2018,4,0,8,"Braga",6,"Avenida Padre Júlio Fragata",67,67,0,83,83,0
10,14,2018,4,0,8,"Braga",7,"Rua Nova Santa Cruz",44,44,0,39,39,0
10,14,2018,4,0,8,"Braga",8,"Rua Costa Gomes",0,41,41,-1,42,-43
10,14,2018,5,0,8,"Braga",1,"Avenida da Liberdade",25,25,0,124,124,0
10,14,2018,5,0,8,"Braga",2,"Avenida Central",25,25,0,124,124,0
10,14,2018,5,0,8,"Braga",3,"Rua de Caires",36,36,0,37,37,0
10,14,2018,5,0,8,"Braga",4,"N14 Bosch",47,47,0,48,48,0
10,14,2018,5,0,8,"Braga",5,"Avenida João Paulo II",39,39,0,9,9,0
10,14,2018,5,0,8,"Braga",6,"Avenida Padre Júlio Fragata",67,67,0,83,83,0
10,14,2018,5,0,8,"Braga",7,"Rua Nova Santa Cruz",44,44,0,39,39,0
10,14,2018,5,0,8,"Braga",8,"Rua Costa Gomes",0,41,41,-1,42,-43
10,14,2018,6,0,8,"Braga",1,"Avenida da Liberdade",25,25,0,124,124,0
10,14,2018,6,0,8,"Braga",2,"Avenida Central",25,25,0,124,124,0
10,14,2018,6,0,8,"Braga",3,"Rua de Caires",36,36,0,37,37,0
10,14,2018,6,0,8,"Braga",4,"N14 Bosch",47,47,0,48,48,0
10,14,2018,6,0,8,"Braga",5,"Avenida João Paulo II",39,39,0,9,9,0
10,14,2018,6,0,8,"Braga",6,"Avenida Padre Júlio Fragata",67,67,0,83,83,0
10,14,2018,6,0,8,"Braga",7,"Rua Nova Santa Cruz",44,44,0,39,39,0
10,14,2018,6,0,8,"Braga",8,"Rua Costa Gomes",0,41,41,-1,42,-43
10,14,2018,7,0,8,"Braga",1,"Avenida da Liberdade",25,25,0,124,124,0
10,14,2018,7,0,8,"Braga",2,"Avenida Central",25,25,0,124,124,0
10,14,2018,7,0,8,"Braga",3,"Rua de Caires",36,36,0,37,37,0
10,14,2018,7,0,8,"Braga",4,"N14 Bosch",47,47,0,48,48,0
10,14,2018,7,0,8,"Braga",5,"Avenida João Paulo II",39,39,0,9,9,0
10,14,2018,7,0,8,"Braga",6,"Avenida Padre Júlio Fragata",67,67,0,83,83,0
10,14,2018,7,0,8,"Braga",7,"Rua Nova Santa Cruz",44,44,0,39,39,0
10,14,2018,7,0,8,"Braga",8,"Rua Costa Gomes",0,41,41,-1,42,-43
10,14,2018,8,0,8,"Braga",1,"Avenida da Liberdade",25,25,0,124,124,0
10,14,2018,8,0,8,"Braga",2,"Avenida Central",25,25,0,124,124,0
10,14,2018,8,0,8,"Braga",3,"Rua de Caires",28,36,8,48,37,11
10,14,2018,8,0,8,"Braga",4,"N14 Bosch",47,47,0,48,48,0
10,14,2018,8,0,8,"Braga",5,"Avenida João Paulo II",39,39,0,9,9,0
10,14,2018,8,0,8,"Braga",6,"Avenida Padre Júlio Fragata",67,67,0,83,83,0
10,14,2018,8,0,8,"Braga",7,"Rua Nova Santa Cruz",44,44,0,39,39,0
10,14,2018,8,0,8,"Braga",8,"Rua Costa Gomes",0,41,41,-1,42,-43
10,14,2018,9,0,8,"Braga",1,"Avenida da Liberdade",25,25,0,124,124,0
10,14,2018,9,0,8,"Braga",2,"Avenida Central",25,25,0,124,124,0
10,14,2018,9,0,8,"Braga",3,"Rua de Caires",36,36,0,37,37,0
10,14,2018,9,0,8,"Braga",4,"N14 Bosch",47,47,0,48,48,0
10,14,2018,9,0,8,"Braga",5,"Avenida João Paulo II",39,39,0,9,9,0
10,14,2018,9,0,8,"Braga",6,"Avenida Padre Júlio Fragata",67,67,0,83,83,0
10,14,2018,9,0,8,"Braga",7,"Rua Nova Santa Cruz",44,44,0,39,39,0
10,14,2018,9,0,8,"Braga",8,"Rua Costa Gomes",0,41,41,-1,42,-43
10,14,2018,10,0,8,"Braga",1,"Avenida da Liberdade",25,25,0,124,124,0
10,14,2018,10,0,8,"Braga",2,"Avenida Central",25,25,0,124,124,0
10,14,2018,10,0,8,"Braga",3,"Rua de Caires",26,36,10,52,37,15
10,14,2018,10,0,8,"Braga",4,"N14 Bosch",47,47,0,48,48,0
10,14,2018,10,0,8,"Braga",5,"Avenida João Paulo II",39,39,0,9,9,0
10,14,2018,10,0,8,"Braga",6,"Avenida Padre Júlio Fragata",67,67,0,83,83,0
10,14,2018,10,0,8,"Braga",7,"Rua Nova Santa Cruz",44,44,0,39,39,0
10,14,2018,10,0,8,"Braga",8,"Rua Costa Gomes",0,41,41,-1,42,-43
10,14,2018,11,0,8,"Braga",1,"Avenida da Liberdade",25,25,0,124,124,0
10,14,2018,11,0,8,"Braga",2,"Avenida Central",25,25,0,124,124,0
10,14,2018,11,0,8,"Braga",3,"Rua de Caires",36,36,0,37,37,0
10,14,2018,11,0,8,"Braga",4,"N14 Bosch",47,47,0,48,48,0
10,14,2018,11,0,8,"Braga",5,"Avenida João Paulo II",39,39,0,9,9,0
10,14,2018,11,0,8,"Braga",6,"Avenida Padre Júlio Fragata",67,67,0,83,83,0
10,14,2018,11,0,8,"Braga",7,"Rua Nova Santa Cruz",44,44,0,39,39,0
10,14,2018,11,0,8,"Braga",8,"Rua Costa Gomes",0,41,41,-1,42,-43
10,14,2018,12,0,8,"Braga",1,"Avenida da Liberdade",18,25,7,172,124,48
10,14,2018,12,0,8,"Braga",2,"Avenida Central",18,25,7,172,124,48
10,14,2018,12,0,8,"Braga",3,"Rua de Caires",8,36,28,168,37,131
10,14,2018,12,0,8,"Braga",4,"N14 Bosch",47,47,0,48,48,0
10,14,2018,12,0,8,"Braga",5,"Avenida João Paulo II",39,39,0,9,9,0
10,14,2018,12,0,8,"Braga",6,"Avenida Padre Júlio Fragata",67,67,0,83,83,0
10,14,2018,12,0,8,"Braga",7,"Rua Nova Santa Cruz",44,44,0,39,39,0
10,14,2018,12,0,8,"Braga",8,"Rua Costa Gomes",0,41,41,-1,42,-43
10,14,2018,13,0,8,"Braga",1,"Avenida da Liberdade",25,25,0,124,124,0
10,14,2018,13,0,8,"Braga",2,"Avenida Central",25,25,0,124,124,0
10,14,2018,13,0,8,"Braga",3,"Rua de Caires",27,36,9,50,37,13
10,14,2018,13,0,8,"Braga",4,"N14 Bosch",47,47,0,48,48,0
10,14,2018,13,0,8,"Braga",5,"Avenida João Paulo II",39,39,0,9,9,0
10,14,2018,13,0,8,"Braga",6,"Avenida Padre Júlio Fragata",67,67,0,83,83,0
10,14,2018,13,0,8,"Braga",7,"Rua Nova Santa Cruz",44,44,0,39,39,0
10,14,2018,13,0,8,"Braga",8,"Rua Costa Gomes",0,41,41,-1,42,-43
10,14,2018,14,0,8,"Braga",1,"Avenida da Liberdade",25,25,0,124,124,0
10,14,2018,14,0,8,"Braga",2,"Avenida Central",25,25,0,124,124,0
10,14,2018,14,0,8,"Braga",3,"Rua de Caires",36,36,0,37,37,0
10,14,2018,14,0,8,"Braga",4,"N14 Bosch",47,47,0,48,48,0
10,14,2018,14,0,8,"Braga",5,"Avenida João Paulo II",3,39,36,116,9,107
10,14,2018,14,0,8,"Braga",6,"Avenida Padre Júlio Fragata",50,67,17,111,83,28
10,14,2018,14,0,8,"Braga",7,"Rua Nova Santa Cruz",44,44,0,39,39,0
10,14,2018,14,0,8,"Braga",8,"Rua Costa Gomes",0,41,41,-1,42,-43
10,14,2018,15,0,8,"Braga",1,"Avenida da Liberdade",25,25,0,124,124,0
10,14,2018,15,0,8,"Braga",2,"Avenida Central",25,25,0,124,124,0
10,14,2018,15,0,8,"Braga",3,"Rua de Caires",36,36,0,37,37,0
10,14,2018,15,0,8,"Braga",4,"N14 Bosch",47,47,0,48,48,0
10,14,2018,15,0,8,"Braga",5,"Avenida João Paulo II",3,39,36,116,9,107
10,14,2018,15,0,8,"Braga",6,"Avenida Padre Júlio Fragata",45,67,22,124,83,41
10,14,2018,15,0,8,"Braga",7,"Rua Nova Santa Cruz",44,44,0,39,39,0
10,14,2018,15,0,8,"Braga",8,"Rua Costa Gomes",0,41,41,-1,42,-43
10,14,2018,16,0,8,"Braga",1,"Avenida da Liberdade",25,25,0,124,124,0
10,14,2018,16,0,8,"Braga",2,"Avenida Central",25,25,0,124,124,0
10,14,2018,16,0,8,"Braga",3,"Rua de Caires",36,36,0,37,37,0
10,14,2018,16,0,8,"Braga",4,"N14 Bosch",36,47,11,62,48,14
10,14,2018,16,0,8,"Braga",5,"Avenida João Paulo II",7,39,32,50,9,41
10,14,2018,16,0,8,"Braga",6,"Avenida Padre Júlio Fragata",51,67,16,109,83,26
10,14,2018,16,0,8,"Braga",7,"Rua Nova Santa Cruz",44,44,0,39,39,0
10,14,2018,16,0,8,"Braga",8,"Rua Costa Gomes",0,41,41,-1,42,-43
10,14,2018,17,0,8,"Braga",1,"Avenida da Liberdade",19,25,6,163,124,39
10,14,2018,17,0,8,"Braga",2,"Avenida Central",25,25,0,124,124,0
10,14,2018,17,0,8,"Braga",3,"Rua de Caires",36,36,0,37,37,0
10,14,2018,17,0,8,"Braga",4,"N14 Bosch",47,47,0,48,48,0
10,14,2018,17,0,8,"Braga",5,"Avenida João Paulo II",13,39,26,27,9,18
10,14,2018,17,0,8,"Braga",6,"Avenida Padre Júlio Fragata",67,67,0,83,83,0
10,14,2018,17,0,8,"Braga",7,"Rua Nova Santa Cruz",44,44,0,39,39,0
10,14,2018,17,0,8,"Braga",8,"Rua Costa Gomes",0,41,41,-1,42,-43
10,14,2018,18,0,8,"Braga",1,"Avenida da Liberdade",25,25,0,124,124,0
10,14,2018,18,0,8,"Braga",2,"Avenida Central",25,25,0,124,124,0
10,14,2018,18,0,8,"Braga",3,"Rua de Caires",36,36,0,37,37,0
10,14,2018,18,0,8,"Braga",4,"N14 Bosch",47,47,0,48,48,0
10,14,2018,18,0,8,"Braga",5,"Avenida João Paulo II",4,39,35,87,9,78
10,14,2018,18,0,8,"Braga",6,"Avenida Padre Júlio Fragata",42,67,25,133,83,50
10,14,2018,18,0,8,"Braga",7,"Rua Nova Santa Cruz",44,44,0,39,39,0
10,14,2018,18,0,8,"Braga",8,"Rua Costa Gomes",0,41,41,-1,42,-43
10,14,2018,19,0,8,"Braga",1,"Avenida da Liberdade",25,25,0,124,124,0
10,14,2018,19,0,8,"Braga",2,"Avenida Central",25,25,0,124,124,0
10,14,2018,19,0,8,"Braga",3,"Rua de Caires",36,36,0,37,37,0
10,14,2018,19,0,8,"Braga",4,"N14 Bosch",47,47,0,48,48,0
10,14,2018,19,0,8,"Braga",5,"Avenida João Paulo II",39,39,0,9,9,0
10,14,2018,19,0,8,"Braga",6,"Avenida Padre Júlio Fragata",67,67,0,83,83,0
10,14,2018,19,0,8,"Braga",7,"Rua Nova Santa Cruz",44,44,0,39,39,0
10,14,2018,19,0,8,"Braga",8,"Rua Costa Gomes",0,41,41,-1,42,-43
10,14,2018,20,0,8,"Braga",1,"Avenida da Liberdade",25,25,0,124,124,0
10,14,2018,20,0,8,"Braga",2,"Avenida Central",25,25,0,124,124,0
10,14,2018,20,0,8,"Braga",3,"Rua de Caires",36,36,0,37,37,0
10,14,2018,20,0,8,"Braga",4,"N14 Bosch",47,47,0,48,48,0
10,14,2018,20,0,8,"Braga",5,"Avenida João Paulo II",39,39,0,9,9,0
10,14,2018,20,0,8,"Braga",6,"Avenida Padre Júlio Fragata",67,67,0,83,83,0
10,14,2018,20,0,8,"Braga",7,"Rua Nova Santa Cruz",44,44,0,39,39,0
10,14,2018,20,0,8,"Braga",8,"Rua Costa Gomes",0,41,41,-1,42,-43
10,14,2018,21,0,8,"Braga",1,"Avenida da Liberdade",25,25,0,124,124,0
10,14,2018,21,0,8,"Braga",2,"Avenida Central",25,25,0,124,124,0
10,14,2018,21,0,8,"Braga",3,"Rua de Caires",36,36,0,37,37,0
10,14,2018,21,0,8,"Braga",4,"N14 Bosch",47,47,0,48,48,0
10,14,2018,21,0,8,"Braga",5,"Avenida João Paulo II",39,39,0,9,9,0
10,14,2018,21,0,8,"Braga",6,"Avenida Padre Júlio Fragata",67,67,0,83,83,0
10,14,2018,21,0,8,"Braga",7,"Rua Nova Santa Cruz",44,44,0,39,39,0
10,14,2018,21,0,8,"Braga",8,"Rua Costa Gomes",0,41,41,-1,42,-43
10,14,2018,22,0,8,"Braga",1,"Avenida da Liberdade",25,25,0,124,124,0
10,14,2018,22,0,8,"Braga",2,"Avenida Central",25,25,0,124,124,0
10,14,2018,22,0,8,"Braga",3,"Rua de Caires",36,36,0,37,37,0
10,14,2018,22,0,8,"Braga",4,"N14 Bosch",47,47,0,48,48,0
10,14,2018,22,0,8,"Braga",5,"Avenida João Paulo II",39,39,0,9,9,0
10,14,2018,22,0,8,"Braga",6,"Avenida Padre Júlio Fragata",67,67,0,83,83,0
10,14,2018,22,0,8,"Braga",7,"Rua Nova Santa Cruz",44,44,0,39,39,0
10,14,2018,22,0,8,"Braga",8,"Rua Costa Gomes",0,41,41,-1,42,-43
10,14,2018,23,0,8,"Braga",1,"Avenida da Liberdade",25,25,0,124,124,0
10,14,2018,23,0,8,"Braga",2,"Avenida Central",25,25,0,124,124,0
10,14,2018,23,0,8,"Braga",3,"Rua de Caires",36,36,0,37,37,0
10,14,2018,23,0,8,"Braga",4,"N14 Bosch",47,47,0,48,48,0
10,14,2018,23,0,8,"Braga",5,"Avenida João Paulo II",39,39,0,9,9,0
10,14,2018,23,0,8,"Braga",6,"Avenida Padre Júlio Fragata",67,67,0,83,83,0
10,14,2018,23,0,8,"Braga",7,"Rua Nova Santa Cruz",44,44,0,39,39,0
10,14,2018,23,0,8,"Braga",8,"Rua Costa Gomes",0,41,41,-1,42,-43
10,15,2018,0,0,2,"Braga",1,"Avenida da Liberdade",25,25,0,124,124,0
10,15,2018,0,0,2,"Braga",2,"Avenida Central",25,25,0,124,124,0
10,15,2018,0,0,2,"Braga",3,"Rua de Caires",36,36,0,37,37,0
10,15,2018,0,0,2,"Braga",4,"N14 Bosch",47,47,0,48,48,0
10,15,2018,0,0,2,"Braga",5,"Avenida João Paulo II",39,39,0,9,9,0
10,15,2018,0,0,2,"Braga",6,"Avenida Padre Júlio Fragata",67,67,0,83,83,0
10,15,2018,0,0,2,"Braga",7,"Rua Nova Santa Cruz",44,44,0,39,39,0
10,15,2018,0,0,2,"Braga",8,"Rua Costa Gomes",0,41,41,-1,42,-43
10,15,2018,1,0,2,"Braga",1,"Avenida da Liberdade",25,25,0,124,124,0
10,15,2018,1,0,2,"Braga",2,"Avenida Central",25,25,0,124,124,0
10,15,2018,1,0,2,"Braga",3,"Rua de Caires",36,36,0,37,37,0
10,15,2018,1,0,2,"Braga",4,"N14 Bosch",47,47,0,48,48,0
10,15,2018,1,0,2,"Braga",5,"Avenida João Paulo II",39,39,0,9,9,0
10,15,2018,1,0,2,"Braga",6,"Avenida Padre Júlio Fragata",67,67,0,83,83,0
10,15,2018,1,0,2,"Braga",7,"Rua Nova Santa Cruz",44,44,0,39,39,0
10,15,2018,1,0,2,"Braga",8,"Rua Costa Gomes",0,41,41,-1,42,-43
10,15,2018,2,0,2,"Braga",1,"Avenida da Liberdade",25,25,0,124,124,0
10,15,2018,2,0,2,"Braga",2,"Avenida Central",25,25,0,124,124,0
10,15,2018,2,0,2,"Braga",3,"Rua de Caires",36,36,0,37,37,0
10,15,2018,2,0,2,"Braga",4,"N14 Bosch",47,47,0,48,48,0
10,15,2018,2,0,2,"Braga",5,"Avenida João Paulo II",39,39,0,9,9,0
10,15,2018,2,0,2,"Braga",6,"Avenida Padre Júlio Fragata",67,67,0,83,83,0
10,15,2018,2,0,2,"Braga",7,"Rua Nova Santa Cruz",44,44,0,39,39,0
10,15,2018,2,0,2,"Braga",8,"Rua Costa Gomes",0,41,41,-1,42,-43
10,15,2018,3,0,2,"Braga",1,"Avenida da Liberdade",25,25,0,124,124,0
10,15,2018,3,0,2,"Braga",2,"Avenida Central",25,25,0,124,124,0
10,15,2018,3,0,2,"Braga",3,"Rua de Caires",36,36,0,37,37,0
10,15,2018,3,0,2,"Braga",4,"N14 Bosch",47,47,0,48,48,0
10,15,2018,3,0,2,"Braga",5,"Avenida João Paulo II",39,39,0,9,9,0
10,15,2018,3,0,2,"Braga",6,"Avenida Padre Júlio Fragata",67,67,0,83,83,0
10,15,2018,3,0,2,"Braga",7,"Rua Nova Santa Cruz",44,44,0,39,39,0
10,15,2018,3,0,2,"Braga",8,"Rua Costa Gomes",0,41,41,-1,42,-43
10,15,2018,4,0,2,"Braga",1,"Avenida da Liberdade",25,25,0,124,124,0
10,15,2018,4,0,2,"Braga",2,"Avenida Central",25,25,0,124,124,0
10,15,2018,4,0,2,"Braga",3,"Rua de Caires",36,36,0,37,37,0
10,15,2018,4,0,2,"Braga",4,"N14 Bosch",47,47,0,48,48,0
10,15,2018,4,0,2,"Braga",5,"Avenida João Paulo II",39,39,0,9,9,0
10,15,2018,4,0,2,"Braga",6,"Avenida Padre Júlio Fragata",67,67,0,83,83,0
10,15,2018,4,0,2,"Braga",7,"Rua Nova Santa Cruz",44,44,0,39,39,0
10,15,2018,4,0,2,"Braga",8,"Rua Costa Gomes",0,41,41,-1,42,-43
10,15,2018,5,0,2,"Braga",1,"Avenida da Liberdade",25,25,0,124,124,0
10,15,2018,5,0,2,"Braga",2,"Avenida Central",25,25,0,124,124,0
10,15,2018,5,0,2,"Braga",3,"Rua de Caires",36,36,0,37,37,0
10,15,2018,5,0,2,"Braga",4,"N14 Bosch",47,47,0,48,48,0
10,15,2018,5,0,2,"Braga",5,"Avenida João Paulo II",39,39,0,9,9,0
10,15,2018,5,0,2,"Braga",6,"Avenida Padre Júlio Fragata",67,67,0,83,83,0
10,15,2018,5,0,2,"Braga",7,"Rua Nova Santa Cruz",44,44,0,39,39,0
10,15,2018,5,0,2,"Braga",8,"Rua Costa Gomes",0,41,41,-1,42,-43
10,15,2018,6,0,2,"Braga",1,"Avenida da Liberdade",25,25,0,124,124,0
10,15,2018,6,0,2,"Braga",2,"Avenida Central",25,25,0,124,124,0
10,15,2018,6,0,2,"Braga",3,"Rua de Caires",36,36,0,37,37,0
10,15,2018,6,0,2,"Braga",4,"N14 Bosch",47,47,0,48,48,0
10,15,2018,6,0,2,"Braga",5,"Avenida João Paulo II",39,39,0,9,9,0
10,15,2018,6,0,2,"Braga",6,"Avenida Padre Júlio Fragata",67,67,0,83,83,0
10,15,2018,6,0,2,"Braga",7,"Rua Nova Santa Cruz",44,44,0,39,39,0
10,15,2018,6,0,2,"Braga",8,"Rua Costa Gomes",0,41,41,-1,42,-43
10,15,2018,7,0,2,"Braga",1,"Avenida da Liberdade",25,25,0,124,124,0
10,15,2018,7,0,2,"Braga",2,"Avenida Central",25,25,0,124,124,0
10,15,2018,7,0,2,"Braga",3,"Rua de Caires",27,36,9,50,37,13
10,15,2018,7,0,2,"Braga",4,"N14 Bosch",35,47,12,64,48,16
10,15,2018,7,0,2,"Braga",5,"Avenida João Paulo II",39,39,0,9,9,0
10,15,2018,7,0,2,"Braga",6,"Avenida Padre Júlio Fragata",67,67,0,83,83,0
10,15,2018,7,0,2,"Braga",7,"Rua Nova Santa Cruz",33,44,11,52,39,13
10,15,2018,7,0,2,"Braga",8,"Rua Costa Gomes",0,41,41,-1,42,-43
10,15,2018,8,0,2,"Braga",1,"Avenida da Liberdade",25,25,0,124,124,0
10,15,2018,8,0,2,"Braga",2,"Avenida Central",25,25,0,124,124,0
10,15,2018,8,0,2,"Braga",3,"Rua de Caires",21,36,15,64,37,27
10,15,2018,8,0,2,"Braga",4,"N14 Bosch",24,47,23,94,48,46
10,15,2018,8,0,2,"Braga",5,"Avenida João Paulo II",39,39,0,9,9,0
10,15,2018,8,0,2,"Braga",6,"Avenida Padre Júlio Fragata",29,67,38,192,83,109
10,15,2018,8,0,2,"Braga",7,"Rua Nova Santa Cruz",1,44,43,1728,39,1689
10,15,2018,8,0,2,"Braga",8,"Rua Costa Gomes",0,41,41,-1,42,-43
10,15,2018,9,0,2,"Braga",1,"Avenida da Liberdade",25,25,0,124,124,0
10,15,2018,9,0,2,"Braga",2,"Avenida Central",25,25,0,124,124,0
10,15,2018,9,0,2,"Braga",3,"Rua de Caires",24,36,12,56,37,19
10,15,2018,9,0,2,"Braga",4,"N14 Bosch",19,47,28,118,48,70
10,15,2018,9,0,2,"Braga",5,"Avenida João Paulo II",39,39,0,9,9,0
10,15,2018,9,0,2,"Braga",6,"Avenida Padre Júlio Fragata",67,67,0,83,83,0
10,15,2018,9,0,2,"Braga",7,"Rua Nova Santa Cruz",44,44,0,39,39,0
10,15,2018,9,0,2,"Braga",8,"Rua Costa Gomes",0,41,41,-1,42,-43
10,15,2018,10,0,2,"Braga",1,"Avenida da Liberdade",25,25,0,124,124,0
10,15,2018,10,0,2,"Braga",2,"Avenida Central",25,25,0,124,124,0
10,15,2018,10,0,2,"Braga",3,"Rua de Caires",36,36,0,37,37,0
10,15,2018,10,0,2,"Braga",4,"N14 Bosch",25,47,22,90,48,42
10,15,2018,10,0,2,"Braga",5,"Avenida João Paulo II",39,39,0,9,9,0
10,15,2018,10,0,2,"Braga",6,"Avenida Padre Júlio Fragata",67,67,0,83,83,0
10,15,2018,10,0,2,"Braga",7,"Rua Nova Santa Cruz",25,44,19,69,39,30
10,15,2018,10,0,2,"Braga",8,"Rua Costa Gomes",0,41,41,-1,42,-43
10,15,2018,11,0,2,"Braga",1,"Avenida da Liberdade",25,25,0,124,124,0
10,15,2018,11,0,2,"Braga",2,"Avenida Central",25,25,0,124,124,0
10,15,2018,11,0,2,"Braga",3,"Rua de Caires",36,36,0,37,37,0
10,15,2018,11,0,2,"Braga",4,"N14 Bosch",47,47,0,48,48,0
10,15,2018,11,0,2,"Braga",5,"Avenida João Paulo II",39,39,0,9,9,0
10,15,2018,11,0,2,"Braga",6,"Avenida Padre Júlio Fragata",45,67,22,124,83,41
10,15,2018,11,0,2,"Braga",7,"Rua Nova Santa Cruz",44,44,0,39,39,0
10,15,2018,11,0,2,"Braga",8,"Rua Costa Gomes",0,41,41,-1,42,-43
10,15,2018,12,0,2,"Braga",1,"Avenida da Liberdade",25,25,0,124,124,0
10,15,2018,12,0,2,"Braga",2,"Avenida Central",25,25,0,124,124,0
10,15,2018,12,0,2,"Braga",3,"Rua de Caires",25,36,11,54,37,17
10,15,2018,12,0,2,"Braga",4,"N14 Bosch",27,47,20,83,48,35
10,15,2018,12,0,2,"Braga",5,"Avenida João Paulo II",39,39,0,9,9,0
10,15,2018,12,0,2,"Braga",6,"Avenida Padre Júlio Fragata",67,67,0,83,83,0
10,15,2018,12,0,2,"Braga",7,"Rua Nova Santa Cruz",21,44,23,82,39,43
10,15,2018,12,0,2,"Braga",8,"Rua Costa Gomes",0,41,41,-1,42,-43
10,15,2018,13,0,2,"Braga",1,"Avenida da Liberdade",25,25,0,124,124,0
10,15,2018,13,0,2,"Braga",2,"Avenida Central",25,25,0,124,124,0
10,15,2018,13,0,2,"Braga",3,"Rua de Caires",36,36,0,37,37,0
10,15,2018,13,0,2,"Braga",4,"N14 Bosch",23,47,24,98,48,50
10,15,2018,13,0,2,"Braga",5,"Avenida João Paulo II",23,39,16,15,9,6
10,15,2018,13,0,2,"Braga",6,"Avenida Padre Júlio Fragata",67,67,0,83,83,0
10,15,2018,13,0,2,"Braga",7,"Rua Nova Santa Cruz",24,44,20,72,39,33
10,15,2018,13,0,2,"Braga",8,"Rua Costa Gomes",0,41,41,-1,42,-43
10,15,2018,14,0,2,"Braga",1,"Avenida da Liberdade",25,25,0,124,124,0
10,15,2018,14,0,2,"Braga",2,"Avenida Central",25,25,0,124,124,0
10,15,2018,14,0,2,"Braga",3,"Rua de Caires",36,36,0,37,37,0
10,15,2018,14,0,2,"Braga",4,"N14 Bosch",33,47,14,68,48,20
10,15,2018,14,0,2,"Braga",5,"Avenida João Paulo II",39,39,0,9,9,0
10,15,2018,14,0,2,"Braga",6,"Avenida Padre Júlio Fragata",67,67,0,83,83,0
10,15,2018,14,0,2,"Braga",7,"Rua Nova Santa Cruz",30,44,14,58,39,19
10,15,2018,14,0,2,"Braga",8,"Rua Costa Gomes",0,41,41,-1,42,-43
10,15,2018,15,0,2,"Braga",1,"Avenida da Liberdade",25,25,0,124,124,0
10,15,2018,15,0,2,"Braga",2,"Avenida Central",25,25,0,124,124,0
10,15,2018,15,0,2,"Braga",3,"Rua de Caires",36,36,0,37,37,0
10,15,2018,15,0,2,"Braga",4,"N14 Bosch",37,47,10,61,48,13
10,15,2018,15,0,2,"Braga",5,"Avenida João Paulo II",39,39,0,9,9,0
10,15,2018,15,0,2,"Braga",6,"Avenida Padre Júlio Fragata",67,67,0,83,83,0
10,15,2018,15,0,2,"Braga",7,"Rua Nova Santa Cruz",27,44,17,64,39,25
10,15,2018,15,0,2,"Braga",8,"Rua Costa Gomes",0,41,41,-1,42,-43
10,15,2018,16,0,2,"Braga",1,"Avenida da Liberdade",18,25,7,172,124,48
10,15,2018,16,0,2,"Braga",2,"Avenida Central",18,25,7,172,124,48
10,15,2018,16,0,2,"Braga",3,"Rua de Caires",36,36,0,37,37,0
10,15,2018,16,0,2,"Braga",4,"N14 Bosch",25,47,22,90,48,42
10,15,2018,16,0,2,"Braga",5,"Avenida João Paulo II",30,39,9,12,9,3
10,15,2018,16,0,2,"Braga",6,"Avenida Padre Júlio Fragata",67,67,0,83,83,0
10,15,2018,16,0,2,"Braga",7,"Rua Nova Santa Cruz",22,44,22,79,39,40
10,15,2018,16,0,2,"Braga",8,"Rua Costa Gomes",0,41,41,-1,42,-43
10,15,2018,17,0,2,"Braga",1,"Avenida da Liberdade",9,25,16,344,124,220
10,15,2018,17,0,2,"Braga",2,"Avenida Central",8,25,17,387,124,263
10,15,2018,17,0,2,"Braga",3,"Rua de Caires",36,36,0,37,37,0
10,15,2018,17,0,2,"Braga",4,"N14 Bosch",27,47,20,83,48,35
10,15,2018,17,0,2,"Braga",5,"Avenida João Paulo II",23,39,16,15,9,6
10,15,2018,17,0,2,"Braga",6,"Avenida Padre Júlio Fragata",42,67,25,133,83,50
10,15,2018,17,0,2,"Braga",7,"Rua Nova Santa Cruz",3,44,41,576,39,537
10,15,2018,17,0,2,"Braga",8,"Rua Costa Gomes",0,41,41,-1,42,-43
10,15,2018,18,0,2,"Braga",1,"Avenida da Liberdade",7,25,18,443,124,319
10,15,2018,18,0,2,"Braga",2,"Avenida Central",7,25,18,443,124,319
10,15,2018,18,0,2,"Braga",3,"Rua de Caires",25,36,11,54,37,17
10,15,2018,18,0,2,"Braga",4,"N14 Bosch",36,47,11,62,48,14
10,15,2018,18,0,2,"Braga",5,"Avenida João Paulo II",30,39,9,12,9,3
10,15,2018,18,0,2,"Braga",6,"Avenida Padre Júlio Fragata",36,67,31,155,83,72
10,15,2018,18,0,2,"Braga",7,"Rua Nova Santa Cruz",19,44,25,91,39,52
10,15,2018,18,0,2,"Braga",8,"Rua Costa Gomes",0,41,41,-1,42,-43
10,15,2018,19,0,2,"Braga",1,"Avenida da Liberdade",25,25,0,124,124,0
10,15,2018,19,0,2,"Braga",2,"Avenida Central",25,25,0,124,124,0
10,15,2018,19,0,2,"Braga",3,"Rua de Caires",36,36,0,37,37,0
10,15,2018,19,0,2,"Braga",4,"N14 Bosch",37,47,10,61,48,13
10,15,2018,19,0,2,"Braga",5,"Avenida João Paulo II",39,39,0,9,9,0
10,15,2018,19,0,2,"Braga",6,"Avenida Padre Júlio Fragata",67,67,0,83,83,0
10,15,2018,19,0,2,"Braga",7,"Rua Nova Santa Cruz",19,44,25,91,39,52
10,15,2018,19,0,2,"Braga",8,"Rua Costa Gomes",0,41,41,-1,42,-43
10,15,2018,20,0,2,"Braga",1,"Avenida da Liberdade",25,25,0,124,124,0
10,15,2018,20,0,2,"Braga",2,"Avenida Central",25,25,0,124,124,0
10,15,2018,20,0,2,"Braga",3,"Rua de Caires",36,36,0,37,37,0
10,15,2018,20,0,2,"Braga",4,"N14 Bosch",47,47,0,48,48,0
10,15,2018,20,0,2,"Braga",5,"Avenida João Paulo II",39,39,0,9,9,0
10,15,2018,20,0,2,"Braga",6,"Avenida Padre Júlio Fragata",67,67,0,83,83,0
10,15,2018,20,0,2,"Braga",7,"Rua Nova Santa Cruz",33,44,11,52,39,13
10,15,2018,20,0,2,"Braga",8,"Rua Costa Gomes",0,41,41,-1,42,-43
10,15,2018,21,0,2,"Braga",1,"Avenida da Liberdade",25,25,0,124,124,0
10,15,2018,21,0,2,"Braga",2,"Avenida Central",25,25,0,124,124,0
10,15,2018,21,0,2,"Braga",3,"Rua de Caires",28,36,8,48,37,11
10,15,2018,21,0,2,"Braga",4,"N14 Bosch",47,47,0,48,48,0
10,15,2018,21,0,2,"Braga",5,"Avenida João Paulo II",39,39,0,9,9,0
10,15,2018,21,0,2,"Braga",6,"Avenida Padre Júlio Fragata",67,67,0,83,83,0
10,15,2018,21,0,2,"Braga",7,"Rua Nova Santa Cruz",33,44,11,52,39,13
10,15,2018,21,0,2,"Braga",8,"Rua Costa Gomes",0,41,41,-1,42,-43
10,15,2018,22,0,2,"Braga",1,"Avenida da Liberdade",25,25,0,124,124,0
10,15,2018,22,0,2,"Braga",2,"Avenida Central",25,25,0,124,124,0
10,15,2018,22,0,2,"Braga",3,"Rua de Caires",36,36,0,37,37,0
10,15,2018,22,0,2,"Braga",4,"N14 Bosch",47,47,0,48,48,0
10,15,2018,22,0,2,"Braga",5,"Avenida João Paulo II",39,39,0,9,9,0
10,15,2018,22,0,2,"Braga",6,"Avenida Padre Júlio Fragata",67,67,0,83,83,0
10,15,2018,22,0,2,"Braga",7,"Rua Nova Santa Cruz",44,44,0,39,39,0
10,15,2018,22,0,2,"Braga",8,"Rua Costa Gomes",0,41,41,-1,42,-43
10,15,2018,23,0,2,"Braga",1,"Avenida da Liberdade",25,25,0,124,124,0
10,15,2018,23,0,2,"Braga",2,"Avenida Central",25,25,0,124,124,0
10,15,2018,23,0,2,"Braga",3,"Rua de Caires",36,36,0,37,37,0
10,15,2018,23,0,2,"Braga",4,"N14 Bosch",47,47,0,48,48,0
10,15,2018,23,0,2,"Braga",5,"Avenida João Paulo II",39,39,0,9,9,0
10,15,2018,23,0,2,"Braga",6,"Avenida Padre Júlio Fragata",67,67,0,83,83,0
10,15,2018,23,0,2,"Braga",7,"Rua Nova Santa Cruz",44,44,0,39,39,0
10,15,2018,23,0,2,"Braga",8,"Rua Costa Gomes",0,41,41,-1,42,-43
10,16,2018,0,0,3,"Braga",1,"Avenida da Liberdade",25,25,0,124,124,0
10,16,2018,0,0,3,"Braga",2,"Avenida Central",25,25,0,124,124,0
10,16,2018,0,0,3,"Braga",3,"Rua de Caires",36,36,0,37,37,0
10,16,2018,0,0,3,"Braga",4,"N14 Bosch",47,47,0,48,48,0
10,16,2018,0,0,3,"Braga",5,"Avenida João Paulo II",39,39,0,9,9,0
10,16,2018,0,0,3,"Braga",6,"Avenida Padre Júlio Fragata",67,67,0,83,83,0
10,16,2018,0,0,3,"Braga",7,"Rua Nova Santa Cruz",44,44,0,39,39,0
10,16,2018,0,0,3,"Braga",8,"Rua Costa Gomes",0,41,41,-1,42,-43
10,16,2018,1,0,3,"Braga",1,"Avenida da Liberdade",25,25,0,124,124,0
10,16,2018,1,0,3,"Braga",2,"Avenida Central",25,25,0,124,124,0
10,16,2018,1,0,3,"Braga",3,"Rua de Caires",36,36,0,37,37,0
10,16,2018,1,0,3,"Braga",4,"N14 Bosch",47,47,0,48,48,0
10,16,2018,1,0,3,"Braga",5,"Avenida João Paulo II",39,39,0,9,9,0
10,16,2018,1,0,3,"Braga",6,"Avenida Padre Júlio Fragata",67,67,0,83,83,0
10,16,2018,1,0,3,"Braga",7,"Rua Nova Santa Cruz",44,44,0,39,39,0
10,16,2018,1,0,3,"Braga",8,"Rua Costa Gomes",0,41,41,-1,42,-43
10,16,2018,2,0,3,"Braga",1,"Avenida da Liberdade",25,25,0,124,124,0
10,16,2018,2,0,3,"Braga",2,"Avenida Central",25,25,0,124,124,0
10,16,2018,2,0,3,"Braga",3,"Rua de Caires",36,36,0,37,37,0
10,16,2018,2,0,3,"Braga",4,"N14 Bosch",47,47,0,48,48,0
10,16,2018,2,0,3,"Braga",5,"Avenida João Paulo II",39,39,0,9,9,0
10,16,2018,2,0,3,"Braga",6,"Avenida Padre Júlio Fragata",67,67,0,83,83,0
10,16,2018,2,0,3,"Braga",7,"Rua Nova Santa Cruz",44,44,0,39,39,0
10,16,2018,2,0,3,"Braga",8,"Rua Costa Gomes",0,41,41,-1,42,-43
10,16,2018,3,0,3,"Braga",1,"Avenida da Liberdade",25,25,0,124,124,0
10,16,2018,3,0,3,"Braga",2,"Avenida Central",25,25,0,124,124,0
10,16,2018,3,0,3,"Braga",3,"Rua de Caires",36,36,0,37,37,0
10,16,2018,3,0,3,"Braga",4,"N14 Bosch",47,47,0,48,48,0
10,16,2018,3,0,3,"Braga",5,"Avenida João Paulo II",39,39,0,9,9,0
10,16,2018,3,0,3,"Braga",6,"Avenida Padre Júlio Fragata",67,67,0,83,83,0
10,16,2018,3,0,3,"Braga",7,"Rua Nova Santa Cruz",44,44,0,39,39,0
10,16,2018,3,0,3,"Braga",8,"Rua Costa Gomes",0,41,41,-1,42,-43
10,16,2018,4,0,3,"Braga",1,"Avenida da Liberdade",25,25,0,124,124,0
10,16,2018,4,0,3,"Braga",2,"Avenida Central",25,25,0,124,124,0
10,16,2018,4,0,3,"Braga",3,"Rua de Caires",36,36,0,37,37,0
10,16,2018,4,0,3,"Braga",4,"N14 Bosch",47,47,0,48,48,0
10,16,2018,4,0,3,"Braga",5,"Avenida João Paulo II",39,39,0,9,9,0
10,16,2018,4,0,3,"Braga",6,"Avenida Padre Júlio Fragata",67,67,0,83,83,0
10,16,2018,4,0,3,"Braga",7,"Rua Nova Santa Cruz",44,44,0,39,39,0
10,16,2018,4,0,3,"Braga",8,"Rua Costa Gomes",0,41,41,-1,42,-43
10,16,2018,5,0,3,"Braga",1,"Avenida da Liberdade",25,25,0,124,124,0
10,16,2018,5,0,3,"Braga",2,"Avenida Central",25,25,0,124,124,0
10,16,2018,5,0,3,"Braga",3,"Rua de Caires",36,36,0,37,37,0
10,16,2018,5,0,3,"Braga",4,"N14 Bosch",47,47,0,48,48,0
10,16,2018,5,0,3,"Braga",5,"Avenida João Paulo II",39,39,0,9,9,0
10,16,2018,5,0,3,"Braga",6,"Avenida Padre Júlio Fragata",67,67,0,83,83,0
10,16,2018,5,0,3,"Braga",7,"Rua Nova Santa Cruz",44,44,0,39,39,0
10,16,2018,5,0,3,"Braga",8,"Rua Costa Gomes",0,41,41,-1,42,-43
10,16,2018,6,0,3,"Braga",1,"Avenida da Liberdade",25,25,0,124,124,0
10,16,2018,6,0,3,"Braga",2,"Avenida Central",25,25,0,124,124,0
10,16,2018,6,0,3,"Braga",3,"Rua de Caires",36,36,0,37,37,0
10,16,2018,6,0,3,"Braga",4,"N14 Bosch",47,47,0,48,48,0
10,16,2018,6,0,3,"Braga",5,"Avenida João Paulo II",39,39,0,9,9,0
10,16,2018,6,0,3,"Braga",6,"Avenida Padre Júlio Fragata",67,67,0,83,83,0
10,16,2018,6,0,3,"Braga",7,"Rua Nova Santa Cruz",44,44,0,39,39,0
10,16,2018,6,0,3,"Braga",8,"Rua Costa Gomes",0,41,41,-1,42,-43
10,16,2018,7,0,3,"Braga",1,"Avenida da Liberdade",19,25,6,163,124,39
10,16,2018,7,0,3,"Braga",2,"Avenida Central",19,25,6,163,124,39
10,16,2018,7,0,3,"Braga",3,"Rua de Caires",25,36,11,54,37,17
10,16,2018,7,0,3,"Braga",4,"N14 Bosch",32,47,15,70,48,22
10,16,2018,7,0,3,"Braga",5,"Avenida João Paulo II",39,39,0,9,9,0
10,16,2018,7,0,3,"Braga",6,"Avenida Padre Júlio Fragata",67,67,0,83,83,0
10,16,2018,7,0,3,"Braga",7,"Rua Nova Santa Cruz",22,44,22,79,39,40
10,16,2018,7,0,3,"Braga",8,"Rua Costa Gomes",0,41,41,-1,42,-43
10,16,2018,8,0,3,"Braga",1,"Avenida da Liberdade",16,25,9,194,124,70
10,16,2018,8,0,3,"Braga",2,"Avenida Central",16,25,9,194,124,70
10,16,2018,8,0,3,"Braga",3,"Rua de Caires",27,36,9,50,37,13
10,16,2018,8,0,3,"Braga",4,"N14 Bosch",47,47,0,48,48,0
10,16,2018,8,0,3,"Braga",5,"Avenida João Paulo II",39,39,0,9,9,0
10,16,2018,8,0,3,"Braga",6,"Avenida Padre Júlio Fragata",48,67,19,116,83,33
10,16,2018,8,0,3,"Braga",7,"Rua Nova Santa Cruz",32,44,12,54,39,15
10,16,2018,8,0,3,"Braga",8,"Rua Costa Gomes",0,41,41,-1,42,-43
10,16,2018,9,0,3,"Braga",1,"Avenida da Liberdade",25,25,0,124,124,0
10,16,2018,9,0,3,"Braga",2,"Avenida Central",25,25,0,124,124,0
10,16,2018,9,0,3,"Braga",3,"Rua de Caires",26,36,10,52,37,15
10,16,2018,9,0,3,"Braga",4,"N14 Bosch",47,47,0,48,48,0
10,16,2018,9,0,3,"Braga",5,"Avenida João Paulo II",39,39,0,9,9,0
10,16,2018,9,0,3,"Braga",6,"Avenida Padre Júlio Fragata",67,67,0,83,83,0
10,16,2018,9,0,3,"Braga",7,"Rua Nova Santa Cruz",24,44,20,72,39,33
10,16,2018,9,0,3,"Braga",8,"Rua Costa Gomes",0,41,41,-1,42,-43
10,16,2018,10,0,3,"Braga",1,"Avenida da Liberdade",25,25,0,124,124,0
10,16,2018,10,0,3,"Braga",2,"Avenida Central",25,25,0,124,124,0
10,16,2018,10,0,3,"Braga",3,"Rua de Caires",36,36,0,37,37,0
10,16,2018,10,0,3,"Braga",4,"N14 Bosch",47,47,0,48,48,0
10,16,2018,10,0,3,"Braga",5,"Avenida João Paulo II",39,39,0,9,9,0
10,16,2018,10,0,3,"Braga",6,"Avenida Padre Júlio Fragata",67,67,0,83,83,0
10,16,2018,10,0,3,"Braga",7,"Rua Nova Santa Cruz",18,44,26,96,39,57
10,16,2018,10,0,3,"Braga",8,"Rua Costa Gomes",0,41,41,-1,42,-43
10,16,2018,11,0,3,"Braga",1,"Avenida da Liberdade",25,25,0,124,124,0
10,16,2018,11,0,3,"Braga",2,"Avenida Central",25,25,0,124,124,0
10,16,2018,11,0,3,"Braga",3,"Rua de Caires",27,36,9,50,37,13
10,16,2018,11,0,3,"Braga",4,"N14 Bosch",30,47,17,75,48,27
10,16,2018,11,0,3,"Braga",5,"Avenida João Paulo II",39,39,0,9,9,0
10,16,2018,11,0,3,"Braga",6,"Avenida Padre Júlio Fragata",67,67,0,83,83,0
10,16,2018,11,0,3,"Braga",7,"Rua Nova Santa Cruz",30,44,14,58,39,19
10,16,2018,11,0,3,"Braga",8,"Rua Costa Gomes",0,41,41,-1,42,-43
10,16,2018,12,0,3,"Braga",1,"Avenida da Liberdade",25,25,0,124,124,0
10,16,2018,12,0,3,"Braga",2,"Avenida Central",25,25,0,124,124,0
10,16,2018,12,0,3,"Braga",3,"Rua de Caires",36,36,0,37,37,0
10,16,2018,12,0,3,"Braga",4,"N14 Bosch",47,47,0,48,48,0
10,16,2018,12,0,3,"Braga",5,"Avenida João Paulo II",39,39,0,9,9,0
10,16,2018,12,0,3,"Braga",6,"Avenida Padre Júlio Fragata",67,67,0,83,83,0
10,16,2018,12,0,3,"Braga",7,"Rua Nova Santa Cruz",23,44,21,75,39,36
10,16,2018,12,0,3,"Braga",8,"Rua Costa Gomes",0,41,41,-1,42,-43
10,16,2018,13,0,3,"Braga",1,"Avenida da Liberdade",25,25,0,124,124,0
10,16,2018,13,0,3,"Braga",2,"Avenida Central",25,25,0,124,124,0
10,16,2018,13,0,3,"Braga",3,"Rua de Caires",10,36,26,135,37,98
10,16,2018,13,0,3,"Braga",4,"N14 Bosch",32,47,15,70,48,22
10,16,2018,13,0,3,"Braga",5,"Avenida João Paulo II",39,39,0,9,9,0
10,16,2018,13,0,3,"Braga",6,"Avenida Padre Júlio Fragata",67,67,0,83,83,0
10,16,2018,13,0,3,"Braga",7,"Rua Nova Santa Cruz",9,44,35,192,39,153
10,16,2018,13,0,3,"Braga",8,"Rua Costa Gomes",0,41,41,-1,42,-43
10,16,2018,14,0,3,"Braga",1,"Avenida da Liberdade",25,25,0,124,124,0
10,16,2018,14,0,3,"Braga",2,"Avenida Central",25,25,0,124,124,0
10,16,2018,14,0,3,"Braga",3,"Rua de Caires",36,36,0,37,37,0
10,16,2018,14,0,3,"Braga",4,"N14 Bosch",33,47,14,68,48,20
10,16,2018,14,0,3,"Braga",5,"Avenida João Paulo II",39,39,0,9,9,0
10,16,2018,14,0,3,"Braga",6,"Avenida Padre Júlio Fragata",67,67,0,83,83,0
10,16,2018,14,0,3,"Braga",7,"Rua Nova Santa Cruz",19,44,25,91,39,52
10,16,2018,14,0,3,"Braga",8,"Rua Costa Gomes",0,41,41,-1,42,-43
10,16,2018,15,0,3,"Braga",1,"Avenida da Liberdade",25,25,0,124,124,0
10,16,2018,15,0,3,"Braga",2,"Avenida Central",25,25,0,124,124,0
10,16,2018,15,0,3,"Braga",3,"Rua de Caires",36,36,0,37,37,0
10,16,2018,15,0,3,"Braga",4,"N14 Bosch",28,47,19,80,48,32
10,16,2018,15,0,3,"Braga",5,"Avenida João Paulo II",39,39,0,9,9,0
10,16,2018,15,0,3,"Braga",6,"Avenida Padre Júlio Fragata",67,67,0,83,83,0
10,16,2018,15,0,3,"Braga",7,"Rua Nova Santa Cruz",19,44,25,91,39,52
10,16,2018,15,0,3,"Braga",8,"Rua Costa Gomes",0,41,41,-1,42,-43
10,16,2018,16,0,3,"Braga",1,"Avenida da Liberdade",19,25,6,163,124,39
10,16,2018,16,0,3,"Braga",2,"Avenida Central",19,25,6,163,124,39
10,16,2018,16,0,3,"Braga",3,"Rua de Caires",26,36,10,52,37,15
10,16,2018,16,0,3,"Braga",4,"N14 Bosch",16,47,31,140,48,92
10,16,2018,16,0,3,"Braga",5,"Avenida João Paulo II",39,39,0,9,9,0
10,16,2018,16,0,3,"Braga",6,"Avenida Padre Júlio Fragata",67,67,0,83,83,0
10,16,2018,16,0,3,"Braga",7,"Rua Nova Santa Cruz",17,44,27,102,39,63
10,16,2018,16,0,3,"Braga",8,"Rua Costa Gomes",0,41,41,-1,42,-43
10,16,2018,17,0,3,"Braga",1,"Avenida da Liberdade",7,25,18,443,124,319
10,16,2018,17,0,3,"Braga",2,"Avenida Central",7,25,18,443,124,319
10,16,2018,17,0,3,"Braga",3,"Rua de Caires",20,36,16,67,37,30
10,16,2018,17,0,3,"Braga",4,"N14 Bosch",15,47,32,150,48,102
10,16,2018,17,0,3,"Braga",5,"Avenida João Paulo II",39,39,0,9,9,0
10,16,2018,17,0,3,"Braga",6,"Avenida Padre Júlio Fragata",43,67,24,130,83,47
10,16,2018,17,0,3,"Braga",7,"Rua Nova Santa Cruz",23,44,21,75,39,36
10,16,2018,17,0,3,"Braga",8,"Rua Costa Gomes",0,41,41,-1,42,-43
10,16,2018,18,0,3,"Braga",1,"Avenida da Liberdade",9,25,16,344,124,220
10,16,2018,18,0,3,"Braga",2,"Avenida Central",9,25,16,344,124,220
10,16,2018,18,0,3,"Braga",3,"Rua de Caires",21,36,15,64,37,27
10,16,2018,18,0,3,"Braga",4,"N14 Bosch",18,47,29,125,48,77
10,16,2018,18,0,3,"Braga",5,"Avenida João Paulo II",9,39,30,39,9,30
10,16,2018,18,0,3,"Braga",6,"Avenida Padre Júlio Fragata",30,67,37,186,83,103
10,16,2018,18,0,3,"Braga",7,"Rua Nova Santa Cruz",18,44,26,96,39,57
10,16,2018,18,0,3,"Braga",8,"Rua Costa Gomes",0,41,41,-1,42,-43
10,16,2018,19,0,3,"Braga",1,"Avenida da Liberdade",25,25,0,124,124,0
10,16,2018,19,0,3,"Braga",2,"Avenida Central",25,25,0,124,124,0
10,16,2018,19,0,3,"Braga",3,"Rua de Caires",36,36,0,37,37,0
10,16,2018,19,0,3,"Braga",4,"N14 Bosch",47,47,0,48,48,0
10,16,2018,19,0,3,"Braga",5,"Avenida João Paulo II",39,39,0,9,9,0
10,16,2018,19,0,3,"Braga",6,"Avenida Padre Júlio Fragata",67,67,0,83,83,0
10,16,2018,19,0,3,"Braga",7,"Rua Nova Santa Cruz",15,44,29,115,39,76
10,16,2018,19,0,3,"Braga",8,"Rua Costa Gomes",25,41,16,69,42,27
10,16,2018,20,0,3,"Braga",1,"Avenida da Liberdade",19,25,6,163,124,39
10,16,2018,20,0,3,"Braga",2,"Avenida Central",19,25,6,163,124,39
10,16,2018,20,0,3,"Braga",3,"Rua de Caires",27,36,9,50,37,13
10,16,2018,20,0,3,"Braga",4,"N14 Bosch",47,47,0,48,48,0
10,16,2018,20,0,3,"Braga",5,"Avenida João Paulo II",39,39,0,9,9,0
10,16,2018,20,0,3,"Braga",6,"Avenida Padre Júlio Fragata",67,67,0,83,83,0
10,16,2018,20,0,3,"Braga",7,"Rua Nova Santa Cruz",44,44,0,39,39,0
10,16,2018,20,0,3,"Braga",8,"Rua Costa Gomes",41,41,0,42,42,0
10,16,2018,21,0,3,"Braga",1,"Avenida da Liberdade",25,25,0,124,124,0
10,16,2018,21,0,3,"Braga",2,"Avenida Central",25,25,0,124,124,0
10,16,2018,21,0,3,"Braga",3,"Rua de Caires",36,36,0,37,37,0
10,16,2018,21,0,3,"Braga",4,"N14 Bosch",47,47,0,48,48,0
10,16,2018,21,0,3,"Braga",5,"Avenida João Paulo II",39,39,0,9,9,0
10,16,2018,21,0,3,"Braga",6,"Avenida Padre Júlio Fragata",67,67,0,83,83,0
10,16,2018,21,0,3,"Braga",7,"Rua Nova Santa Cruz",44,44,0,39,39,0
10,16,2018,21,0,3,"Braga",8,"Rua Costa Gomes",41,41,0,42,42,0
10,16,2018,22,0,3,"Braga",1,"Avenida da Liberdade",25,25,0,124,124,0
10,16,2018,22,0,3,"Braga",2,"Avenida Central",25,25,0,124,124,0
10,16,2018,22,0,3,"Braga",3,"Rua de Caires",36,36,0,37,37,0
10,16,2018,22,0,3,"Braga",4,"N14 Bosch",47,47,0,48,48,0
10,16,2018,22,0,3,"Braga",5,"Avenida João Paulo II",39,39,0,9,9,0
10,16,2018,22,0,3,"Braga",6,"Avenida Padre Júlio Fragata",67,67,0,83,83,0
10,16,2018,22,0,3,"Braga",7,"Rua Nova Santa Cruz",44,44,0,39,39,0
10,16,2018,22,0,3,"Braga",8,"Rua Costa Gomes",41,41,0,42,42,0
10,16,2018,23,0,3,"Braga",1,"Avenida da Liberdade",25,25,0,124,124,0
10,16,2018,23,0,3,"Braga",2,"Avenida Central",25,25,0,124,124,0
10,16,2018,23,0,3,"Braga",3,"Rua de Caires",36,36,0,37,37,0
10,16,2018,23,0,3,"Braga",4,"N14 Bosch",47,47,0,48,48,0
10,16,2018,23,0,3,"Braga",5,"Avenida João Paulo II",39,39,0,9,9,0
10,16,2018,23,0,3,"Braga",6,"Avenida Padre Júlio Fragata",67,67,0,83,83,0
10,16,2018,23,0,3,"Braga",7,"Rua Nova Santa Cruz",44,44,0,39,39,0
10,16,2018,23,0,3,"Braga",8,"Rua Costa Gomes",41,41,0,42,42,0
10,17,2018,0,0,4,"Braga",1,"Avenida da Liberdade",25,25,0,124,124,0
10,17,2018,0,0,4,"Braga",2,"Avenida Central",25,25,0,124,124,0
10,17,2018,0,0,4,"Braga",3,"Rua de Caires",36,36,0,37,37,0
10,17,2018,0,0,4,"Braga",4,"N14 Bosch",47,47,0,48,48,0
10,17,2018,0,0,4,"Braga",5,"Avenida João Paulo II",39,39,0,9,9,0
10,17,2018,0,0,4,"Braga",6,"Avenida Padre Júlio Fragata",67,67,0,83,83,0
10,17,2018,0,0,4,"Braga",7,"Rua Nova Santa Cruz",44,44,0,39,39,0
10,17,2018,0,0,4,"Braga",8,"Rua Costa Gomes",41,41,0,42,42,0
10,17,2018,1,0,4,"Braga",1,"Avenida da Liberdade",25,25,0,124,124,0
10,17,2018,1,0,4,"Braga",2,"Avenida Central",25,25,0,124,124,0
10,17,2018,1,0,4,"Braga",3,"Rua de Caires",36,36,0,37,37,0
10,17,2018,1,0,4,"Braga",4,"N14 Bosch",47,47,0,48,48,0
10,17,2018,1,0,4,"Braga",5,"Avenida João Paulo II",39,39,0,9,9,0
10,17,2018,1,0,4,"Braga",6,"Avenida Padre Júlio Fragata",67,67,0,83,83,0
10,17,2018,1,0,4,"Braga",7,"Rua Nova Santa Cruz",44,44,0,39,39,0
10,17,2018,1,0,4,"Braga",8,"Rua Costa Gomes",41,41,0,42,42,0
10,17,2018,2,0,4,"Braga",1,"Avenida da Liberdade",25,25,0,124,124,0
10,17,2018,2,0,4,"Braga",2,"Avenida Central",25,25,0,124,124,0
10,17,2018,2,0,4,"Braga",3,"Rua de Caires",36,36,0,37,37,0
10,17,2018,2,0,4,"Braga",4,"N14 Bosch",47,47,0,48,48,0
10,17,2018,2,0,4,"Braga",5,"Avenida João Paulo II",39,39,0,9,9,0
10,17,2018,2,0,4,"Braga",6,"Avenida Padre Júlio Fragata",67,67,0,83,83,0
10,17,2018,2,0,4,"Braga",7,"Rua Nova Santa Cruz",44,44,0,39,39,0
10,17,2018,2,0,4,"Braga",8,"Rua Costa Gomes",41,41,0,42,42,0
10,17,2018,3,0,4,"Braga",1,"Avenida da Liberdade",25,25,0,124,124,0
10,17,2018,3,0,4,"Braga",2,"Avenida Central",25,25,0,124,124,0
10,17,2018,3,0,4,"Braga",3,"Rua de Caires",36,36,0,37,37,0
10,17,2018,3,0,4,"Braga",4,"N14 Bosch",47,47,0,48,48,0
10,17,2018,3,0,4,"Braga",5,"Avenida João Paulo II",39,39,0,9,9,0
10,17,2018,3,0,4,"Braga",6,"Avenida Padre Júlio Fragata",67,67,0,83,83,0
10,17,2018,3,0,4,"Braga",7,"Rua Nova Santa Cruz",44,44,0,39,39,0
10,17,2018,3,0,4,"Braga",8,"Rua Costa Gomes",41,41,0,42,42,0
10,17,2018,4,0,4,"Braga",1,"Avenida da Liberdade",25,25,0,124,124,0
10,17,2018,4,0,4,"Braga",2,"Avenida Central",25,25,0,124,124,0
10,17,2018,4,0,4,"Braga",3,"Rua de Caires",36,36,0,37,37,0
10,17,2018,4,0,4,"Braga",4,"N14 Bosch",47,47,0,48,48,0
10,17,2018,4,0,4,"Braga",5,"Avenida João Paulo II",39,39,0,9,9,0
10,17,2018,4,0,4,"Braga",6,"Avenida Padre Júlio Fragata",67,67,0,83,83,0
10,17,2018,4,0,4,"Braga",7,"Rua Nova Santa Cruz",44,44,0,39,39,0
10,17,2018,4,0,4,"Braga",8,"Rua Costa Gomes",41,41,0,42,42,0
10,17,2018,5,0,4,"Braga",1,"Avenida da Liberdade",25,25,0,124,124,0
10,17,2018,5,0,4,"Braga",2,"Avenida Central",25,25,0,124,124,0
10,17,2018,5,0,4,"Braga",3,"Rua de Caires",36,36,0,37,37,0
10,17,2018,5,0,4,"Braga",4,"N14 Bosch",47,47,0,48,48,0
10,17,2018,5,0,4,"Braga",5,"Avenida João Paulo II",39,39,0,9,9,0
10,17,2018,5,0,4,"Braga",6,"Avenida Padre Júlio Fragata",67,67,0,83,83,0
10,17,2018,5,0,4,"Braga",7,"Rua Nova Santa Cruz",44,44,0,39,39,0
10,17,2018,5,0,4,"Braga",8,"Rua Costa Gomes",41,41,0,42,42,0
10,17,2018,6,0,4,"Braga",1,"Avenida da Liberdade",25,25,0,124,124,0
10,17,2018,6,0,4,"Braga",2,"Avenida Central",25,25,0,124,124,0
10,17,2018,6,0,4,"Braga",3,"Rua de Caires",28,36,8,48,37,11
10,17,2018,6,0,4,"Braga",4,"N14 Bosch",47,47,0,48,48,0
10,17,2018,6,0,4,"Braga",5,"Avenida João Paulo II",39,39,0,9,9,0
10,17,2018,6,0,4,"Braga",6,"Avenida Padre Júlio Fragata",67,67,0,83,83,0
10,17,2018,6,0,4,"Braga",7,"Rua Nova Santa Cruz",44,44,0,39,39,0
10,17,2018,6,0,4,"Braga",8,"Rua Costa Gomes",41,41,0,42,42,0
10,17,2018,7,0,4,"Braga",1,"Avenida da Liberdade",25,25,0,124,124,0
10,17,2018,7,0,4,"Braga",2,"Avenida Central",25,25,0,124,124,0
10,17,2018,7,0,4,"Braga",3,"Rua de Caires",28,36,8,48,37,11
10,17,2018,7,0,4,"Braga",4,"N14 Bosch",35,47,12,64,48,16
10,17,2018,7,0,4,"Braga",5,"Avenida João Paulo II",39,39,0,9,9,0
10,17,2018,7,0,4,"Braga",6,"Avenida Padre Júlio Fragata",67,67,0,83,83,0
10,17,2018,7,0,4,"Braga",7,"Rua Nova Santa Cruz",44,44,0,39,39,0
10,17,2018,7,0,4,"Braga",8,"Rua Costa Gomes",41,41,0,42,42,0
10,17,2018,8,0,4,"Braga",1,"Avenida da Liberdade",16,25,9,194,124,70
10,17,2018,8,0,4,"Braga",2,"Avenida Central",16,25,9,194,124,70
10,17,2018,8,0,4,"Braga",3,"Rua de Caires",21,36,15,64,37,27
10,17,2018,8,0,4,"Braga",4,"N14 Bosch",28,47,19,80,48,32
10,17,2018,8,0,4,"Braga",5,"Avenida João Paulo II",27,39,12,13,9,4
10,17,2018,8,0,4,"Braga",6,"Avenida Padre Júlio Fragata",38,67,29,147,83,64
10,17,2018,8,0,4,"Braga",7,"Rua Nova Santa Cruz",3,44,41,576,39,537
10,17,2018,8,0,4,"Braga",8,"Rua Costa Gomes",27,41,14,64,42,22
10,17,2018,9,0,4,"Braga",1,"Avenida da Liberdade",25,25,0,124,124,0
10,17,2018,9,0,4,"Braga",2,"Avenida Central",25,25,0,124,124,0
10,17,2018,9,0,4,"Braga",3,"Rua de Caires",36,36,0,37,37,0
10,17,2018,9,0,4,"Braga",4,"N14 Bosch",33,47,14,68,48,20
10,17,2018,9,0,4,"Braga",5,"Avenida João Paulo II",39,39,0,9,9,0
10,17,2018,9,0,4,"Braga",6,"Avenida Padre Júlio Fragata",67,67,0,83,83,0
10,17,2018,9,0,4,"Braga",7,"Rua Nova Santa Cruz",32,44,12,54,39,15
10,17,2018,9,0,4,"Braga",8,"Rua Costa Gomes",41,41,0,42,42,0
10,17,2018,10,0,4,"Braga",1,"Avenida da Liberdade",25,25,0,124,124,0
10,17,2018,10,0,4,"Braga",2,"Avenida Central",25,25,0,124,124,0
10,17,2018,10,0,4,"Braga",3,"Rua de Caires",28,36,8,48,37,11
10,17,2018,10,0,4,"Braga",4,"N14 Bosch",27,47,20,83,48,35
10,17,2018,10,0,4,"Braga",5,"Avenida João Paulo II",39,39,0,9,9,0
10,17,2018,10,0,4,"Braga",6,"Avenida Padre Júlio Fragata",67,67,0,83,83,0
10,17,2018,10,0,4,"Braga",7,"Rua Nova Santa Cruz",33,44,11,52,39,13
10,17,2018,10,0,4,"Braga",8,"Rua Costa Gomes",41,41,0,42,42,0
10,17,2018,11,0,4,"Braga",1,"Avenida da Liberdade",25,25,0,124,124,0
10,17,2018,11,0,4,"Braga",2,"Avenida Central",25,25,0,124,124,0
10,17,2018,11,0,4,"Braga",3,"Rua de Caires",36,36,0,37,37,0
10,17,2018,11,0,4,"Braga",4,"N14 Bosch",47,47,0,48,48,0
10,17,2018,11,0,4,"Braga",5,"Avenida João Paulo II",39,39,0,9,9,0
10,17,2018,11,0,4,"Braga",6,"Avenida Padre Júlio Fragata",67,67,0,83,83,0
10,17,2018,11,0,4,"Braga",7,"Rua Nova Santa Cruz",44,44,0,39,39,0
10,17,2018,11,0,4,"Braga",8,"Rua Costa Gomes",31,41,10,56,42,14
10,17,2018,12,0,4,"Braga",1,"Avenida da Liberdade",19,25,6,163,124,39
10,17,2018,12,0,4,"Braga",2,"Avenida Central",19,25,6,163,124,39
10,17,2018,12,0,4,"Braga",3,"Rua de Caires",23,36,13,59,37,22
10,17,2018,12,0,4,"Braga",4,"N14 Bosch",27,47,20,83,48,35
10,17,2018,12,0,4,"Braga",5,"Avenida João Paulo II",39,39,0,9,9,0
10,17,2018,12,0,4,"Braga",6,"Avenida Padre Júlio Fragata",67,67,0,83,83,0
10,17,2018,12,0,4,"Braga",7,"Rua Nova Santa Cruz",19,44,25,91,39,52
10,17,2018,12,0,4,"Braga",8,"Rua Costa Gomes",31,41,10,56,42,14
10,17,2018,13,0,4,"Braga",1,"Avenida da Liberdade",25,25,0,124,124,0
10,17,2018,13,0,4,"Braga",2,"Avenida Central",25,25,0,124,124,0
10,17,2018,13,0,4,"Braga",3,"Rua de Caires",36,36,0,37,37,0
10,17,2018,13,0,4,"Braga",4,"N14 Bosch",14,47,33,160,48,112
10,17,2018,13,0,4,"Braga",5,"Avenida João Paulo II",39,39,0,9,9,0
10,17,2018,13,0,4,"Braga",6,"Avenida Padre Júlio Fragata",67,67,0,83,83,0
10,17,2018,13,0,4,"Braga",7,"Rua Nova Santa Cruz",12,44,32,144,39,105
10,17,2018,13,0,4,"Braga",8,"Rua Costa Gomes",41,41,0,42,42,0
10,17,2018,14,0,4,"Braga",1,"Avenida da Liberdade",25,25,0,124,124,0
10,17,2018,14,0,4,"Braga",2,"Avenida Central",25,25,0,124,124,0
10,17,2018,14,0,4,"Braga",3,"Rua de Caires",36,36,0,37,37,0
10,17,2018,14,0,4,"Braga",4,"N14 Bosch",29,47,18,77,48,29
10,17,2018,14,0,4,"Braga",5,"Avenida João Paulo II",28,39,11,12,9,3
10,17,2018,14,0,4,"Braga",6,"Avenida Padre Júlio Fragata",12,67,55,464,83,381
10,17,2018,14,0,4,"Braga",7,"Rua Nova Santa Cruz",44,44,0,39,39,0
10,17,2018,14,0,4,"Braga",8,"Rua Costa Gomes",23,41,18,75,42,33
10,17,2018,15,0,4,"Braga",1,"Avenida da Liberdade",25,25,0,124,124,0
10,17,2018,15,0,4,"Braga",2,"Avenida Central",25,25,0,124,124,0
10,17,2018,15,0,4,"Braga",3,"Rua de Caires",36,36,0,37,37,0
10,17,2018,15,0,4,"Braga",4,"N14 Bosch",22,47,25,102,48,54
10,17,2018,15,0,4,"Braga",5,"Avenida João Paulo II",19,39,20,18,9,9
10,17,2018,15,0,4,"Braga",6,"Avenida Padre Júlio Fragata",21,67,46,265,83,182
10,17,2018,15,0,4,"Braga",7,"Rua Nova Santa Cruz",21,44,23,82,39,43
10,17,2018,15,0,4,"Braga",8,"Rua Costa Gomes",41,41,0,42,42,0
10,17,2018,16,0,4,"Braga",1,"Avenida da Liberdade",16,25,9,194,124,70
10,17,2018,16,0,4,"Braga",2,"Avenida Central",16,25,9,194,124,70
10,17,2018,16,0,4,"Braga",3,"Rua de Caires",28,36,8,48,37,11
10,17,2018,16,0,4,"Braga",4,"N14 Bosch",11,47,36,204,48,156
10,17,2018,16,0,4,"Braga",5,"Avenida João Paulo II",11,39,28,32,9,23
10,17,2018,16,0,4,"Braga",6,"Avenida Padre Júlio Fragata",53,67,14,105,83,22
10,17,2018,16,0,4,"Braga",7,"Rua Nova Santa Cruz",26,44,18,66,39,27
10,17,2018,16,0,4,"Braga",8,"Rua Costa Gomes",23,41,18,75,42,33
10,17,2018,17,0,4,"Braga",1,"Avenida da Liberdade",7,25,18,443,124,319
10,17,2018,17,0,4,"Braga",2,"Avenida Central",7,25,18,443,124,319
10,17,2018,17,0,4,"Braga",3,"Rua de Caires",25,36,11,54,37,17
10,17,2018,17,0,4,"Braga",4,"N14 Bosch",20,47,27,112,48,64
10,17,2018,17,0,4,"Braga",5,"Avenida João Paulo II",39,39,0,9,9,0
10,17,2018,17,0,4,"Braga",6,"Avenida Padre Júlio Fragata",28,67,39,199,83,116
10,17,2018,17,0,4,"Braga",7,"Rua Nova Santa Cruz",5,44,39,346,39,307
10,17,2018,17,0,4,"Braga",8,"Rua Costa Gomes",9,41,32,192,42,150
10,17,2018,18,0,4,"Braga",1,"Avenida da Liberdade",17,25,8,182,124,58
10,17,2018,18,0,4,"Braga",2,"Avenida Central",17,25,8,182,124,58
10,17,2018,18,0,4,"Braga",3,"Rua de Caires",24,36,12,56,37,19
10,17,2018,18,0,4,"Braga",4,"N14 Bosch",32,47,15,70,48,22
10,17,2018,18,0,4,"Braga",5,"Avenida João Paulo II",21,39,18,17,9,8
10,17,2018,18,0,4,"Braga",6,"Avenida Padre Júlio Fragata",37,67,30,151,83,68
10,17,2018,18,0,4,"Braga",7,"Rua Nova Santa Cruz",34,44,10,51,39,12
10,17,2018,18,0,4,"Braga",8,"Rua Costa Gomes",11,41,30,157,42,115
10,17,2018,19,0,4,"Braga",1,"Avenida da Liberdade",25,25,0,124,124,0
10,17,2018,19,0,4,"Braga",2,"Avenida Central",25,25,0,124,124,0
10,17,2018,19,0,4,"Braga",3,"Rua de Caires",28,36,8,48,37,11
10,17,2018,19,0,4,"Braga",4,"N14 Bosch",47,47,0,48,48,0
10,17,2018,19,0,4,"Braga",5,"Avenida João Paulo II",30,39,9,12,9,3
10,17,2018,19,0,4,"Braga",6,"Avenida Padre Júlio Fragata",49,67,18,114,83,31
10,17,2018,19,0,4,"Braga",7,"Rua Nova Santa Cruz",12,44,32,144,39,105
10,17,2018,19,0,4,"Braga",8,"Rua Costa Gomes",41,41,0,42,42,0
10,17,2018,20,0,4,"Braga",1,"Avenida da Liberdade",25,25,0,124,124,0
10,17,2018,20,0,4,"Braga",2,"Avenida Central",25,25,0,124,124,0
10,17,2018,20,0,4,"Braga",3,"Rua de Caires",36,36,0,37,37,0
10,17,2018,20,0,4,"Braga",4,"N14 Bosch",47,47,0,48,48,0
10,17,2018,20,0,4,"Braga",5,"Avenida João Paulo II",39,39,0,9,9,0
10,17,2018,20,0,4,"Braga",6,"Avenida Padre Júlio Fragata",67,67,0,83,83,0
10,17,2018,20,0,4,"Braga",7,"Rua Nova Santa Cruz",32,44,12,54,39,15
10,17,2018,20,0,4,"Braga",8,"Rua Costa Gomes",31,41,10,56,42,14
10,17,2018,21,0,4,"Braga",1,"Avenida da Liberdade",25,25,0,124,124,0
10,17,2018,21,0,4,"Braga",2,"Avenida Central",25,25,0,124,124,0
10,17,2018,21,0,4,"Braga",3,"Rua de Caires",36,36,0,37,37,0
10,17,2018,21,0,4,"Braga",4,"N14 Bosch",47,47,0,48,48,0
10,17,2018,21,0,4,"Braga",5,"Avenida João Paulo II",39,39,0,9,9,0
10,17,2018,21,0,4,"Braga",6,"Avenida Padre Júlio Fragata",67,67,0,83,83,0
10,17,2018,21,0,4,"Braga",7,"Rua Nova Santa Cruz",44,44,0,39,39,0
10,17,2018,21,0,4,"Braga",8,"Rua Costa Gomes",41,41,0,42,42,0
10,17,2018,22,0,4,"Braga",1,"Avenida da Liberdade",25,25,0,124,124,0
10,17,2018,22,0,4,"Braga",2,"Avenida Central",25,25,0,124,124,0
10,17,2018,22,0,4,"Braga",3,"Rua de Caires",36,36,0,37,37,0
10,17,2018,22,0,4,"Braga",4,"N14 Bosch",47,47,0,48,48,0
10,17,2018,22,0,4,"Braga",5,"Avenida João Paulo II",39,39,0,9,9,0
10,17,2018,22,0,4,"Braga",6,"Avenida Padre Júlio Fragata",67,67,0,83,83,0
10,17,2018,22,0,4,"Braga",7,"Rua Nova Santa Cruz",29,44,15,60,39,21
10,17,2018,22,0,4,"Braga",8,"Rua Costa Gomes",41,41,0,42,42,0
10,17,2018,23,0,4,"Braga",1,"Avenida da Liberdade",25,25,0,124,124,0
10,17,2018,23,0,4,"Braga",2,"Avenida Central",25,25,0,124,124,0
10,17,2018,23,0,4,"Braga",3,"Rua de Caires",36,36,0,37,37,0
10,17,2018,23,0,4,"Braga",4,"N14 Bosch",47,47,0,48,48,0
10,17,2018,23,0,4,"Braga",5,"Avenida João Paulo II",39,39,0,9,9,0
10,17,2018,23,0,4,"Braga",6,"Avenida Padre Júlio Fragata",67,67,0,83,83,0
10,17,2018,23,0,4,"Braga",7,"Rua Nova Santa Cruz",31,44,13,56,39,17
10,17,2018,23,0,4,"Braga",8,"Rua Costa Gomes",41,41,0,42,42,0
10,18,2018,0,0,5,"Braga",1,"Avenida da Liberdade",25,25,0,124,124,0
10,18,2018,0,0,5,"Braga",2,"Avenida Central",25,25,0,124,124,0
10,18,2018,0,0,5,"Braga",3,"Rua de Caires",36,36,0,37,37,0
10,18,2018,0,0,5,"Braga",4,"N14 Bosch",47,47,0,48,48,0
10,18,2018,0,0,5,"Braga",5,"Avenida João Paulo II",39,39,0,9,9,0
10,18,2018,0,0,5,"Braga",6,"Avenida Padre Júlio Fragata",67,67,0,83,83,0
10,18,2018,0,0,5,"Braga",7,"Rua Nova Santa Cruz",31,44,13,56,39,17
10,18,2018,0,0,5,"Braga",8,"Rua Costa Gomes",41,41,0,42,42,0
10,18,2018,1,0,5,"Braga",1,"Avenida da Liberdade",25,25,0,124,124,0
10,18,2018,1,0,5,"Braga",2,"Avenida Central",25,25,0,124,124,0
10,18,2018,1,0,5,"Braga",3,"Rua de Caires",36,36,0,37,37,0
10,18,2018,1,0,5,"Braga",4,"N14 Bosch",47,47,0,48,48,0
10,18,2018,1,0,5,"Braga",5,"Avenida João Paulo II",39,39,0,9,9,0
10,18,2018,1,0,5,"Braga",6,"Avenida Padre Júlio Fragata",67,67,0,83,83,0
10,18,2018,1,0,5,"Braga",7,"Rua Nova Santa Cruz",44,44,0,39,39,0
10,18,2018,1,0,5,"Braga",8,"Rua Costa Gomes",41,41,0,42,42,0
10,18,2018,2,0,5,"Braga",1,"Avenida da Liberdade",25,25,0,124,124,0
10,18,2018,2,0,5,"Braga",2,"Avenida Central",25,25,0,124,124,0
10,18,2018,2,0,5,"Braga",3,"Rua de Caires",36,36,0,37,37,0
10,18,2018,2,0,5,"Braga",4,"N14 Bosch",47,47,0,48,48,0
10,18,2018,2,0,5,"Braga",5,"Avenida João Paulo II",39,39,0,9,9,0
10,18,2018,2,0,5,"Braga",6,"Avenida Padre Júlio Fragata",67,67,0,83,83,0
10,18,2018,2,0,5,"Braga",7,"Rua Nova Santa Cruz",44,44,0,39,39,0
10,18,2018,2,0,5,"Braga",8,"Rua Costa Gomes",41,41,0,42,42,0
10,18,2018,3,0,5,"Braga",1,"Avenida da Liberdade",25,25,0,124,124,0
10,18,2018,3,0,5,"Braga",2,"Avenida Central",25,25,0,124,124,0
10,18,2018,3,0,5,"Braga",3,"Rua de Caires",36,36,0,37,37,0
10,18,2018,3,0,5,"Braga",4,"N14 Bosch",47,47,0,48,48,0
10,18,2018,3,0,5,"Braga",5,"Avenida João Paulo II",39,39,0,9,9,0
10,18,2018,3,0,5,"Braga",6,"Avenida Padre Júlio Fragata",67,67,0,83,83,0
10,18,2018,3,0,5,"Braga",7,"Rua Nova Santa Cruz",44,44,0,39,39,0
10,18,2018,3,0,5,"Braga",8,"Rua Costa Gomes",41,41,0,42,42,0
10,18,2018,4,0,5,"Braga",1,"Avenida da Liberdade",25,25,0,124,124,0
10,18,2018,4,0,5,"Braga",2,"Avenida Central",25,25,0,124,124,0
10,18,2018,4,0,5,"Braga",3,"Rua de Caires",36,36,0,37,37,0
10,18,2018,4,0,5,"Braga",4,"N14 Bosch",47,47,0,48,48,0
10,18,2018,4,0,5,"Braga",5,"Avenida João Paulo II",39,39,0,9,9,0
10,18,2018,4,0,5,"Braga",6,"Avenida Padre Júlio Fragata",67,67,0,83,83,0
10,18,2018,4,0,5,"Braga",7,"Rua Nova Santa Cruz",44,44,0,39,39,0
10,18,2018,4,0,5,"Braga",8,"Rua Costa Gomes",41,41,0,42,42,0
10,18,2018,5,0,5,"Braga",1,"Avenida da Liberdade",25,25,0,124,124,0
10,18,2018,5,0,5,"Braga",2,"Avenida Central",25,25,0,124,124,0
10,18,2018,5,0,5,"Braga",3,"Rua de Caires",36,36,0,37,37,0
10,18,2018,5,0,5,"Braga",4,"N14 Bosch",47,47,0,48,48,0
10,18,2018,5,0,5,"Braga",5,"Avenida João Paulo II",39,39,0,9,9,0
10,18,2018,5,0,5,"Braga",6,"Avenida Padre Júlio Fragata",67,67,0,83,83,0
10,18,2018,5,0,5,"Braga",7,"Rua Nova Santa Cruz",44,44,0,39,39,0
10,18,2018,5,0,5,"Braga",8,"Rua Costa Gomes",41,41,0,42,42,0
10,18,2018,6,0,5,"Braga",1,"Avenida da Liberdade",25,25,0,124,124,0
10,18,2018,6,0,5,"Braga",2,"Avenida Central",25,25,0,124,124,0
10,18,2018,6,0,5,"Braga",3,"Rua de Caires",36,36,0,37,37,0
10,18,2018,6,0,5,"Braga",4,"N14 Bosch",47,47,0,48,48,0
10,18,2018,6,0,5,"Braga",5,"Avenida João Paulo II",39,39,0,9,9,0
10,18,2018,6,0,5,"Braga",6,"Avenida Padre Júlio Fragata",67,67,0,83,83,0
10,18,2018,6,0,5,"Braga",7,"Rua Nova Santa Cruz",34,44,10,51,39,12
10,18,2018,6,0,5,"Braga",8,"Rua Costa Gomes",41,41,0,42,42,0
10,18,2018,7,0,5,"Braga",1,"Avenida da Liberdade",25,25,0,124,124,0
10,18,2018,7,0,5,"Braga",2,"Avenida Central",25,25,0,124,124,0
10,18,2018,7,0,5,"Braga",3,"Rua de Caires",25,36,11,54,37,17
10,18,2018,7,0,5,"Braga",4,"N14 Bosch",30,47,17,75,48,27
10,18,2018,7,0,5,"Braga",5,"Avenida João Paulo II",39,39,0,9,9,0
10,18,2018,7,0,5,"Braga",6,"Avenida Padre Júlio Fragata",67,67,0,83,83,0
10,18,2018,7,0,5,"Braga",7,"Rua Nova Santa Cruz",33,44,11,52,39,13
10,18,2018,7,0,5,"Braga",8,"Rua Costa Gomes",32,41,9,54,42,12
10,18,2018,8,0,5,"Braga",1,"Avenida da Liberdade",17,25,8,182,124,58
10,18,2018,8,0,5,"Braga",2,"Avenida Central",17,25,8,182,124,58
10,18,2018,8,0,5,"Braga",3,"Rua de Caires",18,36,18,75,37,38
10,18,2018,8,0,5,"Braga",4,"N14 Bosch",25,47,22,90,48,42
10,18,2018,8,0,5,"Braga",5,"Avenida João Paulo II",39,39,0,9,9,0
10,18,2018,8,0,5,"Braga",6,"Avenida Padre Júlio Fragata",37,67,30,151,83,68
10,18,2018,8,0,5,"Braga",7,"Rua Nova Santa Cruz",2,44,42,864,39,825
10,18,2018,8,0,5,"Braga",8,"Rua Costa Gomes",41,41,0,42,42,0
10,18,2018,9,0,5,"Braga",1,"Avenida da Liberdade",25,25,0,124,124,0
10,18,2018,9,0,5,"Braga",2,"Avenida Central",25,25,0,124,124,0
10,18,2018,9,0,5,"Braga",3,"Rua de Caires",26,36,10,52,37,15
10,18,2018,9,0,5,"Braga",4,"N14 Bosch",36,47,11,62,48,14
10,18,2018,9,0,5,"Braga",5,"Avenida João Paulo II",39,39,0,9,9,0
10,18,2018,9,0,5,"Braga",6,"Avenida Padre Júlio Fragata",67,67,0,83,83,0
10,18,2018,9,0,5,"Braga",7,"Rua Nova Santa Cruz",34,44,10,51,39,12
10,18,2018,9,0,5,"Braga",8,"Rua Costa Gomes",41,41,0,42,42,0
10,18,2018,10,0,5,"Braga",1,"Avenida da Liberdade",25,25,0,124,124,0
10,18,2018,10,0,5,"Braga",2,"Avenida Central",25,25,0,124,124,0
10,18,2018,10,0,5,"Braga",3,"Rua de Caires",36,36,0,37,37,0
10,18,2018,10,0,5,"Braga",4,"N14 Bosch",30,47,17,75,48,27
10,18,2018,10,0,5,"Braga",5,"Avenida João Paulo II",28,39,11,12,9,3
10,18,2018,10,0,5,"Braga",6,"Avenida Padre Júlio Fragata",67,67,0,83,83,0
10,18,2018,10,0,5,"Braga",7,"Rua Nova Santa Cruz",30,44,14,58,39,19
10,18,2018,10,0,5,"Braga",8,"Rua Costa Gomes",41,41,0,42,42,0
10,18,2018,11,0,5,"Braga",1,"Avenida da Liberdade",25,25,0,124,124,0
10,18,2018,11,0,5,"Braga",2,"Avenida Central",25,25,0,124,124,0
10,18,2018,11,0,5,"Braga",3,"Rua de Caires",36,36,0,37,37,0
10,18,2018,11,0,5,"Braga",4,"N14 Bosch",47,47,0,48,48,0
10,18,2018,11,0,5,"Braga",5,"Avenida João Paulo II",29,39,10,12,9,3
10,18,2018,11,0,5,"Braga",6,"Avenida Padre Júlio Fragata",67,67,0,83,83,0
10,18,2018,11,0,5,"Braga",7,"Rua Nova Santa Cruz",44,44,0,39,39,0
10,18,2018,11,0,5,"Braga",8,"Rua Costa Gomes",27,41,14,64,42,22
10,18,2018,12,0,5,"Braga",1,"Avenida da Liberdade",25,25,0,124,124,0
10,18,2018,12,0,5,"Braga",2,"Avenida Central",25,25,0,124,124,0
10,18,2018,12,0,5,"Braga",3,"Rua de Caires",26,36,10,52,37,15
10,18,2018,12,0,5,"Braga",4,"N14 Bosch",20,47,27,112,48,64
10,18,2018,12,0,5,"Braga",5,"Avenida João Paulo II",39,39,0,9,9,0
10,18,2018,12,0,5,"Braga",6,"Avenida Padre Júlio Fragata",52,67,15,107,83,24
10,18,2018,12,0,5,"Braga",7,"Rua Nova Santa Cruz",18,44,26,96,39,57
10,18,2018,12,0,5,"Braga",8,"Rua Costa Gomes",41,41,0,42,42,0
10,18,2018,13,0,5,"Braga",1,"Avenida da Liberdade",25,25,0,124,124,0
10,18,2018,13,0,5,"Braga",2,"Avenida Central",25,25,0,124,124,0
10,18,2018,13,0,5,"Braga",3,"Rua de Caires",26,36,10,52,37,15
10,18,2018,13,0,5,"Braga",4,"N14 Bosch",22,47,25,102,48,54
10,18,2018,13,0,5,"Braga",5,"Avenida João Paulo II",39,39,0,9,9,0
10,18,2018,13,0,5,"Braga",6,"Avenida Padre Júlio Fragata",67,67,0,83,83,0
10,18,2018,13,0,5,"Braga",7,"Rua Nova Santa Cruz",17,44,27,102,39,63
10,18,2018,13,0,5,"Braga",8,"Rua Costa Gomes",31,41,10,56,42,14
10,18,2018,14,0,5,"Braga",1,"Avenida da Liberdade",18,25,7,172,124,48
10,18,2018,14,0,5,"Braga",2,"Avenida Central",18,25,7,172,124,48
10,18,2018,14,0,5,"Braga",3,"Rua de Caires",36,36,0,37,37,0
10,18,2018,14,0,5,"Braga",4,"N14 Bosch",23,47,24,98,48,50
10,18,2018,14,0,5,"Braga",5,"Avenida João Paulo II",39,39,0,9,9,0
10,18,2018,14,0,5,"Braga",6,"Avenida Padre Júlio Fragata",67,67,0,83,83,0
10,18,2018,14,0,5,"Braga",7,"Rua Nova Santa Cruz",44,44,0,39,39,0
10,18,2018,14,0,5,"Braga",8,"Rua Costa Gomes",28,41,13,62,42,20
10,18,2018,15,0,5,"Braga",1,"Avenida da Liberdade",16,25,9,194,124,70
10,18,2018,15,0,5,"Braga",2,"Avenida Central",16,25,9,194,124,70
10,18,2018,15,0,5,"Braga",3,"Rua de Caires",24,36,12,56,37,19
10,18,2018,15,0,5,"Braga",4,"N14 Bosch",32,47,15,70,48,22
10,18,2018,15,0,5,"Braga",5,"Avenida João Paulo II",39,39,0,9,9,0
10,18,2018,15,0,5,"Braga",6,"Avenida Padre Júlio Fragata",67,67,0,83,83,0
10,18,2018,15,0,5,"Braga",7,"Rua Nova Santa Cruz",26,44,18,66,39,27
10,18,2018,15,0,5,"Braga",8,"Rua Costa Gomes",31,41,10,56,42,14
10,18,2018,16,0,5,"Braga",1,"Avenida da Liberdade",17,25,8,182,124,58
10,18,2018,16,0,5,"Braga",2,"Avenida Central",17,25,8,182,124,58
10,18,2018,16,0,5,"Braga",3,"Rua de Caires",24,36,12,56,37,19
10,18,2018,16,0,5,"Braga",4,"N14 Bosch",47,47,0,48,48,0
10,18,2018,16,0,5,"Braga",5,"Avenida João Paulo II",30,39,9,12,9,3
10,18,2018,16,0,5,"Braga",6,"Avenida Padre Júlio Fragata",67,67,0,83,83,0
10,18,2018,16,0,5,"Braga",7,"Rua Nova Santa Cruz",11,44,33,157,39,118
10,18,2018,16,0,5,"Braga",8,"Rua Costa Gomes",22,41,19,79,42,37
10,18,2018,17,0,5,"Braga",1,"Avenida da Liberdade",12,25,13,258,124,134
10,18,2018,17,0,5,"Braga",2,"Avenida Central",12,25,13,258,124,134
10,18,2018,17,0,5,"Braga",3,"Rua de Caires",26,36,10,52,37,15
10,18,2018,17,0,5,"Braga",4,"N14 Bosch",9,47,38,250,48,202
10,18,2018,17,0,5,"Braga",5,"Avenida João Paulo II",39,39,0,9,9,0
10,18,2018,17,0,5,"Braga",6,"Avenida Padre Júlio Fragata",30,67,37,186,83,103
10,18,2018,17,0,5,"Braga",7,"Rua Nova Santa Cruz",5,44,39,346,39,307
10,18,2018,17,0,5,"Braga",8,"Rua Costa Gomes",19,41,22,91,42,49
10,18,2018,18,0,5,"Braga",1,"Avenida da Liberdade",12,25,13,258,124,134
10,18,2018,18,0,5,"Braga",2,"Avenida Central",12,25,13,258,124,134
10,18,2018,18,0,5,"Braga",3,"Rua de Caires",26,36,10,52,37,15
10,18,2018,18,0,5,"Braga",4,"N14 Bosch",20,47,27,112,48,64
10,18,2018,18,0,5,"Braga",5,"Avenida João Paulo II",30,39,9,12,9,3
10,18,2018,18,0,5,"Braga",6,"Avenida Padre Júlio Fragata",32,67,35,174,83,91
10,18,2018,18,0,5,"Braga",7,"Rua Nova Santa Cruz",11,44,33,157,39,118
10,18,2018,18,0,5,"Braga",8,"Rua Costa Gomes",9,41,32,192,42,150
10,18,2018,19,0,5,"Braga",1,"Avenida da Liberdade",25,25,0,124,124,0
10,18,2018,19,0,5,"Braga",2,"Avenida Central",25,25,0,124,124,0
10,18,2018,19,0,5,"Braga",3,"Rua de Caires",36,36,0,37,37,0
10,18,2018,19,0,5,"Braga",4,"N14 Bosch",36,47,11,62,48,14
10,18,2018,19,0,5,"Braga",5,"Avenida João Paulo II",39,39,0,9,9,0
10,18,2018,19,0,5,"Braga",6,"Avenida Padre Júlio Fragata",67,67,0,83,83,0
10,18,2018,19,0,5,"Braga",7,"Rua Nova Santa Cruz",29,44,15,60,39,21
10,18,2018,19,0,5,"Braga",8,"Rua Costa Gomes",16,41,25,108,42,66
10,18,2018,20,0,5,"Braga",1,"Avenida da Liberdade",25,25,0,124,124,0
10,18,2018,20,0,5,"Braga",2,"Avenida Central",25,25,0,124,124,0
10,18,2018,20,0,5,"Braga",3,"Rua de Caires",36,36,0,37,37,0
10,18,2018,20,0,5,"Braga",4,"N14 Bosch",47,47,0,48,48,0
10,18,2018,20,0,5,"Braga",5,"Avenida João Paulo II",39,39,0,9,9,0
10,18,2018,20,0,5,"Braga",6,"Avenida Padre Júlio Fragata",67,67,0,83,83,0
10,18,2018,20,0,5,"Braga",7,"Rua Nova Santa Cruz",44,44,0,39,39,0
10,18,2018,20,0,5,"Braga",8,"Rua Costa Gomes",41,41,0,42,42,0
10,18,2018,21,0,5,"Braga",1,"Avenida da Liberdade",25,25,0,124,124,0
10,18,2018,21,0,5,"Braga",2,"Avenida Central",25,25,0,124,124,0
10,18,2018,21,0,5,"Braga",3,"Rua de Caires",36,36,0,37,37,0
10,18,2018,21,0,5,"Braga",4,"N14 Bosch",47,47,0,48,48,0
10,18,2018,21,0,5,"Braga",5,"Avenida João Paulo II",39,39,0,9,9,0
10,18,2018,21,0,5,"Braga",6,"Avenida Padre Júlio Fragata",67,67,0,83,83,0
10,18,2018,21,0,5,"Braga",7,"Rua Nova Santa Cruz",29,44,15,60,39,21
10,18,2018,21,0,5,"Braga",8,"Rua Costa Gomes",41,41,0,42,42,0
10,18,2018,22,0,5,"Braga",1,"Avenida da Liberdade",25,25,0,124,124,0
10,18,2018,22,0,5,"Braga",2,"Avenida Central",25,25,0,124,124,0
10,18,2018,22,0,5,"Braga",3,"Rua de Caires",36,36,0,37,37,0
10,18,2018,22,0,5,"Braga",4,"N14 Bosch",47,47,0,48,48,0
10,18,2018,22,0,5,"Braga",5,"Avenida João Paulo II",39,39,0,9,9,0
10,18,2018,22,0,5,"Braga",6,"Avenida Padre Júlio Fragata",67,67,0,83,83,0
10,18,2018,22,0,5,"Braga",7,"Rua Nova Santa Cruz",44,44,0,39,39,0
10,18,2018,22,0,5,"Braga",8,"Rua Costa Gomes",41,41,0,42,42,0
10,18,2018,23,0,5,"Braga",1,"Avenida da Liberdade",25,25,0,124,124,0
10,18,2018,23,0,5,"Braga",2,"Avenida Central",25,25,0,124,124,0
10,18,2018,23,0,5,"Braga",3,"Rua de Caires",36,36,0,37,37,0
10,18,2018,23,0,5,"Braga",4,"N14 Bosch",47,47,0,48,48,0
10,18,2018,23,0,5,"Braga",5,"Avenida João Paulo II",39,39,0,9,9,0
10,18,2018,23,0,5,"Braga",6,"Avenida Padre Júlio Fragata",67,67,0,83,83,0
10,18,2018,23,0,5,"Braga",7,"Rua Nova Santa Cruz",44,44,0,39,39,0
10,18,2018,23,0,5,"Braga",8,"Rua Costa Gomes",41,41,0,42,42,0
10,19,2018,0,0,6,"Braga",1,"Avenida da Liberdade",25,25,0,124,124,0
10,19,2018,0,0,6,"Braga",2,"Avenida Central",25,25,0,124,124,0
10,19,2018,0,0,6,"Braga",3,"Rua de Caires",36,36,0,37,37,0
10,19,2018,0,0,6,"Braga",4,"N14 Bosch",47,47,0,48,48,0
10,19,2018,0,0,6,"Braga",5,"Avenida João Paulo II",39,39,0,9,9,0
10,19,2018,0,0,6,"Braga",6,"Avenida Padre Júlio Fragata",67,67,0,83,83,0
10,19,2018,0,0,6,"Braga",7,"Rua Nova Santa Cruz",44,44,0,39,39,0
10,19,2018,0,0,6,"Braga",8,"Rua Costa Gomes",41,41,0,42,42,0
10,19,2018,1,0,6,"Braga",1,"Avenida da Liberdade",25,25,0,124,124,0
10,19,2018,1,0,6,"Braga",2,"Avenida Central",25,25,0,124,124,0
10,19,2018,1,0,6,"Braga",3,"Rua de Caires",36,36,0,37,37,0
10,19,2018,1,0,6,"Braga",4,"N14 Bosch",47,47,0,48,48,0
10,19,2018,1,0,6,"Braga",5,"Avenida João Paulo II",39,39,0,9,9,0
10,19,2018,1,0,6,"Braga",6,"Avenida Padre Júlio Fragata",67,67,0,83,83,0
10,19,2018,1,0,6,"Braga",7,"Rua Nova Santa Cruz",34,44,10,51,39,12
10,19,2018,1,0,6,"Braga",8,"Rua Costa Gomes",41,41,0,42,42,0
10,19,2018,2,0,6,"Braga",1,"Avenida da Liberdade",25,25,0,124,124,0
10,19,2018,2,0,6,"Braga",2,"Avenida Central",25,25,0,124,124,0
10,19,2018,2,0,6,"Braga",3,"Rua de Caires",36,36,0,37,37,0
10,19,2018,2,0,6,"Braga",4,"N14 Bosch",47,47,0,48,48,0
10,19,2018,2,0,6,"Braga",5,"Avenida João Paulo II",39,39,0,9,9,0
10,19,2018,2,0,6,"Braga",6,"Avenida Padre Júlio Fragata",67,67,0,83,83,0
10,19,2018,2,0,6,"Braga",7,"Rua Nova Santa Cruz",44,44,0,39,39,0
10,19,2018,2,0,6,"Braga",8,"Rua Costa Gomes",41,41,0,42,42,0
10,19,2018,3,0,6,"Braga",1,"Avenida da Liberdade",25,25,0,124,124,0
10,19,2018,3,0,6,"Braga",2,"Avenida Central",25,25,0,124,124,0
10,19,2018,3,0,6,"Braga",3,"Rua de Caires",36,36,0,37,37,0
10,19,2018,3,0,6,"Braga",4,"N14 Bosch",47,47,0,48,48,0
10,19,2018,3,0,6,"Braga",5,"Avenida João Paulo II",39,39,0,9,9,0
10,19,2018,3,0,6,"Braga",6,"Avenida Padre Júlio Fragata",67,67,0,83,83,0
10,19,2018,3,0,6,"Braga",7,"Rua Nova Santa Cruz",44,44,0,39,39,0
10,19,2018,3,0,6,"Braga",8,"Rua Costa Gomes",41,41,0,42,42,0
10,19,2018,4,0,6,"Braga",1,"Avenida da Liberdade",25,25,0,124,124,0
10,19,2018,4,0,6,"Braga",2,"Avenida Central",25,25,0,124,124,0
10,19,2018,4,0,6,"Braga",3,"Rua de Caires",36,36,0,37,37,0
10,19,2018,4,0,6,"Braga",4,"N14 Bosch",47,47,0,48,48,0
10,19,2018,4,0,6,"Braga",5,"Avenida João Paulo II",39,39,0,9,9,0
10,19,2018,4,0,6,"Braga",6,"Avenida Padre Júlio Fragata",67,67,0,83,83,0
10,19,2018,4,0,6,"Braga",7,"Rua Nova Santa Cruz",44,44,0,39,39,0
10,19,2018,4,0,6,"Braga",8,"Rua Costa Gomes",41,41,0,42,42,0
10,19,2018,5,0,6,"Braga",1,"Avenida da Liberdade",25,25,0,124,124,0
10,19,2018,5,0,6,"Braga",2,"Avenida Central",25,25,0,124,124,0
10,19,2018,5,0,6,"Braga",3,"Rua de Caires",36,36,0,37,37,0
10,19,2018,5,0,6,"Braga",4,"N14 Bosch",47,47,0,48,48,0
10,19,2018,5,0,6,"Braga",5,"Avenida João Paulo II",39,39,0,9,9,0
10,19,2018,5,0,6,"Braga",6,"Avenida Padre Júlio Fragata",67,67,0,83,83,0
10,19,2018,5,0,6,"Braga",7,"Rua Nova Santa Cruz",44,44,0,39,39,0
10,19,2018,5,0,6,"Braga",8,"Rua Costa Gomes",41,41,0,42,42,0
10,19,2018,6,0,6,"Braga",1,"Avenida da Liberdade",25,25,0,124,124,0
10,19,2018,6,0,6,"Braga",2,"Avenida Central",25,25,0,124,124,0
10,19,2018,6,0,6,"Braga",3,"Rua de Caires",36,36,0,37,37,0
10,19,2018,6,0,6,"Braga",4,"N14 Bosch",47,47,0,48,48,0
10,19,2018,6,0,6,"Braga",5,"Avenida João Paulo II",39,39,0,9,9,0
10,19,2018,6,0,6,"Braga",6,"Avenida Padre Júlio Fragata",67,67,0,83,83,0
10,19,2018,6,0,6,"Braga",7,"Rua Nova Santa Cruz",44,44,0,39,39,0
10,19,2018,6,0,6,"Braga",8,"Rua Costa Gomes",41,41,0,42,42,0
10,19,2018,7,0,6,"Braga",1,"Avenida da Liberdade",25,25,0,124,124,0
10,19,2018,7,0,6,"Braga",2,"Avenida Central",25,25,0,124,124,0
10,19,2018,7,0,6,"Braga",3,"Rua de Caires",15,36,21,90,37,53
10,19,2018,7,0,6,"Braga",4,"N14 Bosch",36,47,11,62,48,14
10,19,2018,7,0,6,"Braga",5,"Avenida João Paulo II",39,39,0,9,9,0
10,19,2018,7,0,6,"Braga",6,"Avenida Padre Júlio Fragata",67,67,0,83,83,0
10,19,2018,7,0,6,"Braga",7,"Rua Nova Santa Cruz",44,44,0,39,39,0
10,19,2018,7,0,6,"Braga",8,"Rua Costa Gomes",41,41,0,42,42,0
10,19,2018,8,0,6,"Braga",1,"Avenida da Liberdade",15,25,10,207,124,83
10,19,2018,8,0,6,"Braga",2,"Avenida Central",15,25,10,207,124,83
10,19,2018,8,0,6,"Braga",3,"Rua de Caires",16,36,20,84,37,47
10,19,2018,8,0,6,"Braga",4,"N14 Bosch",30,47,17,75,48,27
10,19,2018,8,0,6,"Braga",5,"Avenida João Paulo II",39,39,0,9,9,0
10,19,2018,8,0,6,"Braga",6,"Avenida Padre Júlio Fragata",40,67,27,139,83,56
10,19,2018,8,0,6,"Braga",7,"Rua Nova Santa Cruz",2,44,42,864,39,825
10,19,2018,8,0,6,"Braga",8,"Rua Costa Gomes",41,41,0,42,42,0
10,19,2018,9,0,6,"Braga",1,"Avenida da Liberdade",20,25,5,155,124,31
10,19,2018,9,0,6,"Braga",2,"Avenida Central",20,25,5,155,124,31
10,19,2018,9,0,6,"Braga",3,"Rua de Caires",22,36,14,61,37,24
10,19,2018,9,0,6,"Braga",4,"N14 Bosch",35,47,12,64,48,16
10,19,2018,9,0,6,"Braga",5,"Avenida João Paulo II",39,39,0,9,9,0
10,19,2018,9,0,6,"Braga",6,"Avenida Padre Júlio Fragata",67,67,0,83,83,0
10,19,2018,9,0,6,"Braga",7,"Rua Nova Santa Cruz",19,44,25,91,39,52
10,19,2018,9,0,6,"Braga",8,"Rua Costa Gomes",41,41,0,42,42,0
10,19,2018,10,0,6,"Braga",1,"Avenida da Liberdade",25,25,0,124,124,0
10,19,2018,10,0,6,"Braga",2,"Avenida Central",25,25,0,124,124,0
10,19,2018,10,0,6,"Braga",3,"Rua de Caires",36,36,0,37,37,0
10,19,2018,10,0,6,"Braga",4,"N14 Bosch",47,47,0,48,48,0
10,19,2018,10,0,6,"Braga",5,"Avenida João Paulo II",39,39,0,9,9,0
10,19,2018,10,0,6,"Braga",6,"Avenida Padre Júlio Fragata",67,67,0,83,83,0
10,19,2018,10,0,6,"Braga",7,"Rua Nova Santa Cruz",31,44,13,56,39,17
10,19,2018,10,0,6,"Braga",8,"Rua Costa Gomes",41,41,0,42,42,0
10,19,2018,11,0,6,"Braga",1,"Avenida da Liberdade",19,25,6,163,124,39
10,19,2018,11,0,6,"Braga",2,"Avenida Central",19,25,6,163,124,39
10,19,2018,11,0,6,"Braga",3,"Rua de Caires",26,36,10,52,37,15
10,19,2018,11,0,6,"Braga",4,"N14 Bosch",35,47,12,64,48,16
10,19,2018,11,0,6,"Braga",5,"Avenida João Paulo II",39,39,0,9,9,0
10,19,2018,11,0,6,"Braga",6,"Avenida Padre Júlio Fragata",67,67,0,83,83,0
10,19,2018,11,0,6,"Braga",7,"Rua Nova Santa Cruz",44,44,0,39,39,0
10,19,2018,11,0,6,"Braga",8,"Rua Costa Gomes",32,41,9,54,42,12
10,19,2018,12,0,6,"Braga",1,"Avenida da Liberdade",25,25,0,124,124,0
10,19,2018,12,0,6,"Braga",2,"Avenida Central",25,25,0,124,124,0
10,19,2018,12,0,6,"Braga",3,"Rua de Caires",36,36,0,37,37,0
10,19,2018,12,0,6,"Braga",4,"N14 Bosch",23,47,24,98,48,50
10,19,2018,12,0,6,"Braga",5,"Avenida João Paulo II",39,39,0,9,9,0
10,19,2018,12,0,6,"Braga",6,"Avenida Padre Júlio Fragata",67,67,0,83,83,0
10,19,2018,12,0,6,"Braga",7,"Rua Nova Santa Cruz",23,44,21,75,39,36
10,19,2018,12,0,6,"Braga",8,"Rua Costa Gomes",41,41,0,42,42,0
10,19,2018,13,0,6,"Braga",1,"Avenida da Liberdade",15,25,10,207,124,83
10,19,2018,13,0,6,"Braga",2,"Avenida Central",15,25,10,207,124,83
10,19,2018,13,0,6,"Braga",3,"Rua de Caires",25,36,11,54,37,17
10,19,2018,13,0,6,"Braga",4,"N14 Bosch",19,47,28,118,48,70
10,19,2018,13,0,6,"Braga",5,"Avenida João Paulo II",39,39,0,9,9,0
10,19,2018,13,0,6,"Braga",6,"Avenida Padre Júlio Fragata",67,67,0,83,83,0
10,19,2018,13,0,6,"Braga",7,"Rua Nova Santa Cruz",15,44,29,115,39,76
10,19,2018,13,0,6,"Braga",8,"Rua Costa Gomes",28,41,13,62,42,20
10,19,2018,14,0,6,"Braga",1,"Avenida da Liberdade",19,25,6,163,124,39
10,19,2018,14,0,6,"Braga",2,"Avenida Central",19,25,6,163,124,39
10,19,2018,14,0,6,"Braga",3,"Rua de Caires",26,36,10,52,37,15
10,19,2018,14,0,6,"Braga",4,"N14 Bosch",18,47,29,125,48,77
10,19,2018,14,0,6,"Braga",5,"Avenida João Paulo II",39,39,0,9,9,0
10,19,2018,14,0,6,"Braga",6,"Avenida Padre Júlio Fragata",67,67,0,83,83,0
10,19,2018,14,0,6,"Braga",7,"Rua Nova Santa Cruz",29,44,15,60,39,21
10,19,2018,14,0,6,"Braga",8,"Rua Costa Gomes",30,41,11,58,42,16
10,19,2018,15,0,6,"Braga",1,"Avenida da Liberdade",17,25,8,182,124,58
10,19,2018,15,0,6,"Braga",2,"Avenida Central",17,25,8,182,124,58
10,19,2018,15,0,6,"Braga",3,"Rua de Caires",22,36,14,61,37,24
10,19,2018,15,0,6,"Braga",4,"N14 Bosch",26,47,21,86,48,38
10,19,2018,15,0,6,"Braga",5,"Avenida João Paulo II",29,39,10,12,9,3
10,19,2018,15,0,6,"Braga",6,"Avenida Padre Júlio Fragata",67,67,0,83,83,0
10,19,2018,15,0,6,"Braga",7,"Rua Nova Santa Cruz",19,44,25,91,39,52
10,19,2018,15,0,6,"Braga",8,"Rua Costa Gomes",28,41,13,62,42,20
10,19,2018,16,0,6,"Braga",1,"Avenida da Liberdade",19,25,6,163,124,39
10,19,2018,16,0,6,"Braga",2,"Avenida Central",19,25,6,163,124,39
10,19,2018,16,0,6,"Braga",3,"Rua de Caires",36,36,0,37,37,0
10,19,2018,16,0,6,"Braga",4,"N14 Bosch",20,47,27,112,48,64
10,19,2018,16,0,6,"Braga",5,"Avenida João Paulo II",39,39,0,9,9,0
10,19,2018,16,0,6,"Braga",6,"Avenida Padre Júlio Fragata",45,67,22,124,83,41
10,19,2018,16,0,6,"Braga",7,"Rua Nova Santa Cruz",18,44,26,96,39,57
10,19,2018,16,0,6,"Braga",8,"Rua Costa Gomes",18,41,23,96,42,54
10,19,2018,17,0,6,"Braga",1,"Avenida da Liberdade",11,25,14,282,124,158
10,19,2018,17,0,6,"Braga",2,"Avenida Central",11,25,14,282,124,158
10,19,2018,17,0,6,"Braga",3,"Rua de Caires",20,36,16,67,37,30
10,19,2018,17,0,6,"Braga",4,"N14 Bosch",13,47,34,173,48,125
10,19,2018,17,0,6,"Braga",5,"Avenida João Paulo II",16,39,23,22,9,13
10,19,2018,17,0,6,"Braga",6,"Avenida Padre Júlio Fragata",24,67,43,232,83,149
10,19,2018,17,0,6,"Braga",7,"Rua Nova Santa Cruz",22,44,22,79,39,40
10,19,2018,17,0,6,"Braga",8,"Rua Costa Gomes",10,41,31,173,42,131
10,19,2018,18,0,6,"Braga",1,"Avenida da Liberdade",19,25,6,163,124,39
10,19,2018,18,0,6,"Braga",2,"Avenida Central",19,25,6,163,124,39
10,19,2018,18,0,6,"Braga",3,"Rua de Caires",15,36,21,90,37,53
10,19,2018,18,0,6,"Braga",4,"N14 Bosch",17,47,30,132,48,84
10,19,2018,18,0,6,"Braga",5,"Avenida João Paulo II",39,39,0,9,9,0
10,19,2018,18,0,6,"Braga",6,"Avenida Padre Júlio Fragata",29,67,38,192,83,109
10,19,2018,18,0,6,"Braga",7,"Rua Nova Santa Cruz",19,44,25,91,39,52
10,19,2018,18,0,6,"Braga",8,"Rua Costa Gomes",11,41,30,157,42,115
10,19,2018,19,0,6,"Braga",1,"Avenida da Liberdade",25,25,0,124,124,0
10,19,2018,19,0,6,"Braga",2,"Avenida Central",25,25,0,124,124,0
10,19,2018,19,0,6,"Braga",3,"Rua de Caires",24,36,12,56,37,19
10,19,2018,19,0,6,"Braga",4,"N14 Bosch",28,47,19,80,48,32
10,19,2018,19,0,6,"Braga",5,"Avenida João Paulo II",25,39,14,14,9,5
10,19,2018,19,0,6,"Braga",6,"Avenida Padre Júlio Fragata",45,67,22,124,83,41
10,19,2018,19,0,6,"Braga",7,"Rua Nova Santa Cruz",8,44,36,216,39,177
10,19,2018,19,0,6,"Braga",8,"Rua Costa Gomes",41,41,0,42,42,0
10,19,2018,20,0,6,"Braga",1,"Avenida da Liberdade",25,25,0,124,124,0
10,19,2018,20,0,6,"Braga",2,"Avenida Central",25,25,0,124,124,0
10,19,2018,20,0,6,"Braga",3,"Rua de Caires",36,36,0,37,37,0
10,19,2018,20,0,6,"Braga",4,"N14 Bosch",47,47,0,48,48,0
10,19,2018,20,0,6,"Braga",5,"Avenida João Paulo II",39,39,0,9,9,0
10,19,2018,20,0,6,"Braga",6,"Avenida Padre Júlio Fragata",67,67,0,83,83,0
10,19,2018,20,0,6,"Braga",7,"Rua Nova Santa Cruz",32,44,12,54,39,15
10,19,2018,20,0,6,"Braga",8,"Rua Costa Gomes",41,41,0,42,42,0
10,19,2018,21,0,6,"Braga",1,"Avenida da Liberdade",25,25,0,124,124,0
10,19,2018,21,0,6,"Braga",2,"Avenida Central",25,25,0,124,124,0
10,19,2018,21,0,6,"Braga",3,"Rua de Caires",36,36,0,37,37,0
10,19,2018,21,0,6,"Braga",4,"N14 Bosch",47,47,0,48,48,0
10,19,2018,21,0,6,"Braga",5,"Avenida João Paulo II",39,39,0,9,9,0
10,19,2018,21,0,6,"Braga",6,"Avenida Padre Júlio Fragata",67,67,0,83,83,0
10,19,2018,21,0,6,"Braga",7,"Rua Nova Santa Cruz",44,44,0,39,39,0
10,19,2018,21,0,6,"Braga",8,"Rua Costa Gomes",41,41,0,42,42,0
10,19,2018,22,0,6,"Braga",1,"Avenida da Liberdade",25,25,0,124,124,0
10,19,2018,22,0,6,"Braga",2,"Avenida Central",25,25,0,124,124,0
10,19,2018,22,0,6,"Braga",3,"Rua de Caires",36,36,0,37,37,0
10,19,2018,22,0,6,"Braga",4,"N14 Bosch",47,47,0,48,48,0
10,19,2018,22,0,6,"Braga",5,"Avenida João Paulo II",39,39,0,9,9,0
10,19,2018,22,0,6,"Braga",6,"Avenida Padre Júlio Fragata",67,67,0,83,83,0
10,19,2018,22,0,6,"Braga",7,"Rua Nova Santa Cruz",44,44,0,39,39,0
10,19,2018,22,0,6,"Braga",8,"Rua Costa Gomes",31,41,10,56,42,14
10,19,2018,23,0,6,"Braga",1,"Avenida da Liberdade",25,25,0,124,124,0
10,19,2018,23,0,6,"Braga",2,"Avenida Central",25,25,0,124,124,0
10,19,2018,23,0,6,"Braga",3,"Rua de Caires",36,36,0,37,37,0
10,19,2018,23,0,6,"Braga",4,"N14 Bosch",47,47,0,48,48,0
10,19,2018,23,0,6,"Braga",5,"Avenida João Paulo II",39,39,0,9,9,0
10,19,2018,23,0,6,"Braga",6,"Avenida Padre Júlio Fragata",67,67,0,83,83,0
10,19,2018,23,0,6,"Braga",7,"Rua Nova Santa Cruz",26,44,18,66,39,27
10,19,2018,23,0,6,"Braga",8,"Rua Costa Gomes",41,41,0,42,42,0
10,20,2018,0,0,7,"Braga",1,"Avenida da Liberdade",25,25,0,124,124,0
10,20,2018,0,0,7,"Braga",2,"Avenida Central",25,25,0,124,124,0
10,20,2018,0,0,7,"Braga",3,"Rua de Caires",36,36,0,37,37,0
10,20,2018,0,0,7,"Braga",4,"N14 Bosch",47,47,0,48,48,0
10,20,2018,0,0,7,"Braga",5,"Avenida João Paulo II",39,39,0,9,9,0
10,20,2018,0,0,7,"Braga",6,"Avenida Padre Júlio Fragata",67,67,0,83,83,0
10,20,2018,0,0,7,"Braga",7,"Rua Nova Santa Cruz",14,44,30,123,39,84
10,20,2018,0,0,7,"Braga",8,"Rua Costa Gomes",41,41,0,42,42,0
10,20,2018,1,0,7,"Braga",1,"Avenida da Liberdade",25,25,0,124,124,0
10,20,2018,1,0,7,"Braga",2,"Avenida Central",25,25,0,124,124,0
10,20,2018,1,0,7,"Braga",3,"Rua de Caires",36,36,0,37,37,0
10,20,2018,1,0,7,"Braga",4,"N14 Bosch",47,47,0,48,48,0
10,20,2018,1,0,7,"Braga",5,"Avenida João Paulo II",39,39,0,9,9,0
10,20,2018,1,0,7,"Braga",6,"Avenida Padre Júlio Fragata",67,67,0,83,83,0
10,20,2018,1,0,7,"Braga",7,"Rua Nova Santa Cruz",18,44,26,96,39,57
10,20,2018,1,0,7,"Braga",8,"Rua Costa Gomes",41,41,0,42,42,0
10,20,2018,2,0,7,"Braga",1,"Avenida da Liberdade",25,25,0,124,124,0
10,20,2018,2,0,7,"Braga",2,"Avenida Central",25,25,0,124,124,0
10,20,2018,2,0,7,"Braga",3,"Rua de Caires",36,36,0,37,37,0
10,20,2018,2,0,7,"Braga",4,"N14 Bosch",47,47,0,48,48,0
10,20,2018,2,0,7,"Braga",5,"Avenida João Paulo II",39,39,0,9,9,0
10,20,2018,2,0,7,"Braga",6,"Avenida Padre Júlio Fragata",67,67,0,83,83,0
10,20,2018,2,0,7,"Braga",7,"Rua Nova Santa Cruz",44,44,0,39,39,0
10,20,2018,2,0,7,"Braga",8,"Rua Costa Gomes",41,41,0,42,42,0
10,20,2018,3,0,7,"Braga",1,"Avenida da Liberdade",25,25,0,124,124,0
10,20,2018,3,0,7,"Braga",2,"Avenida Central",25,25,0,124,124,0
10,20,2018,3,0,7,"Braga",3,"Rua de Caires",36,36,0,37,37,0
10,20,2018,3,0,7,"Braga",4,"N14 Bosch",47,47,0,48,48,0
10,20,2018,3,0,7,"Braga",5,"Avenida João Paulo II",39,39,0,9,9,0
10,20,2018,3,0,7,"Braga",6,"Avenida Padre Júlio Fragata",67,67,0,83,83,0
10,20,2018,3,0,7,"Braga",7,"Rua Nova Santa Cruz",44,44,0,39,39,0
10,20,2018,3,0,7,"Braga",8,"Rua Costa Gomes",41,41,0,42,42,0
10,20,2018,4,0,7,"Braga",1,"Avenida da Liberdade",25,25,0,124,124,0
10,20,2018,4,0,7,"Braga",2,"Avenida Central",25,25,0,124,124,0
10,20,2018,4,0,7,"Braga",3,"Rua de Caires",36,36,0,37,37,0
10,20,2018,4,0,7,"Braga",4,"N14 Bosch",47,47,0,48,48,0
10,20,2018,4,0,7,"Braga",5,"Avenida João Paulo II",39,39,0,9,9,0
10,20,2018,4,0,7,"Braga",6,"Avenida Padre Júlio Fragata",67,67,0,83,83,0
10,20,2018,4,0,7,"Braga",7,"Rua Nova Santa Cruz",44,44,0,39,39,0
10,20,2018,4,0,7,"Braga",8,"Rua Costa Gomes",41,41,0,42,42,0
10,20,2018,5,0,7,"Braga",1,"Avenida da Liberdade",25,25,0,124,124,0
10,20,2018,5,0,7,"Braga",2,"Avenida Central",25,25,0,124,124,0
10,20,2018,5,0,7,"Braga",3,"Rua de Caires",36,36,0,37,37,0
10,20,2018,5,0,7,"Braga",4,"N14 Bosch",47,47,0,48,48,0
10,20,2018,5,0,7,"Braga",5,"Avenida João Paulo II",39,39,0,9,9,0
10,20,2018,5,0,7,"Braga",6,"Avenida Padre Júlio Fragata",67,67,0,83,83,0
10,20,2018,5,0,7,"Braga",7,"Rua Nova Santa Cruz",44,44,0,39,39,0
10,20,2018,5,0,7,"Braga",8,"Rua Costa Gomes",41,41,0,42,42,0
10,20,2018,6,0,7,"Braga",1,"Avenida da Liberdade",25,25,0,124,124,0
10,20,2018,6,0,7,"Braga",2,"Avenida Central",25,25,0,124,124,0
10,20,2018,6,0,7,"Braga",3,"Rua de Caires",36,36,0,37,37,0
10,20,2018,6,0,7,"Braga",4,"N14 Bosch",47,47,0,48,48,0
10,20,2018,6,0,7,"Braga",5,"Avenida João Paulo II",39,39,0,9,9,0
10,20,2018,6,0,7,"Braga",6,"Avenida Padre Júlio Fragata",67,67,0,83,83,0
10,20,2018,6,0,7,"Braga",7,"Rua Nova Santa Cruz",44,44,0,39,39,0
10,20,2018,6,0,7,"Braga",8,"Rua Costa Gomes",41,41,0,42,42,0
10,20,2018,7,0,7,"Braga",1,"Avenida da Liberdade",25,25,0,124,124,0
10,20,2018,7,0,7,"Braga",2,"Avenida Central",25,25,0,124,124,0
10,20,2018,7,0,7,"Braga",3,"Rua de Caires",36,36,0,37,37,0
10,20,2018,7,0,7,"Braga",4,"N14 Bosch",47,47,0,48,48,0
10,20,2018,7,0,7,"Braga",5,"Avenida João Paulo II",39,39,0,9,9,0
10,20,2018,7,0,7,"Braga",6,"Avenida Padre Júlio Fragata",67,67,0,83,83,0
10,20,2018,7,0,7,"Braga",7,"Rua Nova Santa Cruz",44,44,0,39,39,0
10,20,2018,7,0,7,"Braga",8,"Rua Costa Gomes",41,41,0,42,42,0
10,20,2018,8,0,7,"Braga",1,"Avenida da Liberdade",25,25,0,124,124,0
10,20,2018,8,0,7,"Braga",2,"Avenida Central",25,25,0,124,124,0
10,20,2018,8,0,7,"Braga",3,"Rua de Caires",36,36,0,37,37,0
10,20,2018,8,0,7,"Braga",4,"N14 Bosch",47,47,0,48,48,0
10,20,2018,8,0,7,"Braga",5,"Avenida João Paulo II",39,39,0,9,9,0
10,20,2018,8,0,7,"Braga",6,"Avenida Padre Júlio Fragata",67,67,0,83,83,0
10,20,2018,8,0,7,"Braga",7,"Rua Nova Santa Cruz",44,44,0,39,39,0
10,20,2018,8,0,7,"Braga",8,"Rua Costa Gomes",41,41,0,42,42,0
10,20,2018,9,0,7,"Braga",1,"Avenida da Liberdade",25,25,0,124,124,0
10,20,2018,9,0,7,"Braga",2,"Avenida Central",25,25,0,124,124,0
10,20,2018,9,0,7,"Braga",3,"Rua de Caires",27,36,9,50,37,13
10,20,2018,9,0,7,"Braga",4,"N14 Bosch",47,47,0,48,48,0
10,20,2018,9,0,7,"Braga",5,"Avenida João Paulo II",39,39,0,9,9,0
10,20,2018,9,0,7,"Braga",6,"Avenida Padre Júlio Fragata",67,67,0,83,83,0
10,20,2018,9,0,7,"Braga",7,"Rua Nova Santa Cruz",44,44,0,39,39,0
10,20,2018,9,0,7,"Braga",8,"Rua Costa Gomes",32,41,9,54,42,12
10,20,2018,10,0,7,"Braga",1,"Avenida da Liberdade",19,25,6,163,124,39
10,20,2018,10,0,7,"Braga",2,"Avenida Central",19,25,6,163,124,39
10,20,2018,10,0,7,"Braga",3,"Rua de Caires",23,36,13,59,37,22
10,20,2018,10,0,7,"Braga",4,"N14 Bosch",25,47,22,90,48,42
10,20,2018,10,0,7,"Braga",5,"Avenida João Paulo II",39,39,0,9,9,0
10,20,2018,10,0,7,"Braga",6,"Avenida Padre Júlio Fragata",67,67,0,83,83,0
10,20,2018,10,0,7,"Braga",7,"Rua Nova Santa Cruz",29,44,15,60,39,21
10,20,2018,10,0,7,"Braga",8,"Rua Costa Gomes",41,41,0,42,42,0
10,20,2018,11,0,7,"Braga",1,"Avenida da Liberdade",15,25,10,207,124,83
10,20,2018,11,0,7,"Braga",2,"Avenida Central",15,25,10,207,124,83
10,20,2018,11,0,7,"Braga",3,"Rua de Caires",25,36,11,54,37,17
10,20,2018,11,0,7,"Braga",4,"N14 Bosch",18,47,29,125,48,77
10,20,2018,11,0,7,"Braga",5,"Avenida João Paulo II",29,39,10,12,9,3
10,20,2018,11,0,7,"Braga",6,"Avenida Padre Júlio Fragata",67,67,0,83,83,0
10,20,2018,11,0,7,"Braga",7,"Rua Nova Santa Cruz",44,44,0,39,39,0
10,20,2018,11,0,7,"Braga",8,"Rua Costa Gomes",41,41,0,42,42,0
10,20,2018,12,0,7,"Braga",1,"Avenida da Liberdade",25,25,0,124,124,0
10,20,2018,12,0,7,"Braga",2,"Avenida Central",25,25,0,124,124,0
10,20,2018,12,0,7,"Braga",3,"Rua de Caires",24,36,12,56,37,19
10,20,2018,12,0,7,"Braga",4,"N14 Bosch",47,47,0,48,48,0
10,20,2018,12,0,7,"Braga",5,"Avenida João Paulo II",39,39,0,9,9,0
10,20,2018,12,0,7,"Braga",6,"Avenida Padre Júlio Fragata",67,67,0,83,83,0
10,20,2018,12,0,7,"Braga",7,"Rua Nova Santa Cruz",44,44,0,39,39,0
10,20,2018,12,0,7,"Braga",8,"Rua Costa Gomes",30,41,11,58,42,16
10,20,2018,13,0,7,"Braga",1,"Avenida da Liberdade",25,25,0,124,124,0
10,20,2018,13,0,7,"Braga",2,"Avenida Central",25,25,0,124,124,0
10,20,2018,13,0,7,"Braga",3,"Rua de Caires",25,36,11,54,37,17
10,20,2018,13,0,7,"Braga",4,"N14 Bosch",47,47,0,48,48,0
10,20,2018,13,0,7,"Braga",5,"Avenida João Paulo II",39,39,0,9,9,0
10,20,2018,13,0,7,"Braga",6,"Avenida Padre Júlio Fragata",67,67,0,83,83,0
10,20,2018,13,0,7,"Braga",7,"Rua Nova Santa Cruz",44,44,0,39,39,0
10,20,2018,13,0,7,"Braga",8,"Rua Costa Gomes",28,41,13,62,42,20
10,20,2018,14,0,7,"Braga",1,"Avenida da Liberdade",25,25,0,124,124,0
10,20,2018,14,0,7,"Braga",2,"Avenida Central",25,25,0,124,124,0
10,20,2018,14,0,7,"Braga",3,"Rua de Caires",22,36,14,61,37,24
10,20,2018,14,0,7,"Braga",4,"N14 Bosch",47,47,0,48,48,0
10,20,2018,14,0,7,"Braga",5,"Avenida João Paulo II",39,39,0,9,9,0
10,20,2018,14,0,7,"Braga",6,"Avenida Padre Júlio Fragata",67,67,0,83,83,0
10,20,2018,14,0,7,"Braga",7,"Rua Nova Santa Cruz",44,44,0,39,39,0
10,20,2018,14,0,7,"Braga",8,"Rua Costa Gomes",41,41,0,42,42,0
10,20,2018,15,0,7,"Braga",1,"Avenida da Liberdade",25,25,0,124,124,0
10,20,2018,15,0,7,"Braga",2,"Avenida Central",25,25,0,124,124,0
10,20,2018,15,0,7,"Braga",3,"Rua de Caires",27,36,9,50,37,13
10,20,2018,15,0,7,"Braga",4,"N14 Bosch",35,47,12,64,48,16
10,20,2018,15,0,7,"Braga",5,"Avenida João Paulo II",39,39,0,9,9,0
10,20,2018,15,0,7,"Braga",6,"Avenida Padre Júlio Fragata",67,67,0,83,83,0
10,20,2018,15,0,7,"Braga",7,"Rua Nova Santa Cruz",44,44,0,39,39,0
10,20,2018,15,0,7,"Braga",8,"Rua Costa Gomes",30,41,11,58,42,16
10,20,2018,16,0,7,"Braga",1,"Avenida da Liberdade",25,25,0,124,124,0
10,20,2018,16,0,7,"Braga",2,"Avenida Central",25,25,0,124,124,0
10,20,2018,16,0,7,"Braga",3,"Rua de Caires",36,36,0,37,37,0
10,20,2018,16,0,7,"Braga",4,"N14 Bosch",35,47,12,64,48,16
10,20,2018,16,0,7,"Braga",5,"Avenida João Paulo II",29,39,10,12,9,3
10,20,2018,16,0,7,"Braga",6,"Avenida Padre Júlio Fragata",43,67,24,130,83,47
10,20,2018,16,0,7,"Braga",7,"Rua Nova Santa Cruz",44,44,0,39,39,0
10,20,2018,16,0,7,"Braga",8,"Rua Costa Gomes",41,41,0,42,42,0
10,20,2018,17,0,7,"Braga",1,"Avenida da Liberdade",25,25,0,124,124,0
10,20,2018,17,0,7,"Braga",2,"Avenida Central",25,25,0,124,124,0
10,20,2018,17,0,7,"Braga",3,"Rua de Caires",36,36,0,37,37,0
10,20,2018,17,0,7,"Braga",4,"N14 Bosch",29,47,18,77,48,29
10,20,2018,17,0,7,"Braga",5,"Avenida João Paulo II",39,39,0,9,9,0
10,20,2018,17,0,7,"Braga",6,"Avenida Padre Júlio Fragata",49,67,18,114,83,31
10,20,2018,17,0,7,"Braga",7,"Rua Nova Santa Cruz",44,44,0,39,39,0
10,20,2018,17,0,7,"Braga",8,"Rua Costa Gomes",30,41,11,58,42,16
10,20,2018,18,0,7,"Braga",1,"Avenida da Liberdade",18,25,7,172,124,48
10,20,2018,18,0,7,"Braga",2,"Avenida Central",18,25,7,172,124,48
10,20,2018,18,0,7,"Braga",3,"Rua de Caires",21,36,15,64,37,27
10,20,2018,18,0,7,"Braga",4,"N14 Bosch",33,47,14,68,48,20
10,20,2018,18,0,7,"Braga",5,"Avenida João Paulo II",39,39,0,9,9,0
10,20,2018,18,0,7,"Braga",6,"Avenida Padre Júlio Fragata",52,67,15,107,83,24
10,20,2018,18,0,7,"Braga",7,"Rua Nova Santa Cruz",31,44,13,56,39,17
10,20,2018,18,0,7,"Braga",8,"Rua Costa Gomes",28,41,13,62,42,20
10,20,2018,19,0,7,"Braga",1,"Avenida da Liberdade",25,25,0,124,124,0
10,20,2018,19,0,7,"Braga",2,"Avenida Central",25,25,0,124,124,0
10,20,2018,19,0,7,"Braga",3,"Rua de Caires",14,36,22,96,37,59
10,20,2018,19,0,7,"Braga",4,"N14 Bosch",47,47,0,48,48,0
10,20,2018,19,0,7,"Braga",5,"Avenida João Paulo II",39,39,0,9,9,0
10,20,2018,19,0,7,"Braga",6,"Avenida Padre Júlio Fragata",53,67,14,105,83,22
10,20,2018,19,0,7,"Braga",7,"Rua Nova Santa Cruz",44,44,0,39,39,0
10,20,2018,19,0,7,"Braga",8,"Rua Costa Gomes",22,41,19,79,42,37
10,20,2018,20,0,7,"Braga",1,"Avenida da Liberdade",25,25,0,124,124,0
10,20,2018,20,0,7,"Braga",2,"Avenida Central",25,25,0,124,124,0
10,20,2018,20,0,7,"Braga",3,"Rua de Caires",36,36,0,37,37,0
10,20,2018,20,0,7,"Braga",4,"N14 Bosch",47,47,0,48,48,0
10,20,2018,20,0,7,"Braga",5,"Avenida João Paulo II",39,39,0,9,9,0
10,20,2018,20,0,7,"Braga",6,"Avenida Padre Júlio Fragata",67,67,0,83,83,0
10,20,2018,20,0,7,"Braga",7,"Rua Nova Santa Cruz",44,44,0,39,39,0
10,20,2018,20,0,7,"Braga",8,"Rua Costa Gomes",24,41,17,72,42,30
10,20,2018,21,0,7,"Braga",1,"Avenida da Liberdade",25,25,0,124,124,0
10,20,2018,21,0,7,"Braga",2,"Avenida Central",25,25,0,124,124,0
10,20,2018,21,0,7,"Braga",3,"Rua de Caires",36,36,0,37,37,0
10,20,2018,21,0,7,"Braga",4,"N14 Bosch",47,47,0,48,48,0
10,20,2018,21,0,7,"Braga",5,"Avenida João Paulo II",39,39,0,9,9,0
10,20,2018,21,0,7,"Braga",6,"Avenida Padre Júlio Fragata",67,67,0,83,83,0
10,20,2018,21,0,7,"Braga",7,"Rua Nova Santa Cruz",44,44,0,39,39,0
10,20,2018,21,0,7,"Braga",8,"Rua Costa Gomes",41,41,0,42,42,0
10,20,2018,22,0,7,"Braga",1,"Avenida da Liberdade",25,25,0,124,124,0
10,20,2018,22,0,7,"Braga",2,"Avenida Central",25,25,0,124,124,0
10,20,2018,22,0,7,"Braga",3,"Rua de Caires",36,36,0,37,37,0
10,20,2018,22,0,7,"Braga",4,"N14 Bosch",47,47,0,48,48,0
10,20,2018,22,0,7,"Braga",5,"Avenida João Paulo II",39,39,0,9,9,0
10,20,2018,22,0,7,"Braga",6,"Avenida Padre Júlio Fragata",67,67,0,83,83,0
10,20,2018,22,0,7,"Braga",7,"Rua Nova Santa Cruz",34,44,10,51,39,12
10,20,2018,22,0,7,"Braga",8,"Rua Costa Gomes",41,41,0,42,42,0
10,20,2018,23,0,7,"Braga",1,"Avenida da Liberdade",25,25,0,124,124,0
10,20,2018,23,0,7,"Braga",2,"Avenida Central",25,25,0,124,124,0
10,20,2018,23,0,7,"Braga",3,"Rua de Caires",36,36,0,37,37,0
10,20,2018,23,0,7,"Braga",4,"N14 Bosch",47,47,0,48,48,0
10,20,2018,23,0,7,"Braga",5,"Avenida João Paulo II",39,39,0,9,9,0
10,20,2018,23,0,7,"Braga",6,"Avenida Padre Júlio Fragata",67,67,0,83,83,0
10,20,2018,23,0,7,"Braga",7,"Rua Nova Santa Cruz",44,44,0,39,39,0
10,20,2018,23,0,7,"Braga",8,"Rua Costa Gomes",41,41,0,42,42,0
10,21,2018,0,0,8,"Braga",1,"Avenida da Liberdade",25,25,0,124,124,0
10,21,2018,0,0,8,"Braga",2,"Avenida Central",25,25,0,124,124,0
10,21,2018,0,0,8,"Braga",3,"Rua de Caires",36,36,0,37,37,0
10,21,2018,0,0,8,"Braga",4,"N14 Bosch",47,47,0,48,48,0
10,21,2018,0,0,8,"Braga",5,"Avenida João Paulo II",39,39,0,9,9,0
10,21,2018,0,0,8,"Braga",6,"Avenida Padre Júlio Fragata",67,67,0,83,83,0
10,21,2018,0,0,8,"Braga",7,"Rua Nova Santa Cruz",44,44,0,39,39,0
10,21,2018,0,0,8,"Braga",8,"Rua Costa Gomes",41,41,0,42,42,0
10,21,2018,1,0,8,"Braga",1,"Avenida da Liberdade",25,25,0,124,124,0
10,21,2018,1,0,8,"Braga",2,"Avenida Central",25,25,0,124,124,0
10,21,2018,1,0,8,"Braga",3,"Rua de Caires",36,36,0,37,37,0
10,21,2018,1,0,8,"Braga",4,"N14 Bosch",47,47,0,48,48,0
10,21,2018,1,0,8,"Braga",5,"Avenida João Paulo II",39,39,0,9,9,0
10,21,2018,1,0,8,"Braga",6,"Avenida Padre Júlio Fragata",67,67,0,83,83,0
10,21,2018,1,0,8,"Braga",7,"Rua Nova Santa Cruz",44,44,0,39,39,0
10,21,2018,1,0,8,"Braga",8,"Rua Costa Gomes",41,41,0,42,42,0
10,21,2018,2,0,8,"Braga",1,"Avenida da Liberdade",25,25,0,124,124,0
10,21,2018,2,0,8,"Braga",2,"Avenida Central",25,25,0,124,124,0
10,21,2018,2,0,8,"Braga",3,"Rua de Caires",36,36,0,37,37,0
10,21,2018,2,0,8,"Braga",4,"N14 Bosch",47,47,0,48,48,0
10,21,2018,2,0,8,"Braga",5,"Avenida João Paulo II",39,39,0,9,9,0
10,21,2018,2,0,8,"Braga",6,"Avenida Padre Júlio Fragata",67,67,0,83,83,0
10,21,2018,2,0,8,"Braga",7,"Rua Nova Santa Cruz",44,44,0,39,39,0
10,21,2018,2,0,8,"Braga",8,"Rua Costa Gomes",41,41,0,42,42,0
10,21,2018,3,0,8,"Braga",1,"Avenida da Liberdade",25,25,0,124,124,0
10,21,2018,3,0,8,"Braga",2,"Avenida Central",25,25,0,124,124,0
10,21,2018,3,0,8,"Braga",3,"Rua de Caires",36,36,0,37,37,0
10,21,2018,3,0,8,"Braga",4,"N14 Bosch",47,47,0,48,48,0
10,21,2018,3,0,8,"Braga",5,"Avenida João Paulo II",39,39,0,9,9,0
10,21,2018,3,0,8,"Braga",6,"Avenida Padre Júlio Fragata",67,67,0,83,83,0
10,21,2018,3,0,8,"Braga",7,"Rua Nova Santa Cruz",44,44,0,39,39,0
10,21,2018,3,0,8,"Braga",8,"Rua Costa Gomes",41,41,0,42,42,0
10,21,2018,4,0,8,"Braga",1,"Avenida da Liberdade",25,25,0,124,124,0
10,21,2018,4,0,8,"Braga",2,"Avenida Central",25,25,0,124,124,0
10,21,2018,4,0,8,"Braga",3,"Rua de Caires",36,36,0,37,37,0
10,21,2018,4,0,8,"Braga",4,"N14 Bosch",47,47,0,48,48,0
10,21,2018,4,0,8,"Braga",5,"Avenida João Paulo II",39,39,0,9,9,0
10,21,2018,4,0,8,"Braga",6,"Avenida Padre Júlio Fragata",67,67,0,83,83,0
10,21,2018,4,0,8,"Braga",7,"Rua Nova Santa Cruz",44,44,0,39,39,0
10,21,2018,4,0,8,"Braga",8,"Rua Costa Gomes",41,41,0,42,42,0
10,21,2018,5,0,8,"Braga",1,"Avenida da Liberdade",25,25,0,124,124,0
10,21,2018,5,0,8,"Braga",2,"Avenida Central",25,25,0,124,124,0
10,21,2018,5,0,8,"Braga",3,"Rua de Caires",36,36,0,37,37,0
10,21,2018,5,0,8,"Braga",4,"N14 Bosch",47,47,0,48,48,0
10,21,2018,5,0,8,"Braga",5,"Avenida João Paulo II",39,39,0,9,9,0
10,21,2018,5,0,8,"Braga",6,"Avenida Padre Júlio Fragata",67,67,0,83,83,0
10,21,2018,5,0,8,"Braga",7,"Rua Nova Santa Cruz",44,44,0,39,39,0
10,21,2018,5,0,8,"Braga",8,"Rua Costa Gomes",41,41,0,42,42,0
10,21,2018,6,0,8,"Braga",1,"Avenida da Liberdade",25,25,0,124,124,0
10,21,2018,6,0,8,"Braga",2,"Avenida Central",25,25,0,124,124,0
10,21,2018,6,0,8,"Braga",3,"Rua de Caires",36,36,0,37,37,0
10,21,2018,6,0,8,"Braga",4,"N14 Bosch",47,47,0,48,48,0
10,21,2018,6,0,8,"Braga",5,"Avenida João Paulo II",39,39,0,9,9,0
10,21,2018,6,0,8,"Braga",6,"Avenida Padre Júlio Fragata",67,67,0,83,83,0
10,21,2018,6,0,8,"Braga",7,"Rua Nova Santa Cruz",44,44,0,39,39,0
10,21,2018,6,0,8,"Braga",8,"Rua Costa Gomes",41,41,0,42,42,0
10,21,2018,7,0,8,"Braga",1,"Avenida da Liberdade",25,25,0,124,124,0
10,21,2018,7,0,8,"Braga",2,"Avenida Central",25,25,0,124,124,0
10,21,2018,7,0,8,"Braga",3,"Rua de Caires",36,36,0,37,37,0
10,21,2018,7,0,8,"Braga",4,"N14 Bosch",47,47,0,48,48,0
10,21,2018,7,0,8,"Braga",5,"Avenida João Paulo II",39,39,0,9,9,0
10,21,2018,7,0,8,"Braga",6,"Avenida Padre Júlio Fragata",67,67,0,83,83,0
10,21,2018,7,0,8,"Braga",7,"Rua Nova Santa Cruz",44,44,0,39,39,0
10,21,2018,7,0,8,"Braga",8,"Rua Costa Gomes",41,41,0,42,42,0
10,21,2018,8,0,8,"Braga",1,"Avenida da Liberdade",25,25,0,124,124,0
10,21,2018,8,0,8,"Braga",2,"Avenida Central",25,25,0,124,124,0
10,21,2018,8,0,8,"Braga",3,"Rua de Caires",36,36,0,37,37,0
10,21,2018,8,0,8,"Braga",4,"N14 Bosch",47,47,0,48,48,0
10,21,2018,8,0,8,"Braga",5,"Avenida João Paulo II",39,39,0,9,9,0
10,21,2018,8,0,8,"Braga",6,"Avenida Padre Júlio Fragata",67,67,0,83,83,0
10,21,2018,8,0,8,"Braga",7,"Rua Nova Santa Cruz",44,44,0,39,39,0
10,21,2018,8,0,8,"Braga",8,"Rua Costa Gomes",41,41,0,42,42,0
10,21,2018,9,0,8,"Braga",1,"Avenida da Liberdade",25,25,0,124,124,0
10,21,2018,9,0,8,"Braga",2,"Avenida Central",25,25,0,124,124,0
10,21,2018,9,0,8,"Braga",3,"Rua de Caires",27,36,9,50,37,13
10,21,2018,9,0,8,"Braga",4,"N14 Bosch",47,47,0,48,48,0
10,21,2018,9,0,8,"Braga",5,"Avenida João Paulo II",39,39,0,9,9,0
10,21,2018,9,0,8,"Braga",6,"Avenida Padre Júlio Fragata",67,67,0,83,83,0
10,21,2018,9,0,8,"Braga",7,"Rua Nova Santa Cruz",44,44,0,39,39,0
10,21,2018,9,0,8,"Braga",8,"Rua Costa Gomes",41,41,0,42,42,0
10,21,2018,10,0,8,"Braga",1,"Avenida da Liberdade",25,25,0,124,124,0
10,21,2018,10,0,8,"Braga",2,"Avenida Central",25,25,0,124,124,0
10,21,2018,10,0,8,"Braga",3,"Rua de Caires",36,36,0,37,37,0
10,21,2018,10,0,8,"Braga",4,"N14 Bosch",47,47,0,48,48,0
10,21,2018,10,0,8,"Braga",5,"Avenida João Paulo II",39,39,0,9,9,0
10,21,2018,10,0,8,"Braga",6,"Avenida Padre Júlio Fragata",67,67,0,83,83,0
10,21,2018,10,0,8,"Braga",7,"Rua Nova Santa Cruz",44,44,0,39,39,0
10,21,2018,10,0,8,"Braga",8,"Rua Costa Gomes",41,41,0,42,42,0
10,21,2018,11,0,8,"Braga",1,"Avenida da Liberdade",25,25,0,124,124,0
10,21,2018,11,0,8,"Braga",2,"Avenida Central",25,25,0,124,124,0
10,21,2018,11,0,8,"Braga",3,"Rua de Caires",36,36,0,37,37,0
10,21,2018,11,0,8,"Braga",4,"N14 Bosch",47,47,0,48,48,0
10,21,2018,11,0,8,"Braga",5,"Avenida João Paulo II",39,39,0,9,9,0
10,21,2018,11,0,8,"Braga",6,"Avenida Padre Júlio Fragata",67,67,0,83,83,0
10,21,2018,11,0,8,"Braga",7,"Rua Nova Santa Cruz",44,44,0,39,39,0
10,21,2018,11,0,8,"Braga",8,"Rua Costa Gomes",41,41,0,42,42,0
10,21,2018,12,0,8,"Braga",1,"Avenida da Liberdade",25,25,0,124,124,0
10,21,2018,12,0,8,"Braga",2,"Avenida Central",25,25,0,124,124,0
10,21,2018,12,0,8,"Braga",3,"Rua de Caires",36,36,0,37,37,0
10,21,2018,12,0,8,"Braga",4,"N14 Bosch",47,47,0,48,48,0
10,21,2018,12,0,8,"Braga",5,"Avenida João Paulo II",39,39,0,9,9,0
10,21,2018,12,0,8,"Braga",6,"Avenida Padre Júlio Fragata",67,67,0,83,83,0
10,21,2018,12,0,8,"Braga",7,"Rua Nova Santa Cruz",44,44,0,39,39,0
10,21,2018,12,0,8,"Braga",8,"Rua Costa Gomes",41,41,0,42,42,0
10,21,2018,13,0,8,"Braga",1,"Avenida da Liberdade",25,25,0,124,124,0
10,21,2018,13,0,8,"Braga",2,"Avenida Central",25,25,0,124,124,0
10,21,2018,13,0,8,"Braga",3,"Rua de Caires",36,36,0,37,37,0
10,21,2018,13,0,8,"Braga",4,"N14 Bosch",47,47,0,48,48,0
10,21,2018,13,0,8,"Braga",5,"Avenida João Paulo II",39,39,0,9,9,0
10,21,2018,13,0,8,"Braga",6,"Avenida Padre Júlio Fragata",67,67,0,83,83,0
10,21,2018,13,0,8,"Braga",7,"Rua Nova Santa Cruz",44,44,0,39,39,0
10,21,2018,13,0,8,"Braga",8,"Rua Costa Gomes",15,41,26,115,42,73
10,21,2018,14,0,8,"Braga",1,"Avenida da Liberdade",25,25,0,124,124,0
10,21,2018,14,0,8,"Braga",2,"Avenida Central",25,25,0,124,124,0
10,21,2018,14,0,8,"Braga",3,"Rua de Caires",36,36,0,37,37,0
10,21,2018,14,0,8,"Braga",4,"N14 Bosch",47,47,0,48,48,0
10,21,2018,14,0,8,"Braga",5,"Avenida João Paulo II",39,39,0,9,9,0
10,21,2018,14,0,8,"Braga",6,"Avenida Padre Júlio Fragata",67,67,0,83,83,0
10,21,2018,14,0,8,"Braga",7,"Rua Nova Santa Cruz",44,44,0,39,39,0
10,21,2018,14,0,8,"Braga",8,"Rua Costa Gomes",41,41,0,42,42,0
10,21,2018,15,0,8,"Braga",1,"Avenida da Liberdade",19,25,6,163,124,39
10,21,2018,15,0,8,"Braga",2,"Avenida Central",19,25,6,163,124,39
10,21,2018,15,0,8,"Braga",3,"Rua de Caires",27,36,9,50,37,13
10,21,2018,15,0,8,"Braga",4,"N14 Bosch",47,47,0,48,48,0
10,21,2018,15,0,8,"Braga",5,"Avenida João Paulo II",29,39,10,12,9,3
10,21,2018,15,0,8,"Braga",6,"Avenida Padre Júlio Fragata",49,67,18,114,83,31
10,21,2018,15,0,8,"Braga",7,"Rua Nova Santa Cruz",44,44,0,39,39,0
10,21,2018,15,0,8,"Braga",8,"Rua Costa Gomes",30,41,11,58,42,16
10,21,2018,16,0,8,"Braga",1,"Avenida da Liberdade",25,25,0,124,124,0
10,21,2018,16,0,8,"Braga",2,"Avenida Central",25,25,0,124,124,0
10,21,2018,16,0,8,"Braga",3,"Rua de Caires",25,36,11,54,37,17
10,21,2018,16,0,8,"Braga",4,"N14 Bosch",47,47,0,48,48,0
10,21,2018,16,0,8,"Braga",5,"Avenida João Paulo II",11,39,28,32,9,23
10,21,2018,16,0,8,"Braga",6,"Avenida Padre Júlio Fragata",53,67,14,105,83,22
10,21,2018,16,0,8,"Braga",7,"Rua Nova Santa Cruz",44,44,0,39,39,0
10,21,2018,16,0,8,"Braga",8,"Rua Costa Gomes",41,41,0,42,42,0
10,21,2018,17,0,8,"Braga",1,"Avenida da Liberdade",19,25,6,163,124,39
10,21,2018,17,0,8,"Braga",2,"Avenida Central",19,25,6,163,124,39
10,21,2018,17,0,8,"Braga",3,"Rua de Caires",36,36,0,37,37,0
10,21,2018,17,0,8,"Braga",4,"N14 Bosch",28,47,19,80,48,32
10,21,2018,17,0,8,"Braga",5,"Avenida João Paulo II",14,39,25,25,9,16
10,21,2018,17,0,8,"Braga",6,"Avenida Padre Júlio Fragata",46,67,21,121,83,38
10,21,2018,17,0,8,"Braga",7,"Rua Nova Santa Cruz",44,44,0,39,39,0
10,21,2018,17,0,8,"Braga",8,"Rua Costa Gomes",41,41,0,42,42,0
10,21,2018,18,0,8,"Braga",1,"Avenida da Liberdade",25,25,0,124,124,0
10,21,2018,18,0,8,"Braga",2,"Avenida Central",25,25,0,124,124,0
10,21,2018,18,0,8,"Braga",3,"Rua de Caires",23,36,13,59,37,22
10,21,2018,18,0,8,"Braga",4,"N14 Bosch",35,47,12,64,48,16
10,21,2018,18,0,8,"Braga",5,"Avenida João Paulo II",28,39,11,12,9,3
10,21,2018,18,0,8,"Braga",6,"Avenida Padre Júlio Fragata",67,67,0,83,83,0
10,21,2018,18,0,8,"Braga",7,"Rua Nova Santa Cruz",44,44,0,39,39,0
10,21,2018,18,0,8,"Braga",8,"Rua Costa Gomes",41,41,0,42,42,0
10,21,2018,19,0,8,"Braga",1,"Avenida da Liberdade",25,25,0,124,124,0
10,21,2018,19,0,8,"Braga",2,"Avenida Central",25,25,0,124,124,0
10,21,2018,19,0,8,"Braga",3,"Rua de Caires",26,36,10,52,37,15
10,21,2018,19,0,8,"Braga",4,"N14 Bosch",47,47,0,48,48,0
10,21,2018,19,0,8,"Braga",5,"Avenida João Paulo II",39,39,0,9,9,0
10,21,2018,19,0,8,"Braga",6,"Avenida Padre Júlio Fragata",67,67,0,83,83,0
10,21,2018,19,0,8,"Braga",7,"Rua Nova Santa Cruz",44,44,0,39,39,0
10,21,2018,19,0,8,"Braga",8,"Rua Costa Gomes",41,41,0,42,42,0
10,21,2018,20,0,8,"Braga",1,"Avenida da Liberdade",25,25,0,124,124,0
10,21,2018,20,0,8,"Braga",2,"Avenida Central",25,25,0,124,124,0
10,21,2018,20,0,8,"Braga",3,"Rua de Caires",36,36,0,37,37,0
10,21,2018,20,0,8,"Braga",4,"N14 Bosch",47,47,0,48,48,0
10,21,2018,20,0,8,"Braga",5,"Avenida João Paulo II",39,39,0,9,9,0
10,21,2018,20,0,8,"Braga",6,"Avenida Padre Júlio Fragata",45,67,22,124,83,41
10,21,2018,20,0,8,"Braga",7,"Rua Nova Santa Cruz",44,44,0,39,39,0
10,21,2018,20,0,8,"Braga",8,"Rua Costa Gomes",41,41,0,42,42,0
10,21,2018,21,0,8,"Braga",1,"Avenida da Liberdade",25,25,0,124,124,0
10,21,2018,21,0,8,"Braga",2,"Avenida Central",25,25,0,124,124,0
10,21,2018,21,0,8,"Braga",3,"Rua de Caires",36,36,0,37,37,0
10,21,2018,21,0,8,"Braga",4,"N14 Bosch",47,47,0,48,48,0
10,21,2018,21,0,8,"Braga",5,"Avenida João Paulo II",39,39,0,9,9,0
10,21,2018,21,0,8,"Braga",6,"Avenida Padre Júlio Fragata",67,67,0,83,83,0
10,21,2018,21,0,8,"Braga",7,"Rua Nova Santa Cruz",44,44,0,39,39,0
10,21,2018,21,0,8,"Braga",8,"Rua Costa Gomes",41,41,0,42,42,0
10,21,2018,22,0,8,"Braga",1,"Avenida da Liberdade",25,25,0,124,124,0
10,21,2018,22,0,8,"Braga",2,"Avenida Central",25,25,0,124,124,0
10,21,2018,22,0,8,"Braga",3,"Rua de Caires",36,36,0,37,37,0
10,21,2018,22,0,8,"Braga",4,"N14 Bosch",47,47,0,48,48,0
10,21,2018,22,0,8,"Braga",5,"Avenida João Paulo II",39,39,0,9,9,0
10,21,2018,22,0,8,"Braga",6,"Avenida Padre Júlio Fragata",67,67,0,83,83,0
10,21,2018,22,0,8,"Braga",7,"Rua Nova Santa Cruz",44,44,0,39,39,0
10,21,2018,22,0,8,"Braga",8,"Rua Costa Gomes",41,41,0,42,42,0
10,21,2018,23,0,8,"Braga",1,"Avenida da Liberdade",25,25,0,124,124,0
10,21,2018,23,0,8,"Braga",2,"Avenida Central",25,25,0,124,124,0
10,21,2018,23,0,8,"Braga",3,"Rua de Caires",36,36,0,37,37,0
10,21,2018,23,0,8,"Braga",4,"N14 Bosch",47,47,0,48,48,0
10,21,2018,23,0,8,"Braga",5,"Avenida João Paulo II",39,39,0,9,9,0
10,21,2018,23,0,8,"Braga",6,"Avenida Padre Júlio Fragata",67,67,0,83,83,0
10,21,2018,23,0,8,"Braga",7,"Rua Nova Santa Cruz",44,44,0,39,39,0
10,21,2018,23,0,8,"Braga",8,"Rua Costa Gomes",41,41,0,42,42,0
10,22,2018,0,0,2,"Braga",1,"Avenida da Liberdade",25,25,0,124,124,0
10,22,2018,0,0,2,"Braga",2,"Avenida Central",25,25,0,124,124,0
10,22,2018,0,0,2,"Braga",3,"Rua de Caires",36,36,0,37,37,0
10,22,2018,0,0,2,"Braga",4,"N14 Bosch",47,47,0,48,48,0
10,22,2018,0,0,2,"Braga",5,"Avenida João Paulo II",39,39,0,9,9,0
10,22,2018,0,0,2,"Braga",6,"Avenida Padre Júlio Fragata",67,67,0,83,83,0
10,22,2018,0,0,2,"Braga",7,"Rua Nova Santa Cruz",44,44,0,39,39,0
10,22,2018,0,0,2,"Braga",8,"Rua Costa Gomes",41,41,0,42,42,0
10,22,2018,1,0,2,"Braga",1,"Avenida da Liberdade",25,25,0,124,124,0
10,22,2018,1,0,2,"Braga",2,"Avenida Central",25,25,0,124,124,0
10,22,2018,1,0,2,"Braga",3,"Rua de Caires",36,36,0,37,37,0
10,22,2018,1,0,2,"Braga",4,"N14 Bosch",47,47,0,48,48,0
10,22,2018,1,0,2,"Braga",5,"Avenida João Paulo II",39,39,0,9,9,0
10,22,2018,1,0,2,"Braga",6,"Avenida Padre Júlio Fragata",67,67,0,83,83,0
10,22,2018,1,0,2,"Braga",7,"Rua Nova Santa Cruz",44,44,0,39,39,0
10,22,2018,1,0,2,"Braga",8,"Rua Costa Gomes",41,41,0,42,42,0
10,22,2018,2,0,2,"Braga",1,"Avenida da Liberdade",25,25,0,124,124,0
10,22,2018,2,0,2,"Braga",2,"Avenida Central",25,25,0,124,124,0
10,22,2018,2,0,2,"Braga",3,"Rua de Caires",36,36,0,37,37,0
10,22,2018,2,0,2,"Braga",4,"N14 Bosch",47,47,0,48,48,0
10,22,2018,2,0,2,"Braga",5,"Avenida João Paulo II",39,39,0,9,9,0
10,22,2018,2,0,2,"Braga",6,"Avenida Padre Júlio Fragata",67,67,0,83,83,0
10,22,2018,2,0,2,"Braga",7,"Rua Nova Santa Cruz",44,44,0,39,39,0
10,22,2018,2,0,2,"Braga",8,"Rua Costa Gomes",41,41,0,42,42,0
10,22,2018,3,0,2,"Braga",1,"Avenida da Liberdade",25,25,0,124,124,0
10,22,2018,3,0,2,"Braga",2,"Avenida Central",25,25,0,124,124,0
10,22,2018,3,0,2,"Braga",3,"Rua de Caires",36,36,0,37,37,0
10,22,2018,3,0,2,"Braga",4,"N14 Bosch",47,47,0,48,48,0
10,22,2018,3,0,2,"Braga",5,"Avenida João Paulo II",39,39,0,9,9,0
10,22,2018,3,0,2,"Braga",6,"Avenida Padre Júlio Fragata",67,67,0,83,83,0
10,22,2018,3,0,2,"Braga",7,"Rua Nova Santa Cruz",44,44,0,39,39,0
10,22,2018,3,0,2,"Braga",8,"Rua Costa Gomes",41,41,0,42,42,0
10,22,2018,4,0,2,"Braga",1,"Avenida da Liberdade",25,25,0,124,124,0
10,22,2018,4,0,2,"Braga",2,"Avenida Central",25,25,0,124,124,0
10,22,2018,4,0,2,"Braga",3,"Rua de Caires",36,36,0,37,37,0
10,22,2018,4,0,2,"Braga",4,"N14 Bosch",47,47,0,48,48,0
10,22,2018,4,0,2,"Braga",5,"Avenida João Paulo II",39,39,0,9,9,0
10,22,2018,4,0,2,"Braga",6,"Avenida Padre Júlio Fragata",67,67,0,83,83,0
10,22,2018,4,0,2,"Braga",7,"Rua Nova Santa Cruz",44,44,0,39,39,0
10,22,2018,4,0,2,"Braga",8,"Rua Costa Gomes",41,41,0,42,42,0
10,22,2018,5,0,2,"Braga",1,"Avenida da Liberdade",25,25,0,124,124,0
10,22,2018,5,0,2,"Braga",2,"Avenida Central",25,25,0,124,124,0
10,22,2018,5,0,2,"Braga",3,"Rua de Caires",36,36,0,37,37,0
10,22,2018,5,0,2,"Braga",4,"N14 Bosch",47,47,0,48,48,0
10,22,2018,5,0,2,"Braga",5,"Avenida João Paulo II",39,39,0,9,9,0
10,22,2018,5,0,2,"Braga",6,"Avenida Padre Júlio Fragata",67,67,0,83,83,0
10,22,2018,5,0,2,"Braga",7,"Rua Nova Santa Cruz",44,44,0,39,39,0
10,22,2018,5,0,2,"Braga",8,"Rua Costa Gomes",41,41,0,42,42,0
10,22,2018,6,0,2,"Braga",1,"Avenida da Liberdade",25,25,0,124,124,0
10,22,2018,6,0,2,"Braga",2,"Avenida Central",25,25,0,124,124,0
10,22,2018,6,0,2,"Braga",3,"Rua de Caires",36,36,0,37,37,0
10,22,2018,6,0,2,"Braga",4,"N14 Bosch",47,47,0,48,48,0
10,22,2018,6,0,2,"Braga",5,"Avenida João Paulo II",39,39,0,9,9,0
10,22,2018,6,0,2,"Braga",6,"Avenida Padre Júlio Fragata",67,67,0,83,83,0
10,22,2018,6,0,2,"Braga",7,"Rua Nova Santa Cruz",44,44,0,39,39,0
10,22,2018,6,0,2,"Braga",8,"Rua Costa Gomes",41,41,0,42,42,0
10,22,2018,8,0,2,"Braga",1,"Avenida da Liberdade",16,25,9,194,124,70
10,22,2018,8,0,2,"Braga",2,"Avenida Central",16,25,9,194,124,70
10,22,2018,8,0,2,"Braga",3,"Rua de Caires",25,36,11,54,37,17
10,22,2018,8,0,2,"Braga",4,"N14 Bosch",17,47,30,132,48,84
10,22,2018,8,0,2,"Braga",5,"Avenida João Paulo II",39,39,0,9,9,0
10,22,2018,8,0,2,"Braga",6,"Avenida Padre Júlio Fragata",43,67,24,130,83,47
10,22,2018,8,0,2,"Braga",7,"Rua Nova Santa Cruz",11,44,33,157,39,118
10,22,2018,8,0,2,"Braga",8,"Rua Costa Gomes",23,41,18,75,42,33
10,22,2018,9,0,2,"Braga",1,"Avenida da Liberdade",25,25,0,124,124,0
10,22,2018,9,0,2,"Braga",2,"Avenida Central",25,25,0,124,124,0
10,22,2018,9,0,2,"Braga",3,"Rua de Caires",36,36,0,37,37,0
10,22,2018,9,0,2,"Braga",4,"N14 Bosch",27,47,20,83,48,35
10,22,2018,9,0,2,"Braga",5,"Avenida João Paulo II",23,39,16,15,9,6
10,22,2018,9,0,2,"Braga",6,"Avenida Padre Júlio Fragata",67,67,0,83,83,0
10,22,2018,9,0,2,"Braga",7,"Rua Nova Santa Cruz",44,44,0,39,39,0
10,22,2018,9,0,2,"Braga",8,"Rua Costa Gomes",41,41,0,42,42,0
10,22,2018,10,0,2,"Braga",1,"Avenida da Liberdade",25,25,0,124,124,0
10,22,2018,10,0,2,"Braga",2,"Avenida Central",25,25,0,124,124,0
10,22,2018,10,0,2,"Braga",3,"Rua de Caires",36,36,0,37,37,0
10,22,2018,10,0,2,"Braga",4,"N14 Bosch",47,47,0,48,48,0
10,22,2018,10,0,2,"Braga",5,"Avenida João Paulo II",39,39,0,9,9,0
10,22,2018,10,0,2,"Braga",6,"Avenida Padre Júlio Fragata",67,67,0,83,83,0
10,22,2018,10,0,2,"Braga",7,"Rua Nova Santa Cruz",44,44,0,39,39,0
10,22,2018,10,0,2,"Braga",8,"Rua Costa Gomes",27,41,14,64,42,22
10,22,2018,11,0,2,"Braga",1,"Avenida da Liberdade",25,25,0,124,124,0
10,22,2018,11,0,2,"Braga",2,"Avenida Central",25,25,0,124,124,0
10,22,2018,11,0,2,"Braga",3,"Rua de Caires",25,36,11,54,37,17
10,22,2018,11,0,2,"Braga",4,"N14 Bosch",47,47,0,48,48,0
10,22,2018,11,0,2,"Braga",5,"Avenida João Paulo II",39,39,0,9,9,0
10,22,2018,11,0,2,"Braga",6,"Avenida Padre Júlio Fragata",67,67,0,83,83,0
10,22,2018,11,0,2,"Braga",7,"Rua Nova Santa Cruz",33,44,11,52,39,13
10,22,2018,11,0,2,"Braga",8,"Rua Costa Gomes",41,41,0,42,42,0
10,22,2018,13,0,2,"Braga",1,"Avenida da Liberdade",25,25,0,124,124,0
10,22,2018,13,0,2,"Braga",2,"Avenida Central",25,25,0,124,124,0
10,22,2018,13,0,2,"Braga",3,"Rua de Caires",28,36,8,48,37,11
10,22,2018,13,0,2,"Braga",4,"N14 Bosch",24,47,23,94,48,46
10,22,2018,13,0,2,"Braga",5,"Avenida João Paulo II",39,39,0,9,9,0
10,22,2018,13,0,2,"Braga",6,"Avenida Padre Júlio Fragata",67,67,0,83,83,0
10,22,2018,13,0,2,"Braga",7,"Rua Nova Santa Cruz",6,44,38,288,39,249
10,22,2018,13,0,2,"Braga",8,"Rua Costa Gomes",31,41,10,56,42,14
10,22,2018,14,0,2,"Braga",1,"Avenida da Liberdade",25,25,0,124,124,0
10,22,2018,14,0,2,"Braga",2,"Avenida Central",25,25,0,124,124,0
10,22,2018,14,0,2,"Braga",3,"Rua de Caires",26,36,10,52,37,15
10,22,2018,14,0,2,"Braga",4,"N14 Bosch",30,47,17,75,48,27
10,22,2018,14,0,2,"Braga",5,"Avenida João Paulo II",39,39,0,9,9,0
10,22,2018,14,0,2,"Braga",6,"Avenida Padre Júlio Fragata",67,67,0,83,83,0
10,22,2018,14,0,2,"Braga",7,"Rua Nova Santa Cruz",44,44,0,39,39,0
10,22,2018,14,0,2,"Braga",8,"Rua Costa Gomes",31,41,10,56,42,14
10,22,2018,15,0,2,"Braga",1,"Avenida da Liberdade",19,25,6,163,124,39
10,22,2018,15,0,2,"Braga",2,"Avenida Central",19,25,6,163,124,39
10,22,2018,15,0,2,"Braga",3,"Rua de Caires",36,36,0,37,37,0
10,22,2018,15,0,2,"Braga",4,"N14 Bosch",47,47,0,48,48,0
10,22,2018,15,0,2,"Braga",5,"Avenida João Paulo II",39,39,0,9,9,0
10,22,2018,15,0,2,"Braga",6,"Avenida Padre Júlio Fragata",67,67,0,83,83,0
10,22,2018,15,0,2,"Braga",7,"Rua Nova Santa Cruz",25,44,19,69,39,30
10,22,2018,15,0,2,"Braga",8,"Rua Costa Gomes",41,41,0,42,42,0
10,22,2018,16,0,2,"Braga",1,"Avenida da Liberdade",17,25,8,182,124,58
10,22,2018,16,0,2,"Braga",2,"Avenida Central",17,25,8,182,124,58
10,22,2018,16,0,2,"Braga",3,"Rua de Caires",28,36,8,48,37,11
10,22,2018,16,0,2,"Braga",4,"N14 Bosch",29,47,18,77,48,29
10,22,2018,16,0,2,"Braga",5,"Avenida João Paulo II",39,39,0,9,9,0
10,22,2018,16,0,2,"Braga",6,"Avenida Padre Júlio Fragata",67,67,0,83,83,0
10,22,2018,16,0,2,"Braga",7,"Rua Nova Santa Cruz",27,44,17,64,39,25
10,22,2018,16,0,2,"Braga",8,"Rua Costa Gomes",41,41,0,42,42,0
10,22,2018,17,0,2,"Braga",1,"Avenida da Liberdade",12,25,13,258,124,134
10,22,2018,17,0,2,"Braga",2,"Avenida Central",12,25,13,258,124,134
10,22,2018,17,0,2,"Braga",3,"Rua de Caires",36,36,0,37,37,0
10,22,2018,17,0,2,"Braga",4,"N14 Bosch",29,47,18,77,48,29
10,22,2018,17,0,2,"Braga",5,"Avenida João Paulo II",39,39,0,9,9,0
10,22,2018,17,0,2,"Braga",6,"Avenida Padre Júlio Fragata",27,67,40,206,83,123
10,22,2018,17,0,2,"Braga",7,"Rua Nova Santa Cruz",19,44,25,91,39,52
10,22,2018,17,0,2,"Braga",8,"Rua Costa Gomes",10,41,31,173,42,131
10,22,2018,18,0,2,"Braga",1,"Avenida da Liberdade",9,25,16,344,124,220
10,22,2018,18,0,2,"Braga",2,"Avenida Central",9,25,16,344,124,220
10,22,2018,18,0,2,"Braga",3,"Rua de Caires",22,36,14,61,37,24
10,22,2018,18,0,2,"Braga",4,"N14 Bosch",26,47,21,86,48,38
10,22,2018,18,0,2,"Braga",5,"Avenida João Paulo II",39,39,0,9,9,0
10,22,2018,18,0,2,"Braga",6,"Avenida Padre Júlio Fragata",27,67,40,206,83,123
10,22,2018,18,0,2,"Braga",7,"Rua Nova Santa Cruz",7,44,37,247,39,208
10,22,2018,18,0,2,"Braga",8,"Rua Costa Gomes",10,41,31,173,42,131
10,22,2018,19,0,2,"Braga",1,"Avenida da Liberdade",25,25,0,124,124,0
10,22,2018,19,0,2,"Braga",2,"Avenida Central",25,25,0,124,124,0
10,22,2018,19,0,2,"Braga",3,"Rua de Caires",36,36,0,37,37,0
10,22,2018,19,0,2,"Braga",4,"N14 Bosch",47,47,0,48,48,0
10,22,2018,19,0,2,"Braga",5,"Avenida João Paulo II",30,39,9,12,9,3
10,22,2018,19,0,2,"Braga",6,"Avenida Padre Júlio Fragata",67,67,0,83,83,0
10,22,2018,19,0,2,"Braga",7,"Rua Nova Santa Cruz",24,44,20,72,39,33
10,22,2018,19,0,2,"Braga",8,"Rua Costa Gomes",41,41,0,42,42,0
10,22,2018,20,0,2,"Braga",1,"Avenida da Liberdade",25,25,0,124,124,0
10,22,2018,20,0,2,"Braga",2,"Avenida Central",25,25,0,124,124,0
10,22,2018,20,0,2,"Braga",3,"Rua de Caires",36,36,0,37,37,0
10,22,2018,20,0,2,"Braga",4,"N14 Bosch",47,47,0,48,48,0
10,22,2018,20,0,2,"Braga",5,"Avenida João Paulo II",39,39,0,9,9,0
10,22,2018,20,0,2,"Braga",6,"Avenida Padre Júlio Fragata",67,67,0,83,83,0
10,22,2018,20,0,2,"Braga",7,"Rua Nova Santa Cruz",44,44,0,39,39,0
10,22,2018,20,0,2,"Braga",8,"Rua Costa Gomes",41,41,0,42,42,0
10,22,2018,21,0,2,"Braga",1,"Avenida da Liberdade",25,25,0,124,124,0
10,22,2018,21,0,2,"Braga",2,"Avenida Central",25,25,0,124,124,0
10,22,2018,21,0,2,"Braga",3,"Rua de Caires",36,36,0,37,37,0
10,22,2018,21,0,2,"Braga",4,"N14 Bosch",47,47,0,48,48,0
10,22,2018,21,0,2,"Braga",5,"Avenida João Paulo II",28,39,11,12,9,3
10,22,2018,21,0,2,"Braga",6,"Avenida Padre Júlio Fragata",67,67,0,83,83,0
10,22,2018,21,0,2,"Braga",7,"Rua Nova Santa Cruz",44,44,0,39,39,0
10,22,2018,21,0,2,"Braga",8,"Rua Costa Gomes",41,41,0,42,42,0
10,22,2018,22,0,2,"Braga",1,"Avenida da Liberdade",25,25,0,124,124,0
10,22,2018,22,0,2,"Braga",2,"Avenida Central",25,25,0,124,124,0
10,22,2018,22,0,2,"Braga",3,"Rua de Caires",36,36,0,37,37,0
10,22,2018,22,0,2,"Braga",4,"N14 Bosch",47,47,0,48,48,0
10,22,2018,22,0,2,"Braga",5,"Avenida João Paulo II",39,39,0,9,9,0
10,22,2018,22,0,2,"Braga",6,"Avenida Padre Júlio Fragata",67,67,0,83,83,0
10,22,2018,22,0,2,"Braga",7,"Rua Nova Santa Cruz",44,44,0,39,39,0
10,22,2018,22,0,2,"Braga",8,"Rua Costa Gomes",41,41,0,42,42,0
10,22,2018,23,0,2,"Braga",1,"Avenida da Liberdade",25,25,0,124,124,0
10,22,2018,23,0,2,"Braga",2,"Avenida Central",25,25,0,124,124,0
10,22,2018,23,0,2,"Braga",3,"Rua de Caires",36,36,0,37,37,0
10,22,2018,23,0,2,"Braga",4,"N14 Bosch",47,47,0,48,48,0
10,22,2018,23,0,2,"Braga",5,"Avenida João Paulo II",39,39,0,9,9,0
10,22,2018,23,0,2,"Braga",6,"Avenida Padre Júlio Fragata",67,67,0,83,83,0
10,22,2018,23,0,2,"Braga",7,"Rua Nova Santa Cruz",44,44,0,39,39,0
10,22,2018,23,0,2,"Braga",8,"Rua Costa Gomes",41,41,0,42,42,0
10,23,2018,0,0,3,"Braga",1,"Avenida da Liberdade",25,25,0,124,124,0
10,23,2018,0,0,3,"Braga",2,"Avenida Central",25,25,0,124,124,0
10,23,2018,0,0,3,"Braga",3,"Rua de Caires",36,36,0,37,37,0
10,23,2018,0,0,3,"Braga",4,"N14 Bosch",47,47,0,48,48,0
10,23,2018,0,0,3,"Braga",5,"Avenida João Paulo II",39,39,0,9,9,0
10,23,2018,0,0,3,"Braga",6,"Avenida Padre Júlio Fragata",67,67,0,83,83,0
10,23,2018,0,0,3,"Braga",7,"Rua Nova Santa Cruz",44,44,0,39,39,0
10,23,2018,0,0,3,"Braga",8,"Rua Costa Gomes",41,41,0,42,42,0
10,23,2018,1,0,3,"Braga",1,"Avenida da Liberdade",25,25,0,124,124,0
10,23,2018,1,0,3,"Braga",2,"Avenida Central",25,25,0,124,124,0
10,23,2018,1,0,3,"Braga",3,"Rua de Caires",36,36,0,37,37,0
10,23,2018,1,0,3,"Braga",4,"N14 Bosch",47,47,0,48,48,0
10,23,2018,1,0,3,"Braga",5,"Avenida João Paulo II",39,39,0,9,9,0
10,23,2018,1,0,3,"Braga",6,"Avenida Padre Júlio Fragata",67,67,0,83,83,0
10,23,2018,1,0,3,"Braga",7,"Rua Nova Santa Cruz",44,44,0,39,39,0
10,23,2018,1,0,3,"Braga",8,"Rua Costa Gomes",41,41,0,42,42,0
10,23,2018,2,0,3,"Braga",1,"Avenida da Liberdade",25,25,0,124,124,0
10,23,2018,2,0,3,"Braga",2,"Avenida Central",25,25,0,124,124,0
10,23,2018,2,0,3,"Braga",3,"Rua de Caires",36,36,0,37,37,0
10,23,2018,2,0,3,"Braga",4,"N14 Bosch",47,47,0,48,48,0
10,23,2018,2,0,3,"Braga",5,"Avenida João Paulo II",39,39,0,9,9,0
10,23,2018,2,0,3,"Braga",6,"Avenida Padre Júlio Fragata",67,67,0,83,83,0
10,23,2018,2,0,3,"Braga",7,"Rua Nova Santa Cruz",44,44,0,39,39,0
10,23,2018,2,0,3,"Braga",8,"Rua Costa Gomes",41,41,0,42,42,0
10,23,2018,3,0,3,"Braga",1,"Avenida da Liberdade",25,25,0,124,124,0
10,23,2018,3,0,3,"Braga",2,"Avenida Central",25,25,0,124,124,0
10,23,2018,3,0,3,"Braga",3,"Rua de Caires",36,36,0,37,37,0
10,23,2018,3,0,3,"Braga",4,"N14 Bosch",47,47,0,48,48,0
10,23,2018,3,0,3,"Braga",5,"Avenida João Paulo II",39,39,0,9,9,0
10,23,2018,3,0,3,"Braga",6,"Avenida Padre Júlio Fragata",67,67,0,83,83,0
10,23,2018,3,0,3,"Braga",7,"Rua Nova Santa Cruz",44,44,0,39,39,0
10,23,2018,3,0,3,"Braga",8,"Rua Costa Gomes",41,41,0,42,42,0
10,23,2018,4,0,3,"Braga",1,"Avenida da Liberdade",25,25,0,124,124,0
10,23,2018,4,0,3,"Braga",2,"Avenida Central",25,25,0,124,124,0
10,23,2018,4,0,3,"Braga",3,"Rua de Caires",36,36,0,37,37,0
10,23,2018,4,0,3,"Braga",4,"N14 Bosch",47,47,0,48,48,0
10,23,2018,4,0,3,"Braga",5,"Avenida João Paulo II",39,39,0,9,9,0
10,23,2018,4,0,3,"Braga",6,"Avenida Padre Júlio Fragata",67,67,0,83,83,0
10,23,2018,4,0,3,"Braga",7,"Rua Nova Santa Cruz",44,44,0,39,39,0
10,23,2018,4,0,3,"Braga",8,"Rua Costa Gomes",41,41,0,42,42,0
10,23,2018,5,0,3,"Braga",7,"Rua Nova Santa Cruz",44,44,0,39,39,0
10,23,2018,5,0,3,"Braga",8,"Rua Costa Gomes",41,41,0,42,42,0
10,23,2018,5,0,3,"Braga",1,"Avenida da Liberdade",25,25,0,124,124,0
10,23,2018,5,0,3,"Braga",2,"Avenida Central",25,25,0,124,124,0
10,23,2018,5,0,3,"Braga",3,"Rua de Caires",36,36,0,37,37,0
10,23,2018,5,0,3,"Braga",4,"N14 Bosch",47,47,0,48,48,0
10,23,2018,5,0,3,"Braga",5,"Avenida João Paulo II",39,39,0,9,9,0
10,23,2018,5,0,3,"Braga",6,"Avenida Padre Júlio Fragata",67,67,0,83,83,0
10,23,2018,5,0,3,"Braga",7,"Rua Nova Santa Cruz",44,44,0,39,39,0
10,23,2018,6,0,3,"Braga",1,"Avenida da Liberdade",25,25,0,124,124,0
10,23,2018,6,0,3,"Braga",2,"Avenida Central",25,25,0,124,124,0
10,23,2018,6,0,3,"Braga",3,"Rua de Caires",36,36,0,37,37,0
10,23,2018,6,0,3,"Braga",4,"N14 Bosch",47,47,0,48,48,0
10,23,2018,6,0,3,"Braga",5,"Avenida João Paulo II",39,39,0,9,9,0
10,23,2018,6,0,3,"Braga",6,"Avenida Padre Júlio Fragata",67,67,0,83,83,0
10,23,2018,6,0,3,"Braga",7,"Rua Nova Santa Cruz",44,44,0,39,39,0
10,23,2018,6,0,3,"Braga",8,"Rua Costa Gomes",41,41,0,42,42,0
10,23,2018,7,0,3,"Braga",1,"Avenida da Liberdade",25,25,0,124,124,0
10,23,2018,7,0,3,"Braga",2,"Avenida Central",25,25,0,124,124,0
10,23,2018,7,0,3,"Braga",3,"Rua de Caires",27,36,9,50,37,13
10,23,2018,7,0,3,"Braga",4,"N14 Bosch",28,47,19,80,48,32
10,23,2018,7,0,3,"Braga",5,"Avenida João Paulo II",39,39,0,9,9,0
10,23,2018,7,0,3,"Braga",6,"Avenida Padre Júlio Fragata",67,67,0,83,83,0
10,23,2018,7,0,3,"Braga",7,"Rua Nova Santa Cruz",26,44,18,66,39,27
10,23,2018,7,0,3,"Braga",8,"Rua Costa Gomes",41,41,0,42,42,0
10,23,2018,8,0,3,"Braga",1,"Avenida da Liberdade",25,25,0,124,124,0
10,23,2018,8,0,3,"Braga",2,"Avenida Central",25,25,0,124,124,0
10,23,2018,8,0,3,"Braga",3,"Rua de Caires",22,36,14,61,37,24
10,23,2018,8,0,3,"Braga",4,"N14 Bosch",26,47,21,86,48,38
10,23,2018,8,0,3,"Braga",5,"Avenida João Paulo II",5,39,34,70,9,61
10,23,2018,8,0,3,"Braga",6,"Avenida Padre Júlio Fragata",27,67,40,206,83,123
10,23,2018,8,0,3,"Braga",7,"Rua Nova Santa Cruz",13,44,31,133,39,94
10,23,2018,8,0,3,"Braga",8,"Rua Costa Gomes",28,41,13,62,42,20
10,23,2018,9,0,3,"Braga",1,"Avenida da Liberdade",25,25,0,124,124,0
10,23,2018,9,0,3,"Braga",2,"Avenida Central",25,25,0,124,124,0
10,23,2018,9,0,3,"Braga",3,"Rua de Caires",23,36,13,59,37,22
10,23,2018,9,0,3,"Braga",4,"N14 Bosch",26,47,21,86,48,38
10,23,2018,9,0,3,"Braga",5,"Avenida João Paulo II",39,39,0,9,9,0
10,23,2018,9,0,3,"Braga",6,"Avenida Padre Júlio Fragata",67,67,0,83,83,0
10,23,2018,9,0,3,"Braga",7,"Rua Nova Santa Cruz",22,44,22,79,39,40
10,23,2018,9,0,3,"Braga",8,"Rua Costa Gomes",32,41,9,54,42,12
10,23,2018,10,0,3,"Braga",1,"Avenida da Liberdade",25,25,0,124,124,0
10,23,2018,10,0,3,"Braga",2,"Avenida Central",25,25,0,124,124,0
10,23,2018,10,0,3,"Braga",3,"Rua de Caires",36,36,0,37,37,0
10,23,2018,10,0,3,"Braga",4,"N14 Bosch",31,47,16,72,48,24
10,23,2018,10,0,3,"Braga",5,"Avenida João Paulo II",39,39,0,9,9,0
10,23,2018,10,0,3,"Braga",6,"Avenida Padre Júlio Fragata",67,67,0,83,83,0
10,23,2018,10,0,3,"Braga",7,"Rua Nova Santa Cruz",24,44,20,72,39,33
10,23,2018,10,0,3,"Braga",8,"Rua Costa Gomes",41,41,0,42,42,0
10,23,2018,11,0,3,"Braga",1,"Avenida da Liberdade",25,25,0,124,124,0
10,23,2018,11,0,3,"Braga",2,"Avenida Central",25,25,0,124,124,0
10,23,2018,11,0,3,"Braga",3,"Rua de Caires",36,36,0,37,37,0
10,23,2018,11,0,3,"Braga",4,"N14 Bosch",32,47,15,70,48,22
10,23,2018,11,0,3,"Braga",5,"Avenida João Paulo II",39,39,0,9,9,0
10,23,2018,11,0,3,"Braga",6,"Avenida Padre Júlio Fragata",67,67,0,83,83,0
10,23,2018,11,0,3,"Braga",7,"Rua Nova Santa Cruz",44,44,0,39,39,0
10,23,2018,11,0,3,"Braga",8,"Rua Costa Gomes",31,41,10,56,42,14
10,23,2018,12,0,3,"Braga",1,"Avenida da Liberdade",25,25,0,124,124,0
10,23,2018,12,0,3,"Braga",2,"Avenida Central",25,25,0,124,124,0
10,23,2018,12,0,3,"Braga",3,"Rua de Caires",26,36,10,52,37,15
10,23,2018,12,0,3,"Braga",4,"N14 Bosch",15,47,32,150,48,102
10,23,2018,12,0,3,"Braga",5,"Avenida João Paulo II",39,39,0,9,9,0
10,23,2018,12,0,3,"Braga",6,"Avenida Padre Júlio Fragata",67,67,0,83,83,0
10,23,2018,12,0,3,"Braga",7,"Rua Nova Santa Cruz",25,44,19,69,39,30
10,23,2018,12,0,3,"Braga",8,"Rua Costa Gomes",23,41,18,75,42,33
10,23,2018,13,0,3,"Braga",1,"Avenida da Liberdade",25,25,0,124,124,0
10,23,2018,13,0,3,"Braga",2,"Avenida Central",25,25,0,124,124,0
10,23,2018,13,0,3,"Braga",3,"Rua de Caires",25,36,11,54,37,17
10,23,2018,13,0,3,"Braga",4,"N14 Bosch",21,47,26,107,48,59
10,23,2018,13,0,3,"Braga",5,"Avenida João Paulo II",26,39,13,13,9,4
10,23,2018,13,0,3,"Braga",6,"Avenida Padre Júlio Fragata",67,67,0,83,83,0
10,23,2018,13,0,3,"Braga",7,"Rua Nova Santa Cruz",29,44,15,60,39,21
10,23,2018,13,0,3,"Braga",8,"Rua Costa Gomes",41,41,0,42,42,0
10,23,2018,14,0,3,"Braga",1,"Avenida da Liberdade",25,25,0,124,124,0
10,23,2018,14,0,3,"Braga",2,"Avenida Central",25,25,0,124,124,0
10,23,2018,14,0,3,"Braga",3,"Rua de Caires",23,36,13,59,37,22
10,23,2018,14,0,3,"Braga",4,"N14 Bosch",33,47,14,68,48,20
10,23,2018,14,0,3,"Braga",5,"Avenida João Paulo II",29,39,10,12,9,3
10,23,2018,14,0,3,"Braga",6,"Avenida Padre Júlio Fragata",67,67,0,83,83,0
10,23,2018,14,0,3,"Braga",7,"Rua Nova Santa Cruz",44,44,0,39,39,0
10,23,2018,14,0,3,"Braga",8,"Rua Costa Gomes",31,41,10,56,42,14
10,23,2018,15,0,3,"Braga",1,"Avenida da Liberdade",25,25,0,124,124,0
10,23,2018,15,0,3,"Braga",2,"Avenida Central",25,25,0,124,124,0
10,23,2018,15,0,3,"Braga",3,"Rua de Caires",36,36,0,37,37,0
10,23,2018,15,0,3,"Braga",4,"N14 Bosch",32,47,15,70,48,22
10,23,2018,15,0,3,"Braga",5,"Avenida João Paulo II",31,39,8,11,9,2
10,23,2018,15,0,3,"Braga",6,"Avenida Padre Júlio Fragata",67,67,0,83,83,0
10,23,2018,15,0,3,"Braga",7,"Rua Nova Santa Cruz",23,44,21,75,39,36
10,23,2018,15,0,3,"Braga",8,"Rua Costa Gomes",28,41,13,62,42,20
10,23,2018,16,0,3,"Braga",1,"Avenida da Liberdade",25,25,0,124,124,0
10,23,2018,16,0,3,"Braga",2,"Avenida Central",25,25,0,124,124,0
10,23,2018,16,0,3,"Braga",3,"Rua de Caires",36,36,0,37,37,0
10,23,2018,16,0,3,"Braga",4,"N14 Bosch",17,47,30,132,48,84
10,23,2018,16,0,3,"Braga",5,"Avenida João Paulo II",39,39,0,9,9,0
10,23,2018,16,0,3,"Braga",6,"Avenida Padre Júlio Fragata",67,67,0,83,83,0
10,23,2018,16,0,3,"Braga",7,"Rua Nova Santa Cruz",24,44,20,72,39,33
10,23,2018,16,0,3,"Braga",8,"Rua Costa Gomes",25,41,16,69,42,27
10,23,2018,17,0,3,"Braga",1,"Avenida da Liberdade",25,25,0,124,124,0
10,23,2018,17,0,3,"Braga",2,"Avenida Central",25,25,0,124,124,0
10,23,2018,17,0,3,"Braga",3,"Rua de Caires",14,36,22,96,37,59
10,23,2018,17,0,3,"Braga",4,"N14 Bosch",12,47,35,187,48,139
10,23,2018,17,0,3,"Braga",5,"Avenida João Paulo II",26,39,13,13,9,4
10,23,2018,17,0,3,"Braga",6,"Avenida Padre Júlio Fragata",31,67,36,180,83,97
10,23,2018,17,0,3,"Braga",7,"Rua Nova Santa Cruz",16,44,28,108,39,69
10,23,2018,17,0,3,"Braga",8,"Rua Costa Gomes",28,41,13,62,42,20
10,23,2018,18,0,3,"Braga",1,"Avenida da Liberdade",25,25,0,124,124,0
10,23,2018,18,0,3,"Braga",2,"Avenida Central",25,25,0,124,124,0
10,23,2018,18,0,3,"Braga",3,"Rua de Caires",19,36,17,71,37,34
10,23,2018,18,0,3,"Braga",4,"N14 Bosch",16,47,31,140,48,92
10,23,2018,18,0,3,"Braga",5,"Avenida João Paulo II",24,39,15,15,9,6
10,23,2018,18,0,3,"Braga",6,"Avenida Padre Júlio Fragata",32,67,35,174,83,91
10,23,2018,18,0,3,"Braga",7,"Rua Nova Santa Cruz",7,44,37,247,39,208
10,23,2018,18,0,3,"Braga",8,"Rua Costa Gomes",18,41,23,96,42,54
10,23,2018,19,0,3,"Braga",1,"Avenida da Liberdade",25,25,0,124,124,0
10,23,2018,19,0,3,"Braga",2,"Avenida Central",25,25,0,124,124,0
10,23,2018,19,0,3,"Braga",3,"Rua de Caires",26,36,10,52,37,15
10,23,2018,19,0,3,"Braga",4,"N14 Bosch",34,47,13,66,48,18
10,23,2018,19,0,3,"Braga",5,"Avenida João Paulo II",39,39,0,9,9,0
10,23,2018,19,0,3,"Braga",6,"Avenida Padre Júlio Fragata",67,67,0,83,83,0
10,23,2018,19,0,3,"Braga",7,"Rua Nova Santa Cruz",11,44,33,157,39,118
10,23,2018,19,0,3,"Braga",8,"Rua Costa Gomes",41,41,0,42,42,0
10,23,2018,20,0,3,"Braga",1,"Avenida da Liberdade",25,25,0,124,124,0
10,23,2018,20,0,3,"Braga",2,"Avenida Central",25,25,0,124,124,0
10,23,2018,20,0,3,"Braga",3,"Rua de Caires",36,36,0,37,37,0
10,23,2018,20,0,3,"Braga",4,"N14 Bosch",47,47,0,48,48,0
10,23,2018,20,0,3,"Braga",5,"Avenida João Paulo II",39,39,0,9,9,0
10,23,2018,20,0,3,"Braga",6,"Avenida Padre Júlio Fragata",67,67,0,83,83,0
10,23,2018,20,0,3,"Braga",7,"Rua Nova Santa Cruz",32,44,12,54,39,15
10,23,2018,20,0,3,"Braga",8,"Rua Costa Gomes",19,41,22,91,42,49
10,23,2018,21,0,3,"Braga",1,"Avenida da Liberdade",25,25,0,124,124,0
10,23,2018,21,0,3,"Braga",2,"Avenida Central",25,25,0,124,124,0
10,23,2018,21,0,3,"Braga",3,"Rua de Caires",36,36,0,37,37,0
10,23,2018,21,0,3,"Braga",4,"N14 Bosch",47,47,0,48,48,0
10,23,2018,21,0,3,"Braga",5,"Avenida João Paulo II",39,39,0,9,9,0
10,23,2018,21,0,3,"Braga",6,"Avenida Padre Júlio Fragata",52,67,15,107,83,24
10,23,2018,21,0,3,"Braga",7,"Rua Nova Santa Cruz",44,44,0,39,39,0
10,23,2018,21,0,3,"Braga",8,"Rua Costa Gomes",41,41,0,42,42,0
10,23,2018,22,0,3,"Braga",1,"Avenida da Liberdade",13,13,0,60,60,0
10,23,2018,22,0,3,"Braga",2,"Avenida Central",14,49,35,247,71,176
10,23,2018,22,0,3,"Braga",3,"Rua de Caires",25,25,0,4,4,0
10,23,2018,22,0,3,"Braga",4,"N14 Bosch",47,47,0,48,48,0
10,23,2018,22,0,3,"Braga",5,"Avenida João Paulo II",39,39,0,9,9,0
10,23,2018,22,0,3,"Braga",6,"Avenida Padre Júlio Fragata",67,67,0,83,83,0
10,23,2018,22,0,3,"Braga",7,"Rua Nova Santa Cruz",44,44,0,39,39,0
10,23,2018,22,0,3,"Braga",8,"Rua Costa Gomes",41,41,0,42,42,0
10,23,2018,23,0,3,"Braga",1,"Avenida da Liberdade",13,13,0,60,60,0
10,23,2018,23,0,3,"Braga",2,"Avenida Central",21,49,28,165,71,94
10,23,2018,23,0,3,"Braga",3,"Rua de Caires",25,25,0,4,4,0
10,23,2018,23,0,3,"Braga",4,"N14 Bosch",47,47,0,48,48,0
10,23,2018,23,0,3,"Braga",5,"Avenida João Paulo II",39,39,0,9,9,0
10,23,2018,23,0,3,"Braga",6,"Avenida Padre Júlio Fragata",67,67,0,83,83,0
10,23,2018,23,0,3,"Braga",7,"Rua Nova Santa Cruz",44,44,0,39,39,0
10,23,2018,23,0,3,"Braga",8,"Rua Costa Gomes",41,41,0,42,42,0
10,24,2018,0,0,4,"Braga",1,"Avenida da Liberdade",13,13,0,60,60,0
10,24,2018,0,0,4,"Braga",2,"Avenida Central",49,49,0,71,71,0
10,24,2018,0,0,4,"Braga",3,"Rua de Caires",25,25,0,4,4,0
10,24,2018,0,0,4,"Braga",4,"N14 Bosch",47,47,0,48,48,0
10,24,2018,0,0,4,"Braga",5,"Avenida João Paulo II",39,39,0,9,9,0
10,24,2018,0,0,4,"Braga",6,"Avenida Padre Júlio Fragata",67,67,0,83,83,0
10,24,2018,0,0,4,"Braga",7,"Rua Nova Santa Cruz",44,44,0,39,39,0
10,24,2018,0,0,4,"Braga",8,"Rua Costa Gomes",41,41,0,42,42,0
10,24,2018,1,0,4,"Braga",1,"Avenida da Liberdade",13,13,0,60,60,0
10,24,2018,1,0,4,"Braga",2,"Avenida Central",49,49,0,71,71,0
10,24,2018,1,0,4,"Braga",3,"Rua de Caires",25,25,0,4,4,0
10,24,2018,1,0,4,"Braga",4,"N14 Bosch",47,47,0,48,48,0
10,24,2018,1,0,4,"Braga",5,"Avenida João Paulo II",39,39,0,9,9,0
10,24,2018,1,0,4,"Braga",6,"Avenida Padre Júlio Fragata",67,67,0,83,83,0
10,24,2018,1,0,4,"Braga",7,"Rua Nova Santa Cruz",44,44,0,39,39,0
10,24,2018,1,0,4,"Braga",8,"Rua Costa Gomes",41,41,0,42,42,0
10,24,2018,2,0,4,"Braga",1,"Avenida da Liberdade",13,13,0,60,60,0
10,24,2018,2,0,4,"Braga",2,"Avenida Central",49,49,0,71,71,0
10,24,2018,2,0,4,"Braga",3,"Rua de Caires",25,25,0,4,4,0
10,24,2018,2,0,4,"Braga",4,"N14 Bosch",47,47,0,48,48,0
10,24,2018,2,0,4,"Braga",5,"Avenida João Paulo II",39,39,0,9,9,0
10,24,2018,2,0,4,"Braga",6,"Avenida Padre Júlio Fragata",67,67,0,83,83,0
10,24,2018,2,0,4,"Braga",7,"Rua Nova Santa Cruz",44,44,0,39,39,0
10,24,2018,2,0,4,"Braga",8,"Rua Costa Gomes",41,41,0,42,42,0
10,24,2018,3,0,4,"Braga",1,"Avenida da Liberdade",13,13,0,60,60,0
10,24,2018,3,0,4,"Braga",2,"Avenida Central",49,49,0,71,71,0
10,24,2018,3,0,4,"Braga",3,"Rua de Caires",25,25,0,4,4,0
10,24,2018,3,0,4,"Braga",4,"N14 Bosch",47,47,0,48,48,0
10,24,2018,3,0,4,"Braga",5,"Avenida João Paulo II",39,39,0,9,9,0
10,24,2018,3,0,4,"Braga",6,"Avenida Padre Júlio Fragata",67,67,0,83,83,0
10,24,2018,3,0,4,"Braga",7,"Rua Nova Santa Cruz",44,44,0,39,39,0
10,24,2018,3,0,4,"Braga",8,"Rua Costa Gomes",41,41,0,42,42,0
10,24,2018,4,0,4,"Braga",1,"Avenida da Liberdade",13,13,0,60,60,0
10,24,2018,4,0,4,"Braga",2,"Avenida Central",49,49,0,71,71,0
10,24,2018,4,0,4,"Braga",3,"Rua de Caires",25,25,0,4,4,0
10,24,2018,4,0,4,"Braga",4,"N14 Bosch",47,47,0,48,48,0
10,24,2018,4,0,4,"Braga",5,"Avenida João Paulo II",39,39,0,9,9,0
10,24,2018,4,0,4,"Braga",6,"Avenida Padre Júlio Fragata",67,67,0,83,83,0
10,24,2018,4,0,4,"Braga",7,"Rua Nova Santa Cruz",44,44,0,39,39,0
10,24,2018,4,0,4,"Braga",8,"Rua Costa Gomes",41,41,0,42,42,0
10,24,2018,5,0,4,"Braga",1,"Avenida da Liberdade",13,13,0,60,60,0
10,24,2018,5,0,4,"Braga",2,"Avenida Central",49,49,0,71,71,0
10,24,2018,5,0,4,"Braga",3,"Rua de Caires",25,25,0,4,4,0
10,24,2018,5,0,4,"Braga",4,"N14 Bosch",47,47,0,48,48,0
10,24,2018,5,0,4,"Braga",5,"Avenida João Paulo II",39,39,0,9,9,0
10,24,2018,5,0,4,"Braga",6,"Avenida Padre Júlio Fragata",67,67,0,83,83,0
10,24,2018,5,0,4,"Braga",7,"Rua Nova Santa Cruz",44,44,0,39,39,0
10,24,2018,5,0,4,"Braga",8,"Rua Costa Gomes",41,41,0,42,42,0
10,24,2018,6,0,4,"Braga",1,"Avenida da Liberdade",13,13,0,60,60,0
10,24,2018,6,0,4,"Braga",2,"Avenida Central",49,49,0,71,71,0
10,24,2018,6,0,4,"Braga",3,"Rua de Caires",25,25,0,4,4,0
10,24,2018,6,0,4,"Braga",4,"N14 Bosch",47,47,0,48,48,0
10,24,2018,6,0,4,"Braga",5,"Avenida João Paulo II",39,39,0,9,9,0
10,24,2018,6,0,4,"Braga",6,"Avenida Padre Júlio Fragata",67,67,0,83,83,0
10,24,2018,6,0,4,"Braga",7,"Rua Nova Santa Cruz",44,44,0,39,39,0
10,24,2018,6,0,4,"Braga",8,"Rua Costa Gomes",41,41,0,42,42,0
10,24,2018,11,0,4,"Braga",1,"Avenida da Liberdade",13,13,0,60,60,0
10,24,2018,11,0,4,"Braga",2,"Avenida Central",33,49,16,105,71,34
10,24,2018,11,0,4,"Braga",3,"Rua de Caires",25,25,0,4,4,0
10,24,2018,11,0,4,"Braga",4,"N14 Bosch",47,47,0,48,48,0
10,24,2018,11,0,4,"Braga",5,"Avenida João Paulo II",26,39,13,13,9,4
10,24,2018,11,0,4,"Braga",6,"Avenida Padre Júlio Fragata",67,67,0,83,83,0
10,24,2018,11,0,4,"Braga",7,"Rua Nova Santa Cruz",44,44,0,39,39,0
10,24,2018,11,0,4,"Braga",8,"Rua Costa Gomes",41,41,0,42,42,0
10,24,2018,12,0,4,"Braga",1,"Avenida da Liberdade",13,13,0,60,60,0
10,24,2018,12,0,4,"Braga",2,"Avenida Central",49,49,0,71,71,0
10,24,2018,12,0,4,"Braga",3,"Rua de Caires",25,25,0,4,4,0
10,24,2018,12,0,4,"Braga",4,"N14 Bosch",28,47,19,80,48,32
10,24,2018,12,0,4,"Braga",5,"Avenida João Paulo II",39,39,0,9,9,0
10,24,2018,12,0,4,"Braga",6,"Avenida Padre Júlio Fragata",67,67,0,83,83,0
10,24,2018,12,0,4,"Braga",7,"Rua Nova Santa Cruz",15,44,29,115,39,76
10,24,2018,12,0,4,"Braga",8,"Rua Costa Gomes",41,41,0,42,42,0
10,24,2018,13,0,4,"Braga",1,"Avenida da Liberdade",13,13,0,60,60,0
10,24,2018,13,0,4,"Braga",2,"Avenida Central",49,49,0,71,71,0
10,24,2018,13,0,4,"Braga",3,"Rua de Caires",25,25,0,4,4,0
10,24,2018,13,0,4,"Braga",4,"N14 Bosch",31,47,16,72,48,24
10,24,2018,13,0,4,"Braga",5,"Avenida João Paulo II",39,39,0,9,9,0
10,24,2018,13,0,4,"Braga",6,"Avenida Padre Júlio Fragata",67,67,0,83,83,0
10,24,2018,13,0,4,"Braga",7,"Rua Nova Santa Cruz",44,44,0,39,39,0
10,24,2018,13,0,4,"Braga",8,"Rua Costa Gomes",31,41,10,56,42,14
10,24,2018,14,0,4,"Braga",1,"Avenida da Liberdade",13,13,0,60,60,0
10,24,2018,14,0,4,"Braga",2,"Avenida Central",49,49,0,71,71,0
10,24,2018,14,0,4,"Braga",3,"Rua de Caires",25,25,0,4,4,0
10,24,2018,14,0,4,"Braga",4,"N14 Bosch",24,47,23,94,48,46
10,24,2018,14,0,4,"Braga",5,"Avenida João Paulo II",23,39,16,15,9,6
10,24,2018,14,0,4,"Braga",6,"Avenida Padre Júlio Fragata",67,67,0,83,83,0
10,24,2018,14,0,4,"Braga",7,"Rua Nova Santa Cruz",34,44,10,51,39,12
10,24,2018,14,0,4,"Braga",8,"Rua Costa Gomes",31,41,10,56,42,14
10,24,2018,15,0,4,"Braga",1,"Avenida da Liberdade",13,13,0,60,60,0
10,24,2018,15,0,4,"Braga",2,"Avenida Central",49,49,0,71,71,0
10,24,2018,15,0,4,"Braga",3,"Rua de Caires",25,25,0,4,4,0
10,24,2018,15,0,4,"Braga",4,"N14 Bosch",33,47,14,68,48,20
10,24,2018,15,0,4,"Braga",5,"Avenida João Paulo II",39,39,0,9,9,0
10,24,2018,15,0,4,"Braga",6,"Avenida Padre Júlio Fragata",67,67,0,83,83,0
10,24,2018,15,0,4,"Braga",7,"Rua Nova Santa Cruz",44,44,0,39,39,0
10,24,2018,15,0,4,"Braga",8,"Rua Costa Gomes",28,41,13,62,42,20
10,24,2018,16,0,4,"Braga",1,"Avenida da Liberdade",10,13,3,78,60,18
10,24,2018,16,0,4,"Braga",2,"Avenida Central",49,49,0,71,71,0
10,24,2018,16,0,4,"Braga",3,"Rua de Caires",19,25,6,5,4,1
10,24,2018,16,0,4,"Braga",4,"N14 Bosch",33,47,14,68,48,20
10,24,2018,16,0,4,"Braga",5,"Avenida João Paulo II",39,39,0,9,9,0
10,24,2018,16,0,4,"Braga",6,"Avenida Padre Júlio Fragata",67,67,0,83,83,0
10,24,2018,16,0,4,"Braga",7,"Rua Nova Santa Cruz",25,44,19,69,39,30
10,24,2018,16,0,4,"Braga",8,"Rua Costa Gomes",24,41,17,72,42,30
10,24,2018,17,0,4,"Braga",1,"Avenida da Liberdade",13,13,0,60,60,0
10,24,2018,17,0,4,"Braga",2,"Avenida Central",49,49,0,71,71,0
10,24,2018,17,0,4,"Braga",3,"Rua de Caires",25,25,0,4,4,0
10,24,2018,17,0,4,"Braga",4,"N14 Bosch",29,47,18,77,48,29
10,24,2018,17,0,4,"Braga",5,"Avenida João Paulo II",39,39,0,9,9,0
10,24,2018,17,0,4,"Braga",6,"Avenida Padre Júlio Fragata",44,67,23,127,83,44
10,24,2018,17,0,4,"Braga",7,"Rua Nova Santa Cruz",14,44,30,123,39,84
10,24,2018,17,0,4,"Braga",8,"Rua Costa Gomes",28,41,13,62,42,20
10,24,2018,18,0,4,"Braga",1,"Avenida da Liberdade",13,13,0,60,60,0
10,24,2018,18,0,4,"Braga",2,"Avenida Central",35,49,14,99,71,28
10,24,2018,18,0,4,"Braga",3,"Rua de Caires",14,25,11,7,4,3
10,24,2018,18,0,4,"Braga",4,"N14 Bosch",31,47,16,72,48,24
10,24,2018,18,0,4,"Braga",5,"Avenida João Paulo II",14,39,25,25,9,16
10,24,2018,18,0,4,"Braga",6,"Avenida Padre Júlio Fragata",29,67,38,192,83,109
10,24,2018,18,0,4,"Braga",7,"Rua Nova Santa Cruz",22,44,22,79,39,40
10,24,2018,18,0,4,"Braga",8,"Rua Costa Gomes",5,41,36,346,42,304
10,24,2018,19,0,4,"Braga",1,"Avenida da Liberdade",13,13,0,60,60,0
10,24,2018,19,0,4,"Braga",2,"Avenida Central",28,49,21,124,71,53
10,24,2018,19,0,4,"Braga",3,"Rua de Caires",25,25,0,4,4,0
10,24,2018,19,0,4,"Braga",4,"N14 Bosch",47,47,0,48,48,0
10,24,2018,19,0,4,"Braga",5,"Avenida João Paulo II",39,39,0,9,9,0
10,24,2018,19,0,4,"Braga",6,"Avenida Padre Júlio Fragata",51,67,16,109,83,26
10,24,2018,19,0,4,"Braga",7,"Rua Nova Santa Cruz",34,44,10,51,39,12
10,24,2018,19,0,4,"Braga",8,"Rua Costa Gomes",25,41,16,69,42,27
10,24,2018,20,0,4,"Braga",1,"Avenida da Liberdade",13,13,0,60,60,0
10,24,2018,20,0,4,"Braga",2,"Avenida Central",49,49,0,71,71,0
10,24,2018,20,0,4,"Braga",3,"Rua de Caires",14,25,11,7,4,3
10,24,2018,20,0,4,"Braga",4,"N14 Bosch",47,47,0,48,48,0
10,24,2018,20,0,4,"Braga",5,"Avenida João Paulo II",39,39,0,9,9,0
10,24,2018,20,0,4,"Braga",6,"Avenida Padre Júlio Fragata",52,67,15,107,83,24
10,24,2018,20,0,4,"Braga",7,"Rua Nova Santa Cruz",44,44,0,39,39,0
10,24,2018,20,0,4,"Braga",8,"Rua Costa Gomes",41,41,0,42,42,0
10,24,2018,21,0,4,"Braga",1,"Avenida da Liberdade",13,13,0,60,60,0
10,24,2018,21,0,4,"Braga",2,"Avenida Central",49,49,0,71,71,0
10,24,2018,21,0,4,"Braga",3,"Rua de Caires",25,25,0,4,4,0
10,24,2018,21,0,4,"Braga",4,"N14 Bosch",47,47,0,48,48,0
10,24,2018,21,0,4,"Braga",5,"Avenida João Paulo II",39,39,0,9,9,0
10,24,2018,21,0,4,"Braga",6,"Avenida Padre Júlio Fragata",67,67,0,83,83,0
10,24,2018,21,0,4,"Braga",7,"Rua Nova Santa Cruz",44,44,0,39,39,0
10,24,2018,21,0,4,"Braga",8,"Rua Costa Gomes",41,41,0,42,42,0
10,24,2018,22,0,4,"Braga",1,"Avenida da Liberdade",13,13,0,60,60,0
10,24,2018,22,0,4,"Braga",2,"Avenida Central",49,49,0,71,71,0
10,24,2018,22,0,4,"Braga",3,"Rua de Caires",25,25,0,4,4,0
10,24,2018,22,0,4,"Braga",4,"N14 Bosch",47,47,0,48,48,0
10,24,2018,22,0,4,"Braga",5,"Avenida João Paulo II",39,39,0,9,9,0
10,24,2018,22,0,4,"Braga",6,"Avenida Padre Júlio Fragata",67,67,0,83,83,0
10,24,2018,22,0,4,"Braga",7,"Rua Nova Santa Cruz",44,44,0,39,39,0
10,24,2018,22,0,4,"Braga",8,"Rua Costa Gomes",41,41,0,42,42,0
10,24,2018,23,0,4,"Braga",1,"Avenida da Liberdade",13,13,0,60,60,0
10,24,2018,23,0,4,"Braga",2,"Avenida Central",49,49,0,71,71,0
10,24,2018,23,0,4,"Braga",3,"Rua de Caires",25,25,0,4,4,0
10,24,2018,23,0,4,"Braga",4,"N14 Bosch",47,47,0,48,48,0
10,24,2018,23,0,4,"Braga",5,"Avenida João Paulo II",39,39,0,9,9,0
10,24,2018,23,0,4,"Braga",6,"Avenida Padre Júlio Fragata",67,67,0,83,83,0
10,24,2018,23,0,4,"Braga",7,"Rua Nova Santa Cruz",44,44,0,39,39,0
10,24,2018,23,0,4,"Braga",8,"Rua Costa Gomes",41,41,0,42,42,0
10,25,2018,0,0,5,"Braga",1,"Avenida da Liberdade",13,13,0,60,60,0
10,25,2018,0,0,5,"Braga",2,"Avenida Central",49,49,0,71,71,0
10,25,2018,0,0,5,"Braga",3,"Rua de Caires",20,25,5,5,4,1
10,25,2018,0,0,5,"Braga",4,"N14 Bosch",47,47,0,48,48,0
10,25,2018,0,0,5,"Braga",5,"Avenida João Paulo II",39,39,0,9,9,0
10,25,2018,0,0,5,"Braga",6,"Avenida Padre Júlio Fragata",67,67,0,83,83,0
10,25,2018,0,0,5,"Braga",7,"Rua Nova Santa Cruz",44,44,0,39,39,0
10,25,2018,0,0,5,"Braga",8,"Rua Costa Gomes",41,41,0,42,42,0
10,25,2018,1,0,5,"Braga",1,"Avenida da Liberdade",13,13,0,60,60,0
10,25,2018,1,0,5,"Braga",2,"Avenida Central",49,49,0,71,71,0
10,25,2018,1,0,5,"Braga",3,"Rua de Caires",25,25,0,4,4,0
10,25,2018,1,0,5,"Braga",4,"N14 Bosch",47,47,0,48,48,0
10,25,2018,1,0,5,"Braga",5,"Avenida João Paulo II",39,39,0,9,9,0
10,25,2018,1,0,5,"Braga",6,"Avenida Padre Júlio Fragata",67,67,0,83,83,0
10,25,2018,1,0,5,"Braga",7,"Rua Nova Santa Cruz",44,44,0,39,39,0
10,25,2018,1,0,5,"Braga",8,"Rua Costa Gomes",41,41,0,42,42,0
10,25,2018,2,0,5,"Braga",1,"Avenida da Liberdade",13,13,0,60,60,0
10,25,2018,2,0,5,"Braga",2,"Avenida Central",49,49,0,71,71,0
10,25,2018,2,0,5,"Braga",3,"Rua de Caires",25,25,0,4,4,0
10,25,2018,2,0,5,"Braga",4,"N14 Bosch",47,47,0,48,48,0
10,25,2018,2,0,5,"Braga",5,"Avenida João Paulo II",39,39,0,9,9,0
10,25,2018,2,0,5,"Braga",6,"Avenida Padre Júlio Fragata",67,67,0,83,83,0
10,25,2018,2,0,5,"Braga",7,"Rua Nova Santa Cruz",44,44,0,39,39,0
10,25,2018,2,0,5,"Braga",8,"Rua Costa Gomes",41,41,0,42,42,0
10,25,2018,3,0,5,"Braga",1,"Avenida da Liberdade",13,13,0,60,60,0
10,25,2018,3,0,5,"Braga",2,"Avenida Central",49,49,0,71,71,0
10,25,2018,3,0,5,"Braga",3,"Rua de Caires",25,25,0,4,4,0
10,25,2018,3,0,5,"Braga",4,"N14 Bosch",47,47,0,48,48,0
10,25,2018,3,0,5,"Braga",5,"Avenida João Paulo II",39,39,0,9,9,0
10,25,2018,3,0,5,"Braga",6,"Avenida Padre Júlio Fragata",67,67,0,83,83,0
10,25,2018,3,0,5,"Braga",7,"Rua Nova Santa Cruz",44,44,0,39,39,0
10,25,2018,3,0,5,"Braga",8,"Rua Costa Gomes",41,41,0,42,42,0
10,25,2018,4,0,5,"Braga",1,"Avenida da Liberdade",13,13,0,60,60,0
10,25,2018,4,0,5,"Braga",2,"Avenida Central",49,49,0,71,71,0
10,25,2018,4,0,5,"Braga",3,"Rua de Caires",25,25,0,4,4,0
10,25,2018,4,0,5,"Braga",4,"N14 Bosch",47,47,0,48,48,0
10,25,2018,4,0,5,"Braga",5,"Avenida João Paulo II",39,39,0,9,9,0
10,25,2018,4,0,5,"Braga",6,"Avenida Padre Júlio Fragata",67,67,0,83,83,0
10,25,2018,4,0,5,"Braga",7,"Rua Nova Santa Cruz",44,44,0,39,39,0
10,25,2018,4,0,5,"Braga",8,"Rua Costa Gomes",41,41,0,42,42,0
10,25,2018,5,0,5,"Braga",1,"Avenida da Liberdade",13,13,0,60,60,0
10,25,2018,5,0,5,"Braga",2,"Avenida Central",49,49,0,71,71,0
10,25,2018,5,0,5,"Braga",3,"Rua de Caires",25,25,0,4,4,0
10,25,2018,5,0,5,"Braga",4,"N14 Bosch",47,47,0,48,48,0
10,25,2018,5,0,5,"Braga",5,"Avenida João Paulo II",39,39,0,9,9,0
10,25,2018,5,0,5,"Braga",6,"Avenida Padre Júlio Fragata",67,67,0,83,83,0
10,25,2018,5,0,5,"Braga",7,"Rua Nova Santa Cruz",44,44,0,39,39,0
10,25,2018,5,0,5,"Braga",8,"Rua Costa Gomes",41,41,0,42,42,0
10,25,2018,6,0,5,"Braga",1,"Avenida da Liberdade",13,13,0,60,60,0
10,25,2018,6,0,5,"Braga",2,"Avenida Central",49,49,0,71,71,0
10,25,2018,6,0,5,"Braga",3,"Rua de Caires",25,25,0,4,4,0
10,25,2018,6,0,5,"Braga",4,"N14 Bosch",47,47,0,48,48,0
10,25,2018,6,0,5,"Braga",5,"Avenida João Paulo II",39,39,0,9,9,0
10,25,2018,6,0,5,"Braga",6,"Avenida Padre Júlio Fragata",67,67,0,83,83,0
10,25,2018,6,0,5,"Braga",7,"Rua Nova Santa Cruz",44,44,0,39,39,0
10,25,2018,6,0,5,"Braga",8,"Rua Costa Gomes",41,41,0,42,42,0
10,25,2018,7,0,5,"Braga",1,"Avenida da Liberdade",13,13,0,60,60,0
10,25,2018,7,0,5,"Braga",2,"Avenida Central",37,49,12,94,71,23
10,25,2018,7,0,5,"Braga",3,"Rua de Caires",25,25,0,4,4,0
10,25,2018,7,0,5,"Braga",4,"N14 Bosch",19,47,28,118,48,70
10,25,2018,7,0,5,"Braga",5,"Avenida João Paulo II",39,39,0,9,9,0
10,25,2018,7,0,5,"Braga",6,"Avenida Padre Júlio Fragata",67,67,0,83,83,0
10,25,2018,7,0,5,"Braga",7,"Rua Nova Santa Cruz",26,44,18,66,39,27
10,25,2018,7,0,5,"Braga",8,"Rua Costa Gomes",32,41,9,54,42,12
10,25,2018,8,0,5,"Braga",1,"Avenida da Liberdade",13,13,0,60,60,0
10,25,2018,8,0,5,"Braga",2,"Avenida Central",30,49,19,115,71,44
10,25,2018,8,0,5,"Braga",3,"Rua de Caires",25,25,0,4,4,0
10,25,2018,8,0,5,"Braga",4,"N14 Bosch",22,47,25,102,48,54
10,25,2018,8,0,5,"Braga",5,"Avenida João Paulo II",29,39,10,12,9,3
10,25,2018,8,0,5,"Braga",6,"Avenida Padre Júlio Fragata",41,67,26,136,83,53
10,25,2018,8,0,5,"Braga",7,"Rua Nova Santa Cruz",13,44,31,133,39,94
10,25,2018,8,0,5,"Braga",8,"Rua Costa Gomes",28,41,13,62,42,20
10,25,2018,9,0,5,"Braga",1,"Avenida da Liberdade",13,13,0,60,60,0
10,25,2018,9,0,5,"Braga",2,"Avenida Central",49,49,0,71,71,0
10,25,2018,9,0,5,"Braga",3,"Rua de Caires",25,25,0,4,4,0
10,25,2018,9,0,5,"Braga",4,"N14 Bosch",47,47,0,48,48,0
10,25,2018,9,0,5,"Braga",5,"Avenida João Paulo II",39,39,0,9,9,0
10,25,2018,9,0,5,"Braga",6,"Avenida Padre Júlio Fragata",67,67,0,83,83,0
10,25,2018,9,0,5,"Braga",7,"Rua Nova Santa Cruz",17,44,27,102,39,63
10,25,2018,9,0,5,"Braga",8,"Rua Costa Gomes",31,41,10,56,42,14
10,25,2018,10,0,5,"Braga",1,"Avenida da Liberdade",13,13,0,60,60,0
10,25,2018,10,0,5,"Braga",2,"Avenida Central",49,49,0,71,71,0
10,25,2018,10,0,5,"Braga",3,"Rua de Caires",25,25,0,4,4,0
10,25,2018,10,0,5,"Braga",4,"N14 Bosch",33,47,14,68,48,20
10,25,2018,10,0,5,"Braga",5,"Avenida João Paulo II",39,39,0,9,9,0
10,25,2018,10,0,5,"Braga",6,"Avenida Padre Júlio Fragata",67,67,0,83,83,0
10,25,2018,10,0,5,"Braga",7,"Rua Nova Santa Cruz",44,44,0,39,39,0
10,25,2018,10,0,5,"Braga",8,"Rua Costa Gomes",41,41,0,42,42,0
10,25,2018,11,0,5,"Braga",1,"Avenida da Liberdade",13,13,0,60,60,0
10,25,2018,11,0,5,"Braga",2,"Avenida Central",14,49,35,247,71,176
10,25,2018,11,0,5,"Braga",3,"Rua de Caires",25,25,0,4,4,0
10,25,2018,11,0,5,"Braga",4,"N14 Bosch",30,47,17,75,48,27
10,25,2018,11,0,5,"Braga",5,"Avenida João Paulo II",31,39,8,11,9,2
10,25,2018,11,0,5,"Braga",6,"Avenida Padre Júlio Fragata",67,67,0,83,83,0
10,25,2018,11,0,5,"Braga",7,"Rua Nova Santa Cruz",44,44,0,39,39,0
10,25,2018,11,0,5,"Braga",8,"Rua Costa Gomes",28,41,13,62,42,20
10,25,2018,12,0,5,"Braga",1,"Avenida da Liberdade",13,13,0,60,60,0
10,25,2018,12,0,5,"Braga",2,"Avenida Central",49,49,0,71,71,0
10,25,2018,12,0,5,"Braga",3,"Rua de Caires",25,25,0,4,4,0
10,25,2018,12,0,5,"Braga",4,"N14 Bosch",17,47,30,132,48,84
10,25,2018,12,0,5,"Braga",5,"Avenida João Paulo II",39,39,0,9,9,0
10,25,2018,12,0,5,"Braga",6,"Avenida Padre Júlio Fragata",67,67,0,83,83,0
10,25,2018,12,0,5,"Braga",7,"Rua Nova Santa Cruz",28,44,16,62,39,23
10,25,2018,12,0,5,"Braga",8,"Rua Costa Gomes",41,41,0,42,42,0
10,25,2018,13,0,5,"Braga",1,"Avenida da Liberdade",13,13,0,60,60,0
10,25,2018,13,0,5,"Braga",2,"Avenida Central",49,49,0,71,71,0
10,25,2018,13,0,5,"Braga",3,"Rua de Caires",25,25,0,4,4,0
10,25,2018,13,0,5,"Braga",4,"N14 Bosch",29,47,18,77,48,29
10,25,2018,13,0,5,"Braga",5,"Avenida João Paulo II",39,39,0,9,9,0
10,25,2018,13,0,5,"Braga",6,"Avenida Padre Júlio Fragata",67,67,0,83,83,0
10,25,2018,13,0,5,"Braga",7,"Rua Nova Santa Cruz",26,44,18,66,39,27
10,25,2018,13,0,5,"Braga",8,"Rua Costa Gomes",41,41,0,42,42,0
10,25,2018,14,0,5,"Braga",1,"Avenida da Liberdade",13,13,0,60,60,0
10,25,2018,14,0,5,"Braga",2,"Avenida Central",49,49,0,71,71,0
10,25,2018,14,0,5,"Braga",3,"Rua de Caires",25,25,0,4,4,0
10,25,2018,14,0,5,"Braga",4,"N14 Bosch",30,47,17,75,48,27
10,25,2018,14,0,5,"Braga",5,"Avenida João Paulo II",39,39,0,9,9,0
10,25,2018,14,0,5,"Braga",6,"Avenida Padre Júlio Fragata",67,67,0,83,83,0
10,25,2018,14,0,5,"Braga",7,"Rua Nova Santa Cruz",34,44,10,51,39,12
10,25,2018,14,0,5,"Braga",8,"Rua Costa Gomes",30,41,11,58,42,16
10,25,2018,15,0,5,"Braga",1,"Avenida da Liberdade",13,13,0,60,60,0
10,25,2018,15,0,5,"Braga",2,"Avenida Central",49,49,0,71,71,0
10,25,2018,15,0,5,"Braga",3,"Rua de Caires",16,25,9,7,4,3
10,25,2018,15,0,5,"Braga",4,"N14 Bosch",33,47,14,68,48,20
10,25,2018,15,0,5,"Braga",5,"Avenida João Paulo II",39,39,0,9,9,0
10,25,2018,15,0,5,"Braga",6,"Avenida Padre Júlio Fragata",67,67,0,83,83,0
10,25,2018,15,0,5,"Braga",7,"Rua Nova Santa Cruz",44,44,0,39,39,0
10,25,2018,15,0,5,"Braga",8,"Rua Costa Gomes",28,41,13,62,42,20
10,25,2018,16,0,5,"Braga",1,"Avenida da Liberdade",13,13,0,60,60,0
10,25,2018,16,0,5,"Braga",2,"Avenida Central",49,49,0,71,71,0
10,25,2018,16,0,5,"Braga",3,"Rua de Caires",16,25,9,7,4,3
10,25,2018,16,0,5,"Braga",4,"N14 Bosch",21,47,26,107,48,59
10,25,2018,16,0,5,"Braga",5,"Avenida João Paulo II",27,39,12,13,9,4
10,25,2018,16,0,5,"Braga",6,"Avenida Padre Júlio Fragata",49,67,18,114,83,31
10,25,2018,16,0,5,"Braga",7,"Rua Nova Santa Cruz",44,44,0,39,39,0
10,25,2018,16,0,5,"Braga",8,"Rua Costa Gomes",23,41,18,75,42,33
10,25,2018,17,0,5,"Braga",1,"Avenida da Liberdade",13,13,0,60,60,0
10,25,2018,17,0,5,"Braga",2,"Avenida Central",33,49,16,105,71,34
10,25,2018,17,0,5,"Braga",3,"Rua de Caires",12,25,13,9,4,5
10,25,2018,17,0,5,"Braga",4,"N14 Bosch",14,47,33,160,48,112
10,25,2018,17,0,5,"Braga",5,"Avenida João Paulo II",39,39,0,9,9,0
10,25,2018,17,0,5,"Braga",6,"Avenida Padre Júlio Fragata",30,67,37,186,83,103
10,25,2018,17,0,5,"Braga",7,"Rua Nova Santa Cruz",8,44,36,216,39,177
10,25,2018,17,0,5,"Braga",8,"Rua Costa Gomes",10,41,31,173,42,131
10,25,2018,18,0,5,"Braga",1,"Avenida da Liberdade",13,13,0,60,60,0
10,25,2018,18,0,5,"Braga",2,"Avenida Central",34,49,15,102,71,31
10,25,2018,18,0,5,"Braga",3,"Rua de Caires",8,25,17,13,4,9
10,25,2018,18,0,5,"Braga",4,"N14 Bosch",19,47,28,118,48,70
10,25,2018,18,0,5,"Braga",5,"Avenida João Paulo II",21,39,18,17,9,8
10,25,2018,18,0,5,"Braga",6,"Avenida Padre Júlio Fragata",39,67,28,143,83,60
10,25,2018,18,0,5,"Braga",7,"Rua Nova Santa Cruz",8,44,36,216,39,177
10,25,2018,18,0,5,"Braga",8,"Rua Costa Gomes",15,41,26,115,42,73
10,25,2018,19,0,5,"Braga",1,"Avenida da Liberdade",13,13,0,60,60,0
10,25,2018,19,0,5,"Braga",2,"Avenida Central",49,49,0,71,71,0
10,25,2018,19,0,5,"Braga",3,"Rua de Caires",25,25,0,4,4,0
10,25,2018,19,0,5,"Braga",4,"N14 Bosch",47,47,0,48,48,0
10,25,2018,19,0,5,"Braga",5,"Avenida João Paulo II",39,39,0,9,9,0
10,25,2018,19,0,5,"Braga",6,"Avenida Padre Júlio Fragata",67,67,0,83,83,0
10,25,2018,19,0,5,"Braga",7,"Rua Nova Santa Cruz",28,44,16,62,39,23
10,25,2018,19,0,5,"Braga",8,"Rua Costa Gomes",41,41,0,42,42,0
10,25,2018,20,0,5,"Braga",1,"Avenida da Liberdade",13,13,0,60,60,0
10,25,2018,20,0,5,"Braga",2,"Avenida Central",34,49,15,102,71,31
10,25,2018,20,0,5,"Braga",3,"Rua de Caires",25,25,0,4,4,0
10,25,2018,20,0,5,"Braga",4,"N14 Bosch",47,47,0,48,48,0
10,25,2018,20,0,5,"Braga",5,"Avenida João Paulo II",39,39,0,9,9,0
10,25,2018,20,0,5,"Braga",6,"Avenida Padre Júlio Fragata",67,67,0,83,83,0
10,25,2018,20,0,5,"Braga",7,"Rua Nova Santa Cruz",44,44,0,39,39,0
10,25,2018,20,0,5,"Braga",8,"Rua Costa Gomes",41,41,0,42,42,0
10,25,2018,21,0,5,"Braga",1,"Avenida da Liberdade",13,13,0,60,60,0
10,25,2018,21,0,5,"Braga",2,"Avenida Central",49,49,0,71,71,0
10,25,2018,21,0,5,"Braga",3,"Rua de Caires",7,25,18,15,4,11
10,25,2018,21,0,5,"Braga",4,"N14 Bosch",47,47,0,48,48,0
10,25,2018,21,0,5,"Braga",5,"Avenida João Paulo II",39,39,0,9,9,0
10,25,2018,21,0,5,"Braga",6,"Avenida Padre Júlio Fragata",67,67,0,83,83,0
10,25,2018,21,0,5,"Braga",7,"Rua Nova Santa Cruz",44,44,0,39,39,0
10,25,2018,21,0,5,"Braga",8,"Rua Costa Gomes",41,41,0,42,42,0
10,25,2018,22,0,5,"Braga",1,"Avenida da Liberdade",13,13,0,60,60,0
10,25,2018,22,0,5,"Braga",2,"Avenida Central",49,49,0,71,71,0
10,25,2018,22,0,5,"Braga",3,"Rua de Caires",19,25,6,5,4,1
10,25,2018,22,0,5,"Braga",4,"N14 Bosch",20,47,27,112,48,64
10,25,2018,22,0,5,"Braga",5,"Avenida João Paulo II",39,39,0,9,9,0
10,25,2018,22,0,5,"Braga",6,"Avenida Padre Júlio Fragata",67,67,0,83,83,0
10,25,2018,22,0,5,"Braga",7,"Rua Nova Santa Cruz",44,44,0,39,39,0
10,25,2018,22,0,5,"Braga",8,"Rua Costa Gomes",41,41,0,42,42,0
10,25,2018,23,0,5,"Braga",1,"Avenida da Liberdade",13,13,0,60,60,0
10,25,2018,23,0,5,"Braga",2,"Avenida Central",49,49,0,71,71,0
10,25,2018,23,0,5,"Braga",3,"Rua de Caires",2,25,23,52,4,48
10,25,2018,23,0,5,"Braga",4,"N14 Bosch",47,47,0,48,48,0
10,25,2018,23,0,5,"Braga",5,"Avenida João Paulo II",39,39,0,9,9,0
10,25,2018,23,0,5,"Braga",6,"Avenida Padre Júlio Fragata",67,67,0,83,83,0
10,25,2018,23,0,5,"Braga",7,"Rua Nova Santa Cruz",44,44,0,39,39,0
10,25,2018,23,0,5,"Braga",8,"Rua Costa Gomes",41,41,0,42,42,0
10,26,2018,0,0,6,"Braga",1,"Avenida da Liberdade",13,13,0,60,60,0
10,26,2018,0,0,6,"Braga",2,"Avenida Central",49,49,0,71,71,0
10,26,2018,0,0,6,"Braga",3,"Rua de Caires",25,25,0,4,4,0
10,26,2018,0,0,6,"Braga",4,"N14 Bosch",47,47,0,48,48,0
10,26,2018,0,0,6,"Braga",5,"Avenida João Paulo II",39,39,0,9,9,0
10,26,2018,0,0,6,"Braga",6,"Avenida Padre Júlio Fragata",67,67,0,83,83,0
10,26,2018,0,0,6,"Braga",7,"Rua Nova Santa Cruz",27,44,17,64,39,25
10,26,2018,0,0,6,"Braga",8,"Rua Costa Gomes",41,41,0,42,42,0
10,26,2018,1,0,6,"Braga",1,"Avenida da Liberdade",13,13,0,60,60,0
10,26,2018,1,0,6,"Braga",2,"Avenida Central",49,49,0,71,71,0
10,26,2018,1,0,6,"Braga",3,"Rua de Caires",25,25,0,4,4,0
10,26,2018,1,0,6,"Braga",4,"N14 Bosch",47,47,0,48,48,0
10,26,2018,1,0,6,"Braga",5,"Avenida João Paulo II",39,39,0,9,9,0
10,26,2018,1,0,6,"Braga",6,"Avenida Padre Júlio Fragata",67,67,0,83,83,0
10,26,2018,1,0,6,"Braga",7,"Rua Nova Santa Cruz",44,44,0,39,39,0
10,26,2018,1,0,6,"Braga",8,"Rua Costa Gomes",41,41,0,42,42,0
10,26,2018,2,0,6,"Braga",1,"Avenida da Liberdade",13,13,0,60,60,0
10,26,2018,2,0,6,"Braga",2,"Avenida Central",49,49,0,71,71,0
10,26,2018,2,0,6,"Braga",3,"Rua de Caires",25,25,0,4,4,0
10,26,2018,2,0,6,"Braga",4,"N14 Bosch",47,47,0,48,48,0
10,26,2018,2,0,6,"Braga",5,"Avenida João Paulo II",39,39,0,9,9,0
10,26,2018,2,0,6,"Braga",6,"Avenida Padre Júlio Fragata",67,67,0,83,83,0
10,26,2018,2,0,6,"Braga",7,"Rua Nova Santa Cruz",44,44,0,39,39,0
10,26,2018,2,0,6,"Braga",8,"Rua Costa Gomes",41,41,0,42,42,0
10,26,2018,3,0,6,"Braga",1,"Avenida da Liberdade",13,13,0,60,60,0
10,26,2018,3,0,6,"Braga",2,"Avenida Central",49,49,0,71,71,0
10,26,2018,3,0,6,"Braga",3,"Rua de Caires",25,25,0,4,4,0
10,26,2018,3,0,6,"Braga",4,"N14 Bosch",47,47,0,48,48,0
10,26,2018,3,0,6,"Braga",5,"Avenida João Paulo II",39,39,0,9,9,0
10,26,2018,3,0,6,"Braga",6,"Avenida Padre Júlio Fragata",67,67,0,83,83,0
10,26,2018,3,0,6,"Braga",7,"Rua Nova Santa Cruz",44,44,0,39,39,0
10,26,2018,3,0,6,"Braga",8,"Rua Costa Gomes",41,41,0,42,42,0
10,26,2018,4,0,6,"Braga",1,"Avenida da Liberdade",13,13,0,60,60,0
10,26,2018,4,0,6,"Braga",2,"Avenida Central",49,49,0,71,71,0
10,26,2018,4,0,6,"Braga",3,"Rua de Caires",25,25,0,4,4,0
10,26,2018,4,0,6,"Braga",4,"N14 Bosch",47,47,0,48,48,0
10,26,2018,4,0,6,"Braga",5,"Avenida João Paulo II",39,39,0,9,9,0
10,26,2018,4,0,6,"Braga",6,"Avenida Padre Júlio Fragata",67,67,0,83,83,0
10,26,2018,4,0,6,"Braga",7,"Rua Nova Santa Cruz",44,44,0,39,39,0
10,26,2018,4,0,6,"Braga",8,"Rua Costa Gomes",41,41,0,42,42,0
10,26,2018,5,0,6,"Braga",1,"Avenida da Liberdade",13,13,0,60,60,0
10,26,2018,5,0,6,"Braga",2,"Avenida Central",49,49,0,71,71,0
10,26,2018,5,0,6,"Braga",3,"Rua de Caires",25,25,0,4,4,0
10,26,2018,5,0,6,"Braga",4,"N14 Bosch",47,47,0,48,48,0
10,26,2018,5,0,6,"Braga",5,"Avenida João Paulo II",39,39,0,9,9,0
10,26,2018,5,0,6,"Braga",6,"Avenida Padre Júlio Fragata",67,67,0,83,83,0
10,26,2018,5,0,6,"Braga",7,"Rua Nova Santa Cruz",44,44,0,39,39,0
10,26,2018,5,0,6,"Braga",8,"Rua Costa Gomes",41,41,0,42,42,0
10,26,2018,6,0,6,"Braga",1,"Avenida da Liberdade",10,13,3,78,60,18
10,26,2018,6,0,6,"Braga",2,"Avenida Central",49,49,0,71,71,0
10,26,2018,6,0,6,"Braga",3,"Rua de Caires",25,25,0,4,4,0
10,26,2018,6,0,6,"Braga",4,"N14 Bosch",47,47,0,48,48,0
10,26,2018,6,0,6,"Braga",5,"Avenida João Paulo II",39,39,0,9,9,0
10,26,2018,6,0,6,"Braga",6,"Avenida Padre Júlio Fragata",67,67,0,83,83,0
10,26,2018,6,0,6,"Braga",7,"Rua Nova Santa Cruz",44,44,0,39,39,0
10,26,2018,6,0,6,"Braga",8,"Rua Costa Gomes",41,41,0,42,42,0
10,26,2018,7,0,6,"Braga",1,"Avenida da Liberdade",10,13,3,78,60,18
10,26,2018,7,0,6,"Braga",2,"Avenida Central",49,49,0,71,71,0
10,26,2018,7,0,6,"Braga",3,"Rua de Caires",25,25,0,4,4,0
10,26,2018,7,0,6,"Braga",4,"N14 Bosch",47,47,0,48,48,0
10,26,2018,7,0,6,"Braga",5,"Avenida João Paulo II",39,39,0,9,9,0
10,26,2018,7,0,6,"Braga",6,"Avenida Padre Júlio Fragata",67,67,0,83,83,0
10,26,2018,7,0,6,"Braga",7,"Rua Nova Santa Cruz",44,44,0,39,39,0
10,26,2018,7,0,6,"Braga",8,"Rua Costa Gomes",41,41,0,42,42,0
10,26,2018,8,0,6,"Braga",1,"Avenida da Liberdade",13,13,0,60,60,0
10,26,2018,8,0,6,"Braga",2,"Avenida Central",30,49,19,115,71,44
10,26,2018,8,0,6,"Braga",3,"Rua de Caires",25,25,0,4,4,0
10,26,2018,8,0,6,"Braga",4,"N14 Bosch",30,47,17,75,48,27
10,26,2018,8,0,6,"Braga",5,"Avenida João Paulo II",26,39,13,13,9,4
10,26,2018,8,0,6,"Braga",6,"Avenida Padre Júlio Fragata",45,67,22,124,83,41
10,26,2018,8,0,6,"Braga",7,"Rua Nova Santa Cruz",18,44,26,96,39,57
10,26,2018,8,0,6,"Braga",8,"Rua Costa Gomes",16,41,25,108,42,66
10,26,2018,9,0,6,"Braga",1,"Avenida da Liberdade",13,13,0,60,60,0
10,26,2018,9,0,6,"Braga",2,"Avenida Central",49,49,0,71,71,0
10,26,2018,9,0,6,"Braga",3,"Rua de Caires",25,25,0,4,4,0
10,26,2018,9,0,6,"Braga",4,"N14 Bosch",47,47,0,48,48,0
10,26,2018,9,0,6,"Braga",5,"Avenida João Paulo II",39,39,0,9,9,0
10,26,2018,9,0,6,"Braga",6,"Avenida Padre Júlio Fragata",67,67,0,83,83,0
10,26,2018,9,0,6,"Braga",7,"Rua Nova Santa Cruz",31,44,13,56,39,17
10,26,2018,9,0,6,"Braga",8,"Rua Costa Gomes",30,41,11,58,42,16
10,26,2018,10,0,6,"Braga",1,"Avenida da Liberdade",13,13,0,60,60,0
10,26,2018,10,0,6,"Braga",2,"Avenida Central",49,49,0,71,71,0
10,26,2018,10,0,6,"Braga",3,"Rua de Caires",25,25,0,4,4,0
10,26,2018,10,0,6,"Braga",4,"N14 Bosch",47,47,0,48,48,0
10,26,2018,10,0,6,"Braga",5,"Avenida João Paulo II",24,39,15,15,9,6
10,26,2018,10,0,6,"Braga",6,"Avenida Padre Júlio Fragata",67,67,0,83,83,0
10,26,2018,10,0,6,"Braga",7,"Rua Nova Santa Cruz",44,44,0,39,39,0
10,26,2018,10,0,6,"Braga",8,"Rua Costa Gomes",41,41,0,42,42,0
10,26,2018,11,0,6,"Braga",1,"Avenida da Liberdade",13,13,0,60,60,0
10,26,2018,11,0,6,"Braga",2,"Avenida Central",49,49,0,71,71,0
10,26,2018,11,0,6,"Braga",3,"Rua de Caires",25,25,0,4,4,0
10,26,2018,11,0,6,"Braga",4,"N14 Bosch",28,47,19,80,48,32
10,26,2018,11,0,6,"Braga",5,"Avenida João Paulo II",39,39,0,9,9,0
10,26,2018,11,0,6,"Braga",6,"Avenida Padre Júlio Fragata",67,67,0,83,83,0
10,26,2018,11,0,6,"Braga",7,"Rua Nova Santa Cruz",44,44,0,39,39,0
10,26,2018,11,0,6,"Braga",8,"Rua Costa Gomes",41,41,0,42,42,0
10,26,2018,12,0,6,"Braga",1,"Avenida da Liberdade",13,13,0,60,60,0
10,26,2018,12,0,6,"Braga",2,"Avenida Central",49,49,0,71,71,0
10,26,2018,12,0,6,"Braga",3,"Rua de Caires",25,25,0,4,4,0
10,26,2018,12,0,6,"Braga",4,"N14 Bosch",17,47,30,132,48,84
10,26,2018,12,0,6,"Braga",5,"Avenida João Paulo II",39,39,0,9,9,0
10,26,2018,12,0,6,"Braga",6,"Avenida Padre Júlio Fragata",67,67,0,83,83,0
10,26,2018,12,0,6,"Braga",7,"Rua Nova Santa Cruz",24,44,20,72,39,33
10,26,2018,12,0,6,"Braga",8,"Rua Costa Gomes",41,41,0,42,42,0
10,26,2018,13,0,6,"Braga",1,"Avenida da Liberdade",13,13,0,60,60,0
10,26,2018,13,0,6,"Braga",2,"Avenida Central",49,49,0,71,71,0
10,26,2018,13,0,6,"Braga",3,"Rua de Caires",3,25,22,35,4,31
10,26,2018,13,0,6,"Braga",4,"N14 Bosch",30,47,17,75,48,27
10,26,2018,13,0,6,"Braga",5,"Avenida João Paulo II",39,39,0,9,9,0
10,26,2018,13,0,6,"Braga",6,"Avenida Padre Júlio Fragata",51,67,16,109,83,26
10,26,2018,13,0,6,"Braga",7,"Rua Nova Santa Cruz",22,44,22,79,39,40
10,26,2018,13,0,6,"Braga",8,"Rua Costa Gomes",31,41,10,56,42,14
10,26,2018,14,0,6,"Braga",1,"Avenida da Liberdade",13,13,0,60,60,0
10,26,2018,14,0,6,"Braga",2,"Avenida Central",38,49,11,91,71,20
10,26,2018,14,0,6,"Braga",3,"Rua de Caires",25,25,0,4,4,0
10,26,2018,14,0,6,"Braga",4,"N14 Bosch",19,47,28,118,48,70
10,26,2018,14,0,6,"Braga",5,"Avenida João Paulo II",9,39,30,39,9,30
10,26,2018,14,0,6,"Braga",6,"Avenida Padre Júlio Fragata",67,67,0,83,83,0
10,26,2018,14,0,6,"Braga",7,"Rua Nova Santa Cruz",33,44,11,52,39,13
10,26,2018,14,0,6,"Braga",8,"Rua Costa Gomes",29,41,12,60,42,18
10,26,2018,15,0,6,"Braga",1,"Avenida da Liberdade",13,13,0,60,60,0
10,26,2018,15,0,6,"Braga",2,"Avenida Central",49,49,0,71,71,0
10,26,2018,15,0,6,"Braga",3,"Rua de Caires",13,25,12,8,4,4
10,26,2018,15,0,6,"Braga",4,"N14 Bosch",15,47,32,150,48,102
10,26,2018,15,0,6,"Braga",5,"Avenida João Paulo II",30,39,9,12,9,3
10,26,2018,15,0,6,"Braga",6,"Avenida Padre Júlio Fragata",51,67,16,109,83,26
10,26,2018,15,0,6,"Braga",7,"Rua Nova Santa Cruz",25,44,19,69,39,30
10,26,2018,15,0,6,"Braga",8,"Rua Costa Gomes",41,41,0,42,42,0
10,26,2018,16,0,6,"Braga",1,"Avenida da Liberdade",13,13,0,60,60,0
10,26,2018,16,0,6,"Braga",2,"Avenida Central",49,49,0,71,71,0
10,26,2018,16,0,6,"Braga",3,"Rua de Caires",25,25,0,4,4,0
10,26,2018,16,0,6,"Braga",4,"N14 Bosch",11,47,36,204,48,156
10,26,2018,16,0,6,"Braga",5,"Avenida João Paulo II",39,39,0,9,9,0
10,26,2018,16,0,6,"Braga",6,"Avenida Padre Júlio Fragata",42,67,25,133,83,50
10,26,2018,16,0,6,"Braga",7,"Rua Nova Santa Cruz",34,44,10,51,39,12
10,26,2018,16,0,6,"Braga",8,"Rua Costa Gomes",18,41,23,96,42,54
10,26,2018,17,0,6,"Braga",1,"Avenida da Liberdade",13,13,0,60,60,0
10,26,2018,17,0,6,"Braga",2,"Avenida Central",38,49,11,91,71,20
10,26,2018,17,0,6,"Braga",3,"Rua de Caires",12,25,13,9,4,5
10,26,2018,17,0,6,"Braga",4,"N14 Bosch",11,47,36,204,48,156
10,26,2018,17,0,6,"Braga",5,"Avenida João Paulo II",39,39,0,9,9,0
10,26,2018,17,0,6,"Braga",6,"Avenida Padre Júlio Fragata",28,67,39,199,83,116
10,26,2018,17,0,6,"Braga",7,"Rua Nova Santa Cruz",11,44,33,157,39,118
10,26,2018,17,0,6,"Braga",8,"Rua Costa Gomes",10,41,31,173,42,131
10,26,2018,18,0,6,"Braga",1,"Avenida da Liberdade",13,13,0,60,60,0
10,26,2018,18,0,6,"Braga",2,"Avenida Central",49,49,0,71,71,0
10,26,2018,18,0,6,"Braga",3,"Rua de Caires",12,25,13,9,4,5
10,26,2018,18,0,6,"Braga",4,"N14 Bosch",16,47,31,140,48,92
10,26,2018,18,0,6,"Braga",5,"Avenida João Paulo II",30,39,9,12,9,3
10,26,2018,18,0,6,"Braga",6,"Avenida Padre Júlio Fragata",24,67,43,232,83,149
10,26,2018,18,0,6,"Braga",7,"Rua Nova Santa Cruz",31,44,13,56,39,17
10,26,2018,18,0,6,"Braga",8,"Rua Costa Gomes",20,41,21,87,42,45
10,26,2018,19,0,6,"Braga",1,"Avenida da Liberdade",13,13,0,60,60,0
10,26,2018,19,0,6,"Braga",2,"Avenida Central",49,49,0,71,71,0
10,26,2018,19,0,6,"Braga",3,"Rua de Caires",5,25,20,21,4,17
10,26,2018,19,0,6,"Braga",4,"N14 Bosch",14,47,33,160,48,112
10,26,2018,19,0,6,"Braga",5,"Avenida João Paulo II",39,39,0,9,9,0
10,26,2018,19,0,6,"Braga",6,"Avenida Padre Júlio Fragata",19,67,48,293,83,210
10,26,2018,19,0,6,"Braga",7,"Rua Nova Santa Cruz",25,44,19,69,39,30
10,26,2018,19,0,6,"Braga",8,"Rua Costa Gomes",30,41,11,58,42,16
10,26,2018,20,0,6,"Braga",1,"Avenida da Liberdade",13,13,0,60,60,0
10,26,2018,20,0,6,"Braga",2,"Avenida Central",49,49,0,71,71,0
10,26,2018,20,0,6,"Braga",3,"Rua de Caires",25,25,0,4,4,0
10,26,2018,20,0,6,"Braga",4,"N14 Bosch",36,47,11,62,48,14
10,26,2018,20,0,6,"Braga",5,"Avenida João Paulo II",39,39,0,9,9,0
10,26,2018,20,0,6,"Braga",6,"Avenida Padre Júlio Fragata",52,67,15,107,83,24
10,26,2018,20,0,6,"Braga",7,"Rua Nova Santa Cruz",44,44,0,39,39,0
10,26,2018,20,0,6,"Braga",8,"Rua Costa Gomes",41,41,0,42,42,0
10,26,2018,21,0,6,"Braga",1,"Avenida da Liberdade",13,13,0,60,60,0
10,26,2018,21,0,6,"Braga",2,"Avenida Central",49,49,0,71,71,0
10,26,2018,21,0,6,"Braga",3,"Rua de Caires",25,25,0,4,4,0
10,26,2018,21,0,6,"Braga",4,"N14 Bosch",47,47,0,48,48,0
10,26,2018,21,0,6,"Braga",5,"Avenida João Paulo II",39,39,0,9,9,0
10,26,2018,21,0,6,"Braga",6,"Avenida Padre Júlio Fragata",67,67,0,83,83,0
10,26,2018,21,0,6,"Braga",7,"Rua Nova Santa Cruz",44,44,0,39,39,0
10,26,2018,21,0,6,"Braga",8,"Rua Costa Gomes",41,41,0,42,42,0
10,26,2018,22,0,6,"Braga",1,"Avenida da Liberdade",13,13,0,60,60,0
10,26,2018,22,0,6,"Braga",2,"Avenida Central",49,49,0,71,71,0
10,26,2018,22,0,6,"Braga",3,"Rua de Caires",25,25,0,4,4,0
10,26,2018,22,0,6,"Braga",4,"N14 Bosch",47,47,0,48,48,0
10,26,2018,22,0,6,"Braga",5,"Avenida João Paulo II",39,39,0,9,9,0
10,26,2018,22,0,6,"Braga",6,"Avenida Padre Júlio Fragata",38,67,29,147,83,64
10,26,2018,22,0,6,"Braga",7,"Rua Nova Santa Cruz",44,44,0,39,39,0
10,26,2018,22,0,6,"Braga",8,"Rua Costa Gomes",41,41,0,42,42,0
10,26,2018,23,0,6,"Braga",1,"Avenida da Liberdade",13,13,0,60,60,0
10,26,2018,23,0,6,"Braga",2,"Avenida Central",49,49,0,71,71,0
10,26,2018,23,0,6,"Braga",3,"Rua de Caires",25,25,0,4,4,0
10,26,2018,23,0,6,"Braga",4,"N14 Bosch",47,47,0,48,48,0
10,26,2018,23,0,6,"Braga",5,"Avenida João Paulo II",39,39,0,9,9,0
10,26,2018,23,0,6,"Braga",6,"Avenida Padre Júlio Fragata",67,67,0,83,83,0
10,26,2018,23,0,6,"Braga",7,"Rua Nova Santa Cruz",44,44,0,39,39,0
10,26,2018,23,0,6,"Braga",8,"Rua Costa Gomes",41,41,0,42,42,0
10,27,2018,0,0,7,"Braga",1,"Avenida da Liberdade",13,13,0,60,60,0
10,27,2018,0,0,7,"Braga",2,"Avenida Central",49,49,0,71,71,0
10,27,2018,0,0,7,"Braga",3,"Rua de Caires",25,25,0,4,4,0
10,27,2018,0,0,7,"Braga",4,"N14 Bosch",47,47,0,48,48,0
10,27,2018,0,0,7,"Braga",5,"Avenida João Paulo II",39,39,0,9,9,0
10,27,2018,0,0,7,"Braga",6,"Avenida Padre Júlio Fragata",67,67,0,83,83,0
10,27,2018,0,0,7,"Braga",7,"Rua Nova Santa Cruz",44,44,0,39,39,0
10,27,2018,0,0,7,"Braga",8,"Rua Costa Gomes",41,41,0,42,42,0
10,27,2018,1,0,7,"Braga",1,"Avenida da Liberdade",13,13,0,60,60,0
10,27,2018,1,0,7,"Braga",2,"Avenida Central",49,49,0,71,71,0
10,27,2018,1,0,7,"Braga",3,"Rua de Caires",25,25,0,4,4,0
10,27,2018,1,0,7,"Braga",4,"N14 Bosch",47,47,0,48,48,0
10,27,2018,1,0,7,"Braga",5,"Avenida João Paulo II",39,39,0,9,9,0
10,27,2018,1,0,7,"Braga",6,"Avenida Padre Júlio Fragata",67,67,0,83,83,0
10,27,2018,1,0,7,"Braga",7,"Rua Nova Santa Cruz",44,44,0,39,39,0
10,27,2018,1,0,7,"Braga",8,"Rua Costa Gomes",41,41,0,42,42,0
10,27,2018,2,0,7,"Braga",1,"Avenida da Liberdade",13,13,0,60,60,0
10,27,2018,2,0,7,"Braga",2,"Avenida Central",49,49,0,71,71,0
10,27,2018,2,0,7,"Braga",3,"Rua de Caires",25,25,0,4,4,0
10,27,2018,2,0,7,"Braga",4,"N14 Bosch",47,47,0,48,48,0
10,27,2018,2,0,7,"Braga",5,"Avenida João Paulo II",39,39,0,9,9,0
10,27,2018,2,0,7,"Braga",6,"Avenida Padre Júlio Fragata",67,67,0,83,83,0
10,27,2018,2,0,7,"Braga",7,"Rua Nova Santa Cruz",44,44,0,39,39,0
10,27,2018,2,0,7,"Braga",8,"Rua Costa Gomes",41,41,0,42,42,0
10,27,2018,3,0,7,"Braga",1,"Avenida da Liberdade",13,13,0,60,60,0
10,27,2018,3,0,7,"Braga",2,"Avenida Central",49,49,0,71,71,0
10,27,2018,3,0,7,"Braga",3,"Rua de Caires",25,25,0,4,4,0
10,27,2018,3,0,7,"Braga",4,"N14 Bosch",47,47,0,48,48,0
10,27,2018,3,0,7,"Braga",5,"Avenida João Paulo II",39,39,0,9,9,0
10,27,2018,3,0,7,"Braga",6,"Avenida Padre Júlio Fragata",67,67,0,83,83,0
10,27,2018,3,0,7,"Braga",7,"Rua Nova Santa Cruz",44,44,0,39,39,0
10,27,2018,3,0,7,"Braga",8,"Rua Costa Gomes",41,41,0,42,42,0
10,27,2018,4,0,7,"Braga",1,"Avenida da Liberdade",13,13,0,60,60,0
10,27,2018,4,0,7,"Braga",2,"Avenida Central",49,49,0,71,71,0
10,27,2018,4,0,7,"Braga",3,"Rua de Caires",25,25,0,4,4,0
10,27,2018,4,0,7,"Braga",4,"N14 Bosch",47,47,0,48,48,0
10,27,2018,4,0,7,"Braga",5,"Avenida João Paulo II",39,39,0,9,9,0
10,27,2018,4,0,7,"Braga",6,"Avenida Padre Júlio Fragata",67,67,0,83,83,0
10,27,2018,4,0,7,"Braga",7,"Rua Nova Santa Cruz",44,44,0,39,39,0
10,27,2018,4,0,7,"Braga",8,"Rua Costa Gomes",41,41,0,42,42,0
10,27,2018,5,0,7,"Braga",1,"Avenida da Liberdade",13,13,0,60,60,0
10,27,2018,5,0,7,"Braga",2,"Avenida Central",49,49,0,71,71,0
10,27,2018,5,0,7,"Braga",3,"Rua de Caires",25,25,0,4,4,0
10,27,2018,5,0,7,"Braga",4,"N14 Bosch",47,47,0,48,48,0
10,27,2018,5,0,7,"Braga",5,"Avenida João Paulo II",39,39,0,9,9,0
10,27,2018,5,0,7,"Braga",6,"Avenida Padre Júlio Fragata",67,67,0,83,83,0
10,27,2018,5,0,7,"Braga",7,"Rua Nova Santa Cruz",44,44,0,39,39,0
10,27,2018,5,0,7,"Braga",8,"Rua Costa Gomes",41,41,0,42,42,0
10,27,2018,6,0,7,"Braga",1,"Avenida da Liberdade",13,13,0,60,60,0
10,27,2018,6,0,7,"Braga",2,"Avenida Central",49,49,0,71,71,0
10,27,2018,6,0,7,"Braga",3,"Rua de Caires",25,25,0,4,4,0
10,27,2018,6,0,7,"Braga",4,"N14 Bosch",47,47,0,48,48,0
10,27,2018,6,0,7,"Braga",5,"Avenida João Paulo II",39,39,0,9,9,0
10,27,2018,6,0,7,"Braga",6,"Avenida Padre Júlio Fragata",67,67,0,83,83,0
10,27,2018,6,0,7,"Braga",7,"Rua Nova Santa Cruz",44,44,0,39,39,0
10,27,2018,6,0,7,"Braga",8,"Rua Costa Gomes",41,41,0,42,42,0
10,27,2018,7,0,7,"Braga",1,"Avenida da Liberdade",13,13,0,60,60,0
10,27,2018,7,0,7,"Braga",2,"Avenida Central",49,49,0,71,71,0
10,27,2018,7,0,7,"Braga",3,"Rua de Caires",7,25,18,15,4,11
10,27,2018,7,0,7,"Braga",4,"N14 Bosch",47,47,0,48,48,0
10,27,2018,7,0,7,"Braga",5,"Avenida João Paulo II",39,39,0,9,9,0
10,27,2018,7,0,7,"Braga",6,"Avenida Padre Júlio Fragata",67,67,0,83,83,0
10,27,2018,7,0,7,"Braga",7,"Rua Nova Santa Cruz",44,44,0,39,39,0
10,27,2018,7,0,7,"Braga",8,"Rua Costa Gomes",41,41,0,42,42,0
10,27,2018,8,0,7,"Braga",1,"Avenida da Liberdade",13,13,0,60,60,0
10,27,2018,8,0,7,"Braga",2,"Avenida Central",49,49,0,71,71,0
10,27,2018,8,0,7,"Braga",3,"Rua de Caires",5,25,20,21,4,17
10,27,2018,8,0,7,"Braga",4,"N14 Bosch",47,47,0,48,48,0
10,27,2018,8,0,7,"Braga",5,"Avenida João Paulo II",39,39,0,9,9,0
10,27,2018,8,0,7,"Braga",6,"Avenida Padre Júlio Fragata",67,67,0,83,83,0
10,27,2018,8,0,7,"Braga",7,"Rua Nova Santa Cruz",44,44,0,39,39,0
10,27,2018,8,0,7,"Braga",8,"Rua Costa Gomes",41,41,0,42,42,0
10,27,2018,9,0,7,"Braga",1,"Avenida da Liberdade",13,13,0,60,60,0
10,27,2018,9,0,7,"Braga",2,"Avenida Central",49,49,0,71,71,0
10,27,2018,9,0,7,"Braga",3,"Rua de Caires",25,25,0,4,4,0
10,27,2018,9,0,7,"Braga",4,"N14 Bosch",47,47,0,48,48,0
10,27,2018,9,0,7,"Braga",5,"Avenida João Paulo II",39,39,0,9,9,0
10,27,2018,9,0,7,"Braga",6,"Avenida Padre Júlio Fragata",67,67,0,83,83,0
10,27,2018,9,0,7,"Braga",7,"Rua Nova Santa Cruz",33,44,11,52,39,13
10,27,2018,9,0,7,"Braga",8,"Rua Costa Gomes",32,41,9,54,42,12
10,27,2018,10,0,7,"Braga",1,"Avenida da Liberdade",13,13,0,60,60,0
10,27,2018,10,0,7,"Braga",2,"Avenida Central",49,49,0,71,71,0
10,27,2018,10,0,7,"Braga",3,"Rua de Caires",25,25,0,4,4,0
10,27,2018,10,0,7,"Braga",4,"N14 Bosch",34,47,13,66,48,18
10,27,2018,10,0,7,"Braga",5,"Avenida João Paulo II",28,39,11,12,9,3
10,27,2018,10,0,7,"Braga",6,"Avenida Padre Júlio Fragata",67,67,0,83,83,0
10,27,2018,10,0,7,"Braga",7,"Rua Nova Santa Cruz",44,44,0,39,39,0
10,27,2018,10,0,7,"Braga",8,"Rua Costa Gomes",41,41,0,42,42,0
10,27,2018,11,0,7,"Braga",1,"Avenida da Liberdade",13,13,0,60,60,0
10,27,2018,11,0,7,"Braga",2,"Avenida Central",49,49,0,71,71,0
10,27,2018,11,0,7,"Braga",3,"Rua de Caires",25,25,0,4,4,0
10,27,2018,11,0,7,"Braga",4,"N14 Bosch",47,47,0,48,48,0
10,27,2018,11,0,7,"Braga",5,"Avenida João Paulo II",28,39,11,12,9,3
10,27,2018,11,0,7,"Braga",6,"Avenida Padre Júlio Fragata",67,67,0,83,83,0
10,27,2018,11,0,7,"Braga",7,"Rua Nova Santa Cruz",44,44,0,39,39,0
10,27,2018,11,0,7,"Braga",8,"Rua Costa Gomes",41,41,0,42,42,0
10,27,2018,12,0,7,"Braga",1,"Avenida da Liberdade",13,13,0,60,60,0
10,27,2018,12,0,7,"Braga",2,"Avenida Central",49,49,0,71,71,0
10,27,2018,12,0,7,"Braga",3,"Rua de Caires",25,25,0,4,4,0
10,27,2018,12,0,7,"Braga",4,"N14 Bosch",34,47,13,66,48,18
10,27,2018,12,0,7,"Braga",5,"Avenida João Paulo II",39,39,0,9,9,0
10,27,2018,12,0,7,"Braga",6,"Avenida Padre Júlio Fragata",67,67,0,83,83,0
10,27,2018,12,0,7,"Braga",7,"Rua Nova Santa Cruz",34,44,10,51,39,12
10,27,2018,12,0,7,"Braga",8,"Rua Costa Gomes",41,41,0,42,42,0
10,27,2018,13,0,7,"Braga",1,"Avenida da Liberdade",13,13,0,60,60,0
10,27,2018,13,0,7,"Braga",2,"Avenida Central",49,49,0,71,71,0
10,27,2018,13,0,7,"Braga",3,"Rua de Caires",25,25,0,4,4,0
10,27,2018,13,0,7,"Braga",4,"N14 Bosch",47,47,0,48,48,0
10,27,2018,13,0,7,"Braga",5,"Avenida João Paulo II",39,39,0,9,9,0
10,27,2018,13,0,7,"Braga",6,"Avenida Padre Júlio Fragata",67,67,0,83,83,0
10,27,2018,13,0,7,"Braga",7,"Rua Nova Santa Cruz",44,44,0,39,39,0
10,27,2018,13,0,7,"Braga",8,"Rua Costa Gomes",41,41,0,42,42,0
10,27,2018,14,0,7,"Braga",1,"Avenida da Liberdade",13,13,0,60,60,0
10,27,2018,14,0,7,"Braga",2,"Avenida Central",49,49,0,71,71,0
10,27,2018,14,0,7,"Braga",3,"Rua de Caires",25,25,0,4,4,0
10,27,2018,14,0,7,"Braga",4,"N14 Bosch",47,47,0,48,48,0
10,27,2018,14,0,7,"Braga",5,"Avenida João Paulo II",39,39,0,9,9,0
10,27,2018,14,0,7,"Braga",6,"Avenida Padre Júlio Fragata",67,67,0,83,83,0
10,27,2018,14,0,7,"Braga",7,"Rua Nova Santa Cruz",44,44,0,39,39,0
10,27,2018,14,0,7,"Braga",8,"Rua Costa Gomes",30,41,11,58,42,16
10,27,2018,15,0,7,"Braga",1,"Avenida da Liberdade",13,13,0,60,60,0
10,27,2018,15,0,7,"Braga",2,"Avenida Central",49,49,0,71,71,0
10,27,2018,15,0,7,"Braga",3,"Rua de Caires",25,25,0,4,4,0
10,27,2018,15,0,7,"Braga",4,"N14 Bosch",34,47,13,66,48,18
10,27,2018,15,0,7,"Braga",5,"Avenida João Paulo II",9,39,30,39,9,30
10,27,2018,15,0,7,"Braga",6,"Avenida Padre Júlio Fragata",67,67,0,83,83,0
10,27,2018,15,0,7,"Braga",7,"Rua Nova Santa Cruz",44,44,0,39,39,0
10,27,2018,15,0,7,"Braga",8,"Rua Costa Gomes",31,41,10,56,42,14
10,27,2018,16,0,7,"Braga",1,"Avenida da Liberdade",13,13,0,60,60,0
10,27,2018,16,0,7,"Braga",2,"Avenida Central",49,49,0,71,71,0
10,27,2018,16,0,7,"Braga",3,"Rua de Caires",25,25,0,4,4,0
10,27,2018,16,0,7,"Braga",4,"N14 Bosch",47,47,0,48,48,0
10,27,2018,16,0,7,"Braga",5,"Avenida João Paulo II",39,39,0,9,9,0
10,27,2018,16,0,7,"Braga",6,"Avenida Padre Júlio Fragata",50,67,17,111,83,28
10,27,2018,16,0,7,"Braga",7,"Rua Nova Santa Cruz",24,44,20,72,39,33
10,27,2018,16,0,7,"Braga",8,"Rua Costa Gomes",18,41,23,96,42,54
10,27,2018,17,0,7,"Braga",1,"Avenida da Liberdade",13,13,0,60,60,0
10,27,2018,17,0,7,"Braga",2,"Avenida Central",49,49,0,71,71,0
10,27,2018,17,0,7,"Braga",3,"Rua de Caires",25,25,0,4,4,0
10,27,2018,17,0,7,"Braga",4,"N14 Bosch",36,47,11,62,48,14
10,27,2018,17,0,7,"Braga",5,"Avenida João Paulo II",30,39,9,12,9,3
10,27,2018,17,0,7,"Braga",6,"Avenida Padre Júlio Fragata",67,67,0,83,83,0
10,27,2018,17,0,7,"Braga",7,"Rua Nova Santa Cruz",44,44,0,39,39,0
10,27,2018,17,0,7,"Braga",8,"Rua Costa Gomes",41,41,0,42,42,0
10,27,2018,18,0,7,"Braga",1,"Avenida da Liberdade",13,13,0,60,60,0
10,27,2018,18,0,7,"Braga",2,"Avenida Central",49,49,0,71,71,0
10,27,2018,18,0,7,"Braga",3,"Rua de Caires",25,25,0,4,4,0
10,27,2018,18,0,7,"Braga",4,"N14 Bosch",33,47,14,68,48,20
10,27,2018,18,0,7,"Braga",5,"Avenida João Paulo II",39,39,0,9,9,0
10,27,2018,18,0,7,"Braga",6,"Avenida Padre Júlio Fragata",51,67,16,109,83,26
10,27,2018,18,0,7,"Braga",7,"Rua Nova Santa Cruz",44,44,0,39,39,0
10,27,2018,18,0,7,"Braga",8,"Rua Costa Gomes",31,41,10,56,42,14
10,27,2018,19,0,7,"Braga",1,"Avenida da Liberdade",13,13,0,60,60,0
10,27,2018,19,0,7,"Braga",2,"Avenida Central",49,49,0,71,71,0
10,27,2018,19,0,7,"Braga",3,"Rua de Caires",25,25,0,4,4,0
10,27,2018,19,0,7,"Braga",4,"N14 Bosch",47,47,0,48,48,0
10,27,2018,19,0,7,"Braga",5,"Avenida João Paulo II",23,39,16,15,9,6
10,27,2018,19,0,7,"Braga",6,"Avenida Padre Júlio Fragata",45,67,22,124,83,41
10,27,2018,19,0,7,"Braga",7,"Rua Nova Santa Cruz",32,44,12,54,39,15
10,27,2018,19,0,7,"Braga",8,"Rua Costa Gomes",27,41,14,64,42,22
10,27,2018,20,0,7,"Braga",1,"Avenida da Liberdade",13,13,0,60,60,0
10,27,2018,20,0,7,"Braga",2,"Avenida Central",49,49,0,71,71,0
10,27,2018,20,0,7,"Braga",3,"Rua de Caires",14,25,11,7,4,3
10,27,2018,20,0,7,"Braga",4,"N14 Bosch",47,47,0,48,48,0
10,27,2018,20,0,7,"Braga",5,"Avenida João Paulo II",39,39,0,9,9,0
10,27,2018,20,0,7,"Braga",6,"Avenida Padre Júlio Fragata",67,67,0,83,83,0
10,27,2018,20,0,7,"Braga",7,"Rua Nova Santa Cruz",44,44,0,39,39,0
10,27,2018,20,0,7,"Braga",8,"Rua Costa Gomes",41,41,0,42,42,0
10,27,2018,21,0,7,"Braga",1,"Avenida da Liberdade",13,13,0,60,60,0
10,27,2018,21,0,7,"Braga",2,"Avenida Central",49,49,0,71,71,0
10,27,2018,21,0,7,"Braga",3,"Rua de Caires",25,25,0,4,4,0
10,27,2018,21,0,7,"Braga",4,"N14 Bosch",47,47,0,48,48,0
10,27,2018,21,0,7,"Braga",5,"Avenida João Paulo II",39,39,0,9,9,0
10,27,2018,21,0,7,"Braga",6,"Avenida Padre Júlio Fragata",67,67,0,83,83,0
10,27,2018,21,0,7,"Braga",7,"Rua Nova Santa Cruz",44,44,0,39,39,0
10,27,2018,21,0,7,"Braga",8,"Rua Costa Gomes",41,41,0,42,42,0
10,27,2018,22,0,7,"Braga",1,"Avenida da Liberdade",13,13,0,60,60,0
10,27,2018,22,0,7,"Braga",2,"Avenida Central",49,49,0,71,71,0
10,27,2018,22,0,7,"Braga",3,"Rua de Caires",25,25,0,4,4,0
10,27,2018,22,0,7,"Braga",4,"N14 Bosch",47,47,0,48,48,0
10,27,2018,22,0,7,"Braga",5,"Avenida João Paulo II",39,39,0,9,9,0
10,27,2018,22,0,7,"Braga",6,"Avenida Padre Júlio Fragata",67,67,0,83,83,0
10,27,2018,22,0,7,"Braga",7,"Rua Nova Santa Cruz",44,44,0,39,39,0
10,27,2018,22,0,7,"Braga",8,"Rua Costa Gomes",41,41,0,42,42,0
10,27,2018,23,0,7,"Braga",1,"Avenida da Liberdade",13,13,0,60,60,0
10,27,2018,23,0,7,"Braga",2,"Avenida Central",49,49,0,71,71,0
10,27,2018,23,0,7,"Braga",3,"Rua de Caires",25,25,0,4,4,0
10,27,2018,23,0,7,"Braga",4,"N14 Bosch",47,47,0,48,48,0
10,27,2018,23,0,7,"Braga",5,"Avenida João Paulo II",39,39,0,9,9,0
10,27,2018,23,0,7,"Braga",6,"Avenida Padre Júlio Fragata",67,67,0,83,83,0
10,27,2018,23,0,7,"Braga",7,"Rua Nova Santa Cruz",44,44,0,39,39,0
10,27,2018,23,0,7,"Braga",8,"Rua Costa Gomes",41,41,0,42,42,0
10,28,2018,0,0,8,"Braga",1,"Avenida da Liberdade",13,13,0,60,60,0
10,28,2018,0,0,8,"Braga",2,"Avenida Central",49,49,0,71,71,0
10,28,2018,0,0,8,"Braga",3,"Rua de Caires",25,25,0,4,4,0
10,28,2018,0,0,8,"Braga",4,"N14 Bosch",47,47,0,48,48,0
10,28,2018,0,0,8,"Braga",5,"Avenida João Paulo II",39,39,0,9,9,0
10,28,2018,0,0,8,"Braga",6,"Avenida Padre Júlio Fragata",67,67,0,83,83,0
10,28,2018,0,0,8,"Braga",7,"Rua Nova Santa Cruz",44,44,0,39,39,0
10,28,2018,0,0,8,"Braga",8,"Rua Costa Gomes",41,41,0,42,42,0
10,28,2018,1,0,8,"Braga",1,"Avenida da Liberdade",13,13,0,60,60,0
10,28,2018,1,0,8,"Braga",2,"Avenida Central",49,49,0,71,71,0
10,28,2018,1,0,8,"Braga",3,"Rua de Caires",25,25,0,4,4,0
10,28,2018,1,0,8,"Braga",4,"N14 Bosch",47,47,0,48,48,0
10,28,2018,1,0,8,"Braga",5,"Avenida João Paulo II",39,39,0,9,9,0
10,28,2018,1,0,8,"Braga",6,"Avenida Padre Júlio Fragata",67,67,0,83,83,0
10,28,2018,1,0,8,"Braga",7,"Rua Nova Santa Cruz",44,44,0,39,39,0
10,28,2018,1,0,8,"Braga",8,"Rua Costa Gomes",41,41,0,42,42,0
10,28,2018,2,0,8,"Braga",1,"Avenida da Liberdade",13,13,0,60,60,0
10,28,2018,2,0,8,"Braga",2,"Avenida Central",49,49,0,71,71,0
10,28,2018,2,0,8,"Braga",3,"Rua de Caires",25,25,0,4,4,0
10,28,2018,2,0,8,"Braga",4,"N14 Bosch",47,47,0,48,48,0
10,28,2018,2,0,8,"Braga",5,"Avenida João Paulo II",39,39,0,9,9,0
10,28,2018,2,0,8,"Braga",6,"Avenida Padre Júlio Fragata",67,67,0,83,83,0
10,28,2018,2,0,8,"Braga",7,"Rua Nova Santa Cruz",44,44,0,39,39,0
10,28,2018,2,0,8,"Braga",8,"Rua Costa Gomes",41,41,0,42,42,0
10,28,2018,3,0,8,"Braga",1,"Avenida da Liberdade",13,13,0,60,60,0
10,28,2018,3,0,8,"Braga",2,"Avenida Central",49,49,0,71,71,0
10,28,2018,3,0,8,"Braga",3,"Rua de Caires",25,25,0,4,4,0
10,28,2018,3,0,8,"Braga",4,"N14 Bosch",47,47,0,48,48,0
10,28,2018,3,0,8,"Braga",5,"Avenida João Paulo II",39,39,0,9,9,0
10,28,2018,3,0,8,"Braga",6,"Avenida Padre Júlio Fragata",67,67,0,83,83,0
10,28,2018,3,0,8,"Braga",7,"Rua Nova Santa Cruz",44,44,0,39,39,0
10,28,2018,3,0,8,"Braga",8,"Rua Costa Gomes",41,41,0,42,42,0
10,28,2018,4,0,8,"Braga",1,"Avenida da Liberdade",13,13,0,60,60,0
10,28,2018,4,0,8,"Braga",2,"Avenida Central",49,49,0,71,71,0
10,28,2018,4,0,8,"Braga",3,"Rua de Caires",25,25,0,4,4,0
10,28,2018,4,0,8,"Braga",4,"N14 Bosch",47,47,0,48,48,0
10,28,2018,4,0,8,"Braga",5,"Avenida João Paulo II",39,39,0,9,9,0
10,28,2018,4,0,8,"Braga",6,"Avenida Padre Júlio Fragata",67,67,0,83,83,0
10,28,2018,4,0,8,"Braga",7,"Rua Nova Santa Cruz",44,44,0,39,39,0
10,28,2018,4,0,8,"Braga",8,"Rua Costa Gomes",41,41,0,42,42,0
10,28,2018,5,0,8,"Braga",1,"Avenida da Liberdade",13,13,0,60,60,0
10,28,2018,5,0,8,"Braga",2,"Avenida Central",49,49,0,71,71,0
10,28,2018,5,0,8,"Braga",3,"Rua de Caires",25,25,0,4,4,0
10,28,2018,5,0,8,"Braga",4,"N14 Bosch",47,47,0,48,48,0
10,28,2018,5,0,8,"Braga",5,"Avenida João Paulo II",39,39,0,9,9,0
10,28,2018,5,0,8,"Braga",6,"Avenida Padre Júlio Fragata",67,67,0,83,83,0
10,28,2018,5,0,8,"Braga",7,"Rua Nova Santa Cruz",44,44,0,39,39,0
10,28,2018,5,0,8,"Braga",8,"Rua Costa Gomes",41,41,0,42,42,0
10,28,2018,6,0,8,"Braga",1,"Avenida da Liberdade",13,13,0,60,60,0
10,28,2018,6,0,8,"Braga",2,"Avenida Central",49,49,0,71,71,0
10,28,2018,6,0,8,"Braga",3,"Rua de Caires",25,25,0,4,4,0
10,28,2018,6,0,8,"Braga",4,"N14 Bosch",47,47,0,48,48,0
10,28,2018,6,0,8,"Braga",5,"Avenida João Paulo II",39,39,0,9,9,0
10,28,2018,6,0,8,"Braga",6,"Avenida Padre Júlio Fragata",67,67,0,83,83,0
10,28,2018,6,0,8,"Braga",7,"Rua Nova Santa Cruz",44,44,0,39,39,0
10,28,2018,6,0,8,"Braga",8,"Rua Costa Gomes",41,41,0,42,42,0
10,28,2018,7,0,8,"Braga",1,"Avenida da Liberdade",13,13,0,60,60,0
10,28,2018,7,0,8,"Braga",2,"Avenida Central",49,49,0,71,71,0
10,28,2018,7,0,8,"Braga",3,"Rua de Caires",25,25,0,4,4,0
10,28,2018,7,0,8,"Braga",4,"N14 Bosch",47,47,0,48,48,0
10,28,2018,7,0,8,"Braga",5,"Avenida João Paulo II",39,39,0,9,9,0
10,28,2018,7,0,8,"Braga",6,"Avenida Padre Júlio Fragata",67,67,0,83,83,0
10,28,2018,7,0,8,"Braga",7,"Rua Nova Santa Cruz",44,44,0,39,39,0
10,28,2018,7,0,8,"Braga",8,"Rua Costa Gomes",41,41,0,42,42,0
10,28,2018,8,0,8,"Braga",1,"Avenida da Liberdade",13,13,0,60,60,0
10,28,2018,8,0,8,"Braga",2,"Avenida Central",49,49,0,71,71,0
10,28,2018,8,0,8,"Braga",3,"Rua de Caires",25,25,0,4,4,0
10,28,2018,8,0,8,"Braga",4,"N14 Bosch",47,47,0,48,48,0
10,28,2018,8,0,8,"Braga",5,"Avenida João Paulo II",39,39,0,9,9,0
10,28,2018,8,0,8,"Braga",6,"Avenida Padre Júlio Fragata",67,67,0,83,83,0
10,28,2018,8,0,8,"Braga",7,"Rua Nova Santa Cruz",44,44,0,39,39,0
10,28,2018,8,0,8,"Braga",8,"Rua Costa Gomes",41,41,0,42,42,0
10,28,2018,9,0,8,"Braga",1,"Avenida da Liberdade",13,13,0,60,60,0
10,28,2018,9,0,8,"Braga",2,"Avenida Central",49,49,0,71,71,0
10,28,2018,9,0,8,"Braga",3,"Rua de Caires",25,25,0,4,4,0
10,28,2018,9,0,8,"Braga",4,"N14 Bosch",47,47,0,48,48,0
10,28,2018,9,0,8,"Braga",5,"Avenida João Paulo II",39,39,0,9,9,0
10,28,2018,9,0,8,"Braga",6,"Avenida Padre Júlio Fragata",67,67,0,83,83,0
10,28,2018,9,0,8,"Braga",7,"Rua Nova Santa Cruz",44,44,0,39,39,0
10,28,2018,9,0,8,"Braga",8,"Rua Costa Gomes",41,41,0,42,42,0
10,28,2018,10,0,8,"Braga",1,"Avenida da Liberdade",13,13,0,60,60,0
10,28,2018,10,0,8,"Braga",2,"Avenida Central",49,49,0,71,71,0
10,28,2018,10,0,8,"Braga",3,"Rua de Caires",25,25,0,4,4,0
10,28,2018,10,0,8,"Braga",4,"N14 Bosch",47,47,0,48,48,0
10,28,2018,10,0,8,"Braga",5,"Avenida João Paulo II",39,39,0,9,9,0
10,28,2018,10,0,8,"Braga",6,"Avenida Padre Júlio Fragata",67,67,0,83,83,0
10,28,2018,10,0,8,"Braga",7,"Rua Nova Santa Cruz",44,44,0,39,39,0
10,28,2018,10,0,8,"Braga",8,"Rua Costa Gomes",41,41,0,42,42,0
10,28,2018,11,0,8,"Braga",1,"Avenida da Liberdade",13,13,0,60,60,0
10,28,2018,11,0,8,"Braga",2,"Avenida Central",49,49,0,71,71,0
10,28,2018,11,0,8,"Braga",3,"Rua de Caires",25,25,0,4,4,0
10,28,2018,11,0,8,"Braga",4,"N14 Bosch",47,47,0,48,48,0
10,28,2018,11,0,8,"Braga",5,"Avenida João Paulo II",39,39,0,9,9,0
10,28,2018,11,0,8,"Braga",6,"Avenida Padre Júlio Fragata",67,67,0,83,83,0
10,28,2018,11,0,8,"Braga",7,"Rua Nova Santa Cruz",44,44,0,39,39,0
10,28,2018,11,0,8,"Braga",8,"Rua Costa Gomes",32,41,9,54,42,12
10,28,2018,12,0,8,"Braga",1,"Avenida da Liberdade",13,13,0,60,60,0
10,28,2018,12,0,8,"Braga",2,"Avenida Central",49,49,0,71,71,0
10,28,2018,12,0,8,"Braga",3,"Rua de Caires",25,25,0,4,4,0
10,28,2018,12,0,8,"Braga",4,"N14 Bosch",47,47,0,48,48,0
10,28,2018,12,0,8,"Braga",5,"Avenida João Paulo II",39,39,0,9,9,0
10,28,2018,12,0,8,"Braga",6,"Avenida Padre Júlio Fragata",67,67,0,83,83,0
10,28,2018,12,0,8,"Braga",7,"Rua Nova Santa Cruz",44,44,0,39,39,0
10,28,2018,12,0,8,"Braga",8,"Rua Costa Gomes",41,41,0,42,42,0
10,28,2018,13,0,8,"Braga",1,"Avenida da Liberdade",13,13,0,60,60,0
10,28,2018,13,0,8,"Braga",2,"Avenida Central",49,49,0,71,71,0
10,28,2018,13,0,8,"Braga",3,"Rua de Caires",25,25,0,4,4,0
10,28,2018,13,0,8,"Braga",4,"N14 Bosch",47,47,0,48,48,0
10,28,2018,13,0,8,"Braga",5,"Avenida João Paulo II",39,39,0,9,9,0
10,28,2018,13,0,8,"Braga",6,"Avenida Padre Júlio Fragata",67,67,0,83,83,0
10,28,2018,13,0,8,"Braga",7,"Rua Nova Santa Cruz",44,44,0,39,39,0
10,28,2018,13,0,8,"Braga",8,"Rua Costa Gomes",41,41,0,42,42,0
10,28,2018,14,0,8,"Braga",1,"Avenida da Liberdade",13,13,0,60,60,0
10,28,2018,14,0,8,"Braga",2,"Avenida Central",49,49,0,71,71,0
10,28,2018,14,0,8,"Braga",3,"Rua de Caires",25,25,0,4,4,0
10,28,2018,14,0,8,"Braga",4,"N14 Bosch",47,47,0,48,48,0
10,28,2018,14,0,8,"Braga",5,"Avenida João Paulo II",39,39,0,9,9,0
10,28,2018,14,0,8,"Braga",6,"Avenida Padre Júlio Fragata",67,67,0,83,83,0
10,28,2018,14,0,8,"Braga",7,"Rua Nova Santa Cruz",44,44,0,39,39,0
10,28,2018,14,0,8,"Braga",8,"Rua Costa Gomes",30,41,11,58,42,16
10,28,2018,15,0,8,"Braga",1,"Avenida da Liberdade",13,13,0,60,60,0
10,28,2018,15,0,8,"Braga",2,"Avenida Central",49,49,0,71,71,0
10,28,2018,15,0,8,"Braga",3,"Rua de Caires",25,25,0,4,4,0
10,28,2018,15,0,8,"Braga",4,"N14 Bosch",47,47,0,48,48,0
10,28,2018,15,0,8,"Braga",5,"Avenida João Paulo II",17,39,22,21,9,12
10,28,2018,15,0,8,"Braga",6,"Avenida Padre Júlio Fragata",50,67,17,111,83,28
10,28,2018,15,0,8,"Braga",7,"Rua Nova Santa Cruz",44,44,0,39,39,0
10,28,2018,15,0,8,"Braga",8,"Rua Costa Gomes",41,41,0,42,42,0
10,28,2018,16,0,8,"Braga",1,"Avenida da Liberdade",13,13,0,60,60,0
10,28,2018,16,0,8,"Braga",2,"Avenida Central",49,49,0,71,71,0
10,28,2018,16,0,8,"Braga",3,"Rua de Caires",19,25,6,5,4,1
10,28,2018,16,0,8,"Braga",4,"N14 Bosch",47,47,0,48,48,0
10,28,2018,16,0,8,"Braga",5,"Avenida João Paulo II",5,39,34,70,9,61
10,28,2018,16,0,8,"Braga",6,"Avenida Padre Júlio Fragata",52,67,15,107,83,24
10,28,2018,16,0,8,"Braga",7,"Rua Nova Santa Cruz",44,44,0,39,39,0
10,28,2018,16,0,8,"Braga",8,"Rua Costa Gomes",31,41,10,56,42,14
10,28,2018,17,0,8,"Braga",1,"Avenida da Liberdade",13,13,0,60,60,0
10,28,2018,17,0,8,"Braga",2,"Avenida Central",49,49,0,71,71,0
10,28,2018,17,0,8,"Braga",3,"Rua de Caires",25,25,0,4,4,0
10,28,2018,17,0,8,"Braga",4,"N14 Bosch",36,47,11,62,48,14
10,28,2018,17,0,8,"Braga",5,"Avenida João Paulo II",39,39,0,9,9,0
10,28,2018,17,0,8,"Braga",6,"Avenida Padre Júlio Fragata",48,67,19,116,83,33
10,28,2018,17,0,8,"Braga",7,"Rua Nova Santa Cruz",44,44,0,39,39,0
10,28,2018,17,0,8,"Braga",8,"Rua Costa Gomes",41,41,0,42,42,0
10,28,2018,18,0,8,"Braga",1,"Avenida da Liberdade",13,13,0,60,60,0
10,28,2018,18,0,8,"Braga",2,"Avenida Central",49,49,0,71,71,0
10,28,2018,18,0,8,"Braga",3,"Rua de Caires",25,25,0,4,4,0
10,28,2018,18,0,8,"Braga",4,"N14 Bosch",35,47,12,64,48,16
10,28,2018,18,0,8,"Braga",5,"Avenida João Paulo II",39,39,0,9,9,0
10,28,2018,18,0,8,"Braga",6,"Avenida Padre Júlio Fragata",67,67,0,83,83,0
10,28,2018,18,0,8,"Braga",7,"Rua Nova Santa Cruz",44,44,0,39,39,0
10,28,2018,18,0,8,"Braga",8,"Rua Costa Gomes",31,41,10,56,42,14
10,28,2018,19,0,8,"Braga",1,"Avenida da Liberdade",13,13,0,60,60,0
10,28,2018,19,0,8,"Braga",2,"Avenida Central",49,49,0,71,71,0
10,28,2018,19,0,8,"Braga",3,"Rua de Caires",16,25,9,7,4,3
10,28,2018,19,0,8,"Braga",4,"N14 Bosch",47,47,0,48,48,0
10,28,2018,19,0,8,"Braga",5,"Avenida João Paulo II",39,39,0,9,9,0
10,28,2018,19,0,8,"Braga",6,"Avenida Padre Júlio Fragata",67,67,0,83,83,0
10,28,2018,19,0,8,"Braga",7,"Rua Nova Santa Cruz",44,44,0,39,39,0
10,28,2018,19,0,8,"Braga",8,"Rua Costa Gomes",41,41,0,42,42,0
10,28,2018,20,0,8,"Braga",1,"Avenida da Liberdade",8,13,5,97,60,37
10,28,2018,20,0,8,"Braga",2,"Avenida Central",49,49,0,71,71,0
10,28,2018,20,0,8,"Braga",3,"Rua de Caires",25,25,0,4,4,0
10,28,2018,20,0,8,"Braga",4,"N14 Bosch",47,47,0,48,48,0
10,28,2018,20,0,8,"Braga",5,"Avenida João Paulo II",39,39,0,9,9,0
10,28,2018,20,0,8,"Braga",6,"Avenida Padre Júlio Fragata",48,67,19,116,83,33
10,28,2018,20,0,8,"Braga",7,"Rua Nova Santa Cruz",44,44,0,39,39,0
10,28,2018,20,0,8,"Braga",8,"Rua Costa Gomes",26,41,15,67,42,25
10,28,2018,21,0,8,"Braga",1,"Avenida da Liberdade",13,13,0,60,60,0
10,28,2018,21,0,8,"Braga",2,"Avenida Central",49,49,0,71,71,0
10,28,2018,21,0,8,"Braga",3,"Rua de Caires",25,25,0,4,4,0
10,28,2018,21,0,8,"Braga",4,"N14 Bosch",47,47,0,48,48,0
10,28,2018,21,0,8,"Braga",5,"Avenida João Paulo II",39,39,0,9,9,0
10,28,2018,21,0,8,"Braga",6,"Avenida Padre Júlio Fragata",67,67,0,83,83,0
10,28,2018,21,0,8,"Braga",7,"Rua Nova Santa Cruz",44,44,0,39,39,0
10,28,2018,21,0,8,"Braga",8,"Rua Costa Gomes",41,41,0,42,42,0
10,28,2018,22,0,8,"Braga",1,"Avenida da Liberdade",13,13,0,60,60,0
10,28,2018,22,0,8,"Braga",2,"Avenida Central",49,49,0,71,71,0
10,28,2018,22,0,8,"Braga",3,"Rua de Caires",25,25,0,4,4,0
10,28,2018,22,0,8,"Braga",4,"N14 Bosch",47,47,0,48,48,0
10,28,2018,22,0,8,"Braga",5,"Avenida João Paulo II",39,39,0,9,9,0
10,28,2018,22,0,8,"Braga",6,"Avenida Padre Júlio Fragata",67,67,0,83,83,0
10,28,2018,22,0,8,"Braga",7,"Rua Nova Santa Cruz",44,44,0,39,39,0
10,28,2018,22,0,8,"Braga",8,"Rua Costa Gomes",41,41,0,42,42,0
10,28,2018,23,0,8,"Braga",1,"Avenida da Liberdade",13,13,0,60,60,0
10,28,2018,23,0,8,"Braga",2,"Avenida Central",49,49,0,71,71,0
10,28,2018,23,0,8,"Braga",3,"Rua de Caires",25,25,0,4,4,0
10,28,2018,23,0,8,"Braga",4,"N14 Bosch",47,47,0,48,48,0
10,28,2018,23,0,8,"Braga",5,"Avenida João Paulo II",39,39,0,9,9,0
10,28,2018,23,0,8,"Braga",6,"Avenida Padre Júlio Fragata",67,67,0,83,83,0
10,28,2018,23,0,8,"Braga",7,"Rua Nova Santa Cruz",44,44,0,39,39,0
10,28,2018,23,0,8,"Braga",8,"Rua Costa Gomes",41,41,0,42,42,0
10,29,2018,0,0,2,"Braga",1,"Avenida da Liberdade",13,13,0,60,60,0
10,29,2018,0,0,2,"Braga",2,"Avenida Central",49,49,0,71,71,0
10,29,2018,0,0,2,"Braga",3,"Rua de Caires",25,25,0,4,4,0
10,29,2018,0,0,2,"Braga",4,"N14 Bosch",47,47,0,48,48,0
10,29,2018,0,0,2,"Braga",5,"Avenida João Paulo II",39,39,0,9,9,0
10,29,2018,0,0,2,"Braga",6,"Avenida Padre Júlio Fragata",67,67,0,83,83,0
10,29,2018,0,0,2,"Braga",7,"Rua Nova Santa Cruz",44,44,0,39,39,0
10,29,2018,0,0,2,"Braga",8,"Rua Costa Gomes",41,41,0,42,42,0
10,29,2018,1,0,2,"Braga",1,"Avenida da Liberdade",13,13,0,60,60,0
10,29,2018,1,0,2,"Braga",2,"Avenida Central",49,49,0,71,71,0
10,29,2018,1,0,2,"Braga",3,"Rua de Caires",25,25,0,4,4,0
10,29,2018,1,0,2,"Braga",4,"N14 Bosch",47,47,0,48,48,0
10,29,2018,1,0,2,"Braga",5,"Avenida João Paulo II",39,39,0,9,9,0
10,29,2018,1,0,2,"Braga",6,"Avenida Padre Júlio Fragata",67,67,0,83,83,0
10,29,2018,1,0,2,"Braga",7,"Rua Nova Santa Cruz",44,44,0,39,39,0
10,29,2018,1,0,2,"Braga",8,"Rua Costa Gomes",41,41,0,42,42,0
10,29,2018,2,0,2,"Braga",1,"Avenida da Liberdade",13,13,0,60,60,0
10,29,2018,2,0,2,"Braga",2,"Avenida Central",49,49,0,71,71,0
10,29,2018,2,0,2,"Braga",3,"Rua de Caires",25,25,0,4,4,0
10,29,2018,2,0,2,"Braga",4,"N14 Bosch",47,47,0,48,48,0
10,29,2018,2,0,2,"Braga",5,"Avenida João Paulo II",39,39,0,9,9,0
10,29,2018,2,0,2,"Braga",6,"Avenida Padre Júlio Fragata",67,67,0,83,83,0
10,29,2018,2,0,2,"Braga",7,"Rua Nova Santa Cruz",44,44,0,39,39,0
10,29,2018,2,0,2,"Braga",8,"Rua Costa Gomes",41,41,0,42,42,0
10,29,2018,3,0,2,"Braga",1,"Avenida da Liberdade",13,13,0,60,60,0
10,29,2018,3,0,2,"Braga",2,"Avenida Central",49,49,0,71,71,0
10,29,2018,3,0,2,"Braga",3,"Rua de Caires",25,25,0,4,4,0
10,29,2018,3,0,2,"Braga",4,"N14 Bosch",47,47,0,48,48,0
10,29,2018,3,0,2,"Braga",5,"Avenida João Paulo II",39,39,0,9,9,0
10,29,2018,3,0,2,"Braga",6,"Avenida Padre Júlio Fragata",67,67,0,83,83,0
10,29,2018,3,0,2,"Braga",7,"Rua Nova Santa Cruz",44,44,0,39,39,0
10,29,2018,3,0,2,"Braga",8,"Rua Costa Gomes",41,41,0,42,42,0
10,29,2018,4,0,2,"Braga",1,"Avenida da Liberdade",13,13,0,60,60,0
10,29,2018,4,0,2,"Braga",2,"Avenida Central",49,49,0,71,71,0
10,29,2018,4,0,2,"Braga",3,"Rua de Caires",25,25,0,4,4,0
10,29,2018,4,0,2,"Braga",4,"N14 Bosch",47,47,0,48,48,0
10,29,2018,4,0,2,"Braga",5,"Avenida João Paulo II",39,39,0,9,9,0
10,29,2018,4,0,2,"Braga",6,"Avenida Padre Júlio Fragata",67,67,0,83,83,0
10,29,2018,4,0,2,"Braga",7,"Rua Nova Santa Cruz",44,44,0,39,39,0
10,29,2018,4,0,2,"Braga",8,"Rua Costa Gomes",41,41,0,42,42,0
10,29,2018,5,0,2,"Braga",1,"Avenida da Liberdade",13,13,0,60,60,0
10,29,2018,5,0,2,"Braga",2,"Avenida Central",49,49,0,71,71,0
10,29,2018,5,0,2,"Braga",3,"Rua de Caires",25,25,0,4,4,0
10,29,2018,5,0,2,"Braga",4,"N14 Bosch",47,47,0,48,48,0
10,29,2018,5,0,2,"Braga",5,"Avenida João Paulo II",39,39,0,9,9,0
10,29,2018,5,0,2,"Braga",6,"Avenida Padre Júlio Fragata",67,67,0,83,83,0
10,29,2018,5,0,2,"Braga",7,"Rua Nova Santa Cruz",44,44,0,39,39,0
10,29,2018,5,0,2,"Braga",8,"Rua Costa Gomes",41,41,0,42,42,0
10,29,2018,7,0,2,"Braga",1,"Avenida da Liberdade",13,13,0,60,60,0
10,29,2018,7,0,2,"Braga",2,"Avenida Central",49,49,0,71,71,0
10,29,2018,7,0,2,"Braga",3,"Rua de Caires",25,25,0,4,4,0
10,29,2018,7,0,2,"Braga",4,"N14 Bosch",47,47,0,48,48,0
10,29,2018,7,0,2,"Braga",5,"Avenida João Paulo II",39,39,0,9,9,0
10,29,2018,7,0,2,"Braga",6,"Avenida Padre Júlio Fragata",67,67,0,83,83,0
10,29,2018,7,0,2,"Braga",7,"Rua Nova Santa Cruz",44,44,0,39,39,0
10,29,2018,7,0,2,"Braga",8,"Rua Costa Gomes",41,41,0,42,42,0
10,29,2018,8,0,2,"Braga",1,"Avenida da Liberdade",13,13,0,60,60,0
10,29,2018,8,0,2,"Braga",2,"Avenida Central",32,49,17,108,71,37
10,29,2018,8,0,2,"Braga",3,"Rua de Caires",25,25,0,4,4,0
10,29,2018,8,0,2,"Braga",4,"N14 Bosch",47,47,0,48,48,0
10,29,2018,8,0,2,"Braga",5,"Avenida João Paulo II",39,39,0,9,9,0
10,29,2018,8,0,2,"Braga",6,"Avenida Padre Júlio Fragata",67,67,0,83,83,0
10,29,2018,8,0,2,"Braga",7,"Rua Nova Santa Cruz",26,44,18,66,39,27
10,29,2018,8,0,2,"Braga",8,"Rua Costa Gomes",41,41,0,42,42,0
10,29,2018,9,0,2,"Braga",1,"Avenida da Liberdade",13,13,0,60,60,0
10,29,2018,9,0,2,"Braga",2,"Avenida Central",27,49,22,128,71,57
10,29,2018,9,0,2,"Braga",3,"Rua de Caires",19,25,6,5,4,1
10,29,2018,9,0,2,"Braga",4,"N14 Bosch",34,47,13,66,48,18
10,29,2018,9,0,2,"Braga",5,"Avenida João Paulo II",39,39,0,9,9,0
10,29,2018,9,0,2,"Braga",6,"Avenida Padre Júlio Fragata",39,67,28,143,83,60
10,29,2018,9,0,2,"Braga",7,"Rua Nova Santa Cruz",23,44,21,75,39,36
10,29,2018,9,0,2,"Braga",8,"Rua Costa Gomes",32,41,9,54,42,12
10,29,2018,10,0,2,"Braga",1,"Avenida da Liberdade",13,13,0,60,60,0
10,29,2018,10,0,2,"Braga",2,"Avenida Central",49,49,0,71,71,0
10,29,2018,10,0,2,"Braga",3,"Rua de Caires",25,25,0,4,4,0
10,29,2018,10,0,2,"Braga",4,"N14 Bosch",34,47,13,66,48,18
10,29,2018,10,0,2,"Braga",5,"Avenida João Paulo II",39,39,0,9,9,0
10,29,2018,10,0,2,"Braga",6,"Avenida Padre Júlio Fragata",67,67,0,83,83,0
10,29,2018,10,0,2,"Braga",7,"Rua Nova Santa Cruz",22,44,22,79,39,40
10,29,2018,10,0,2,"Braga",8,"Rua Costa Gomes",41,41,0,42,42,0
10,29,2018,11,0,2,"Braga",1,"Avenida da Liberdade",13,13,0,60,60,0
10,29,2018,11,0,2,"Braga",2,"Avenida Central",49,49,0,71,71,0
10,29,2018,11,0,2,"Braga",3,"Rua de Caires",25,25,0,4,4,0
10,29,2018,11,0,2,"Braga",4,"N14 Bosch",47,47,0,48,48,0
10,29,2018,11,0,2,"Braga",5,"Avenida João Paulo II",39,39,0,9,9,0
10,29,2018,11,0,2,"Braga",6,"Avenida Padre Júlio Fragata",67,67,0,83,83,0
10,29,2018,11,0,2,"Braga",7,"Rua Nova Santa Cruz",21,44,23,82,39,43
10,29,2018,11,0,2,"Braga",8,"Rua Costa Gomes",41,41,0,42,42,0
10,29,2018,12,0,2,"Braga",1,"Avenida da Liberdade",13,13,0,60,60,0
10,29,2018,12,0,2,"Braga",2,"Avenida Central",49,49,0,71,71,0
10,29,2018,12,0,2,"Braga",3,"Rua de Caires",25,25,0,4,4,0
10,29,2018,12,0,2,"Braga",4,"N14 Bosch",35,47,12,64,48,16
10,29,2018,12,0,2,"Braga",5,"Avenida João Paulo II",39,39,0,9,9,0
10,29,2018,12,0,2,"Braga",6,"Avenida Padre Júlio Fragata",67,67,0,83,83,0
10,29,2018,12,0,2,"Braga",7,"Rua Nova Santa Cruz",44,44,0,39,39,0
10,29,2018,12,0,2,"Braga",8,"Rua Costa Gomes",41,41,0,42,42,0
10,29,2018,13,0,2,"Braga",1,"Avenida da Liberdade",13,13,0,60,60,0
10,29,2018,13,0,2,"Braga",2,"Avenida Central",49,49,0,71,71,0
10,29,2018,13,0,2,"Braga",3,"Rua de Caires",25,25,0,4,4,0
10,29,2018,13,0,2,"Braga",4,"N14 Bosch",15,47,32,150,48,102
10,29,2018,13,0,2,"Braga",5,"Avenida João Paulo II",29,39,10,12,9,3
10,29,2018,13,0,2,"Braga",6,"Avenida Padre Júlio Fragata",67,67,0,83,83,0
10,29,2018,13,0,2,"Braga",7,"Rua Nova Santa Cruz",30,44,14,58,39,19
10,29,2018,13,0,2,"Braga",8,"Rua Costa Gomes",41,41,0,42,42,0
10,29,2018,14,0,2,"Braga",1,"Avenida da Liberdade",13,13,0,60,60,0
10,29,2018,14,0,2,"Braga",2,"Avenida Central",49,49,0,71,71,0
10,29,2018,14,0,2,"Braga",3,"Rua de Caires",25,25,0,4,4,0
10,29,2018,14,0,2,"Braga",4,"N14 Bosch",35,47,12,64,48,16
10,29,2018,14,0,2,"Braga",5,"Avenida João Paulo II",30,39,9,12,9,3
10,29,2018,14,0,2,"Braga",6,"Avenida Padre Júlio Fragata",67,67,0,83,83,0
10,29,2018,14,0,2,"Braga",7,"Rua Nova Santa Cruz",14,44,30,123,39,84
10,29,2018,14,0,2,"Braga",8,"Rua Costa Gomes",41,41,0,42,42,0
10,29,2018,15,0,2,"Braga",1,"Avenida da Liberdade",13,13,0,60,60,0
10,29,2018,15,0,2,"Braga",2,"Avenida Central",49,49,0,71,71,0
10,29,2018,15,0,2,"Braga",3,"Rua de Caires",25,25,0,4,4,0
10,29,2018,15,0,2,"Braga",4,"N14 Bosch",20,47,27,112,48,64
10,29,2018,15,0,2,"Braga",5,"Avenida João Paulo II",17,39,22,21,9,12
10,29,2018,15,0,2,"Braga",6,"Avenida Padre Júlio Fragata",67,67,0,83,83,0
10,29,2018,15,0,2,"Braga",7,"Rua Nova Santa Cruz",44,44,0,39,39,0
10,29,2018,15,0,2,"Braga",8,"Rua Costa Gomes",30,41,11,58,42,16
10,29,2018,16,0,2,"Braga",1,"Avenida da Liberdade",13,13,0,60,60,0
10,29,2018,16,0,2,"Braga",2,"Avenida Central",49,49,0,71,71,0
10,29,2018,16,0,2,"Braga",3,"Rua de Caires",25,25,0,4,4,0
10,29,2018,16,0,2,"Braga",4,"N14 Bosch",34,47,13,66,48,18
10,29,2018,16,0,2,"Braga",5,"Avenida João Paulo II",39,39,0,9,9,0
10,29,2018,16,0,2,"Braga",6,"Avenida Padre Júlio Fragata",67,67,0,83,83,0
10,29,2018,16,0,2,"Braga",7,"Rua Nova Santa Cruz",44,44,0,39,39,0
10,29,2018,16,0,2,"Braga",8,"Rua Costa Gomes",41,41,0,42,42,0
10,29,2018,17,0,2,"Braga",1,"Avenida da Liberdade",13,13,0,60,60,0
10,29,2018,17,0,2,"Braga",2,"Avenida Central",36,49,13,96,71,25
10,29,2018,17,0,2,"Braga",3,"Rua de Caires",25,25,0,4,4,0
10,29,2018,17,0,2,"Braga",4,"N14 Bosch",23,47,24,98,48,50
10,29,2018,17,0,2,"Braga",5,"Avenida João Paulo II",39,39,0,9,9,0
10,29,2018,17,0,2,"Braga",6,"Avenida Padre Júlio Fragata",67,67,0,83,83,0
10,29,2018,17,0,2,"Braga",7,"Rua Nova Santa Cruz",32,44,12,54,39,15
10,29,2018,17,0,2,"Braga",8,"Rua Costa Gomes",24,41,17,72,42,30
10,29,2018,18,0,2,"Braga",1,"Avenida da Liberdade",13,13,0,60,60,0
10,29,2018,18,0,2,"Braga",2,"Avenida Central",49,49,0,71,71,0
10,29,2018,18,0,2,"Braga",3,"Rua de Caires",3,25,22,35,4,31
10,29,2018,18,0,2,"Braga",4,"N14 Bosch",14,47,33,160,48,112
10,29,2018,18,0,2,"Braga",5,"Avenida João Paulo II",39,39,0,9,9,0
10,29,2018,18,0,2,"Braga",6,"Avenida Padre Júlio Fragata",26,67,41,214,83,131
10,29,2018,18,0,2,"Braga",7,"Rua Nova Santa Cruz",11,44,33,157,39,118
10,29,2018,18,0,2,"Braga",8,"Rua Costa Gomes",10,41,31,173,42,131
10,29,2018,19,0,2,"Braga",1,"Avenida da Liberdade",13,13,0,60,60,0
10,29,2018,19,0,2,"Braga",2,"Avenida Central",30,49,19,115,71,44
10,29,2018,19,0,2,"Braga",3,"Rua de Caires",11,25,14,9,4,5
10,29,2018,19,0,2,"Braga",4,"N14 Bosch",32,47,15,70,48,22
10,29,2018,19,0,2,"Braga",5,"Avenida João Paulo II",13,39,26,27,9,18
10,29,2018,19,0,2,"Braga",6,"Avenida Padre Júlio Fragata",26,67,41,214,83,131
10,29,2018,19,0,2,"Braga",7,"Rua Nova Santa Cruz",30,44,14,58,39,19
10,29,2018,19,0,2,"Braga",8,"Rua Costa Gomes",18,41,23,96,42,54
10,29,2018,20,0,2,"Braga",1,"Avenida da Liberdade",13,13,0,60,60,0
10,29,2018,20,0,2,"Braga",2,"Avenida Central",49,49,0,71,71,0
10,29,2018,20,0,2,"Braga",3,"Rua de Caires",15,25,10,7,4,3
10,29,2018,20,0,2,"Braga",4,"N14 Bosch",47,47,0,48,48,0
10,29,2018,20,0,2,"Braga",5,"Avenida João Paulo II",29,39,10,12,9,3
10,29,2018,20,0,2,"Braga",6,"Avenida Padre Júlio Fragata",67,67,0,83,83,0
10,29,2018,20,0,2,"Braga",7,"Rua Nova Santa Cruz",18,44,26,96,39,57
10,29,2018,20,0,2,"Braga",8,"Rua Costa Gomes",41,41,0,42,42,0
10,29,2018,21,0,2,"Braga",1,"Avenida da Liberdade",13,13,0,60,60,0
10,29,2018,21,0,2,"Braga",2,"Avenida Central",49,49,0,71,71,0
10,29,2018,21,0,2,"Braga",3,"Rua de Caires",25,25,0,4,4,0
10,29,2018,21,0,2,"Braga",4,"N14 Bosch",47,47,0,48,48,0
10,29,2018,21,0,2,"Braga",5,"Avenida João Paulo II",39,39,0,9,9,0
10,29,2018,21,0,2,"Braga",6,"Avenida Padre Júlio Fragata",67,67,0,83,83,0
10,29,2018,21,0,2,"Braga",7,"Rua Nova Santa Cruz",33,44,11,52,39,13
10,29,2018,21,0,2,"Braga",8,"Rua Costa Gomes",41,41,0,42,42,0
10,29,2018,22,0,2,"Braga",1,"Avenida da Liberdade",13,13,0,60,60,0
10,29,2018,22,0,2,"Braga",2,"Avenida Central",49,49,0,71,71,0
10,29,2018,22,0,2,"Braga",3,"Rua de Caires",25,25,0,4,4,0
10,29,2018,22,0,2,"Braga",4,"N14 Bosch",47,47,0,48,48,0
10,29,2018,22,0,2,"Braga",5,"Avenida João Paulo II",39,39,0,9,9,0
10,29,2018,22,0,2,"Braga",6,"Avenida Padre Júlio Fragata",67,67,0,83,83,0
10,29,2018,22,0,2,"Braga",7,"Rua Nova Santa Cruz",44,44,0,39,39,0
10,29,2018,22,0,2,"Braga",8,"Rua Costa Gomes",41,41,0,42,42,0
10,29,2018,23,0,2,"Braga",1,"Avenida da Liberdade",13,13,0,60,60,0
10,29,2018,23,0,2,"Braga",2,"Avenida Central",49,49,0,71,71,0
10,29,2018,23,0,2,"Braga",3,"Rua de Caires",25,25,0,4,4,0
10,29,2018,23,0,2,"Braga",4,"N14 Bosch",47,47,0,48,48,0
10,29,2018,23,0,2,"Braga",5,"Avenida João Paulo II",28,39,11,12,9,3
10,29,2018,23,0,2,"Braga",6,"Avenida Padre Júlio Fragata",67,67,0,83,83,0
10,29,2018,23,0,2,"Braga",7,"Rua Nova Santa Cruz",44,44,0,39,39,0
10,29,2018,23,0,2,"Braga",8,"Rua Costa Gomes",41,41,0,42,42,0
10,30,2018,0,0,3,"Braga",1,"Avenida da Liberdade",13,13,0,60,60,0
10,30,2018,0,0,3,"Braga",2,"Avenida Central",49,49,0,71,71,0
10,30,2018,0,0,3,"Braga",3,"Rua de Caires",25,25,0,4,4,0
10,30,2018,0,0,3,"Braga",4,"N14 Bosch",47,47,0,48,48,0
10,30,2018,0,0,3,"Braga",5,"Avenida João Paulo II",39,39,0,9,9,0
10,30,2018,0,0,3,"Braga",6,"Avenida Padre Júlio Fragata",67,67,0,83,83,0
10,30,2018,0,0,3,"Braga",7,"Rua Nova Santa Cruz",44,44,0,39,39,0
10,30,2018,0,0,3,"Braga",8,"Rua Costa Gomes",41,41,0,42,42,0
10,30,2018,1,0,3,"Braga",1,"Avenida da Liberdade",13,13,0,60,60,0
10,30,2018,1,0,3,"Braga",2,"Avenida Central",49,49,0,71,71,0
10,30,2018,1,0,3,"Braga",3,"Rua de Caires",25,25,0,4,4,0
10,30,2018,1,0,3,"Braga",4,"N14 Bosch",47,47,0,48,48,0
10,30,2018,1,0,3,"Braga",5,"Avenida João Paulo II",39,39,0,9,9,0
10,30,2018,1,0,3,"Braga",6,"Avenida Padre Júlio Fragata",67,67,0,83,83,0
10,30,2018,1,0,3,"Braga",7,"Rua Nova Santa Cruz",44,44,0,39,39,0
10,30,2018,1,0,3,"Braga",8,"Rua Costa Gomes",41,41,0,42,42,0
10,30,2018,2,0,3,"Braga",1,"Avenida da Liberdade",13,13,0,60,60,0
10,30,2018,2,0,3,"Braga",2,"Avenida Central",49,49,0,71,71,0
10,30,2018,2,0,3,"Braga",3,"Rua de Caires",25,25,0,4,4,0
10,30,2018,2,0,3,"Braga",4,"N14 Bosch",47,47,0,48,48,0
10,30,2018,2,0,3,"Braga",5,"Avenida João Paulo II",39,39,0,9,9,0
10,30,2018,2,0,3,"Braga",6,"Avenida Padre Júlio Fragata",67,67,0,83,83,0
10,30,2018,2,0,3,"Braga",7,"Rua Nova Santa Cruz",44,44,0,39,39,0
10,30,2018,2,0,3,"Braga",8,"Rua Costa Gomes",41,41,0,42,42,0
10,30,2018,3,0,3,"Braga",1,"Avenida da Liberdade",13,13,0,60,60,0
10,30,2018,3,0,3,"Braga",2,"Avenida Central",49,49,0,71,71,0
10,30,2018,3,0,3,"Braga",3,"Rua de Caires",25,25,0,4,4,0
10,30,2018,3,0,3,"Braga",4,"N14 Bosch",47,47,0,48,48,0
10,30,2018,3,0,3,"Braga",5,"Avenida João Paulo II",39,39,0,9,9,0
10,30,2018,3,0,3,"Braga",6,"Avenida Padre Júlio Fragata",67,67,0,83,83,0
10,30,2018,3,0,3,"Braga",7,"Rua Nova Santa Cruz",44,44,0,39,39,0
10,30,2018,3,0,3,"Braga",8,"Rua Costa Gomes",41,41,0,42,42,0
10,30,2018,4,0,3,"Braga",1,"Avenida da Liberdade",13,13,0,60,60,0
10,30,2018,4,0,3,"Braga",2,"Avenida Central",49,49,0,71,71,0
10,30,2018,4,0,3,"Braga",3,"Rua de Caires",25,25,0,4,4,0
10,30,2018,4,0,3,"Braga",4,"N14 Bosch",47,47,0,48,48,0
10,30,2018,4,0,3,"Braga",5,"Avenida João Paulo II",39,39,0,9,9,0
10,30,2018,4,0,3,"Braga",6,"Avenida Padre Júlio Fragata",67,67,0,83,83,0
10,30,2018,4,0,3,"Braga",7,"Rua Nova Santa Cruz",44,44,0,39,39,0
10,30,2018,4,0,3,"Braga",8,"Rua Costa Gomes",41,41,0,42,42,0
10,30,2018,5,0,3,"Braga",1,"Avenida da Liberdade",13,13,0,60,60,0
10,30,2018,5,0,3,"Braga",2,"Avenida Central",49,49,0,71,71,0
10,30,2018,5,0,3,"Braga",3,"Rua de Caires",25,25,0,4,4,0
10,30,2018,5,0,3,"Braga",4,"N14 Bosch",47,47,0,48,48,0
10,30,2018,5,0,3,"Braga",5,"Avenida João Paulo II",39,39,0,9,9,0
10,30,2018,5,0,3,"Braga",6,"Avenida Padre Júlio Fragata",67,67,0,83,83,0
10,30,2018,5,0,3,"Braga",7,"Rua Nova Santa Cruz",44,44,0,39,39,0
10,30,2018,5,0,3,"Braga",8,"Rua Costa Gomes",41,41,0,42,42,0
10,30,2018,6,0,3,"Braga",1,"Avenida da Liberdade",13,13,0,60,60,0
10,30,2018,6,0,3,"Braga",2,"Avenida Central",49,49,0,71,71,0
10,30,2018,6,0,3,"Braga",3,"Rua de Caires",25,25,0,4,4,0
10,30,2018,6,0,3,"Braga",4,"N14 Bosch",47,47,0,48,48,0
10,30,2018,6,0,3,"Braga",5,"Avenida João Paulo II",39,39,0,9,9,0
10,30,2018,6,0,3,"Braga",6,"Avenida Padre Júlio Fragata",67,67,0,83,83,0
10,30,2018,6,0,3,"Braga",7,"Rua Nova Santa Cruz",44,44,0,39,39,0
10,30,2018,6,0,3,"Braga",8,"Rua Costa Gomes",41,41,0,42,42,0
10,30,2018,7,0,3,"Braga",1,"Avenida da Liberdade",13,13,0,60,60,0
10,30,2018,7,0,3,"Braga",2,"Avenida Central",49,49,0,71,71,0
10,30,2018,7,0,3,"Braga",3,"Rua de Caires",25,25,0,4,4,0
10,30,2018,7,0,3,"Braga",4,"N14 Bosch",47,47,0,48,48,0
10,30,2018,7,0,3,"Braga",5,"Avenida João Paulo II",39,39,0,9,9,0
10,30,2018,7,0,3,"Braga",6,"Avenida Padre Júlio Fragata",67,67,0,83,83,0
10,30,2018,7,0,3,"Braga",7,"Rua Nova Santa Cruz",44,44,0,39,39,0
10,30,2018,7,0,3,"Braga",8,"Rua Costa Gomes",41,41,0,42,42,0
10,30,2018,8,0,3,"Braga",1,"Avenida da Liberdade",13,13,0,60,60,0
10,30,2018,8,0,3,"Braga",2,"Avenida Central",38,49,11,91,71,20
10,30,2018,8,0,3,"Braga",3,"Rua de Caires",25,25,0,4,4,0
10,30,2018,8,0,3,"Braga",4,"N14 Bosch",36,47,11,62,48,14
10,30,2018,8,0,3,"Braga",5,"Avenida João Paulo II",39,39,0,9,9,0
10,30,2018,8,0,3,"Braga",6,"Avenida Padre Júlio Fragata",67,67,0,83,83,0
10,30,2018,8,0,3,"Braga",7,"Rua Nova Santa Cruz",44,44,0,39,39,0
10,30,2018,8,0,3,"Braga",8,"Rua Costa Gomes",41,41,0,42,42,0
10,30,2018,9,0,3,"Braga",1,"Avenida da Liberdade",13,13,0,60,60,0
10,30,2018,9,0,3,"Braga",2,"Avenida Central",26,49,23,133,71,62
10,30,2018,9,0,3,"Braga",3,"Rua de Caires",25,25,0,4,4,0
10,30,2018,9,0,3,"Braga",4,"N14 Bosch",28,47,19,80,48,32
10,30,2018,9,0,3,"Braga",5,"Avenida João Paulo II",7,39,32,50,9,41
10,30,2018,9,0,3,"Braga",6,"Avenida Padre Júlio Fragata",32,67,35,174,83,91
10,30,2018,9,0,3,"Braga",7,"Rua Nova Santa Cruz",5,44,39,346,39,307
10,30,2018,9,0,3,"Braga",8,"Rua Costa Gomes",41,41,0,42,42,0
10,30,2018,10,0,3,"Braga",1,"Avenida da Liberdade",13,13,0,60,60,0
10,30,2018,10,0,3,"Braga",2,"Avenida Central",49,49,0,71,71,0
10,30,2018,10,0,3,"Braga",3,"Rua de Caires",25,25,0,4,4,0
10,30,2018,10,0,3,"Braga",4,"N14 Bosch",31,47,16,72,48,24
10,30,2018,10,0,3,"Braga",5,"Avenida João Paulo II",39,39,0,9,9,0
10,30,2018,10,0,3,"Braga",6,"Avenida Padre Júlio Fragata",67,67,0,83,83,0
10,30,2018,10,0,3,"Braga",7,"Rua Nova Santa Cruz",44,44,0,39,39,0
10,30,2018,10,0,3,"Braga",8,"Rua Costa Gomes",23,41,18,75,42,33
10,30,2018,11,0,3,"Braga",1,"Avenida da Liberdade",13,13,0,60,60,0
10,30,2018,11,0,3,"Braga",2,"Avenida Central",49,49,0,71,71,0
10,30,2018,11,0,3,"Braga",3,"Rua de Caires",25,25,0,4,4,0
10,30,2018,11,0,3,"Braga",4,"N14 Bosch",47,47,0,48,48,0
10,30,2018,11,0,3,"Braga",5,"Avenida João Paulo II",39,39,0,9,9,0
10,30,2018,11,0,3,"Braga",6,"Avenida Padre Júlio Fragata",67,67,0,83,83,0
10,30,2018,11,0,3,"Braga",7,"Rua Nova Santa Cruz",27,44,17,64,39,25
10,30,2018,11,0,3,"Braga",8,"Rua Costa Gomes",41,41,0,42,42,0
10,30,2018,12,0,3,"Braga",1,"Avenida da Liberdade",13,13,0,60,60,0
10,30,2018,12,0,3,"Braga",2,"Avenida Central",49,49,0,71,71,0
10,30,2018,12,0,3,"Braga",3,"Rua de Caires",25,25,0,4,4,0
10,30,2018,12,0,3,"Braga",4,"N14 Bosch",47,47,0,48,48,0
10,30,2018,12,0,3,"Braga",5,"Avenida João Paulo II",30,39,9,12,9,3
10,30,2018,12,0,3,"Braga",6,"Avenida Padre Júlio Fragata",67,67,0,83,83,0
10,30,2018,12,0,3,"Braga",7,"Rua Nova Santa Cruz",44,44,0,39,39,0
10,30,2018,12,0,3,"Braga",8,"Rua Costa Gomes",31,41,10,56,42,14
10,30,2018,13,0,3,"Braga",1,"Avenida da Liberdade",13,13,0,60,60,0
10,30,2018,13,0,3,"Braga",2,"Avenida Central",49,49,0,71,71,0
10,30,2018,13,0,3,"Braga",3,"Rua de Caires",25,25,0,4,4,0
10,30,2018,13,0,3,"Braga",4,"N14 Bosch",35,47,12,64,48,16
10,30,2018,13,0,3,"Braga",5,"Avenida João Paulo II",39,39,0,9,9,0
10,30,2018,13,0,3,"Braga",6,"Avenida Padre Júlio Fragata",67,67,0,83,83,0
10,30,2018,13,0,3,"Braga",7,"Rua Nova Santa Cruz",25,44,19,69,39,30
10,30,2018,13,0,3,"Braga",8,"Rua Costa Gomes",26,41,15,67,42,25
10,30,2018,14,0,3,"Braga",1,"Avenida da Liberdade",13,13,0,60,60,0
10,30,2018,14,0,3,"Braga",2,"Avenida Central",49,49,0,71,71,0
10,30,2018,14,0,3,"Braga",3,"Rua de Caires",25,25,0,4,4,0
10,30,2018,14,0,3,"Braga",4,"N14 Bosch",13,47,34,173,48,125
10,30,2018,14,0,3,"Braga",5,"Avenida João Paulo II",39,39,0,9,9,0
10,30,2018,14,0,3,"Braga",6,"Avenida Padre Júlio Fragata",52,67,15,107,83,24
10,30,2018,14,0,3,"Braga",7,"Rua Nova Santa Cruz",20,44,24,86,39,47
10,30,2018,14,0,3,"Braga",8,"Rua Costa Gomes",31,41,10,56,42,14
10,30,2018,15,0,3,"Braga",1,"Avenida da Liberdade",13,13,0,60,60,0
10,30,2018,15,0,3,"Braga",2,"Avenida Central",49,49,0,71,71,0
10,30,2018,15,0,3,"Braga",3,"Rua de Caires",25,25,0,4,4,0
10,30,2018,15,0,3,"Braga",4,"N14 Bosch",29,47,18,77,48,29
10,30,2018,15,0,3,"Braga",5,"Avenida João Paulo II",39,39,0,9,9,0
10,30,2018,15,0,3,"Braga",6,"Avenida Padre Júlio Fragata",67,67,0,83,83,0
10,30,2018,15,0,3,"Braga",7,"Rua Nova Santa Cruz",28,44,16,62,39,23
10,30,2018,15,0,3,"Braga",8,"Rua Costa Gomes",28,41,13,62,42,20
10,30,2018,16,0,3,"Braga",1,"Avenida da Liberdade",13,13,0,60,60,0
10,30,2018,16,0,3,"Braga",2,"Avenida Central",49,49,0,71,71,0
10,30,2018,16,0,3,"Braga",3,"Rua de Caires",25,25,0,4,4,0
10,30,2018,16,0,3,"Braga",4,"N14 Bosch",16,47,31,140,48,92
10,30,2018,16,0,3,"Braga",5,"Avenida João Paulo II",30,39,9,12,9,3
10,30,2018,16,0,3,"Braga",6,"Avenida Padre Júlio Fragata",67,67,0,83,83,0
10,30,2018,16,0,3,"Braga",7,"Rua Nova Santa Cruz",32,44,12,54,39,15
10,30,2018,16,0,3,"Braga",8,"Rua Costa Gomes",30,41,11,58,42,16
10,30,2018,17,0,3,"Braga",1,"Avenida da Liberdade",13,13,0,60,60,0
10,30,2018,17,0,3,"Braga",2,"Avenida Central",49,49,0,71,71,0
10,30,2018,17,0,3,"Braga",3,"Rua de Caires",25,25,0,4,4,0
10,30,2018,17,0,3,"Braga",4,"N14 Bosch",36,47,11,62,48,14
10,30,2018,17,0,3,"Braga",5,"Avenida João Paulo II",27,39,12,13,9,4
10,30,2018,17,0,3,"Braga",6,"Avenida Padre Júlio Fragata",53,67,14,105,83,22
10,30,2018,17,0,3,"Braga",7,"Rua Nova Santa Cruz",33,44,11,52,39,13
10,30,2018,17,0,3,"Braga",8,"Rua Costa Gomes",24,41,17,72,42,30
10,30,2018,18,0,3,"Braga",1,"Avenida da Liberdade",13,13,0,60,60,0
10,30,2018,18,0,3,"Braga",2,"Avenida Central",38,49,11,91,71,20
10,30,2018,18,0,3,"Braga",3,"Rua de Caires",17,25,8,6,4,2
10,30,2018,18,0,3,"Braga",4,"N14 Bosch",22,47,25,102,48,54
10,30,2018,18,0,3,"Braga",5,"Avenida João Paulo II",4,39,35,87,9,78
10,30,2018,18,0,3,"Braga",6,"Avenida Padre Júlio Fragata",6,67,61,929,83,846
10,30,2018,18,0,3,"Braga",7,"Rua Nova Santa Cruz",18,44,26,96,39,57
10,30,2018,18,0,3,"Braga",8,"Rua Costa Gomes",12,41,29,144,42,102
10,30,2018,19,0,3,"Braga",1,"Avenida da Liberdade",13,13,0,60,60,0
10,30,2018,19,0,3,"Braga",2,"Avenida Central",37,49,12,94,71,23
10,30,2018,19,0,3,"Braga",3,"Rua de Caires",3,25,22,35,4,31
10,30,2018,19,0,3,"Braga",4,"N14 Bosch",15,47,32,150,48,102
10,30,2018,19,0,3,"Braga",5,"Avenida João Paulo II",8,39,31,44,9,35
10,30,2018,19,0,3,"Braga",6,"Avenida Padre Júlio Fragata",32,67,35,174,83,91
10,30,2018,19,0,3,"Braga",7,"Rua Nova Santa Cruz",4,44,40,432,39,393
10,30,2018,19,0,3,"Braga",8,"Rua Costa Gomes",10,41,31,173,42,131
10,30,2018,20,0,3,"Braga",1,"Avenida da Liberdade",13,13,0,60,60,0
10,30,2018,20,0,3,"Braga",2,"Avenida Central",49,49,0,71,71,0
10,30,2018,20,0,3,"Braga",3,"Rua de Caires",25,25,0,4,4,0
10,30,2018,20,0,3,"Braga",4,"N14 Bosch",47,47,0,48,48,0
10,30,2018,20,0,3,"Braga",5,"Avenida João Paulo II",30,39,9,12,9,3
10,30,2018,20,0,3,"Braga",6,"Avenida Padre Júlio Fragata",52,67,15,107,83,24
10,30,2018,20,0,3,"Braga",7,"Rua Nova Santa Cruz",25,44,19,69,39,30
10,30,2018,20,0,3,"Braga",8,"Rua Costa Gomes",41,41,0,42,42,0
10,30,2018,21,0,3,"Braga",1,"Avenida da Liberdade",13,13,0,60,60,0
10,30,2018,21,0,3,"Braga",2,"Avenida Central",49,49,0,71,71,0
10,30,2018,21,0,3,"Braga",3,"Rua de Caires",25,25,0,4,4,0
10,30,2018,21,0,3,"Braga",4,"N14 Bosch",47,47,0,48,48,0
10,30,2018,21,0,3,"Braga",5,"Avenida João Paulo II",39,39,0,9,9,0
10,30,2018,21,0,3,"Braga",6,"Avenida Padre Júlio Fragata",67,67,0,83,83,0
10,30,2018,21,0,3,"Braga",7,"Rua Nova Santa Cruz",33,44,11,52,39,13
10,30,2018,21,0,3,"Braga",8,"Rua Costa Gomes",32,41,9,54,42,12
10,30,2018,22,0,3,"Braga",1,"Avenida da Liberdade",13,13,0,60,60,0
10,30,2018,22,0,3,"Braga",2,"Avenida Central",49,49,0,71,71,0
10,30,2018,22,0,3,"Braga",3,"Rua de Caires",25,25,0,4,4,0
10,30,2018,22,0,3,"Braga",4,"N14 Bosch",47,47,0,48,48,0
10,30,2018,22,0,3,"Braga",5,"Avenida João Paulo II",39,39,0,9,9,0
10,30,2018,22,0,3,"Braga",6,"Avenida Padre Júlio Fragata",67,67,0,83,83,0
10,30,2018,22,0,3,"Braga",7,"Rua Nova Santa Cruz",44,44,0,39,39,0
10,30,2018,22,0,3,"Braga",8,"Rua Costa Gomes",41,41,0,42,42,0
10,30,2018,23,0,3,"Braga",1,"Avenida da Liberdade",13,13,0,60,60,0
10,30,2018,23,0,3,"Braga",2,"Avenida Central",49,49,0,71,71,0
10,30,2018,23,0,3,"Braga",3,"Rua de Caires",25,25,0,4,4,0
10,30,2018,23,0,3,"Braga",4,"N14 Bosch",47,47,0,48,48,0
10,30,2018,23,0,3,"Braga",5,"Avenida João Paulo II",39,39,0,9,9,0
10,30,2018,23,0,3,"Braga",6,"Avenida Padre Júlio Fragata",67,67,0,83,83,0
10,30,2018,23,0,3,"Braga",7,"Rua Nova Santa Cruz",44,44,0,39,39,0
10,30,2018,23,0,3,"Braga",8,"Rua Costa Gomes",41,41,0,42,42,0
10,31,2018,0,0,4,"Braga",1,"Avenida da Liberdade",13,13,0,60,60,0
10,31,2018,0,0,4,"Braga",2,"Avenida Central",49,49,0,71,71,0
10,31,2018,0,0,4,"Braga",3,"Rua de Caires",25,25,0,4,4,0
10,31,2018,0,0,4,"Braga",4,"N14 Bosch",47,47,0,48,48,0
10,31,2018,0,0,4,"Braga",5,"Avenida João Paulo II",39,39,0,9,9,0
10,31,2018,0,0,4,"Braga",6,"Avenida Padre Júlio Fragata",67,67,0,83,83,0
10,31,2018,0,0,4,"Braga",7,"Rua Nova Santa Cruz",44,44,0,39,39,0
10,31,2018,0,0,4,"Braga",8,"Rua Costa Gomes",41,41,0,42,42,0
10,31,2018,1,0,4,"Braga",1,"Avenida da Liberdade",13,13,0,60,60,0
10,31,2018,1,0,4,"Braga",2,"Avenida Central",49,49,0,71,71,0
10,31,2018,1,0,4,"Braga",3,"Rua de Caires",25,25,0,4,4,0
10,31,2018,1,0,4,"Braga",4,"N14 Bosch",47,47,0,48,48,0
10,31,2018,1,0,4,"Braga",5,"Avenida João Paulo II",39,39,0,9,9,0
10,31,2018,1,0,4,"Braga",6,"Avenida Padre Júlio Fragata",67,67,0,83,83,0
10,31,2018,1,0,4,"Braga",7,"Rua Nova Santa Cruz",44,44,0,39,39,0
10,31,2018,1,0,4,"Braga",8,"Rua Costa Gomes",41,41,0,42,42,0
10,31,2018,2,0,4,"Braga",1,"Avenida da Liberdade",13,13,0,60,60,0
10,31,2018,2,0,4,"Braga",2,"Avenida Central",49,49,0,71,71,0
10,31,2018,2,0,4,"Braga",3,"Rua de Caires",25,25,0,4,4,0
10,31,2018,2,0,4,"Braga",4,"N14 Bosch",47,47,0,48,48,0
10,31,2018,2,0,4,"Braga",5,"Avenida João Paulo II",39,39,0,9,9,0
10,31,2018,2,0,4,"Braga",6,"Avenida Padre Júlio Fragata",67,67,0,83,83,0
10,31,2018,2,0,4,"Braga",7,"Rua Nova Santa Cruz",44,44,0,39,39,0
10,31,2018,2,0,4,"Braga",8,"Rua Costa Gomes",41,41,0,42,42,0
10,31,2018,3,0,4,"Braga",1,"Avenida da Liberdade",13,13,0,60,60,0
10,31,2018,3,0,4,"Braga",2,"Avenida Central",49,49,0,71,71,0
10,31,2018,3,0,4,"Braga",3,"Rua de Caires",25,25,0,4,4,0
10,31,2018,3,0,4,"Braga",4,"N14 Bosch",47,47,0,48,48,0
10,31,2018,3,0,4,"Braga",5,"Avenida João Paulo II",39,39,0,9,9,0
10,31,2018,3,0,4,"Braga",6,"Avenida Padre Júlio Fragata",67,67,0,83,83,0
10,31,2018,3,0,4,"Braga",7,"Rua Nova Santa Cruz",44,44,0,39,39,0
10,31,2018,3,0,4,"Braga",8,"Rua Costa Gomes",41,41,0,42,42,0
10,31,2018,4,0,4,"Braga",1,"Avenida da Liberdade",13,13,0,60,60,0
10,31,2018,4,0,4,"Braga",2,"Avenida Central",49,49,0,71,71,0
10,31,2018,4,0,4,"Braga",3,"Rua de Caires",25,25,0,4,4,0
10,31,2018,4,0,4,"Braga",4,"N14 Bosch",47,47,0,48,48,0
10,31,2018,4,0,4,"Braga",5,"Avenida João Paulo II",39,39,0,9,9,0
10,31,2018,4,0,4,"Braga",6,"Avenida Padre Júlio Fragata",67,67,0,83,83,0
10,31,2018,4,0,4,"Braga",7,"Rua Nova Santa Cruz",44,44,0,39,39,0
10,31,2018,4,0,4,"Braga",8,"Rua Costa Gomes",41,41,0,42,42,0
10,31,2018,5,0,4,"Braga",1,"Avenida da Liberdade",13,13,0,60,60,0
10,31,2018,5,0,4,"Braga",2,"Avenida Central",49,49,0,71,71,0
10,31,2018,5,0,4,"Braga",3,"Rua de Caires",25,25,0,4,4,0
10,31,2018,5,0,4,"Braga",4,"N14 Bosch",47,47,0,48,48,0
10,31,2018,5,0,4,"Braga",5,"Avenida João Paulo II",39,39,0,9,9,0
10,31,2018,5,0,4,"Braga",6,"Avenida Padre Júlio Fragata",67,67,0,83,83,0
10,31,2018,5,0,4,"Braga",7,"Rua Nova Santa Cruz",44,44,0,39,39,0
10,31,2018,5,0,4,"Braga",8,"Rua Costa Gomes",41,41,0,42,42,0
10,31,2018,6,0,4,"Braga",1,"Avenida da Liberdade",13,13,0,60,60,0
10,31,2018,6,0,4,"Braga",2,"Avenida Central",49,49,0,71,71,0
10,31,2018,6,0,4,"Braga",3,"Rua de Caires",25,25,0,4,4,0
10,31,2018,6,0,4,"Braga",4,"N14 Bosch",47,47,0,48,48,0
10,31,2018,6,0,4,"Braga",5,"Avenida João Paulo II",39,39,0,9,9,0
10,31,2018,6,0,4,"Braga",6,"Avenida Padre Júlio Fragata",67,67,0,83,83,0
10,31,2018,6,0,4,"Braga",7,"Rua Nova Santa Cruz",44,44,0,39,39,0
10,31,2018,6,0,4,"Braga",8,"Rua Costa Gomes",41,41,0,42,42,0
10,31,2018,7,0,4,"Braga",1,"Avenida da Liberdade",9,13,4,86,60,26
10,31,2018,7,0,4,"Braga",2,"Avenida Central",49,49,0,71,71,0
10,31,2018,7,0,4,"Braga",3,"Rua de Caires",25,25,0,4,4,0
10,31,2018,7,0,4,"Braga",4,"N14 Bosch",47,47,0,48,48,0
10,31,2018,7,0,4,"Braga",5,"Avenida João Paulo II",39,39,0,9,9,0
10,31,2018,7,0,4,"Braga",6,"Avenida Padre Júlio Fragata",67,67,0,83,83,0
10,31,2018,7,0,4,"Braga",7,"Rua Nova Santa Cruz",44,44,0,39,39,0
10,31,2018,7,0,4,"Braga",8,"Rua Costa Gomes",41,41,0,42,42,0
10,31,2018,8,0,4,"Braga",1,"Avenida da Liberdade",13,13,0,60,60,0
10,31,2018,8,0,4,"Braga",2,"Avenida Central",36,49,13,96,71,25
10,31,2018,8,0,4,"Braga",3,"Rua de Caires",25,25,0,4,4,0
10,31,2018,8,0,4,"Braga",4,"N14 Bosch",25,47,22,90,48,42
10,31,2018,8,0,4,"Braga",5,"Avenida João Paulo II",39,39,0,9,9,0
10,31,2018,8,0,4,"Braga",6,"Avenida Padre Júlio Fragata",67,67,0,83,83,0
10,31,2018,8,0,4,"Braga",7,"Rua Nova Santa Cruz",25,44,19,69,39,30
10,31,2018,8,0,4,"Braga",8,"Rua Costa Gomes",41,41,0,42,42,0
10,31,2018,9,0,4,"Braga",1,"Avenida da Liberdade",13,13,0,60,60,0
10,31,2018,9,0,4,"Braga",2,"Avenida Central",34,49,15,102,71,31
10,31,2018,9,0,4,"Braga",3,"Rua de Caires",25,25,0,4,4,0
10,31,2018,9,0,4,"Braga",4,"N14 Bosch",26,47,21,86,48,38
10,31,2018,9,0,4,"Braga",5,"Avenida João Paulo II",30,39,9,12,9,3
10,31,2018,9,0,4,"Braga",6,"Avenida Padre Júlio Fragata",29,67,38,192,83,109
10,31,2018,9,0,4,"Braga",7,"Rua Nova Santa Cruz",3,44,41,576,39,537
10,31,2018,9,0,4,"Braga",8,"Rua Costa Gomes",41,41,0,42,42,0
10,31,2018,10,0,4,"Braga",1,"Avenida da Liberdade",13,13,0,60,60,0
10,31,2018,10,0,4,"Braga",2,"Avenida Central",49,49,0,71,71,0
10,31,2018,10,0,4,"Braga",3,"Rua de Caires",25,25,0,4,4,0
10,31,2018,10,0,4,"Braga",4,"N14 Bosch",18,47,29,125,48,77
10,31,2018,10,0,4,"Braga",5,"Avenida João Paulo II",29,39,10,12,9,3
10,31,2018,10,0,4,"Braga",6,"Avenida Padre Júlio Fragata",67,67,0,83,83,0
10,31,2018,10,0,4,"Braga",7,"Rua Nova Santa Cruz",44,44,0,39,39,0
10,31,2018,10,0,4,"Braga",8,"Rua Costa Gomes",28,41,13,62,42,20
10,31,2018,11,0,4,"Braga",1,"Avenida da Liberdade",13,13,0,60,60,0
10,31,2018,11,0,4,"Braga",2,"Avenida Central",34,49,15,102,71,31
10,31,2018,11,0,4,"Braga",3,"Rua de Caires",25,25,0,4,4,0
10,31,2018,11,0,4,"Braga",4,"N14 Bosch",30,47,17,75,48,27
10,31,2018,11,0,4,"Braga",5,"Avenida João Paulo II",39,39,0,9,9,0
10,31,2018,11,0,4,"Braga",6,"Avenida Padre Júlio Fragata",67,67,0,83,83,0
10,31,2018,11,0,4,"Braga",7,"Rua Nova Santa Cruz",29,44,15,60,39,21
10,31,2018,11,0,4,"Braga",8,"Rua Costa Gomes",41,41,0,42,42,0
10,31,2018,12,0,4,"Braga",1,"Avenida da Liberdade",13,13,0,60,60,0
10,31,2018,12,0,4,"Braga",2,"Avenida Central",49,49,0,71,71,0
10,31,2018,12,0,4,"Braga",3,"Rua de Caires",25,25,0,4,4,0
10,31,2018,12,0,4,"Braga",4,"N14 Bosch",47,47,0,48,48,0
10,31,2018,12,0,4,"Braga",5,"Avenida João Paulo II",39,39,0,9,9,0
10,31,2018,12,0,4,"Braga",6,"Avenida Padre Júlio Fragata",67,67,0,83,83,0
10,31,2018,12,0,4,"Braga",7,"Rua Nova Santa Cruz",44,44,0,39,39,0
10,31,2018,12,0,4,"Braga",8,"Rua Costa Gomes",31,41,10,56,42,14
10,31,2018,13,0,4,"Braga",1,"Avenida da Liberdade",13,13,0,60,60,0
10,31,2018,13,0,4,"Braga",2,"Avenida Central",49,49,0,71,71,0
10,31,2018,13,0,4,"Braga",3,"Rua de Caires",25,25,0,4,4,0
10,31,2018,13,0,4,"Braga",4,"N14 Bosch",19,47,28,118,48,70
10,31,2018,13,0,4,"Braga",5,"Avenida João Paulo II",39,39,0,9,9,0
10,31,2018,13,0,4,"Braga",6,"Avenida Padre Júlio Fragata",67,67,0,83,83,0
10,31,2018,13,0,4,"Braga",7,"Rua Nova Santa Cruz",19,44,25,91,39,52
10,31,2018,13,0,4,"Braga",8,"Rua Costa Gomes",18,41,23,96,42,54
10,31,2018,14,0,4,"Braga",1,"Avenida da Liberdade",7,13,6,111,60,51
10,31,2018,14,0,4,"Braga",2,"Avenida Central",38,49,11,91,71,20
10,31,2018,14,0,4,"Braga",3,"Rua de Caires",25,25,0,4,4,0
10,31,2018,14,0,4,"Braga",4,"N14 Bosch",19,47,28,118,48,70
10,31,2018,14,0,4,"Braga",5,"Avenida João Paulo II",39,39,0,9,9,0
10,31,2018,14,0,4,"Braga",6,"Avenida Padre Júlio Fragata",67,67,0,83,83,0
10,31,2018,14,0,4,"Braga",7,"Rua Nova Santa Cruz",15,44,29,115,39,76
10,31,2018,14,0,4,"Braga",8,"Rua Costa Gomes",30,41,11,58,42,16
10,31,2018,15,0,4,"Braga",1,"Avenida da Liberdade",13,13,0,60,60,0
10,31,2018,15,0,4,"Braga",2,"Avenida Central",49,49,0,71,71,0
10,31,2018,15,0,4,"Braga",3,"Rua de Caires",25,25,0,4,4,0
10,31,2018,15,0,4,"Braga",4,"N14 Bosch",35,47,12,64,48,16
10,31,2018,15,0,4,"Braga",5,"Avenida João Paulo II",39,39,0,9,9,0
10,31,2018,15,0,4,"Braga",6,"Avenida Padre Júlio Fragata",67,67,0,83,83,0
10,31,2018,15,0,4,"Braga",7,"Rua Nova Santa Cruz",35,44,9,49,39,10
10,31,2018,15,0,4,"Braga",8,"Rua Costa Gomes",27,41,14,64,42,22
10,31,2018,16,0,4,"Braga",1,"Avenida da Liberdade",13,13,0,60,60,0
10,31,2018,16,0,4,"Braga",2,"Avenida Central",49,49,0,71,71,0
10,31,2018,16,0,4,"Braga",3,"Rua de Caires",25,25,0,4,4,0
10,31,2018,16,0,4,"Braga",4,"N14 Bosch",26,47,21,86,48,38
10,31,2018,16,0,4,"Braga",5,"Avenida João Paulo II",39,39,0,9,9,0
10,31,2018,16,0,4,"Braga",6,"Avenida Padre Júlio Fragata",67,67,0,83,83,0
10,31,2018,16,0,4,"Braga",7,"Rua Nova Santa Cruz",26,44,18,66,39,27
10,31,2018,16,0,4,"Braga",8,"Rua Costa Gomes",32,41,9,54,42,12
10,31,2018,17,0,4,"Braga",1,"Avenida da Liberdade",13,13,0,60,60,0
10,31,2018,17,0,4,"Braga",2,"Avenida Central",49,49,0,71,71,0
10,31,2018,17,0,4,"Braga",3,"Rua de Caires",25,25,0,4,4,0
10,31,2018,17,0,4,"Braga",4,"N14 Bosch",28,47,19,80,48,32
10,31,2018,17,0,4,"Braga",5,"Avenida João Paulo II",26,39,13,13,9,4
10,31,2018,17,0,4,"Braga",6,"Avenida Padre Júlio Fragata",67,67,0,83,83,0
10,31,2018,17,0,4,"Braga",7,"Rua Nova Santa Cruz",32,44,12,54,39,15
10,31,2018,17,0,4,"Braga",8,"Rua Costa Gomes",31,41,10,56,42,14
10,31,2018,18,0,4,"Braga",1,"Avenida da Liberdade",13,13,0,60,60,0
10,31,2018,18,0,4,"Braga",2,"Avenida Central",35,49,14,99,71,28
10,31,2018,18,0,4,"Braga",3,"Rua de Caires",18,25,7,6,4,2
10,31,2018,18,0,4,"Braga",4,"N14 Bosch",18,47,29,125,48,77
10,31,2018,18,0,4,"Braga",5,"Avenida João Paulo II",31,39,8,11,9,2
10,31,2018,18,0,4,"Braga",6,"Avenida Padre Júlio Fragata",67,67,0,83,83,0
10,31,2018,18,0,4,"Braga",7,"Rua Nova Santa Cruz",5,44,39,346,39,307
10,31,2018,18,0,4,"Braga",8,"Rua Costa Gomes",10,41,31,173,42,131
10,31,2018,19,0,4,"Braga",1,"Avenida da Liberdade",13,13,0,60,60,0
10,31,2018,19,0,4,"Braga",2,"Avenida Central",49,49,0,71,71,0
10,31,2018,19,0,4,"Braga",3,"Rua de Caires",25,25,0,4,4,0
10,31,2018,19,0,4,"Braga",4,"N14 Bosch",17,47,30,132,48,84
10,31,2018,19,0,4,"Braga",5,"Avenida João Paulo II",5,39,34,70,9,61
10,31,2018,19,0,4,"Braga",6,"Avenida Padre Júlio Fragata",67,67,0,83,83,0
10,31,2018,19,0,4,"Braga",7,"Rua Nova Santa Cruz",30,44,14,58,39,19
10,31,2018,19,0,4,"Braga",8,"Rua Costa Gomes",8,41,33,216,42,174
10,31,2018,20,0,4,"Braga",1,"Avenida da Liberdade",13,13,0,60,60,0
10,31,2018,20,0,4,"Braga",2,"Avenida Central",37,49,12,94,71,23
10,31,2018,20,0,4,"Braga",3,"Rua de Caires",25,25,0,4,4,0
10,31,2018,20,0,4,"Braga",4,"N14 Bosch",30,47,17,75,48,27
10,31,2018,20,0,4,"Braga",5,"Avenida João Paulo II",39,39,0,9,9,0
10,31,2018,20,0,4,"Braga",6,"Avenida Padre Júlio Fragata",67,67,0,83,83,0
10,31,2018,20,0,4,"Braga",7,"Rua Nova Santa Cruz",35,44,9,49,39,10
10,31,2018,20,0,4,"Braga",8,"Rua Costa Gomes",18,41,23,96,42,54
10,31,2018,21,0,4,"Braga",1,"Avenida da Liberdade",13,13,0,60,60,0
10,31,2018,21,0,4,"Braga",2,"Avenida Central",49,49,0,71,71,0
10,31,2018,21,0,4,"Braga",3,"Rua de Caires",25,25,0,4,4,0
10,31,2018,21,0,4,"Braga",4,"N14 Bosch",47,47,0,48,48,0
10,31,2018,21,0,4,"Braga",5,"Avenida João Paulo II",39,39,0,9,9,0
10,31,2018,21,0,4,"Braga",6,"Avenida Padre Júlio Fragata",67,67,0,83,83,0
10,31,2018,21,0,4,"Braga",7,"Rua Nova Santa Cruz",44,44,0,39,39,0
10,31,2018,21,0,4,"Braga",8,"Rua Costa Gomes",41,41,0,42,42,0
10,31,2018,22,0,4,"Braga",1,"Avenida da Liberdade",13,13,0,60,60,0
10,31,2018,22,0,4,"Braga",2,"Avenida Central",49,49,0,71,71,0
10,31,2018,22,0,4,"Braga",3,"Rua de Caires",25,25,0,4,4,0
10,31,2018,22,0,4,"Braga",4,"N14 Bosch",47,47,0,48,48,0
10,31,2018,22,0,4,"Braga",5,"Avenida João Paulo II",39,39,0,9,9,0
10,31,2018,22,0,4,"Braga",6,"Avenida Padre Júlio Fragata",67,67,0,83,83,0
10,31,2018,22,0,4,"Braga",7,"Rua Nova Santa Cruz",33,44,11,52,39,13
10,31,2018,22,0,4,"Braga",8,"Rua Costa Gomes",41,41,0,42,42,0
10,31,2018,23,0,4,"Braga",1,"Avenida da Liberdade",13,13,0,60,60,0
10,31,2018,23,0,4,"Braga",2,"Avenida Central",49,49,0,71,71,0
10,31,2018,23,0,4,"Braga",3,"Rua de Caires",25,25,0,4,4,0
10,31,2018,23,0,4,"Braga",4,"N14 Bosch",47,47,0,48,48,0
10,31,2018,23,0,4,"Braga",5,"Avenida João Paulo II",39,39,0,9,9,0
10,31,2018,23,0,4,"Braga",6,"Avenida Padre Júlio Fragata",67,67,0,83,83,0
10,31,2018,23,0,4,"Braga",7,"Rua Nova Santa Cruz",27,44,17,64,39,25
10,31,2018,23,0,4,"Braga",8,"Rua Costa Gomes",41,41,0,42,42,0
11,1,2018,0,0,5,"Braga",1,"Avenida da Liberdade",13,13,0,60,60,0
11,1,2018,0,0,5,"Braga",2,"Avenida Central",49,49,0,71,71,0
11,1,2018,0,0,5,"Braga",3,"Rua de Caires",25,25,0,4,4,0
11,1,2018,0,0,5,"Braga",4,"N14 Bosch",47,47,0,48,48,0
11,1,2018,0,0,5,"Braga",5,"Avenida João Paulo II",39,39,0,9,9,0
11,1,2018,0,0,5,"Braga",6,"Avenida Padre Júlio Fragata",67,67,0,83,83,0
11,1,2018,0,0,5,"Braga",7,"Rua Nova Santa Cruz",44,44,0,39,39,0
11,1,2018,0,0,5,"Braga",8,"Rua Costa Gomes",41,41,0,42,42,0
11,1,2018,1,0,5,"Braga",1,"Avenida da Liberdade",13,13,0,60,60,0
11,1,2018,1,0,5,"Braga",2,"Avenida Central",49,49,0,71,71,0
11,1,2018,1,0,5,"Braga",3,"Rua de Caires",25,25,0,4,4,0
11,1,2018,1,0,5,"Braga",4,"N14 Bosch",47,47,0,48,48,0
11,1,2018,1,0,5,"Braga",5,"Avenida João Paulo II",16,39,23,22,9,13
11,1,2018,1,0,5,"Braga",6,"Avenida Padre Júlio Fragata",67,67,0,83,83,0
11,1,2018,1,0,5,"Braga",7,"Rua Nova Santa Cruz",44,44,0,39,39,0
11,1,2018,1,0,5,"Braga",8,"Rua Costa Gomes",41,41,0,42,42,0
11,1,2018,2,0,5,"Braga",1,"Avenida da Liberdade",13,13,0,60,60,0
11,1,2018,2,0,5,"Braga",2,"Avenida Central",49,49,0,71,71,0
11,1,2018,2,0,5,"Braga",3,"Rua de Caires",25,25,0,4,4,0
11,1,2018,2,0,5,"Braga",4,"N14 Bosch",47,47,0,48,48,0
11,1,2018,2,0,5,"Braga",5,"Avenida João Paulo II",29,39,10,12,9,3
11,1,2018,2,0,5,"Braga",6,"Avenida Padre Júlio Fragata",67,67,0,83,83,0
11,1,2018,2,0,5,"Braga",7,"Rua Nova Santa Cruz",44,44,0,39,39,0
11,1,2018,2,0,5,"Braga",8,"Rua Costa Gomes",41,41,0,42,42,0
11,1,2018,3,0,5,"Braga",1,"Avenida da Liberdade",13,13,0,60,60,0
11,1,2018,3,0,5,"Braga",2,"Avenida Central",49,49,0,71,71,0
11,1,2018,3,0,5,"Braga",3,"Rua de Caires",25,25,0,4,4,0
11,1,2018,3,0,5,"Braga",4,"N14 Bosch",47,47,0,48,48,0
11,1,2018,3,0,5,"Braga",5,"Avenida João Paulo II",39,39,0,9,9,0
11,1,2018,3,0,5,"Braga",6,"Avenida Padre Júlio Fragata",67,67,0,83,83,0
11,1,2018,3,0,5,"Braga",7,"Rua Nova Santa Cruz",44,44,0,39,39,0
11,1,2018,3,0,5,"Braga",8,"Rua Costa Gomes",41,41,0,42,42,0
11,1,2018,4,0,5,"Braga",1,"Avenida da Liberdade",13,13,0,60,60,0
11,1,2018,4,0,5,"Braga",2,"Avenida Central",49,49,0,71,71,0
11,1,2018,4,0,5,"Braga",3,"Rua de Caires",25,25,0,4,4,0
11,1,2018,4,0,5,"Braga",4,"N14 Bosch",47,47,0,48,48,0
11,1,2018,4,0,5,"Braga",5,"Avenida João Paulo II",39,39,0,9,9,0
11,1,2018,4,0,5,"Braga",6,"Avenida Padre Júlio Fragata",67,67,0,83,83,0
11,1,2018,4,0,5,"Braga",7,"Rua Nova Santa Cruz",44,44,0,39,39,0
11,1,2018,4,0,5,"Braga",8,"Rua Costa Gomes",41,41,0,42,42,0
11,1,2018,5,0,5,"Braga",1,"Avenida da Liberdade",13,13,0,60,60,0
11,1,2018,5,0,5,"Braga",2,"Avenida Central",49,49,0,71,71,0
11,1,2018,5,0,5,"Braga",3,"Rua de Caires",25,25,0,4,4,0
11,1,2018,5,0,5,"Braga",4,"N14 Bosch",47,47,0,48,48,0
11,1,2018,5,0,5,"Braga",5,"Avenida João Paulo II",39,39,0,9,9,0
11,1,2018,5,0,5,"Braga",6,"Avenida Padre Júlio Fragata",67,67,0,83,83,0
11,1,2018,5,0,5,"Braga",7,"Rua Nova Santa Cruz",44,44,0,39,39,0
11,1,2018,5,0,5,"Braga",8,"Rua Costa Gomes",41,41,0,42,42,0
11,1,2018,6,0,5,"Braga",1,"Avenida da Liberdade",13,13,0,60,60,0
11,1,2018,6,0,5,"Braga",2,"Avenida Central",49,49,0,71,71,0
11,1,2018,6,0,5,"Braga",3,"Rua de Caires",25,25,0,4,4,0
11,1,2018,6,0,5,"Braga",4,"N14 Bosch",47,47,0,48,48,0
11,1,2018,6,0,5,"Braga",5,"Avenida João Paulo II",39,39,0,9,9,0
11,1,2018,6,0,5,"Braga",6,"Avenida Padre Júlio Fragata",67,67,0,83,83,0
11,1,2018,6,0,5,"Braga",7,"Rua Nova Santa Cruz",44,44,0,39,39,0
11,1,2018,6,0,5,"Braga",8,"Rua Costa Gomes",41,41,0,42,42,0
11,1,2018,7,0,5,"Braga",1,"Avenida da Liberdade",13,13,0,60,60,0
11,1,2018,7,0,5,"Braga",2,"Avenida Central",49,49,0,71,71,0
11,1,2018,7,0,5,"Braga",3,"Rua de Caires",25,25,0,4,4,0
11,1,2018,7,0,5,"Braga",4,"N14 Bosch",47,47,0,48,48,0
11,1,2018,7,0,5,"Braga",5,"Avenida João Paulo II",39,39,0,9,9,0
11,1,2018,7,0,5,"Braga",6,"Avenida Padre Júlio Fragata",67,67,0,83,83,0
11,1,2018,7,0,5,"Braga",7,"Rua Nova Santa Cruz",44,44,0,39,39,0
11,1,2018,7,0,5,"Braga",8,"Rua Costa Gomes",41,41,0,42,42,0
11,1,2018,8,0,5,"Braga",1,"Avenida da Liberdade",13,13,0,60,60,0
11,1,2018,8,0,5,"Braga",2,"Avenida Central",49,49,0,71,71,0
11,1,2018,8,0,5,"Braga",3,"Rua de Caires",25,25,0,4,4,0
11,1,2018,8,0,5,"Braga",4,"N14 Bosch",47,47,0,48,48,0
11,1,2018,8,0,5,"Braga",5,"Avenida João Paulo II",39,39,0,9,9,0
11,1,2018,8,0,5,"Braga",6,"Avenida Padre Júlio Fragata",67,67,0,83,83,0
11,1,2018,8,0,5,"Braga",7,"Rua Nova Santa Cruz",44,44,0,39,39,0
11,1,2018,8,0,5,"Braga",8,"Rua Costa Gomes",41,41,0,42,42,0
11,1,2018,9,0,5,"Braga",1,"Avenida da Liberdade",13,13,0,60,60,0
11,1,2018,9,0,5,"Braga",2,"Avenida Central",49,49,0,71,71,0
11,1,2018,9,0,5,"Braga",3,"Rua de Caires",25,25,0,4,4,0
11,1,2018,9,0,5,"Braga",4,"N14 Bosch",47,47,0,48,48,0
11,1,2018,9,0,5,"Braga",5,"Avenida João Paulo II",39,39,0,9,9,0
11,1,2018,9,0,5,"Braga",6,"Avenida Padre Júlio Fragata",67,67,0,83,83,0
11,1,2018,9,0,5,"Braga",7,"Rua Nova Santa Cruz",44,44,0,39,39,0
11,1,2018,9,0,5,"Braga",8,"Rua Costa Gomes",41,41,0,42,42,0
11,1,2018,10,0,5,"Braga",1,"Avenida da Liberdade",13,13,0,60,60,0
11,1,2018,10,0,5,"Braga",2,"Avenida Central",49,49,0,71,71,0
11,1,2018,10,0,5,"Braga",3,"Rua de Caires",25,25,0,4,4,0
11,1,2018,10,0,5,"Braga",4,"N14 Bosch",47,47,0,48,48,0
11,1,2018,10,0,5,"Braga",5,"Avenida João Paulo II",39,39,0,9,9,0
11,1,2018,10,0,5,"Braga",6,"Avenida Padre Júlio Fragata",67,67,0,83,83,0
11,1,2018,10,0,5,"Braga",7,"Rua Nova Santa Cruz",44,44,0,39,39,0
11,1,2018,10,0,5,"Braga",8,"Rua Costa Gomes",41,41,0,42,42,0
11,1,2018,11,0,5,"Braga",1,"Avenida da Liberdade",13,13,0,60,60,0
11,1,2018,11,0,5,"Braga",2,"Avenida Central",49,49,0,71,71,0
11,1,2018,11,0,5,"Braga",3,"Rua de Caires",19,25,6,5,4,1
11,1,2018,11,0,5,"Braga",4,"N14 Bosch",47,47,0,48,48,0
11,1,2018,11,0,5,"Braga",5,"Avenida João Paulo II",39,39,0,9,9,0
11,1,2018,11,0,5,"Braga",6,"Avenida Padre Júlio Fragata",67,67,0,83,83,0
11,1,2018,11,0,5,"Braga",7,"Rua Nova Santa Cruz",44,44,0,39,39,0
11,1,2018,11,0,5,"Braga",8,"Rua Costa Gomes",22,41,19,79,42,37
11,1,2018,12,0,5,"Braga",1,"Avenida da Liberdade",13,13,0,60,60,0
11,1,2018,12,0,5,"Braga",2,"Avenida Central",49,49,0,71,71,0
11,1,2018,12,0,5,"Braga",3,"Rua de Caires",25,25,0,4,4,0
11,1,2018,12,0,5,"Braga",4,"N14 Bosch",35,47,12,64,48,16
11,1,2018,12,0,5,"Braga",5,"Avenida João Paulo II",27,39,12,13,9,4
11,1,2018,12,0,5,"Braga",6,"Avenida Padre Júlio Fragata",67,67,0,83,83,0
11,1,2018,12,0,5,"Braga",7,"Rua Nova Santa Cruz",44,44,0,39,39,0
11,1,2018,12,0,5,"Braga",8,"Rua Costa Gomes",32,41,9,54,42,12
11,1,2018,13,0,5,"Braga",1,"Avenida da Liberdade",13,13,0,60,60,0
11,1,2018,13,0,5,"Braga",2,"Avenida Central",49,49,0,71,71,0
11,1,2018,13,0,5,"Braga",3,"Rua de Caires",25,25,0,4,4,0
11,1,2018,13,0,5,"Braga",4,"N14 Bosch",47,47,0,48,48,0
11,1,2018,13,0,5,"Braga",5,"Avenida João Paulo II",39,39,0,9,9,0
11,1,2018,13,0,5,"Braga",6,"Avenida Padre Júlio Fragata",67,67,0,83,83,0
11,1,2018,13,0,5,"Braga",7,"Rua Nova Santa Cruz",44,44,0,39,39,0
11,1,2018,13,0,5,"Braga",8,"Rua Costa Gomes",41,41,0,42,42,0
11,1,2018,14,0,5,"Braga",1,"Avenida da Liberdade",13,13,0,60,60,0
11,1,2018,14,0,5,"Braga",2,"Avenida Central",49,49,0,71,71,0
11,1,2018,14,0,5,"Braga",3,"Rua de Caires",25,25,0,4,4,0
11,1,2018,14,0,5,"Braga",4,"N14 Bosch",47,47,0,48,48,0
11,1,2018,14,0,5,"Braga",5,"Avenida João Paulo II",39,39,0,9,9,0
11,1,2018,14,0,5,"Braga",6,"Avenida Padre Júlio Fragata",67,67,0,83,83,0
11,1,2018,14,0,5,"Braga",7,"Rua Nova Santa Cruz",44,44,0,39,39,0
11,1,2018,14,0,5,"Braga",8,"Rua Costa Gomes",41,41,0,42,42,0
11,1,2018,15,0,5,"Braga",1,"Avenida da Liberdade",13,13,0,60,60,0
11,1,2018,15,0,5,"Braga",2,"Avenida Central",49,49,0,71,71,0
11,1,2018,15,0,5,"Braga",3,"Rua de Caires",25,25,0,4,4,0
11,1,2018,15,0,5,"Braga",4,"N14 Bosch",47,47,0,48,48,0
11,1,2018,15,0,5,"Braga",5,"Avenida João Paulo II",27,39,12,13,9,4
11,1,2018,15,0,5,"Braga",6,"Avenida Padre Júlio Fragata",67,67,0,83,83,0
11,1,2018,15,0,5,"Braga",7,"Rua Nova Santa Cruz",44,44,0,39,39,0
11,1,2018,15,0,5,"Braga",8,"Rua Costa Gomes",18,41,23,96,42,54
11,1,2018,16,0,5,"Braga",1,"Avenida da Liberdade",13,13,0,60,60,0
11,1,2018,16,0,5,"Braga",2,"Avenida Central",49,49,0,71,71,0
11,1,2018,16,0,5,"Braga",3,"Rua de Caires",25,25,0,4,4,0
11,1,2018,16,0,5,"Braga",4,"N14 Bosch",47,47,0,48,48,0
11,1,2018,16,0,5,"Braga",5,"Avenida João Paulo II",25,39,14,14,9,5
11,1,2018,16,0,5,"Braga",6,"Avenida Padre Júlio Fragata",67,67,0,83,83,0
11,1,2018,16,0,5,"Braga",7,"Rua Nova Santa Cruz",44,44,0,39,39,0
11,1,2018,16,0,5,"Braga",8,"Rua Costa Gomes",31,41,10,56,42,14
11,1,2018,17,0,5,"Braga",1,"Avenida da Liberdade",13,13,0,60,60,0
11,1,2018,17,0,5,"Braga",2,"Avenida Central",49,49,0,71,71,0
11,1,2018,17,0,5,"Braga",3,"Rua de Caires",25,25,0,4,4,0
11,1,2018,17,0,5,"Braga",4,"N14 Bosch",47,47,0,48,48,0
11,1,2018,17,0,5,"Braga",5,"Avenida João Paulo II",16,39,23,22,9,13
11,1,2018,17,0,5,"Braga",6,"Avenida Padre Júlio Fragata",25,62,37,51,21,30
11,1,2018,17,0,5,"Braga",7,"Rua Nova Santa Cruz",19,44,25,91,39,52
11,1,2018,17,0,5,"Braga",8,"Rua Costa Gomes",41,41,0,42,42,0
11,1,2018,18,0,5,"Braga",1,"Avenida da Liberdade",13,13,0,60,60,0
11,1,2018,18,0,5,"Braga",2,"Avenida Central",49,49,0,71,71,0
11,1,2018,18,0,5,"Braga",3,"Rua de Caires",16,25,9,7,4,3
11,1,2018,18,0,5,"Braga",4,"N14 Bosch",47,47,0,48,48,0
11,1,2018,18,0,5,"Braga",5,"Avenida João Paulo II",28,39,11,12,9,3
11,1,2018,18,0,5,"Braga",6,"Avenida Padre Júlio Fragata",34,62,28,38,21,17
11,1,2018,18,0,5,"Braga",7,"Rua Nova Santa Cruz",24,44,20,72,39,33
11,1,2018,18,0,5,"Braga",8,"Rua Costa Gomes",25,41,16,69,42,27
11,1,2018,19,0,5,"Braga",1,"Avenida da Liberdade",13,13,0,60,60,0
11,1,2018,19,0,5,"Braga",2,"Avenida Central",49,49,0,71,71,0
11,1,2018,19,0,5,"Braga",3,"Rua de Caires",19,25,6,5,4,1
11,1,2018,19,0,5,"Braga",4,"N14 Bosch",47,47,0,48,48,0
11,1,2018,19,0,5,"Braga",5,"Avenida João Paulo II",39,39,0,9,9,0
11,1,2018,19,0,5,"Braga",6,"Avenida Padre Júlio Fragata",29,62,33,44,21,23
11,1,2018,19,0,5,"Braga",7,"Rua Nova Santa Cruz",44,44,0,39,39,0
11,1,2018,19,0,5,"Braga",8,"Rua Costa Gomes",22,41,19,79,42,37
11,1,2018,20,0,5,"Braga",1,"Avenida da Liberdade",13,13,0,60,60,0
11,1,2018,20,0,5,"Braga",2,"Avenida Central",49,49,0,71,71,0
11,1,2018,20,0,5,"Braga",3,"Rua de Caires",25,25,0,4,4,0
11,1,2018,20,0,5,"Braga",4,"N14 Bosch",47,47,0,48,48,0
11,1,2018,20,0,5,"Braga",5,"Avenida João Paulo II",39,39,0,9,9,0
11,1,2018,20,0,5,"Braga",6,"Avenida Padre Júlio Fragata",44,62,18,29,21,8
11,1,2018,20,0,5,"Braga",7,"Rua Nova Santa Cruz",44,44,0,39,39,0
11,1,2018,20,0,5,"Braga",8,"Rua Costa Gomes",28,41,13,62,42,20
11,1,2018,21,0,5,"Braga",1,"Avenida da Liberdade",13,13,0,60,60,0
11,1,2018,21,0,5,"Braga",2,"Avenida Central",49,49,0,71,71,0
11,1,2018,21,0,5,"Braga",3,"Rua de Caires",25,25,0,4,4,0
11,1,2018,21,0,5,"Braga",4,"N14 Bosch",47,47,0,48,48,0
11,1,2018,21,0,5,"Braga",5,"Avenida João Paulo II",39,39,0,9,9,0
11,1,2018,21,0,5,"Braga",6,"Avenida Padre Júlio Fragata",42,62,20,31,21,10
11,1,2018,21,0,5,"Braga",7,"Rua Nova Santa Cruz",44,44,0,39,39,0
11,1,2018,21,0,5,"Braga",8,"Rua Costa Gomes",41,41,0,42,42,0
11,1,2018,22,0,5,"Braga",1,"Avenida da Liberdade",8,13,5,97,60,37
11,1,2018,22,0,5,"Braga",2,"Avenida Central",49,49,0,71,71,0
11,1,2018,22,0,5,"Braga",3,"Rua de Caires",25,25,0,4,4,0
11,1,2018,22,0,5,"Braga",4,"N14 Bosch",47,47,0,48,48,0
11,1,2018,22,0,5,"Braga",5,"Avenida João Paulo II",39,39,0,9,9,0
11,1,2018,22,0,5,"Braga",6,"Avenida Padre Júlio Fragata",41,62,21,31,21,10
11,1,2018,22,0,5,"Braga",7,"Rua Nova Santa Cruz",44,44,0,39,39,0
11,1,2018,22,0,5,"Braga",8,"Rua Costa Gomes",41,41,0,42,42,0
11,1,2018,23,0,5,"Braga",1,"Avenida da Liberdade",13,13,0,60,60,0
11,1,2018,23,0,5,"Braga",2,"Avenida Central",49,49,0,71,71,0
11,1,2018,23,0,5,"Braga",3,"Rua de Caires",25,25,0,4,4,0
11,1,2018,23,0,5,"Braga",4,"N14 Bosch",47,47,0,48,48,0
11,1,2018,23,0,5,"Braga",5,"Avenida João Paulo II",39,39,0,9,9,0
11,1,2018,23,0,5,"Braga",6,"Avenida Padre Júlio Fragata",30,62,32,43,21,22
11,1,2018,23,0,5,"Braga",7,"Rua Nova Santa Cruz",44,44,0,39,39,0
11,1,2018,23,0,5,"Braga",8,"Rua Costa Gomes",41,41,0,42,42,0
11,2,2018,0,0,6,"Braga",1,"Avenida da Liberdade",13,13,0,60,60,0
11,2,2018,0,0,6,"Braga",2,"Avenida Central",19,49,30,182,71,111
11,2,2018,0,0,6,"Braga",3,"Rua de Caires",25,25,0,4,4,0
11,2,2018,0,0,6,"Braga",4,"N14 Bosch",47,47,0,48,48,0
11,2,2018,0,0,6,"Braga",5,"Avenida João Paulo II",39,39,0,9,9,0
11,2,2018,0,0,6,"Braga",6,"Avenida Padre Júlio Fragata",62,62,0,21,21,0
11,2,2018,0,0,6,"Braga",7,"Rua Nova Santa Cruz",44,44,0,39,39,0
11,2,2018,0,0,6,"Braga",8,"Rua Costa Gomes",41,41,0,42,42,0
11,2,2018,1,0,6,"Braga",1,"Avenida da Liberdade",13,13,0,60,60,0
11,2,2018,1,0,6,"Braga",2,"Avenida Central",49,49,0,71,71,0
11,2,2018,1,0,6,"Braga",3,"Rua de Caires",25,25,0,4,4,0
11,2,2018,1,0,6,"Braga",4,"N14 Bosch",47,47,0,48,48,0
11,2,2018,1,0,6,"Braga",5,"Avenida João Paulo II",39,39,0,9,9,0
11,2,2018,1,0,6,"Braga",6,"Avenida Padre Júlio Fragata",62,62,0,21,21,0
11,2,2018,1,0,6,"Braga",7,"Rua Nova Santa Cruz",44,44,0,39,39,0
11,2,2018,1,0,6,"Braga",8,"Rua Costa Gomes",41,41,0,42,42,0
11,2,2018,2,0,6,"Braga",1,"Avenida da Liberdade",13,13,0,60,60,0
11,2,2018,2,0,6,"Braga",2,"Avenida Central",49,49,0,71,71,0
11,2,2018,2,0,6,"Braga",3,"Rua de Caires",25,25,0,4,4,0
11,2,2018,2,0,6,"Braga",4,"N14 Bosch",47,47,0,48,48,0
11,2,2018,2,0,6,"Braga",5,"Avenida João Paulo II",39,39,0,9,9,0
11,2,2018,2,0,6,"Braga",6,"Avenida Padre Júlio Fragata",62,62,0,21,21,0
11,2,2018,2,0,6,"Braga",7,"Rua Nova Santa Cruz",44,44,0,39,39,0
11,2,2018,2,0,6,"Braga",8,"Rua Costa Gomes",41,41,0,42,42,0
11,2,2018,3,0,6,"Braga",1,"Avenida da Liberdade",13,13,0,60,60,0
11,2,2018,3,0,6,"Braga",2,"Avenida Central",49,49,0,71,71,0
11,2,2018,3,0,6,"Braga",3,"Rua de Caires",25,25,0,4,4,0
11,2,2018,3,0,6,"Braga",4,"N14 Bosch",47,47,0,48,48,0
11,2,2018,3,0,6,"Braga",5,"Avenida João Paulo II",39,39,0,9,9,0
11,2,2018,3,0,6,"Braga",6,"Avenida Padre Júlio Fragata",62,62,0,21,21,0
11,2,2018,3,0,6,"Braga",7,"Rua Nova Santa Cruz",44,44,0,39,39,0
11,2,2018,3,0,6,"Braga",8,"Rua Costa Gomes",41,41,0,42,42,0
11,2,2018,4,0,6,"Braga",1,"Avenida da Liberdade",13,13,0,60,60,0
11,2,2018,4,0,6,"Braga",2,"Avenida Central",49,49,0,71,71,0
11,2,2018,4,0,6,"Braga",3,"Rua de Caires",25,25,0,4,4,0
11,2,2018,4,0,6,"Braga",4,"N14 Bosch",47,47,0,48,48,0
11,2,2018,4,0,6,"Braga",5,"Avenida João Paulo II",39,39,0,9,9,0
11,2,2018,4,0,6,"Braga",6,"Avenida Padre Júlio Fragata",62,62,0,21,21,0
11,2,2018,4,0,6,"Braga",7,"Rua Nova Santa Cruz",44,44,0,39,39,0
11,2,2018,4,0,6,"Braga",8,"Rua Costa Gomes",41,41,0,42,42,0
11,2,2018,5,0,6,"Braga",1,"Avenida da Liberdade",13,13,0,60,60,0
11,2,2018,5,0,6,"Braga",2,"Avenida Central",49,49,0,71,71,0
11,2,2018,5,0,6,"Braga",3,"Rua de Caires",25,25,0,4,4,0
11,2,2018,5,0,6,"Braga",4,"N14 Bosch",47,47,0,48,48,0
11,2,2018,5,0,6,"Braga",5,"Avenida João Paulo II",39,39,0,9,9,0
11,2,2018,5,0,6,"Braga",6,"Avenida Padre Júlio Fragata",62,62,0,21,21,0
11,2,2018,5,0,6,"Braga",7,"Rua Nova Santa Cruz",44,44,0,39,39,0
11,2,2018,5,0,6,"Braga",8,"Rua Costa Gomes",41,41,0,42,42,0
11,2,2018,6,0,6,"Braga",1,"Avenida da Liberdade",13,13,0,60,60,0
11,2,2018,6,0,6,"Braga",2,"Avenida Central",49,49,0,71,71,0
11,2,2018,6,0,6,"Braga",3,"Rua de Caires",25,25,0,4,4,0
11,2,2018,6,0,6,"Braga",4,"N14 Bosch",47,47,0,48,48,0
11,2,2018,6,0,6,"Braga",5,"Avenida João Paulo II",39,39,0,9,9,0
11,2,2018,6,0,6,"Braga",6,"Avenida Padre Júlio Fragata",62,62,0,21,21,0
11,2,2018,6,0,6,"Braga",7,"Rua Nova Santa Cruz",44,44,0,39,39,0
11,2,2018,6,0,6,"Braga",8,"Rua Costa Gomes",41,41,0,42,42,0
11,2,2018,7,0,6,"Braga",1,"Avenida da Liberdade",9,13,4,86,60,26
11,2,2018,7,0,6,"Braga",2,"Avenida Central",49,49,0,71,71,0
11,2,2018,7,0,6,"Braga",3,"Rua de Caires",25,25,0,4,4,0
11,2,2018,7,0,6,"Braga",4,"N14 Bosch",47,47,0,48,48,0
11,2,2018,7,0,6,"Braga",5,"Avenida João Paulo II",39,39,0,9,9,0
11,2,2018,7,0,6,"Braga",6,"Avenida Padre Júlio Fragata",62,62,0,21,21,0
11,2,2018,7,0,6,"Braga",7,"Rua Nova Santa Cruz",44,44,0,39,39,0
11,2,2018,7,0,6,"Braga",8,"Rua Costa Gomes",41,41,0,42,42,0
11,2,2018,8,0,6,"Braga",1,"Avenida da Liberdade",10,13,3,78,60,18
11,2,2018,8,0,6,"Braga",2,"Avenida Central",49,49,0,71,71,0
11,2,2018,8,0,6,"Braga",3,"Rua de Caires",25,25,0,4,4,0
11,2,2018,8,0,6,"Braga",4,"N14 Bosch",30,47,17,75,48,27
11,2,2018,8,0,6,"Braga",5,"Avenida João Paulo II",39,39,0,9,9,0
11,2,2018,8,0,6,"Braga",6,"Avenida Padre Júlio Fragata",62,62,0,21,21,0
11,2,2018,8,0,6,"Braga",7,"Rua Nova Santa Cruz",44,44,0,39,39,0
11,2,2018,8,0,6,"Braga",8,"Rua Costa Gomes",41,41,0,42,42,0
11,2,2018,9,0,6,"Braga",1,"Avenida da Liberdade",13,13,0,60,60,0
11,2,2018,9,0,6,"Braga",2,"Avenida Central",49,49,0,71,71,0
11,2,2018,9,0,6,"Braga",3,"Rua de Caires",25,25,0,4,4,0
11,2,2018,9,0,6,"Braga",4,"N14 Bosch",23,47,24,98,48,50
11,2,2018,9,0,6,"Braga",5,"Avenida João Paulo II",26,39,13,13,9,4
11,2,2018,9,0,6,"Braga",6,"Avenida Padre Júlio Fragata",31,62,31,41,21,20
11,2,2018,9,0,6,"Braga",7,"Rua Nova Santa Cruz",28,44,16,62,39,23
11,2,2018,9,0,6,"Braga",8,"Rua Costa Gomes",27,41,14,64,42,22
11,2,2018,10,0,6,"Braga",1,"Avenida da Liberdade",13,13,0,60,60,0
11,2,2018,10,0,6,"Braga",2,"Avenida Central",49,49,0,71,71,0
11,2,2018,10,0,6,"Braga",3,"Rua de Caires",25,25,0,4,4,0
11,2,2018,10,0,6,"Braga",4,"N14 Bosch",21,47,26,107,48,59
11,2,2018,10,0,6,"Braga",5,"Avenida João Paulo II",39,39,0,9,9,0
11,2,2018,10,0,6,"Braga",6,"Avenida Padre Júlio Fragata",62,62,0,21,21,0
11,2,2018,10,0,6,"Braga",7,"Rua Nova Santa Cruz",44,44,0,39,39,0
11,2,2018,10,0,6,"Braga",8,"Rua Costa Gomes",41,41,0,42,42,0
11,2,2018,11,0,6,"Braga",1,"Avenida da Liberdade",13,13,0,60,60,0
11,2,2018,11,0,6,"Braga",2,"Avenida Central",49,49,0,71,71,0
11,2,2018,11,0,6,"Braga",3,"Rua de Caires",25,25,0,4,4,0
11,2,2018,11,0,6,"Braga",4,"N14 Bosch",24,47,23,94,48,46
11,2,2018,11,0,6,"Braga",5,"Avenida João Paulo II",16,39,23,22,9,13
11,2,2018,11,0,6,"Braga",6,"Avenida Padre Júlio Fragata",48,62,14,27,21,6
11,2,2018,11,0,6,"Braga",7,"Rua Nova Santa Cruz",44,44,0,39,39,0
11,2,2018,11,0,6,"Braga",8,"Rua Costa Gomes",21,41,20,82,42,40
11,2,2018,12,0,6,"Braga",1,"Avenida da Liberdade",13,13,0,60,60,0
11,2,2018,12,0,6,"Braga",2,"Avenida Central",49,49,0,71,71,0
11,2,2018,12,0,6,"Braga",3,"Rua de Caires",18,25,7,6,4,2
11,2,2018,12,0,6,"Braga",4,"N14 Bosch",37,47,10,61,48,13
11,2,2018,12,0,6,"Braga",5,"Avenida João Paulo II",39,39,0,9,9,0
11,2,2018,12,0,6,"Braga",6,"Avenida Padre Júlio Fragata",62,62,0,21,21,0
11,2,2018,12,0,6,"Braga",7,"Rua Nova Santa Cruz",44,44,0,39,39,0
11,2,2018,12,0,6,"Braga",8,"Rua Costa Gomes",32,41,9,54,42,12
11,2,2018,13,0,6,"Braga",1,"Avenida da Liberdade",13,13,0,60,60,0
11,2,2018,13,0,6,"Braga",2,"Avenida Central",49,49,0,71,71,0
11,2,2018,13,0,6,"Braga",3,"Rua de Caires",25,25,0,4,4,0
11,2,2018,13,0,6,"Braga",4,"N14 Bosch",47,47,0,48,48,0
11,2,2018,13,0,6,"Braga",5,"Avenida João Paulo II",31,39,8,11,9,2
11,2,2018,13,0,6,"Braga",6,"Avenida Padre Júlio Fragata",62,62,0,21,21,0
11,2,2018,13,0,6,"Braga",7,"Rua Nova Santa Cruz",19,44,25,91,39,52
11,2,2018,13,0,6,"Braga",8,"Rua Costa Gomes",32,41,9,54,42,12
11,2,2018,14,0,6,"Braga",1,"Avenida da Liberdade",13,13,0,60,60,0
11,2,2018,14,0,6,"Braga",2,"Avenida Central",49,49,0,71,71,0
11,2,2018,14,0,6,"Braga",3,"Rua de Caires",25,25,0,4,4,0
11,2,2018,14,0,6,"Braga",4,"N14 Bosch",47,47,0,48,48,0
11,2,2018,14,0,6,"Braga",5,"Avenida João Paulo II",39,39,0,9,9,0
11,2,2018,14,0,6,"Braga",6,"Avenida Padre Júlio Fragata",62,62,0,21,21,0
11,2,2018,14,0,6,"Braga",7,"Rua Nova Santa Cruz",8,44,36,216,39,177
11,2,2018,14,0,6,"Braga",8,"Rua Costa Gomes",21,41,20,82,42,40
11,2,2018,15,0,6,"Braga",1,"Avenida da Liberdade",13,13,0,60,60,0
11,2,2018,15,0,6,"Braga",2,"Avenida Central",37,49,12,94,71,23
11,2,2018,15,0,6,"Braga",3,"Rua de Caires",25,25,0,4,4,0
11,2,2018,15,0,6,"Braga",4,"N14 Bosch",11,47,36,204,48,156
11,2,2018,15,0,6,"Braga",5,"Avenida João Paulo II",30,39,9,12,9,3
11,2,2018,15,0,6,"Braga",6,"Avenida Padre Júlio Fragata",43,62,19,30,21,9
11,2,2018,15,0,6,"Braga",7,"Rua Nova Santa Cruz",44,44,0,39,39,0
11,2,2018,15,0,6,"Braga",8,"Rua Costa Gomes",41,41,0,42,42,0
11,2,2018,16,0,6,"Braga",1,"Avenida da Liberdade",13,13,0,60,60,0
11,2,2018,16,0,6,"Braga",2,"Avenida Central",49,49,0,71,71,0
11,2,2018,16,0,6,"Braga",3,"Rua de Caires",19,25,6,5,4,1
11,2,2018,16,0,6,"Braga",4,"N14 Bosch",22,47,25,102,48,54
11,2,2018,16,0,6,"Braga",5,"Avenida João Paulo II",9,39,30,39,9,30
11,2,2018,16,0,6,"Braga",6,"Avenida Padre Júlio Fragata",41,62,21,31,21,10
11,2,2018,16,0,6,"Braga",7,"Rua Nova Santa Cruz",44,44,0,39,39,0
11,2,2018,16,0,6,"Braga",8,"Rua Costa Gomes",41,41,0,42,42,0
11,2,2018,17,0,6,"Braga",1,"Avenida da Liberdade",13,13,0,60,60,0
11,2,2018,17,0,6,"Braga",2,"Avenida Central",38,49,11,91,71,20
11,2,2018,17,0,6,"Braga",3,"Rua de Caires",25,25,0,4,4,0
11,2,2018,17,0,6,"Braga",4,"N14 Bosch",16,47,31,140,48,92
11,2,2018,17,0,6,"Braga",5,"Avenida João Paulo II",13,39,26,27,9,18
11,2,2018,17,0,6,"Braga",6,"Avenida Padre Júlio Fragata",32,62,30,40,21,19
11,2,2018,17,0,6,"Braga",7,"Rua Nova Santa Cruz",25,44,19,69,39,30
11,2,2018,17,0,6,"Braga",8,"Rua Costa Gomes",41,41,0,42,42,0
11,2,2018,18,0,6,"Braga",1,"Avenida da Liberdade",13,13,0,60,60,0
11,2,2018,18,0,6,"Braga",2,"Avenida Central",34,49,15,102,71,31
11,2,2018,18,0,6,"Braga",3,"Rua de Caires",20,25,5,5,4,1
11,2,2018,18,0,6,"Braga",4,"N14 Bosch",15,47,32,150,48,102
11,2,2018,18,0,6,"Braga",5,"Avenida João Paulo II",21,39,18,17,9,8
11,2,2018,18,0,6,"Braga",6,"Avenida Padre Júlio Fragata",21,62,41,61,21,40
11,2,2018,18,0,6,"Braga",7,"Rua Nova Santa Cruz",44,44,0,39,39,0
11,2,2018,18,0,6,"Braga",8,"Rua Costa Gomes",15,41,26,115,42,73
11,2,2018,19,0,6,"Braga",1,"Avenida da Liberdade",13,13,0,60,60,0
11,2,2018,19,0,6,"Braga",2,"Avenida Central",37,49,12,94,71,23
11,2,2018,19,0,6,"Braga",3,"Rua de Caires",10,25,15,10,4,6
11,2,2018,19,0,6,"Braga",4,"N14 Bosch",47,47,0,48,48,0
11,2,2018,19,0,6,"Braga",5,"Avenida João Paulo II",39,39,0,9,9,0
11,2,2018,19,0,6,"Braga",6,"Avenida Padre Júlio Fragata",41,62,21,31,21,10
11,2,2018,19,0,6,"Braga",7,"Rua Nova Santa Cruz",22,44,22,79,39,40
11,2,2018,19,0,6,"Braga",8,"Rua Costa Gomes",5,41,36,346,42,304
11,2,2018,20,0,6,"Braga",1,"Avenida da Liberdade",13,13,0,60,60,0
11,2,2018,20,0,6,"Braga",2,"Avenida Central",49,49,0,71,71,0
11,2,2018,20,0,6,"Braga",3,"Rua de Caires",15,25,10,7,4,3
11,2,2018,20,0,6,"Braga",4,"N14 Bosch",32,47,15,70,48,22
11,2,2018,20,0,6,"Braga",5,"Avenida João Paulo II",39,39,0,9,9,0
11,2,2018,20,0,6,"Braga",6,"Avenida Padre Júlio Fragata",47,62,15,27,21,6
11,2,2018,20,0,6,"Braga",7,"Rua Nova Santa Cruz",44,44,0,39,39,0
11,2,2018,20,0,6,"Braga",8,"Rua Costa Gomes",28,41,13,62,42,20
11,2,2018,21,0,6,"Braga",1,"Avenida da Liberdade",13,13,0,60,60,0
11,2,2018,21,0,6,"Braga",2,"Avenida Central",49,49,0,71,71,0
11,2,2018,21,0,6,"Braga",3,"Rua de Caires",25,25,0,4,4,0
11,2,2018,21,0,6,"Braga",4,"N14 Bosch",47,47,0,48,48,0
11,2,2018,21,0,6,"Braga",5,"Avenida João Paulo II",39,39,0,9,9,0
11,2,2018,21,0,6,"Braga",6,"Avenida Padre Júlio Fragata",62,62,0,21,21,0
11,2,2018,21,0,6,"Braga",7,"Rua Nova Santa Cruz",44,44,0,39,39,0
11,2,2018,21,0,6,"Braga",8,"Rua Costa Gomes",41,41,0,42,42,0
11,2,2018,22,0,6,"Braga",1,"Avenida da Liberdade",13,13,0,60,60,0
11,2,2018,22,0,6,"Braga",2,"Avenida Central",49,49,0,71,71,0
11,2,2018,22,0,6,"Braga",3,"Rua de Caires",25,25,0,4,4,0
11,2,2018,22,0,6,"Braga",4,"N14 Bosch",47,47,0,48,48,0
11,2,2018,22,0,6,"Braga",5,"Avenida João Paulo II",39,39,0,9,9,0
11,2,2018,22,0,6,"Braga",6,"Avenida Padre Júlio Fragata",44,62,18,29,21,8
11,2,2018,22,0,6,"Braga",7,"Rua Nova Santa Cruz",44,44,0,39,39,0
11,2,2018,22,0,6,"Braga",8,"Rua Costa Gomes",41,41,0,42,42,0
11,2,2018,23,0,6,"Braga",1,"Avenida da Liberdade",13,13,0,60,60,0
11,2,2018,23,0,6,"Braga",2,"Avenida Central",49,49,0,71,71,0
11,2,2018,23,0,6,"Braga",3,"Rua de Caires",25,25,0,4,4,0
11,2,2018,23,0,6,"Braga",4,"N14 Bosch",47,47,0,48,48,0
11,2,2018,23,0,6,"Braga",5,"Avenida João Paulo II",39,39,0,9,9,0
11,2,2018,23,0,6,"Braga",6,"Avenida Padre Júlio Fragata",62,62,0,21,21,0
11,2,2018,23,0,6,"Braga",7,"Rua Nova Santa Cruz",44,44,0,39,39,0
11,2,2018,23,0,6,"Braga",8,"Rua Costa Gomes",41,41,0,42,42,0
11,3,2018,0,0,7,"Braga",1,"Avenida da Liberdade",13,13,0,60,60,0
11,3,2018,0,0,7,"Braga",2,"Avenida Central",49,49,0,71,71,0
11,3,2018,0,0,7,"Braga",3,"Rua de Caires",25,25,0,4,4,0
11,3,2018,0,0,7,"Braga",4,"N14 Bosch",47,47,0,48,48,0
11,3,2018,0,0,7,"Braga",5,"Avenida João Paulo II",39,39,0,9,9,0
11,3,2018,0,0,7,"Braga",6,"Avenida Padre Júlio Fragata",62,62,0,21,21,0
11,3,2018,0,0,7,"Braga",7,"Rua Nova Santa Cruz",44,44,0,39,39,0
11,3,2018,0,0,7,"Braga",8,"Rua Costa Gomes",41,41,0,42,42,0
11,3,2018,1,0,7,"Braga",1,"Avenida da Liberdade",13,13,0,60,60,0
11,3,2018,1,0,7,"Braga",2,"Avenida Central",49,49,0,71,71,0
11,3,2018,1,0,7,"Braga",3,"Rua de Caires",25,25,0,4,4,0
11,3,2018,1,0,7,"Braga",4,"N14 Bosch",47,47,0,48,48,0
11,3,2018,1,0,7,"Braga",5,"Avenida João Paulo II",39,39,0,9,9,0
11,3,2018,1,0,7,"Braga",6,"Avenida Padre Júlio Fragata",62,62,0,21,21,0
11,3,2018,1,0,7,"Braga",7,"Rua Nova Santa Cruz",44,44,0,39,39,0
11,3,2018,1,0,7,"Braga",8,"Rua Costa Gomes",41,41,0,42,42,0
11,3,2018,2,0,7,"Braga",1,"Avenida da Liberdade",13,13,0,60,60,0
11,3,2018,2,0,7,"Braga",2,"Avenida Central",49,49,0,71,71,0
11,3,2018,2,0,7,"Braga",3,"Rua de Caires",25,25,0,4,4,0
11,3,2018,2,0,7,"Braga",4,"N14 Bosch",47,47,0,48,48,0
11,3,2018,2,0,7,"Braga",5,"Avenida João Paulo II",39,39,0,9,9,0
11,3,2018,2,0,7,"Braga",6,"Avenida Padre Júlio Fragata",62,62,0,21,21,0
11,3,2018,2,0,7,"Braga",7,"Rua Nova Santa Cruz",44,44,0,39,39,0
11,3,2018,2,0,7,"Braga",8,"Rua Costa Gomes",41,41,0,42,42,0
11,3,2018,3,0,7,"Braga",1,"Avenida da Liberdade",13,13,0,60,60,0
11,3,2018,3,0,7,"Braga",2,"Avenida Central",49,49,0,71,71,0
11,3,2018,3,0,7,"Braga",3,"Rua de Caires",25,25,0,4,4,0
11,3,2018,3,0,7,"Braga",4,"N14 Bosch",47,47,0,48,48,0
11,3,2018,3,0,7,"Braga",5,"Avenida João Paulo II",39,39,0,9,9,0
11,3,2018,3,0,7,"Braga",6,"Avenida Padre Júlio Fragata",62,62,0,21,21,0
11,3,2018,3,0,7,"Braga",7,"Rua Nova Santa Cruz",44,44,0,39,39,0
11,3,2018,3,0,7,"Braga",8,"Rua Costa Gomes",41,41,0,42,42,0
11,3,2018,4,0,7,"Braga",1,"Avenida da Liberdade",13,13,0,60,60,0
11,3,2018,4,0,7,"Braga",2,"Avenida Central",49,49,0,71,71,0
11,3,2018,4,0,7,"Braga",3,"Rua de Caires",25,25,0,4,4,0
11,3,2018,4,0,7,"Braga",4,"N14 Bosch",47,47,0,48,48,0
11,3,2018,4,0,7,"Braga",5,"Avenida João Paulo II",39,39,0,9,9,0
11,3,2018,4,0,7,"Braga",6,"Avenida Padre Júlio Fragata",62,62,0,21,21,0
11,3,2018,4,0,7,"Braga",7,"Rua Nova Santa Cruz",44,44,0,39,39,0
11,3,2018,4,0,7,"Braga",8,"Rua Costa Gomes",41,41,0,42,42,0
11,3,2018,5,0,7,"Braga",1,"Avenida da Liberdade",13,13,0,60,60,0
11,3,2018,5,0,7,"Braga",2,"Avenida Central",49,49,0,71,71,0
11,3,2018,5,0,7,"Braga",3,"Rua de Caires",25,25,0,4,4,0
11,3,2018,5,0,7,"Braga",4,"N14 Bosch",47,47,0,48,48,0
11,3,2018,5,0,7,"Braga",5,"Avenida João Paulo II",39,39,0,9,9,0
11,3,2018,5,0,7,"Braga",6,"Avenida Padre Júlio Fragata",62,62,0,21,21,0
11,3,2018,5,0,7,"Braga",7,"Rua Nova Santa Cruz",44,44,0,39,39,0
11,3,2018,5,0,7,"Braga",8,"Rua Costa Gomes",41,41,0,42,42,0
11,3,2018,6,0,7,"Braga",1,"Avenida da Liberdade",13,13,0,60,60,0
11,3,2018,6,0,7,"Braga",2,"Avenida Central",49,49,0,71,71,0
11,3,2018,6,0,7,"Braga",3,"Rua de Caires",25,25,0,4,4,0
11,3,2018,6,0,7,"Braga",4,"N14 Bosch",47,47,0,48,48,0
11,3,2018,6,0,7,"Braga",5,"Avenida João Paulo II",39,39,0,9,9,0
11,3,2018,6,0,7,"Braga",6,"Avenida Padre Júlio Fragata",62,62,0,21,21,0
11,3,2018,6,0,7,"Braga",7,"Rua Nova Santa Cruz",44,44,0,39,39,0
11,3,2018,6,0,7,"Braga",8,"Rua Costa Gomes",41,41,0,42,42,0
11,3,2018,7,0,7,"Braga",1,"Avenida da Liberdade",13,13,0,60,60,0
11,3,2018,7,0,7,"Braga",2,"Avenida Central",49,49,0,71,71,0
11,3,2018,7,0,7,"Braga",3,"Rua de Caires",25,25,0,4,4,0
11,3,2018,7,0,7,"Braga",4,"N14 Bosch",47,47,0,48,48,0
11,3,2018,7,0,7,"Braga",5,"Avenida João Paulo II",39,39,0,9,9,0
11,3,2018,7,0,7,"Braga",6,"Avenida Padre Júlio Fragata",62,62,0,21,21,0
11,3,2018,7,0,7,"Braga",7,"Rua Nova Santa Cruz",44,44,0,39,39,0
11,3,2018,7,0,7,"Braga",8,"Rua Costa Gomes",41,41,0,42,42,0
11,3,2018,8,0,7,"Braga",1,"Avenida da Liberdade",13,13,0,60,60,0
11,3,2018,8,0,7,"Braga",2,"Avenida Central",49,49,0,71,71,0
11,3,2018,8,0,7,"Braga",3,"Rua de Caires",25,25,0,4,4,0
11,3,2018,8,0,7,"Braga",4,"N14 Bosch",47,47,0,48,48,0
11,3,2018,8,0,7,"Braga",5,"Avenida João Paulo II",39,39,0,9,9,0
11,3,2018,8,0,7,"Braga",6,"Avenida Padre Júlio Fragata",62,62,0,21,21,0
11,3,2018,8,0,7,"Braga",7,"Rua Nova Santa Cruz",44,44,0,39,39,0
11,3,2018,8,0,7,"Braga",8,"Rua Costa Gomes",41,41,0,42,42,0
11,3,2018,9,0,7,"Braga",1,"Avenida da Liberdade",13,13,0,60,60,0
11,3,2018,9,0,7,"Braga",2,"Avenida Central",49,49,0,71,71,0
11,3,2018,9,0,7,"Braga",3,"Rua de Caires",25,25,0,4,4,0
11,3,2018,9,0,7,"Braga",4,"N14 Bosch",47,47,0,48,48,0
11,3,2018,9,0,7,"Braga",5,"Avenida João Paulo II",39,39,0,9,9,0
11,3,2018,9,0,7,"Braga",6,"Avenida Padre Júlio Fragata",62,62,0,21,21,0
11,3,2018,9,0,7,"Braga",7,"Rua Nova Santa Cruz",26,44,18,66,39,27
11,3,2018,9,0,7,"Braga",8,"Rua Costa Gomes",41,41,0,42,42,0
11,3,2018,10,0,7,"Braga",1,"Avenida da Liberdade",10,13,3,78,60,18
11,3,2018,10,0,7,"Braga",2,"Avenida Central",31,49,18,112,71,41
11,3,2018,10,0,7,"Braga",3,"Rua de Caires",25,25,0,4,4,0
11,3,2018,10,0,7,"Braga",4,"N14 Bosch",47,47,0,48,48,0
11,3,2018,10,0,7,"Braga",5,"Avenida João Paulo II",39,39,0,9,9,0
11,3,2018,10,0,7,"Braga",6,"Avenida Padre Júlio Fragata",62,62,0,21,21,0
11,3,2018,10,0,7,"Braga",7,"Rua Nova Santa Cruz",44,44,0,39,39,0
11,3,2018,10,0,7,"Braga",8,"Rua Costa Gomes",32,41,9,54,42,12
11,3,2018,11,0,7,"Braga",1,"Avenida da Liberdade",13,13,0,60,60,0
11,3,2018,11,0,7,"Braga",2,"Avenida Central",49,49,0,71,71,0
11,3,2018,11,0,7,"Braga",3,"Rua de Caires",25,25,0,4,4,0
11,3,2018,11,0,7,"Braga",4,"N14 Bosch",34,47,13,66,48,18
11,3,2018,11,0,7,"Braga",5,"Avenida João Paulo II",39,39,0,9,9,0
11,3,2018,11,0,7,"Braga",6,"Avenida Padre Júlio Fragata",48,62,14,27,21,6
11,3,2018,11,0,7,"Braga",7,"Rua Nova Santa Cruz",28,44,16,62,39,23
11,3,2018,11,0,7,"Braga",8,"Rua Costa Gomes",41,41,0,42,42,0
11,3,2018,12,0,7,"Braga",1,"Avenida da Liberdade",13,13,0,60,60,0
11,3,2018,12,0,7,"Braga",2,"Avenida Central",49,49,0,71,71,0
11,3,2018,12,0,7,"Braga",3,"Rua de Caires",25,25,0,4,4,0
11,3,2018,12,0,7,"Braga",4,"N14 Bosch",27,47,20,83,48,35
11,3,2018,12,0,7,"Braga",5,"Avenida João Paulo II",39,39,0,9,9,0
11,3,2018,12,0,7,"Braga",6,"Avenida Padre Júlio Fragata",48,62,14,27,21,6
11,3,2018,12,0,7,"Braga",7,"Rua Nova Santa Cruz",25,44,19,69,39,30
11,3,2018,12,0,7,"Braga",8,"Rua Costa Gomes",32,41,9,54,42,12
11,3,2018,13,0,7,"Braga",1,"Avenida da Liberdade",13,13,0,60,60,0
11,3,2018,13,0,7,"Braga",2,"Avenida Central",38,49,11,91,71,20
11,3,2018,13,0,7,"Braga",3,"Rua de Caires",25,25,0,4,4,0
11,3,2018,13,0,7,"Braga",4,"N14 Bosch",47,47,0,48,48,0
11,3,2018,13,0,7,"Braga",5,"Avenida João Paulo II",30,39,9,12,9,3
11,3,2018,13,0,7,"Braga",6,"Avenida Padre Júlio Fragata",48,62,14,27,21,6
11,3,2018,13,0,7,"Braga",7,"Rua Nova Santa Cruz",44,44,0,39,39,0
11,3,2018,13,0,7,"Braga",8,"Rua Costa Gomes",41,41,0,42,42,0
11,3,2018,14,0,7,"Braga",1,"Avenida da Liberdade",13,13,0,60,60,0
11,3,2018,14,0,7,"Braga",2,"Avenida Central",49,49,0,71,71,0
11,3,2018,14,0,7,"Braga",3,"Rua de Caires",25,25,0,4,4,0
11,3,2018,14,0,7,"Braga",4,"N14 Bosch",36,47,11,62,48,14
11,3,2018,14,0,7,"Braga",5,"Avenida João Paulo II",39,39,0,9,9,0
11,3,2018,14,0,7,"Braga",6,"Avenida Padre Júlio Fragata",49,62,13,26,21,5
11,3,2018,14,0,7,"Braga",7,"Rua Nova Santa Cruz",44,44,0,39,39,0
11,3,2018,14,0,7,"Braga",8,"Rua Costa Gomes",41,41,0,42,42,0
11,3,2018,15,0,7,"Braga",1,"Avenida da Liberdade",13,13,0,60,60,0
11,3,2018,15,0,7,"Braga",2,"Avenida Central",38,49,11,91,71,20
11,3,2018,15,0,7,"Braga",3,"Rua de Caires",25,25,0,4,4,0
11,3,2018,15,0,7,"Braga",4,"N14 Bosch",47,47,0,48,48,0
11,3,2018,15,0,7,"Braga",5,"Avenida João Paulo II",28,39,11,12,9,3
11,3,2018,15,0,7,"Braga",6,"Avenida Padre Júlio Fragata",41,62,21,31,21,10
11,3,2018,15,0,7,"Braga",7,"Rua Nova Santa Cruz",44,44,0,39,39,0
11,3,2018,15,0,7,"Braga",8,"Rua Costa Gomes",41,41,0,42,42,0
11,3,2018,16,0,7,"Braga",1,"Avenida da Liberdade",13,13,0,60,60,0
11,3,2018,16,0,7,"Braga",2,"Avenida Central",49,49,0,71,71,0
11,3,2018,16,0,7,"Braga",3,"Rua de Caires",25,25,0,4,4,0
11,3,2018,16,0,7,"Braga",4,"N14 Bosch",34,47,13,66,48,18
11,3,2018,16,0,7,"Braga",5,"Avenida João Paulo II",20,39,19,17,9,8
11,3,2018,16,0,7,"Braga",6,"Avenida Padre Júlio Fragata",34,62,28,38,21,17
11,3,2018,16,0,7,"Braga",7,"Rua Nova Santa Cruz",44,44,0,39,39,0
11,3,2018,16,0,7,"Braga",8,"Rua Costa Gomes",41,41,0,42,42,0
11,3,2018,17,0,7,"Braga",1,"Avenida da Liberdade",13,13,0,60,60,0
11,3,2018,17,0,7,"Braga",2,"Avenida Central",49,49,0,71,71,0
11,3,2018,17,0,7,"Braga",3,"Rua de Caires",25,25,0,4,4,0
11,3,2018,17,0,7,"Braga",4,"N14 Bosch",47,47,0,48,48,0
11,3,2018,17,0,7,"Braga",5,"Avenida João Paulo II",39,39,0,9,9,0
11,3,2018,17,0,7,"Braga",6,"Avenida Padre Júlio Fragata",38,62,24,34,21,13
11,3,2018,17,0,7,"Braga",7,"Rua Nova Santa Cruz",44,44,0,39,39,0
11,3,2018,17,0,7,"Braga",8,"Rua Costa Gomes",41,41,0,42,42,0
11,3,2018,18,0,7,"Braga",1,"Avenida da Liberdade",13,13,0,60,60,0
11,3,2018,18,0,7,"Braga",2,"Avenida Central",49,49,0,71,71,0
11,3,2018,18,0,7,"Braga",3,"Rua de Caires",25,25,0,4,4,0
11,3,2018,18,0,7,"Braga",4,"N14 Bosch",31,47,16,72,48,24
11,3,2018,18,0,7,"Braga",5,"Avenida João Paulo II",39,39,0,9,9,0
11,3,2018,18,0,7,"Braga",6,"Avenida Padre Júlio Fragata",46,62,16,28,21,7
11,3,2018,18,0,7,"Braga",7,"Rua Nova Santa Cruz",44,44,0,39,39,0
11,3,2018,18,0,7,"Braga",8,"Rua Costa Gomes",31,41,10,56,42,14
11,3,2018,19,0,7,"Braga",1,"Avenida da Liberdade",13,13,0,60,60,0
11,3,2018,19,0,7,"Braga",2,"Avenida Central",49,49,0,71,71,0
11,3,2018,19,0,7,"Braga",3,"Rua de Caires",25,25,0,4,4,0
11,3,2018,19,0,7,"Braga",4,"N14 Bosch",47,47,0,48,48,0
11,3,2018,19,0,7,"Braga",5,"Avenida João Paulo II",39,39,0,9,9,0
11,3,2018,19,0,7,"Braga",6,"Avenida Padre Júlio Fragata",33,62,29,39,21,18
11,3,2018,19,0,7,"Braga",7,"Rua Nova Santa Cruz",44,44,0,39,39,0
11,3,2018,19,0,7,"Braga",8,"Rua Costa Gomes",41,41,0,42,42,0
11,3,2018,20,0,7,"Braga",1,"Avenida da Liberdade",13,13,0,60,60,0
11,3,2018,20,0,7,"Braga",2,"Avenida Central",49,49,0,71,71,0
11,3,2018,20,0,7,"Braga",3,"Rua de Caires",25,25,0,4,4,0
11,3,2018,20,0,7,"Braga",4,"N14 Bosch",47,47,0,48,48,0
11,3,2018,20,0,7,"Braga",5,"Avenida João Paulo II",24,39,15,15,9,6
11,3,2018,20,0,7,"Braga",6,"Avenida Padre Júlio Fragata",62,62,0,21,21,0
11,3,2018,20,0,7,"Braga",7,"Rua Nova Santa Cruz",44,44,0,39,39,0
11,3,2018,20,0,7,"Braga",8,"Rua Costa Gomes",41,41,0,42,42,0
11,3,2018,21,0,7,"Braga",1,"Avenida da Liberdade",13,13,0,60,60,0
11,3,2018,21,0,7,"Braga",2,"Avenida Central",49,49,0,71,71,0
11,3,2018,21,0,7,"Braga",3,"Rua de Caires",25,25,0,4,4,0
11,3,2018,21,0,7,"Braga",4,"N14 Bosch",47,47,0,48,48,0
11,3,2018,21,0,7,"Braga",5,"Avenida João Paulo II",39,39,0,9,9,0
11,3,2018,21,0,7,"Braga",6,"Avenida Padre Júlio Fragata",62,62,0,21,21,0
11,3,2018,21,0,7,"Braga",7,"Rua Nova Santa Cruz",44,44,0,39,39,0
11,3,2018,21,0,7,"Braga",8,"Rua Costa Gomes",26,41,15,67,42,25
11,3,2018,22,0,7,"Braga",1,"Avenida da Liberdade",13,13,0,60,60,0
11,3,2018,22,0,7,"Braga",2,"Avenida Central",49,49,0,71,71,0
11,3,2018,22,0,7,"Braga",3,"Rua de Caires",25,25,0,4,4,0
11,3,2018,22,0,7,"Braga",4,"N14 Bosch",47,47,0,48,48,0
11,3,2018,22,0,7,"Braga",5,"Avenida João Paulo II",39,39,0,9,9,0
11,3,2018,22,0,7,"Braga",6,"Avenida Padre Júlio Fragata",62,62,0,21,21,0
11,3,2018,22,0,7,"Braga",7,"Rua Nova Santa Cruz",44,44,0,39,39,0
11,3,2018,22,0,7,"Braga",8,"Rua Costa Gomes",41,41,0,42,42,0
11,3,2018,23,0,7,"Braga",1,"Avenida da Liberdade",13,13,0,60,60,0
11,3,2018,23,0,7,"Braga",2,"Avenida Central",49,49,0,71,71,0
11,3,2018,23,0,7,"Braga",3,"Rua de Caires",25,25,0,4,4,0
11,3,2018,23,0,7,"Braga",4,"N14 Bosch",47,47,0,48,48,0
11,3,2018,23,0,7,"Braga",5,"Avenida João Paulo II",39,39,0,9,9,0
11,3,2018,23,0,7,"Braga",6,"Avenida Padre Júlio Fragata",62,62,0,21,21,0
11,3,2018,23,0,7,"Braga",7,"Rua Nova Santa Cruz",44,44,0,39,39,0
11,3,2018,23,0,7,"Braga",8,"Rua Costa Gomes",41,41,0,42,42,0
11,4,2018,0,0,8,"Braga",1,"Avenida da Liberdade",9,13,4,86,60,26
11,4,2018,0,0,8,"Braga",2,"Avenida Central",49,49,0,71,71,0
11,4,2018,0,0,8,"Braga",3,"Rua de Caires",25,25,0,4,4,0
11,4,2018,0,0,8,"Braga",4,"N14 Bosch",47,47,0,48,48,0
11,4,2018,0,0,8,"Braga",5,"Avenida João Paulo II",39,39,0,9,9,0
11,4,2018,0,0,8,"Braga",6,"Avenida Padre Júlio Fragata",30,62,32,43,21,22
11,4,2018,0,0,8,"Braga",7,"Rua Nova Santa Cruz",44,44,0,39,39,0
11,4,2018,0,0,8,"Braga",8,"Rua Costa Gomes",41,41,0,42,42,0
11,4,2018,1,0,8,"Braga",1,"Avenida da Liberdade",13,13,0,60,60,0
11,4,2018,1,0,8,"Braga",2,"Avenida Central",49,49,0,71,71,0
11,4,2018,1,0,8,"Braga",3,"Rua de Caires",25,25,0,4,4,0
11,4,2018,1,0,8,"Braga",4,"N14 Bosch",47,47,0,48,48,0
11,4,2018,1,0,8,"Braga",5,"Avenida João Paulo II",39,39,0,9,9,0
11,4,2018,1,0,8,"Braga",6,"Avenida Padre Júlio Fragata",62,62,0,21,21,0
11,4,2018,1,0,8,"Braga",7,"Rua Nova Santa Cruz",44,44,0,39,39,0
11,4,2018,1,0,8,"Braga",8,"Rua Costa Gomes",41,41,0,42,42,0
11,4,2018,2,0,8,"Braga",1,"Avenida da Liberdade",13,13,0,60,60,0
11,4,2018,2,0,8,"Braga",2,"Avenida Central",49,49,0,71,71,0
11,4,2018,2,0,8,"Braga",3,"Rua de Caires",25,25,0,4,4,0
11,4,2018,2,0,8,"Braga",4,"N14 Bosch",47,47,0,48,48,0
11,4,2018,2,0,8,"Braga",5,"Avenida João Paulo II",39,39,0,9,9,0
11,4,2018,2,0,8,"Braga",6,"Avenida Padre Júlio Fragata",62,62,0,21,21,0
11,4,2018,2,0,8,"Braga",7,"Rua Nova Santa Cruz",44,44,0,39,39,0
11,4,2018,2,0,8,"Braga",8,"Rua Costa Gomes",41,41,0,42,42,0
11,4,2018,3,0,8,"Braga",1,"Avenida da Liberdade",13,13,0,60,60,0
11,4,2018,3,0,8,"Braga",2,"Avenida Central",49,49,0,71,71,0
11,4,2018,3,0,8,"Braga",3,"Rua de Caires",25,25,0,4,4,0
11,4,2018,3,0,8,"Braga",4,"N14 Bosch",47,47,0,48,48,0
11,4,2018,3,0,8,"Braga",5,"Avenida João Paulo II",39,39,0,9,9,0
11,4,2018,3,0,8,"Braga",6,"Avenida Padre Júlio Fragata",62,62,0,21,21,0
11,4,2018,3,0,8,"Braga",7,"Rua Nova Santa Cruz",44,44,0,39,39,0
11,4,2018,3,0,8,"Braga",8,"Rua Costa Gomes",41,41,0,42,42,0
11,4,2018,4,0,8,"Braga",1,"Avenida da Liberdade",13,13,0,60,60,0
11,4,2018,4,0,8,"Braga",2,"Avenida Central",49,49,0,71,71,0
11,4,2018,4,0,8,"Braga",3,"Rua de Caires",25,25,0,4,4,0
11,4,2018,4,0,8,"Braga",4,"N14 Bosch",47,47,0,48,48,0
11,4,2018,4,0,8,"Braga",5,"Avenida João Paulo II",39,39,0,9,9,0
11,4,2018,4,0,8,"Braga",6,"Avenida Padre Júlio Fragata",62,62,0,21,21,0
11,4,2018,4,0,8,"Braga",7,"Rua Nova Santa Cruz",44,44,0,39,39,0
11,4,2018,4,0,8,"Braga",8,"Rua Costa Gomes",41,41,0,42,42,0
11,4,2018,5,0,8,"Braga",1,"Avenida da Liberdade",13,13,0,60,60,0
11,4,2018,5,0,8,"Braga",2,"Avenida Central",49,49,0,71,71,0
11,4,2018,5,0,8,"Braga",3,"Rua de Caires",25,25,0,4,4,0
11,4,2018,5,0,8,"Braga",4,"N14 Bosch",47,47,0,48,48,0
11,4,2018,5,0,8,"Braga",5,"Avenida João Paulo II",39,39,0,9,9,0
11,4,2018,5,0,8,"Braga",6,"Avenida Padre Júlio Fragata",62,62,0,21,21,0
11,4,2018,5,0,8,"Braga",7,"Rua Nova Santa Cruz",44,44,0,39,39,0
11,4,2018,5,0,8,"Braga",8,"Rua Costa Gomes",41,41,0,42,42,0
11,4,2018,6,0,8,"Braga",1,"Avenida da Liberdade",13,13,0,60,60,0
11,4,2018,6,0,8,"Braga",2,"Avenida Central",49,49,0,71,71,0
11,4,2018,6,0,8,"Braga",3,"Rua de Caires",25,25,0,4,4,0
11,4,2018,6,0,8,"Braga",4,"N14 Bosch",47,47,0,48,48,0
11,4,2018,6,0,8,"Braga",5,"Avenida João Paulo II",39,39,0,9,9,0
11,4,2018,6,0,8,"Braga",6,"Avenida Padre Júlio Fragata",62,62,0,21,21,0
11,4,2018,6,0,8,"Braga",7,"Rua Nova Santa Cruz",44,44,0,39,39,0
11,4,2018,6,0,8,"Braga",8,"Rua Costa Gomes",41,41,0,42,42,0
11,4,2018,7,0,8,"Braga",1,"Avenida da Liberdade",13,13,0,60,60,0
11,4,2018,7,0,8,"Braga",2,"Avenida Central",49,49,0,71,71,0
11,4,2018,7,0,8,"Braga",3,"Rua de Caires",25,25,0,4,4,0
11,4,2018,7,0,8,"Braga",4,"N14 Bosch",47,47,0,48,48,0
11,4,2018,7,0,8,"Braga",5,"Avenida João Paulo II",39,39,0,9,9,0
11,4,2018,7,0,8,"Braga",6,"Avenida Padre Júlio Fragata",62,62,0,21,21,0
11,4,2018,7,0,8,"Braga",7,"Rua Nova Santa Cruz",44,44,0,39,39,0
11,4,2018,7,0,8,"Braga",8,"Rua Costa Gomes",41,41,0,42,42,0
11,4,2018,8,0,8,"Braga",1,"Avenida da Liberdade",13,13,0,60,60,0
11,4,2018,8,0,8,"Braga",2,"Avenida Central",49,49,0,71,71,0
11,4,2018,8,0,8,"Braga",3,"Rua de Caires",3,25,22,35,4,31
11,4,2018,8,0,8,"Braga",4,"N14 Bosch",47,47,0,48,48,0
11,4,2018,8,0,8,"Braga",5,"Avenida João Paulo II",39,39,0,9,9,0
11,4,2018,8,0,8,"Braga",6,"Avenida Padre Júlio Fragata",62,62,0,21,21,0
11,4,2018,8,0,8,"Braga",7,"Rua Nova Santa Cruz",44,44,0,39,39,0
11,4,2018,8,0,8,"Braga",8,"Rua Costa Gomes",41,41,0,42,42,0
11,4,2018,9,0,8,"Braga",1,"Avenida da Liberdade",13,13,0,60,60,0
11,4,2018,9,0,8,"Braga",2,"Avenida Central",49,49,0,71,71,0
11,4,2018,9,0,8,"Braga",3,"Rua de Caires",25,25,0,4,4,0
11,4,2018,9,0,8,"Braga",4,"N14 Bosch",47,47,0,48,48,0
11,4,2018,9,0,8,"Braga",5,"Avenida João Paulo II",39,39,0,9,9,0
11,4,2018,9,0,8,"Braga",6,"Avenida Padre Júlio Fragata",62,62,0,21,21,0
11,4,2018,9,0,8,"Braga",7,"Rua Nova Santa Cruz",44,44,0,39,39,0
11,4,2018,9,0,8,"Braga",8,"Rua Costa Gomes",41,41,0,42,42,0
11,4,2018,10,0,8,"Braga",1,"Avenida da Liberdade",13,13,0,60,60,0
11,4,2018,10,0,8,"Braga",2,"Avenida Central",49,49,0,71,71,0
11,4,2018,10,0,8,"Braga",3,"Rua de Caires",25,25,0,4,4,0
11,4,2018,10,0,8,"Braga",4,"N14 Bosch",47,47,0,48,48,0
11,4,2018,10,0,8,"Braga",5,"Avenida João Paulo II",39,39,0,9,9,0
11,4,2018,10,0,8,"Braga",6,"Avenida Padre Júlio Fragata",38,62,24,34,21,13
11,4,2018,10,0,8,"Braga",7,"Rua Nova Santa Cruz",44,44,0,39,39,0
11,4,2018,10,0,8,"Braga",8,"Rua Costa Gomes",41,41,0,42,42,0
11,4,2018,11,0,8,"Braga",1,"Avenida da Liberdade",13,13,0,60,60,0
11,4,2018,11,0,8,"Braga",2,"Avenida Central",49,49,0,71,71,0
11,4,2018,11,0,8,"Braga",3,"Rua de Caires",25,25,0,4,4,0
11,4,2018,11,0,8,"Braga",4,"N14 Bosch",47,47,0,48,48,0
11,4,2018,11,0,8,"Braga",5,"Avenida João Paulo II",39,39,0,9,9,0
11,4,2018,11,0,8,"Braga",6,"Avenida Padre Júlio Fragata",62,62,0,21,21,0
11,4,2018,11,0,8,"Braga",7,"Rua Nova Santa Cruz",44,44,0,39,39,0
11,4,2018,11,0,8,"Braga",8,"Rua Costa Gomes",41,41,0,42,42,0
11,4,2018,12,0,8,"Braga",1,"Avenida da Liberdade",13,13,0,60,60,0
11,4,2018,12,0,8,"Braga",2,"Avenida Central",49,49,0,71,71,0
11,4,2018,12,0,8,"Braga",3,"Rua de Caires",25,25,0,4,4,0
11,4,2018,12,0,8,"Braga",4,"N14 Bosch",47,47,0,48,48,0
11,4,2018,12,0,8,"Braga",5,"Avenida João Paulo II",39,39,0,9,9,0
11,4,2018,12,0,8,"Braga",6,"Avenida Padre Júlio Fragata",62,62,0,21,21,0
11,4,2018,12,0,8,"Braga",7,"Rua Nova Santa Cruz",44,44,0,39,39,0
11,4,2018,12,0,8,"Braga",8,"Rua Costa Gomes",30,41,11,58,42,16
11,4,2018,13,0,8,"Braga",1,"Avenida da Liberdade",13,13,0,60,60,0
11,4,2018,13,0,8,"Braga",2,"Avenida Central",49,49,0,71,71,0
11,4,2018,13,0,8,"Braga",3,"Rua de Caires",25,25,0,4,4,0
11,4,2018,13,0,8,"Braga",4,"N14 Bosch",47,47,0,48,48,0
11,4,2018,13,0,8,"Braga",5,"Avenida João Paulo II",39,39,0,9,9,0
11,4,2018,13,0,8,"Braga",6,"Avenida Padre Júlio Fragata",44,62,18,29,21,8
11,4,2018,13,0,8,"Braga",7,"Rua Nova Santa Cruz",44,44,0,39,39,0
11,4,2018,13,0,8,"Braga",8,"Rua Costa Gomes",32,41,9,54,42,12
11,4,2018,14,0,8,"Braga",1,"Avenida da Liberdade",13,13,0,60,60,0
11,4,2018,14,0,8,"Braga",2,"Avenida Central",49,49,0,71,71,0
11,4,2018,14,0,8,"Braga",3,"Rua de Caires",25,25,0,4,4,0
11,4,2018,14,0,8,"Braga",4,"N14 Bosch",5,47,42,449,48,401
11,4,2018,14,0,8,"Braga",5,"Avenida João Paulo II",39,39,0,9,9,0
11,4,2018,14,0,8,"Braga",6,"Avenida Padre Júlio Fragata",62,62,0,21,21,0
11,4,2018,14,0,8,"Braga",7,"Rua Nova Santa Cruz",44,44,0,39,39,0
11,4,2018,14,0,8,"Braga",8,"Rua Costa Gomes",32,41,9,54,42,12
11,4,2018,15,0,8,"Braga",1,"Avenida da Liberdade",13,13,0,60,60,0
11,4,2018,15,0,8,"Braga",2,"Avenida Central",49,49,0,71,71,0
11,4,2018,15,0,8,"Braga",3,"Rua de Caires",25,25,0,4,4,0
11,4,2018,15,0,8,"Braga",4,"N14 Bosch",47,47,0,48,48,0
11,4,2018,15,0,8,"Braga",5,"Avenida João Paulo II",2,39,37,175,9,166
11,4,2018,15,0,8,"Braga",6,"Avenida Padre Júlio Fragata",24,62,38,54,21,33
11,4,2018,15,0,8,"Braga",7,"Rua Nova Santa Cruz",44,44,0,39,39,0
11,4,2018,15,0,8,"Braga",8,"Rua Costa Gomes",32,41,9,54,42,12
11,4,2018,16,0,8,"Braga",1,"Avenida da Liberdade",13,13,0,60,60,0
11,4,2018,16,0,8,"Braga",2,"Avenida Central",49,49,0,71,71,0
11,4,2018,16,0,8,"Braga",3,"Rua de Caires",18,25,7,6,4,2
11,4,2018,16,0,8,"Braga",4,"N14 Bosch",47,47,0,48,48,0
11,4,2018,16,0,8,"Braga",5,"Avenida João Paulo II",4,39,35,87,9,78
11,4,2018,16,0,8,"Braga",6,"Avenida Padre Júlio Fragata",25,62,37,51,21,30
11,4,2018,16,0,8,"Braga",7,"Rua Nova Santa Cruz",31,44,13,56,39,17
11,4,2018,16,0,8,"Braga",8,"Rua Costa Gomes",41,41,0,42,42,0
11,4,2018,17,0,8,"Braga",1,"Avenida da Liberdade",13,13,0,60,60,0
11,4,2018,17,0,8,"Braga",2,"Avenida Central",39,49,10,89,71,18
11,4,2018,17,0,8,"Braga",3,"Rua de Caires",17,25,8,6,4,2
11,4,2018,17,0,8,"Braga",4,"N14 Bosch",47,47,0,48,48,0
11,4,2018,17,0,8,"Braga",5,"Avenida João Paulo II",10,39,29,35,9,26
11,4,2018,17,0,8,"Braga",6,"Avenida Padre Júlio Fragata",24,62,38,54,21,33
11,4,2018,17,0,8,"Braga",7,"Rua Nova Santa Cruz",44,44,0,39,39,0
11,4,2018,17,0,8,"Braga",8,"Rua Costa Gomes",30,41,11,58,42,16
11,4,2018,18,0,8,"Braga",1,"Avenida da Liberdade",13,13,0,60,60,0
11,4,2018,18,0,8,"Braga",2,"Avenida Central",49,49,0,71,71,0
11,4,2018,18,0,8,"Braga",3,"Rua de Caires",25,25,0,4,4,0
11,4,2018,18,0,8,"Braga",4,"N14 Bosch",21,47,26,107,48,59
11,4,2018,18,0,8,"Braga",5,"Avenida João Paulo II",39,39,0,9,9,0
11,4,2018,18,0,8,"Braga",6,"Avenida Padre Júlio Fragata",32,62,30,40,21,19
11,4,2018,18,0,8,"Braga",7,"Rua Nova Santa Cruz",44,44,0,39,39,0
11,4,2018,18,0,8,"Braga",8,"Rua Costa Gomes",30,41,11,58,42,16
11,4,2018,19,0,8,"Braga",1,"Avenida da Liberdade",13,13,0,60,60,0
11,4,2018,19,0,8,"Braga",2,"Avenida Central",49,49,0,71,71,0
11,4,2018,19,0,8,"Braga",3,"Rua de Caires",25,25,0,4,4,0
11,4,2018,19,0,8,"Braga",4,"N14 Bosch",47,47,0,48,48,0
11,4,2018,19,0,8,"Braga",5,"Avenida João Paulo II",39,39,0,9,9,0
11,4,2018,19,0,8,"Braga",6,"Avenida Padre Júlio Fragata",62,62,0,21,21,0
11,4,2018,19,0,8,"Braga",7,"Rua Nova Santa Cruz",44,44,0,39,39,0
11,4,2018,19,0,8,"Braga",8,"Rua Costa Gomes",41,41,0,42,42,0
11,4,2018,20,0,8,"Braga",1,"Avenida da Liberdade",13,13,0,60,60,0
11,4,2018,20,0,8,"Braga",2,"Avenida Central",49,49,0,71,71,0
11,4,2018,20,0,8,"Braga",3,"Rua de Caires",19,25,6,5,4,1
11,4,2018,20,0,8,"Braga",4,"N14 Bosch",47,47,0,48,48,0
11,4,2018,20,0,8,"Braga",5,"Avenida João Paulo II",26,39,13,13,9,4
11,4,2018,20,0,8,"Braga",6,"Avenida Padre Júlio Fragata",62,62,0,21,21,0
11,4,2018,20,0,8,"Braga",7,"Rua Nova Santa Cruz",44,44,0,39,39,0
11,4,2018,20,0,8,"Braga",8,"Rua Costa Gomes",41,41,0,42,42,0
11,4,2018,21,0,8,"Braga",1,"Avenida da Liberdade",13,13,0,60,60,0
11,4,2018,21,0,8,"Braga",2,"Avenida Central",49,49,0,71,71,0
11,4,2018,21,0,8,"Braga",3,"Rua de Caires",25,25,0,4,4,0
11,4,2018,21,0,8,"Braga",4,"N14 Bosch",47,47,0,48,48,0
11,4,2018,21,0,8,"Braga",5,"Avenida João Paulo II",39,39,0,9,9,0
11,4,2018,21,0,8,"Braga",6,"Avenida Padre Júlio Fragata",31,62,31,41,21,20
11,4,2018,21,0,8,"Braga",7,"Rua Nova Santa Cruz",44,44,0,39,39,0
11,4,2018,21,0,8,"Braga",8,"Rua Costa Gomes",41,41,0,42,42,0
11,4,2018,22,0,8,"Braga",1,"Avenida da Liberdade",13,13,0,60,60,0
11,4,2018,22,0,8,"Braga",2,"Avenida Central",49,49,0,71,71,0
11,4,2018,22,0,8,"Braga",3,"Rua de Caires",25,25,0,4,4,0
11,4,2018,22,0,8,"Braga",4,"N14 Bosch",47,47,0,48,48,0
11,4,2018,22,0,8,"Braga",5,"Avenida João Paulo II",39,39,0,9,9,0
11,4,2018,22,0,8,"Braga",6,"Avenida Padre Júlio Fragata",62,62,0,21,21,0
11,4,2018,22,0,8,"Braga",7,"Rua Nova Santa Cruz",44,44,0,39,39,0
11,4,2018,22,0,8,"Braga",8,"Rua Costa Gomes",41,41,0,42,42,0
11,4,2018,23,0,8,"Braga",1,"Avenida da Liberdade",13,13,0,60,60,0
11,4,2018,23,0,8,"Braga",2,"Avenida Central",49,49,0,71,71,0
11,4,2018,23,0,8,"Braga",3,"Rua de Caires",25,25,0,4,4,0
11,4,2018,23,0,8,"Braga",4,"N14 Bosch",47,47,0,48,48,0
11,4,2018,23,0,8,"Braga",5,"Avenida João Paulo II",39,39,0,9,9,0
11,4,2018,23,0,8,"Braga",6,"Avenida Padre Júlio Fragata",62,62,0,21,21,0
11,4,2018,23,0,8,"Braga",7,"Rua Nova Santa Cruz",44,44,0,39,39,0
11,4,2018,23,0,8,"Braga",8,"Rua Costa Gomes",41,41,0,42,42,0
11,5,2018,0,0,2,"Braga",1,"Avenida da Liberdade",13,13,0,60,60,0
11,5,2018,0,0,2,"Braga",2,"Avenida Central",49,49,0,71,71,0
11,5,2018,0,0,2,"Braga",3,"Rua de Caires",25,25,0,4,4,0
11,5,2018,0,0,2,"Braga",4,"N14 Bosch",47,47,0,48,48,0
11,5,2018,0,0,2,"Braga",5,"Avenida João Paulo II",39,39,0,9,9,0
11,5,2018,0,0,2,"Braga",6,"Avenida Padre Júlio Fragata",62,62,0,21,21,0
11,5,2018,0,0,2,"Braga",7,"Rua Nova Santa Cruz",44,44,0,39,39,0
11,5,2018,0,0,2,"Braga",8,"Rua Costa Gomes",41,41,0,42,42,0
11,5,2018,1,0,2,"Braga",1,"Avenida da Liberdade",13,13,0,60,60,0
11,5,2018,1,0,2,"Braga",2,"Avenida Central",49,49,0,71,71,0
11,5,2018,1,0,2,"Braga",3,"Rua de Caires",25,25,0,4,4,0
11,5,2018,1,0,2,"Braga",4,"N14 Bosch",47,47,0,48,48,0
11,5,2018,1,0,2,"Braga",5,"Avenida João Paulo II",39,39,0,9,9,0
11,5,2018,1,0,2,"Braga",6,"Avenida Padre Júlio Fragata",62,62,0,21,21,0
11,5,2018,1,0,2,"Braga",7,"Rua Nova Santa Cruz",44,44,0,39,39,0
11,5,2018,1,0,2,"Braga",8,"Rua Costa Gomes",41,41,0,42,42,0
11,5,2018,2,0,2,"Braga",1,"Avenida da Liberdade",13,13,0,60,60,0
11,5,2018,2,0,2,"Braga",2,"Avenida Central",49,49,0,71,71,0
11,5,2018,2,0,2,"Braga",3,"Rua de Caires",25,25,0,4,4,0
11,5,2018,2,0,2,"Braga",4,"N14 Bosch",47,47,0,48,48,0
11,5,2018,2,0,2,"Braga",5,"Avenida João Paulo II",39,39,0,9,9,0
11,5,2018,2,0,2,"Braga",6,"Avenida Padre Júlio Fragata",62,62,0,21,21,0
11,5,2018,2,0,2,"Braga",7,"Rua Nova Santa Cruz",44,44,0,39,39,0
11,5,2018,2,0,2,"Braga",8,"Rua Costa Gomes",41,41,0,42,42,0
11,5,2018,3,0,2,"Braga",1,"Avenida da Liberdade",13,13,0,60,60,0
11,5,2018,3,0,2,"Braga",2,"Avenida Central",49,49,0,71,71,0
11,5,2018,3,0,2,"Braga",3,"Rua de Caires",25,25,0,4,4,0
11,5,2018,3,0,2,"Braga",4,"N14 Bosch",47,47,0,48,48,0
11,5,2018,3,0,2,"Braga",5,"Avenida João Paulo II",39,39,0,9,9,0
11,5,2018,3,0,2,"Braga",6,"Avenida Padre Júlio Fragata",62,62,0,21,21,0
11,5,2018,3,0,2,"Braga",7,"Rua Nova Santa Cruz",44,44,0,39,39,0
11,5,2018,3,0,2,"Braga",8,"Rua Costa Gomes",41,41,0,42,42,0
11,5,2018,4,0,2,"Braga",1,"Avenida da Liberdade",13,13,0,60,60,0
11,5,2018,4,0,2,"Braga",2,"Avenida Central",49,49,0,71,71,0
11,5,2018,4,0,2,"Braga",3,"Rua de Caires",25,25,0,4,4,0
11,5,2018,4,0,2,"Braga",4,"N14 Bosch",47,47,0,48,48,0
11,5,2018,4,0,2,"Braga",5,"Avenida João Paulo II",39,39,0,9,9,0
11,5,2018,4,0,2,"Braga",6,"Avenida Padre Júlio Fragata",62,62,0,21,21,0
11,5,2018,4,0,2,"Braga",7,"Rua Nova Santa Cruz",44,44,0,39,39,0
11,5,2018,4,0,2,"Braga",8,"Rua Costa Gomes",41,41,0,42,42,0
11,5,2018,5,0,2,"Braga",1,"Avenida da Liberdade",13,13,0,60,60,0
11,5,2018,5,0,2,"Braga",2,"Avenida Central",49,49,0,71,71,0
11,5,2018,5,0,2,"Braga",3,"Rua de Caires",25,25,0,4,4,0
11,5,2018,5,0,2,"Braga",4,"N14 Bosch",47,47,0,48,48,0
11,5,2018,5,0,2,"Braga",5,"Avenida João Paulo II",39,39,0,9,9,0
11,5,2018,5,0,2,"Braga",6,"Avenida Padre Júlio Fragata",62,62,0,21,21,0
11,5,2018,5,0,2,"Braga",7,"Rua Nova Santa Cruz",44,44,0,39,39,0
11,5,2018,5,0,2,"Braga",8,"Rua Costa Gomes",41,41,0,42,42,0
11,5,2018,6,0,2,"Braga",1,"Avenida da Liberdade",13,13,0,60,60,0
11,5,2018,6,0,2,"Braga",2,"Avenida Central",49,49,0,71,71,0
11,5,2018,6,0,2,"Braga",3,"Rua de Caires",25,25,0,4,4,0
11,5,2018,6,0,2,"Braga",4,"N14 Bosch",47,47,0,48,48,0
11,5,2018,6,0,2,"Braga",5,"Avenida João Paulo II",39,39,0,9,9,0
11,5,2018,6,0,2,"Braga",6,"Avenida Padre Júlio Fragata",62,62,0,21,21,0
11,5,2018,6,0,2,"Braga",7,"Rua Nova Santa Cruz",44,44,0,39,39,0
11,5,2018,6,0,2,"Braga",8,"Rua Costa Gomes",41,41,0,42,42,0
11,5,2018,7,0,2,"Braga",1,"Avenida da Liberdade",13,13,0,60,60,0
11,5,2018,7,0,2,"Braga",2,"Avenida Central",49,49,0,71,71,0
11,5,2018,7,0,2,"Braga",3,"Rua de Caires",25,25,0,4,4,0
11,5,2018,7,0,2,"Braga",4,"N14 Bosch",47,47,0,48,48,0
11,5,2018,7,0,2,"Braga",5,"Avenida João Paulo II",39,39,0,9,9,0
11,5,2018,7,0,2,"Braga",6,"Avenida Padre Júlio Fragata",62,62,0,21,21,0
11,5,2018,7,0,2,"Braga",7,"Rua Nova Santa Cruz",44,44,0,39,39,0
11,5,2018,7,0,2,"Braga",8,"Rua Costa Gomes",41,41,0,42,42,0
11,5,2018,8,0,2,"Braga",1,"Avenida da Liberdade",13,13,0,60,60,0
11,5,2018,8,0,2,"Braga",2,"Avenida Central",34,49,15,102,71,31
11,5,2018,8,0,2,"Braga",3,"Rua de Caires",19,25,6,5,4,1
11,5,2018,8,0,2,"Braga",4,"N14 Bosch",19,47,28,118,48,70
11,5,2018,8,0,2,"Braga",5,"Avenida João Paulo II",39,39,0,9,9,0
11,5,2018,8,0,2,"Braga",6,"Avenida Padre Júlio Fragata",62,62,0,21,21,0
11,5,2018,8,0,2,"Braga",7,"Rua Nova Santa Cruz",25,44,19,69,39,30
11,5,2018,8,0,2,"Braga",8,"Rua Costa Gomes",29,41,12,60,42,18
11,5,2018,9,0,2,"Braga",1,"Avenida da Liberdade",13,13,0,60,60,0
11,5,2018,9,0,2,"Braga",2,"Avenida Central",32,49,17,108,71,37
11,5,2018,9,0,2,"Braga",3,"Rua de Caires",25,25,0,4,4,0
11,5,2018,9,0,2,"Braga",4,"N14 Bosch",16,47,31,140,48,92
11,5,2018,9,0,2,"Braga",5,"Avenida João Paulo II",19,39,20,18,9,9
11,5,2018,9,0,2,"Braga",6,"Avenida Padre Júlio Fragata",25,62,37,51,21,30
11,5,2018,9,0,2,"Braga",7,"Rua Nova Santa Cruz",4,44,40,432,39,393
11,5,2018,9,0,2,"Braga",8,"Rua Costa Gomes",20,41,21,87,42,45
11,5,2018,10,0,2,"Braga",1,"Avenida da Liberdade",13,13,0,60,60,0
11,5,2018,10,0,2,"Braga",2,"Avenida Central",49,49,0,71,71,0
11,5,2018,10,0,2,"Braga",3,"Rua de Caires",25,25,0,4,4,0
11,5,2018,10,0,2,"Braga",4,"N14 Bosch",47,47,0,48,48,0
11,5,2018,10,0,2,"Braga",5,"Avenida João Paulo II",39,39,0,9,9,0
11,5,2018,10,0,2,"Braga",6,"Avenida Padre Júlio Fragata",62,62,0,21,21,0
11,5,2018,10,0,2,"Braga",7,"Rua Nova Santa Cruz",19,44,25,91,39,52
11,5,2018,10,0,2,"Braga",8,"Rua Costa Gomes",29,41,12,60,42,18
11,5,2018,11,0,2,"Braga",1,"Avenida da Liberdade",13,13,0,60,60,0
11,5,2018,11,0,2,"Braga",2,"Avenida Central",49,49,0,71,71,0
11,5,2018,11,0,2,"Braga",3,"Rua de Caires",25,25,0,4,4,0
11,5,2018,11,0,2,"Braga",4,"N14 Bosch",47,47,0,48,48,0
11,5,2018,11,0,2,"Braga",5,"Avenida João Paulo II",39,39,0,9,9,0
11,5,2018,11,0,2,"Braga",6,"Avenida Padre Júlio Fragata",62,62,0,21,21,0
11,5,2018,11,0,2,"Braga",7,"Rua Nova Santa Cruz",29,44,15,60,39,21
11,5,2018,11,0,2,"Braga",8,"Rua Costa Gomes",41,41,0,42,42,0
11,5,2018,12,0,2,"Braga",1,"Avenida da Liberdade",13,13,0,60,60,0
11,5,2018,12,0,2,"Braga",2,"Avenida Central",49,49,0,71,71,0
11,5,2018,12,0,2,"Braga",3,"Rua de Caires",25,25,0,4,4,0
11,5,2018,12,0,2,"Braga",4,"N14 Bosch",28,47,19,80,48,32
11,5,2018,12,0,2,"Braga",5,"Avenida João Paulo II",39,39,0,9,9,0
11,5,2018,12,0,2,"Braga",6,"Avenida Padre Júlio Fragata",62,62,0,21,21,0
11,5,2018,12,0,2,"Braga",7,"Rua Nova Santa Cruz",44,44,0,39,39,0
11,5,2018,12,0,2,"Braga",8,"Rua Costa Gomes",41,41,0,42,42,0
11,5,2018,13,0,2,"Braga",1,"Avenida da Liberdade",9,13,4,86,60,26
11,5,2018,13,0,2,"Braga",2,"Avenida Central",49,49,0,71,71,0
11,5,2018,13,0,2,"Braga",3,"Rua de Caires",19,25,6,5,4,1
11,5,2018,13,0,2,"Braga",4,"N14 Bosch",29,47,18,77,48,29
11,5,2018,13,0,2,"Braga",5,"Avenida João Paulo II",39,39,0,9,9,0
11,5,2018,13,0,2,"Braga",6,"Avenida Padre Júlio Fragata",49,62,13,26,21,5
11,5,2018,13,0,2,"Braga",7,"Rua Nova Santa Cruz",44,44,0,39,39,0
11,5,2018,13,0,2,"Braga",8,"Rua Costa Gomes",29,41,12,60,42,18
11,5,2018,14,0,2,"Braga",1,"Avenida da Liberdade",13,13,0,60,60,0
11,5,2018,14,0,2,"Braga",2,"Avenida Central",31,49,18,112,71,41
11,5,2018,14,0,2,"Braga",3,"Rua de Caires",25,25,0,4,4,0
11,5,2018,14,0,2,"Braga",4,"N14 Bosch",20,47,27,112,48,64
11,5,2018,14,0,2,"Braga",5,"Avenida João Paulo II",24,39,15,15,9,6
11,5,2018,14,0,2,"Braga",6,"Avenida Padre Júlio Fragata",62,62,0,21,21,0
11,5,2018,14,0,2,"Braga",7,"Rua Nova Santa Cruz",13,44,31,133,39,94
11,5,2018,14,0,2,"Braga",8,"Rua Costa Gomes",24,41,17,72,42,30
11,5,2018,15,0,2,"Braga",1,"Avenida da Liberdade",13,13,0,60,60,0
11,5,2018,15,0,2,"Braga",2,"Avenida Central",37,49,12,94,71,23
11,5,2018,15,0,2,"Braga",3,"Rua de Caires",25,25,0,4,4,0
11,5,2018,15,0,2,"Braga",4,"N14 Bosch",19,47,28,118,48,70
11,5,2018,15,0,2,"Braga",5,"Avenida João Paulo II",39,39,0,9,9,0
11,5,2018,15,0,2,"Braga",6,"Avenida Padre Júlio Fragata",62,62,0,21,21,0
11,5,2018,15,0,2,"Braga",7,"Rua Nova Santa Cruz",44,44,0,39,39,0
11,5,2018,15,0,2,"Braga",8,"Rua Costa Gomes",31,41,10,56,42,14
11,5,2018,16,0,2,"Braga",1,"Avenida da Liberdade",13,13,0,60,60,0
11,5,2018,16,0,2,"Braga",2,"Avenida Central",49,49,0,71,71,0
11,5,2018,16,0,2,"Braga",3,"Rua de Caires",25,25,0,4,4,0
11,5,2018,16,0,2,"Braga",4,"N14 Bosch",47,47,0,48,48,0
11,5,2018,16,0,2,"Braga",5,"Avenida João Paulo II",29,39,10,12,9,3
11,5,2018,16,0,2,"Braga",6,"Avenida Padre Júlio Fragata",62,62,0,21,21,0
11,5,2018,16,0,2,"Braga",7,"Rua Nova Santa Cruz",28,44,16,62,39,23
11,5,2018,16,0,2,"Braga",8,"Rua Costa Gomes",30,41,11,58,42,16
11,5,2018,17,0,2,"Braga",1,"Avenida da Liberdade",13,13,0,60,60,0
11,5,2018,17,0,2,"Braga",2,"Avenida Central",49,49,0,71,71,0
11,5,2018,17,0,2,"Braga",3,"Rua de Caires",25,25,0,4,4,0
11,5,2018,17,0,2,"Braga",4,"N14 Bosch",22,47,25,102,48,54
11,5,2018,17,0,2,"Braga",5,"Avenida João Paulo II",23,39,16,15,9,6
11,5,2018,17,0,2,"Braga",6,"Avenida Padre Júlio Fragata",35,62,27,37,21,16
11,5,2018,17,0,2,"Braga",7,"Rua Nova Santa Cruz",12,44,32,144,39,105
11,5,2018,17,0,2,"Braga",8,"Rua Costa Gomes",41,41,0,42,42,0
11,5,2018,18,0,2,"Braga",1,"Avenida da Liberdade",13,13,0,60,60,0
11,5,2018,18,0,2,"Braga",2,"Avenida Central",35,49,14,99,71,28
11,5,2018,18,0,2,"Braga",3,"Rua de Caires",19,25,6,5,4,1
11,5,2018,18,0,2,"Braga",4,"N14 Bosch",18,47,29,125,48,77
11,5,2018,18,0,2,"Braga",5,"Avenida João Paulo II",10,39,29,35,9,26
11,5,2018,18,0,2,"Braga",6,"Avenida Padre Júlio Fragata",22,62,40,58,21,37
11,5,2018,18,0,2,"Braga",7,"Rua Nova Santa Cruz",7,44,37,247,39,208
11,5,2018,18,0,2,"Braga",8,"Rua Costa Gomes",20,41,21,87,42,45
11,5,2018,19,0,2,"Braga",1,"Avenida da Liberdade",10,13,3,78,60,18
11,5,2018,19,0,2,"Braga",2,"Avenida Central",37,49,12,94,71,23
11,5,2018,19,0,2,"Braga",3,"Rua de Caires",14,25,11,7,4,3
11,5,2018,19,0,2,"Braga",4,"N14 Bosch",30,47,17,75,48,27
11,5,2018,19,0,2,"Braga",5,"Avenida João Paulo II",23,39,16,15,9,6
11,5,2018,19,0,2,"Braga",6,"Avenida Padre Júlio Fragata",25,62,37,51,21,30
11,5,2018,19,0,2,"Braga",7,"Rua Nova Santa Cruz",14,44,30,123,39,84
11,5,2018,19,0,2,"Braga",8,"Rua Costa Gomes",5,41,36,346,42,304
11,5,2018,20,0,2,"Braga",1,"Avenida da Liberdade",13,13,0,60,60,0
11,5,2018,20,0,2,"Braga",2,"Avenida Central",49,49,0,71,71,0
11,5,2018,20,0,2,"Braga",3,"Rua de Caires",18,25,7,6,4,2
11,5,2018,20,0,2,"Braga",4,"N14 Bosch",34,47,13,66,48,18
11,5,2018,20,0,2,"Braga",5,"Avenida João Paulo II",10,39,29,35,9,26
11,5,2018,20,0,2,"Braga",6,"Avenida Padre Júlio Fragata",6,62,56,214,21,193
11,5,2018,20,0,2,"Braga",7,"Rua Nova Santa Cruz",24,44,20,72,39,33
11,5,2018,20,0,2,"Braga",8,"Rua Costa Gomes",41,41,0,42,42,0
11,5,2018,21,0,2,"Braga",1,"Avenida da Liberdade",13,13,0,60,60,0
11,5,2018,21,0,2,"Braga",2,"Avenida Central",49,49,0,71,71,0
11,5,2018,21,0,2,"Braga",3,"Rua de Caires",25,25,0,4,4,0
11,5,2018,21,0,2,"Braga",4,"N14 Bosch",47,47,0,48,48,0
11,5,2018,21,0,2,"Braga",5,"Avenida João Paulo II",39,39,0,9,9,0
11,5,2018,21,0,2,"Braga",6,"Avenida Padre Júlio Fragata",62,62,0,21,21,0
11,5,2018,21,0,2,"Braga",7,"Rua Nova Santa Cruz",32,44,12,54,39,15
11,5,2018,21,0,2,"Braga",8,"Rua Costa Gomes",29,41,12,60,42,18
11,5,2018,22,0,2,"Braga",1,"Avenida da Liberdade",13,13,0,60,60,0
11,5,2018,22,0,2,"Braga",2,"Avenida Central",49,49,0,71,71,0
11,5,2018,22,0,2,"Braga",3,"Rua de Caires",25,25,0,4,4,0
11,5,2018,22,0,2,"Braga",4,"N14 Bosch",47,47,0,48,48,0
11,5,2018,22,0,2,"Braga",5,"Avenida João Paulo II",39,39,0,9,9,0
11,5,2018,22,0,2,"Braga",6,"Avenida Padre Júlio Fragata",62,62,0,21,21,0
11,5,2018,22,0,2,"Braga",7,"Rua Nova Santa Cruz",22,44,22,79,39,40
11,5,2018,22,0,2,"Braga",8,"Rua Costa Gomes",41,41,0,42,42,0
11,5,2018,23,0,2,"Braga",1,"Avenida da Liberdade",13,13,0,60,60,0
11,5,2018,23,0,2,"Braga",2,"Avenida Central",49,49,0,71,71,0
11,5,2018,23,0,2,"Braga",3,"Rua de Caires",25,25,0,4,4,0
11,5,2018,23,0,2,"Braga",4,"N14 Bosch",47,47,0,48,48,0
11,5,2018,23,0,2,"Braga",5,"Avenida João Paulo II",39,39,0,9,9,0
11,5,2018,23,0,2,"Braga",6,"Avenida Padre Júlio Fragata",62,62,0,21,21,0
11,5,2018,23,0,2,"Braga",7,"Rua Nova Santa Cruz",44,44,0,39,39,0
11,5,2018,23,0,2,"Braga",8,"Rua Costa Gomes",41,41,0,42,42,0
11,6,2018,0,0,3,"Braga",1,"Avenida da Liberdade",13,13,0,60,60,0
11,6,2018,0,0,3,"Braga",2,"Avenida Central",49,49,0,71,71,0
11,6,2018,0,0,3,"Braga",3,"Rua de Caires",25,25,0,4,4,0
11,6,2018,0,0,3,"Braga",4,"N14 Bosch",47,47,0,48,48,0
11,6,2018,0,0,3,"Braga",5,"Avenida João Paulo II",39,39,0,9,9,0
11,6,2018,0,0,3,"Braga",6,"Avenida Padre Júlio Fragata",62,62,0,21,21,0
11,6,2018,0,0,3,"Braga",7,"Rua Nova Santa Cruz",44,44,0,39,39,0
11,6,2018,0,0,3,"Braga",8,"Rua Costa Gomes",41,41,0,42,42,0
11,6,2018,1,0,3,"Braga",1,"Avenida da Liberdade",13,13,0,60,60,0
11,6,2018,1,0,3,"Braga",2,"Avenida Central",49,49,0,71,71,0
11,6,2018,1,0,3,"Braga",3,"Rua de Caires",25,25,0,4,4,0
11,6,2018,1,0,3,"Braga",4,"N14 Bosch",47,47,0,48,48,0
11,6,2018,1,0,3,"Braga",5,"Avenida João Paulo II",39,39,0,9,9,0
11,6,2018,1,0,3,"Braga",6,"Avenida Padre Júlio Fragata",62,62,0,21,21,0
11,6,2018,1,0,3,"Braga",7,"Rua Nova Santa Cruz",44,44,0,39,39,0
11,6,2018,1,0,3,"Braga",8,"Rua Costa Gomes",41,41,0,42,42,0
11,6,2018,2,0,3,"Braga",1,"Avenida da Liberdade",13,13,0,60,60,0
11,6,2018,2,0,3,"Braga",2,"Avenida Central",49,49,0,71,71,0
11,6,2018,2,0,3,"Braga",3,"Rua de Caires",25,25,0,4,4,0
11,6,2018,2,0,3,"Braga",4,"N14 Bosch",47,47,0,48,48,0
11,6,2018,2,0,3,"Braga",5,"Avenida João Paulo II",39,39,0,9,9,0
11,6,2018,2,0,3,"Braga",6,"Avenida Padre Júlio Fragata",62,62,0,21,21,0
11,6,2018,2,0,3,"Braga",7,"Rua Nova Santa Cruz",44,44,0,39,39,0
11,6,2018,2,0,3,"Braga",8,"Rua Costa Gomes",41,41,0,42,42,0
11,6,2018,3,0,3,"Braga",1,"Avenida da Liberdade",13,13,0,60,60,0
11,6,2018,3,0,3,"Braga",2,"Avenida Central",49,49,0,71,71,0
11,6,2018,3,0,3,"Braga",3,"Rua de Caires",25,25,0,4,4,0
11,6,2018,3,0,3,"Braga",4,"N14 Bosch",47,47,0,48,48,0
11,6,2018,3,0,3,"Braga",5,"Avenida João Paulo II",39,39,0,9,9,0
11,6,2018,3,0,3,"Braga",6,"Avenida Padre Júlio Fragata",62,62,0,21,21,0
11,6,2018,3,0,3,"Braga",7,"Rua Nova Santa Cruz",44,44,0,39,39,0
11,6,2018,3,0,3,"Braga",8,"Rua Costa Gomes",41,41,0,42,42,0
11,6,2018,4,0,3,"Braga",1,"Avenida da Liberdade",13,13,0,60,60,0
11,6,2018,4,0,3,"Braga",2,"Avenida Central",49,49,0,71,71,0
11,6,2018,4,0,3,"Braga",3,"Rua de Caires",25,25,0,4,4,0
11,6,2018,4,0,3,"Braga",4,"N14 Bosch",47,47,0,48,48,0
11,6,2018,4,0,3,"Braga",5,"Avenida João Paulo II",39,39,0,9,9,0
11,6,2018,4,0,3,"Braga",6,"Avenida Padre Júlio Fragata",62,62,0,21,21,0
11,6,2018,4,0,3,"Braga",7,"Rua Nova Santa Cruz",44,44,0,39,39,0
11,6,2018,4,0,3,"Braga",8,"Rua Costa Gomes",41,41,0,42,42,0
11,6,2018,5,0,3,"Braga",1,"Avenida da Liberdade",13,13,0,60,60,0
11,6,2018,5,0,3,"Braga",2,"Avenida Central",49,49,0,71,71,0
11,6,2018,5,0,3,"Braga",3,"Rua de Caires",25,25,0,4,4,0
11,6,2018,5,0,3,"Braga",4,"N14 Bosch",47,47,0,48,48,0
11,6,2018,5,0,3,"Braga",5,"Avenida João Paulo II",39,39,0,9,9,0
11,6,2018,5,0,3,"Braga",6,"Avenida Padre Júlio Fragata",62,62,0,21,21,0
11,6,2018,5,0,3,"Braga",7,"Rua Nova Santa Cruz",44,44,0,39,39,0
11,6,2018,5,0,3,"Braga",8,"Rua Costa Gomes",41,41,0,42,42,0
11,6,2018,6,0,3,"Braga",1,"Avenida da Liberdade",13,13,0,60,60,0
11,6,2018,6,0,3,"Braga",2,"Avenida Central",49,49,0,71,71,0
11,6,2018,6,0,3,"Braga",3,"Rua de Caires",25,25,0,4,4,0
11,6,2018,6,0,3,"Braga",4,"N14 Bosch",47,47,0,48,48,0
11,6,2018,6,0,3,"Braga",5,"Avenida João Paulo II",39,39,0,9,9,0
11,6,2018,6,0,3,"Braga",6,"Avenida Padre Júlio Fragata",62,62,0,21,21,0
11,6,2018,6,0,3,"Braga",7,"Rua Nova Santa Cruz",44,44,0,39,39,0
11,6,2018,6,0,3,"Braga",8,"Rua Costa Gomes",41,41,0,42,42,0
11,6,2018,7,0,3,"Braga",1,"Avenida da Liberdade",13,13,0,60,60,0
11,6,2018,7,0,3,"Braga",2,"Avenida Central",49,49,0,71,71,0
11,6,2018,7,0,3,"Braga",3,"Rua de Caires",25,25,0,4,4,0
11,6,2018,7,0,3,"Braga",4,"N14 Bosch",47,47,0,48,48,0
11,6,2018,7,0,3,"Braga",5,"Avenida João Paulo II",39,39,0,9,9,0
11,6,2018,7,0,3,"Braga",6,"Avenida Padre Júlio Fragata",62,62,0,21,21,0
11,6,2018,7,0,3,"Braga",7,"Rua Nova Santa Cruz",44,44,0,39,39,0
11,6,2018,7,0,3,"Braga",8,"Rua Costa Gomes",41,41,0,42,42,0
11,6,2018,8,0,3,"Braga",1,"Avenida da Liberdade",13,13,0,60,60,0
11,6,2018,8,0,3,"Braga",2,"Avenida Central",37,49,12,94,71,23
11,6,2018,8,0,3,"Braga",3,"Rua de Caires",25,25,0,4,4,0
11,6,2018,8,0,3,"Braga",4,"N14 Bosch",36,47,11,62,48,14
11,6,2018,8,0,3,"Braga",5,"Avenida João Paulo II",39,39,0,9,9,0
11,6,2018,8,0,3,"Braga",6,"Avenida Padre Júlio Fragata",62,62,0,21,21,0
11,6,2018,8,0,3,"Braga",7,"Rua Nova Santa Cruz",44,44,0,39,39,0
11,6,2018,8,0,3,"Braga",8,"Rua Costa Gomes",41,41,0,42,42,0
11,6,2018,9,0,3,"Braga",1,"Avenida da Liberdade",13,13,0,60,60,0
11,6,2018,9,0,3,"Braga",2,"Avenida Central",25,49,24,139,71,68
11,6,2018,9,0,3,"Braga",3,"Rua de Caires",13,25,12,8,4,4
11,6,2018,9,0,3,"Braga",4,"N14 Bosch",20,47,27,112,48,64
11,6,2018,9,0,3,"Braga",5,"Avenida João Paulo II",6,39,33,58,9,49
11,6,2018,9,0,3,"Braga",6,"Avenida Padre Júlio Fragata",27,62,35,48,21,27
11,6,2018,9,0,3,"Braga",7,"Rua Nova Santa Cruz",19,44,25,91,39,52
11,6,2018,9,0,3,"Braga",8,"Rua Costa Gomes",22,41,19,79,42,37
11,6,2018,10,0,3,"Braga",1,"Avenida da Liberdade",13,13,0,60,60,0
11,6,2018,10,0,3,"Braga",2,"Avenida Central",29,49,20,119,71,48
11,6,2018,10,0,3,"Braga",3,"Rua de Caires",25,25,0,4,4,0
11,6,2018,10,0,3,"Braga",4,"N14 Bosch",47,47,0,48,48,0
11,6,2018,10,0,3,"Braga",5,"Avenida João Paulo II",39,39,0,9,9,0
11,6,2018,10,0,3,"Braga",6,"Avenida Padre Júlio Fragata",62,62,0,21,21,0
11,6,2018,10,0,3,"Braga",7,"Rua Nova Santa Cruz",44,44,0,39,39,0
11,6,2018,10,0,3,"Braga",8,"Rua Costa Gomes",41,41,0,42,42,0
11,6,2018,11,0,3,"Braga",1,"Avenida da Liberdade",13,13,0,60,60,0
11,6,2018,11,0,3,"Braga",2,"Avenida Central",49,49,0,71,71,0
11,6,2018,11,0,3,"Braga",3,"Rua de Caires",25,25,0,4,4,0
11,6,2018,11,0,3,"Braga",4,"N14 Bosch",32,47,15,70,48,22
11,6,2018,11,0,3,"Braga",5,"Avenida João Paulo II",39,39,0,9,9,0
11,6,2018,11,0,3,"Braga",6,"Avenida Padre Júlio Fragata",62,62,0,21,21,0
11,6,2018,11,0,3,"Braga",7,"Rua Nova Santa Cruz",44,44,0,39,39,0
11,6,2018,11,0,3,"Braga",8,"Rua Costa Gomes",23,41,18,75,42,33
11,6,2018,12,0,3,"Braga",1,"Avenida da Liberdade",13,13,0,60,60,0
11,6,2018,12,0,3,"Braga",2,"Avenida Central",49,49,0,71,71,0
11,6,2018,12,0,3,"Braga",3,"Rua de Caires",25,25,0,4,4,0
11,6,2018,12,0,3,"Braga",4,"N14 Bosch",47,47,0,48,48,0
11,6,2018,12,0,3,"Braga",5,"Avenida João Paulo II",39,39,0,9,9,0
11,6,2018,12,0,3,"Braga",6,"Avenida Padre Júlio Fragata",62,62,0,21,21,0
11,6,2018,12,0,3,"Braga",7,"Rua Nova Santa Cruz",44,44,0,39,39,0
11,6,2018,12,0,3,"Braga",8,"Rua Costa Gomes",30,41,11,58,42,16
11,6,2018,13,0,3,"Braga",1,"Avenida da Liberdade",13,13,0,60,60,0
11,6,2018,13,0,3,"Braga",2,"Avenida Central",49,49,0,71,71,0
11,6,2018,13,0,3,"Braga",3,"Rua de Caires",25,25,0,4,4,0
11,6,2018,13,0,3,"Braga",4,"N14 Bosch",18,47,29,125,48,77
11,6,2018,13,0,3,"Braga",5,"Avenida João Paulo II",39,39,0,9,9,0
11,6,2018,13,0,3,"Braga",6,"Avenida Padre Júlio Fragata",46,62,16,28,21,7
11,6,2018,13,0,3,"Braga",7,"Rua Nova Santa Cruz",10,44,34,173,39,134
11,6,2018,13,0,3,"Braga",8,"Rua Costa Gomes",23,41,18,75,42,33
11,6,2018,14,0,3,"Braga",1,"Avenida da Liberdade",6,13,7,130,60,70
11,6,2018,14,0,3,"Braga",2,"Avenida Central",49,49,0,71,71,0
11,6,2018,14,0,3,"Braga",3,"Rua de Caires",25,25,0,4,4,0
11,6,2018,14,0,3,"Braga",4,"N14 Bosch",22,47,25,102,48,54
11,6,2018,14,0,3,"Braga",5,"Avenida João Paulo II",39,39,0,9,9,0
11,6,2018,14,0,3,"Braga",6,"Avenida Padre Júlio Fragata",45,62,17,29,21,8
11,6,2018,14,0,3,"Braga",7,"Rua Nova Santa Cruz",30,44,14,58,39,19
11,6,2018,14,0,3,"Braga",8,"Rua Costa Gomes",29,41,12,60,42,18
11,6,2018,15,0,3,"Braga",1,"Avenida da Liberdade",8,13,5,97,60,37
11,6,2018,15,0,3,"Braga",2,"Avenida Central",38,49,11,91,71,20
11,6,2018,15,0,3,"Braga",3,"Rua de Caires",25,25,0,4,4,0
11,6,2018,15,0,3,"Braga",4,"N14 Bosch",18,47,29,125,48,77
11,6,2018,15,0,3,"Braga",5,"Avenida João Paulo II",39,39,0,9,9,0
11,6,2018,15,0,3,"Braga",6,"Avenida Padre Júlio Fragata",30,62,32,43,21,22
11,6,2018,15,0,3,"Braga",7,"Rua Nova Santa Cruz",33,44,11,52,39,13
11,6,2018,15,0,3,"Braga",8,"Rua Costa Gomes",29,41,12,60,42,18
11,6,2018,16,0,3,"Braga",1,"Avenida da Liberdade",13,13,0,60,60,0
11,6,2018,16,0,3,"Braga",2,"Avenida Central",29,49,20,119,71,48
11,6,2018,16,0,3,"Braga",3,"Rua de Caires",25,25,0,4,4,0
11,6,2018,16,0,3,"Braga",4,"N14 Bosch",21,47,26,107,48,59
11,6,2018,16,0,3,"Braga",5,"Avenida João Paulo II",39,39,0,9,9,0
11,6,2018,16,0,3,"Braga",6,"Avenida Padre Júlio Fragata",33,62,29,39,21,18
11,6,2018,16,0,3,"Braga",7,"Rua Nova Santa Cruz",21,44,23,82,39,43
11,6,2018,16,0,3,"Braga",8,"Rua Costa Gomes",28,41,13,62,42,20
11,6,2018,17,0,3,"Braga",1,"Avenida da Liberdade",13,13,0,60,60,0
11,6,2018,17,0,3,"Braga",2,"Avenida Central",49,49,0,71,71,0
11,6,2018,17,0,3,"Braga",3,"Rua de Caires",25,25,0,4,4,0
11,6,2018,17,0,3,"Braga",4,"N14 Bosch",36,47,11,62,48,14
11,6,2018,17,0,3,"Braga",5,"Avenida João Paulo II",28,39,11,12,9,3
11,6,2018,17,0,3,"Braga",6,"Avenida Padre Júlio Fragata",26,62,36,49,21,28
11,6,2018,17,0,3,"Braga",7,"Rua Nova Santa Cruz",32,44,12,54,39,15
11,6,2018,17,0,3,"Braga",8,"Rua Costa Gomes",24,41,17,72,42,30
11,6,2018,18,0,3,"Braga",1,"Avenida da Liberdade",13,13,0,60,60,0
11,6,2018,18,0,3,"Braga",2,"Avenida Central",34,49,15,102,71,31
11,6,2018,18,0,3,"Braga",3,"Rua de Caires",18,25,7,6,4,2
11,6,2018,18,0,3,"Braga",4,"N14 Bosch",17,47,30,132,48,84
11,6,2018,18,0,3,"Braga",5,"Avenida João Paulo II",13,39,26,27,9,18
11,6,2018,18,0,3,"Braga",6,"Avenida Padre Júlio Fragata",22,62,40,58,21,37
11,6,2018,18,0,3,"Braga",7,"Rua Nova Santa Cruz",5,44,39,346,39,307
11,6,2018,18,0,3,"Braga",8,"Rua Costa Gomes",22,41,19,79,42,37
11,6,2018,19,0,3,"Braga",1,"Avenida da Liberdade",13,13,0,60,60,0
11,6,2018,19,0,3,"Braga",2,"Avenida Central",49,49,0,71,71,0
11,6,2018,19,0,3,"Braga",3,"Rua de Caires",6,25,19,17,4,13
11,6,2018,19,0,3,"Braga",4,"N14 Bosch",27,47,20,83,48,35
11,6,2018,19,0,3,"Braga",5,"Avenida João Paulo II",39,39,0,9,9,0
11,6,2018,19,0,3,"Braga",6,"Avenida Padre Júlio Fragata",40,62,22,32,21,11
11,6,2018,19,0,3,"Braga",7,"Rua Nova Santa Cruz",18,44,26,96,39,57
11,6,2018,19,0,3,"Braga",8,"Rua Costa Gomes",16,41,25,108,42,66
11,6,2018,20,0,3,"Braga",1,"Avenida da Liberdade",13,13,0,60,60,0
11,6,2018,20,0,3,"Braga",2,"Avenida Central",35,49,14,99,71,28
11,6,2018,20,0,3,"Braga",3,"Rua de Caires",25,25,0,4,4,0
11,6,2018,20,0,3,"Braga",4,"N14 Bosch",36,47,11,62,48,14
11,6,2018,20,0,3,"Braga",5,"Avenida João Paulo II",39,39,0,9,9,0
11,6,2018,20,0,3,"Braga",6,"Avenida Padre Júlio Fragata",47,62,15,27,21,6
11,6,2018,20,0,3,"Braga",7,"Rua Nova Santa Cruz",7,44,37,247,39,208
11,6,2018,20,0,3,"Braga",8,"Rua Costa Gomes",25,41,16,69,42,27
11,6,2018,21,0,3,"Braga",1,"Avenida da Liberdade",13,13,0,60,60,0
11,6,2018,21,0,3,"Braga",2,"Avenida Central",49,49,0,71,71,0
11,6,2018,21,0,3,"Braga",3,"Rua de Caires",19,25,6,5,4,1
11,6,2018,21,0,3,"Braga",4,"N14 Bosch",47,47,0,48,48,0
11,6,2018,21,0,3,"Braga",5,"Avenida João Paulo II",39,39,0,9,9,0
11,6,2018,21,0,3,"Braga",6,"Avenida Padre Júlio Fragata",45,62,17,29,21,8
11,6,2018,21,0,3,"Braga",7,"Rua Nova Santa Cruz",8,44,36,216,39,177
11,6,2018,21,0,3,"Braga",8,"Rua Costa Gomes",31,41,10,56,42,14
11,6,2018,22,0,3,"Braga",1,"Avenida da Liberdade",13,13,0,60,60,0
11,6,2018,22,0,3,"Braga",2,"Avenida Central",49,49,0,71,71,0
11,6,2018,22,0,3,"Braga",3,"Rua de Caires",25,25,0,4,4,0
11,6,2018,22,0,3,"Braga",4,"N14 Bosch",47,47,0,48,48,0
11,6,2018,22,0,3,"Braga",5,"Avenida João Paulo II",39,39,0,9,9,0
11,6,2018,22,0,3,"Braga",6,"Avenida Padre Júlio Fragata",33,62,29,39,21,18
11,6,2018,22,0,3,"Braga",7,"Rua Nova Santa Cruz",44,44,0,39,39,0
11,6,2018,22,0,3,"Braga",8,"Rua Costa Gomes",41,41,0,42,42,0
11,6,2018,23,0,3,"Braga",1,"Avenida da Liberdade",13,13,0,60,60,0
11,6,2018,23,0,3,"Braga",2,"Avenida Central",49,49,0,71,71,0
11,6,2018,23,0,3,"Braga",3,"Rua de Caires",25,25,0,4,4,0
11,6,2018,23,0,3,"Braga",4,"N14 Bosch",47,47,0,48,48,0
11,6,2018,23,0,3,"Braga",5,"Avenida João Paulo II",39,39,0,9,9,0
11,6,2018,23,0,3,"Braga",6,"Avenida Padre Júlio Fragata",62,62,0,21,21,0
11,6,2018,23,0,3,"Braga",7,"Rua Nova Santa Cruz",44,44,0,39,39,0
11,6,2018,23,0,3,"Braga",8,"Rua Costa Gomes",41,41,0,42,42,0
11,7,2018,0,0,4,"Braga",1,"Avenida da Liberdade",13,13,0,60,60,0
11,7,2018,0,0,4,"Braga",2,"Avenida Central",49,49,0,71,71,0
11,7,2018,0,0,4,"Braga",3,"Rua de Caires",25,25,0,4,4,0
11,7,2018,0,0,4,"Braga",4,"N14 Bosch",47,47,0,48,48,0
11,7,2018,0,0,4,"Braga",5,"Avenida João Paulo II",39,39,0,9,9,0
11,7,2018,0,0,4,"Braga",6,"Avenida Padre Júlio Fragata",62,62,0,21,21,0
11,7,2018,0,0,4,"Braga",7,"Rua Nova Santa Cruz",44,44,0,39,39,0
11,7,2018,0,0,4,"Braga",8,"Rua Costa Gomes",41,41,0,42,42,0
11,7,2018,1,0,4,"Braga",1,"Avenida da Liberdade",13,13,0,60,60,0
11,7,2018,1,0,4,"Braga",2,"Avenida Central",49,49,0,71,71,0
11,7,2018,1,0,4,"Braga",3,"Rua de Caires",25,25,0,4,4,0
11,7,2018,1,0,4,"Braga",4,"N14 Bosch",47,47,0,48,48,0
11,7,2018,1,0,4,"Braga",5,"Avenida João Paulo II",39,39,0,9,9,0
11,7,2018,1,0,4,"Braga",6,"Avenida Padre Júlio Fragata",62,62,0,21,21,0
11,7,2018,1,0,4,"Braga",7,"Rua Nova Santa Cruz",44,44,0,39,39,0
11,7,2018,1,0,4,"Braga",8,"Rua Costa Gomes",41,41,0,42,42,0
11,7,2018,2,0,4,"Braga",1,"Avenida da Liberdade",13,13,0,60,60,0
11,7,2018,2,0,4,"Braga",2,"Avenida Central",49,49,0,71,71,0
11,7,2018,2,0,4,"Braga",3,"Rua de Caires",25,25,0,4,4,0
11,7,2018,2,0,4,"Braga",4,"N14 Bosch",47,47,0,48,48,0
11,7,2018,2,0,4,"Braga",5,"Avenida João Paulo II",39,39,0,9,9,0
11,7,2018,2,0,4,"Braga",6,"Avenida Padre Júlio Fragata",62,62,0,21,21,0
11,7,2018,2,0,4,"Braga",7,"Rua Nova Santa Cruz",44,44,0,39,39,0
11,7,2018,2,0,4,"Braga",8,"Rua Costa Gomes",41,41,0,42,42,0
11,7,2018,3,0,4,"Braga",1,"Avenida da Liberdade",13,13,0,60,60,0
11,7,2018,3,0,4,"Braga",2,"Avenida Central",49,49,0,71,71,0
11,7,2018,3,0,4,"Braga",3,"Rua de Caires",25,25,0,4,4,0
11,7,2018,3,0,4,"Braga",4,"N14 Bosch",47,47,0,48,48,0
11,7,2018,3,0,4,"Braga",5,"Avenida João Paulo II",39,39,0,9,9,0
11,7,2018,3,0,4,"Braga",6,"Avenida Padre Júlio Fragata",62,62,0,21,21,0
11,7,2018,3,0,4,"Braga",7,"Rua Nova Santa Cruz",44,44,0,39,39,0
11,7,2018,3,0,4,"Braga",8,"Rua Costa Gomes",41,41,0,42,42,0
11,7,2018,4,0,4,"Braga",1,"Avenida da Liberdade",13,13,0,60,60,0
11,7,2018,4,0,4,"Braga",2,"Avenida Central",49,49,0,71,71,0
11,7,2018,4,0,4,"Braga",3,"Rua de Caires",25,25,0,4,4,0
11,7,2018,4,0,4,"Braga",4,"N14 Bosch",47,47,0,48,48,0
11,7,2018,4,0,4,"Braga",5,"Avenida João Paulo II",39,39,0,9,9,0
11,7,2018,4,0,4,"Braga",6,"Avenida Padre Júlio Fragata",62,62,0,21,21,0
11,7,2018,4,0,4,"Braga",7,"Rua Nova Santa Cruz",44,44,0,39,39,0
11,7,2018,4,0,4,"Braga",8,"Rua Costa Gomes",41,41,0,42,42,0
11,7,2018,5,0,4,"Braga",1,"Avenida da Liberdade",13,13,0,60,60,0
11,7,2018,5,0,4,"Braga",2,"Avenida Central",49,49,0,71,71,0
11,7,2018,5,0,4,"Braga",3,"Rua de Caires",25,25,0,4,4,0
11,7,2018,5,0,4,"Braga",4,"N14 Bosch",47,47,0,48,48,0
11,7,2018,5,0,4,"Braga",5,"Avenida João Paulo II",39,39,0,9,9,0
11,7,2018,5,0,4,"Braga",6,"Avenida Padre Júlio Fragata",62,62,0,21,21,0
11,7,2018,5,0,4,"Braga",7,"Rua Nova Santa Cruz",44,44,0,39,39,0
11,7,2018,5,0,4,"Braga",8,"Rua Costa Gomes",41,41,0,42,42,0
11,7,2018,6,0,4,"Braga",1,"Avenida da Liberdade",13,13,0,60,60,0
11,7,2018,6,0,4,"Braga",2,"Avenida Central",49,49,0,71,71,0
11,7,2018,6,0,4,"Braga",3,"Rua de Caires",25,25,0,4,4,0
11,7,2018,6,0,4,"Braga",4,"N14 Bosch",47,47,0,48,48,0
11,7,2018,6,0,4,"Braga",5,"Avenida João Paulo II",39,39,0,9,9,0
11,7,2018,6,0,4,"Braga",6,"Avenida Padre Júlio Fragata",62,62,0,21,21,0
11,7,2018,6,0,4,"Braga",7,"Rua Nova Santa Cruz",44,44,0,39,39,0
11,7,2018,6,0,4,"Braga",8,"Rua Costa Gomes",41,41,0,42,42,0
11,7,2018,7,0,4,"Braga",1,"Avenida da Liberdade",9,13,4,86,60,26
11,7,2018,7,0,4,"Braga",2,"Avenida Central",49,49,0,71,71,0
11,7,2018,7,0,4,"Braga",3,"Rua de Caires",25,25,0,4,4,0
11,7,2018,7,0,4,"Braga",4,"N14 Bosch",47,47,0,48,48,0
11,7,2018,7,0,4,"Braga",5,"Avenida João Paulo II",39,39,0,9,9,0
11,7,2018,7,0,4,"Braga",6,"Avenida Padre Júlio Fragata",62,62,0,21,21,0
11,7,2018,7,0,4,"Braga",7,"Rua Nova Santa Cruz",44,44,0,39,39,0
11,7,2018,7,0,4,"Braga",8,"Rua Costa Gomes",41,41,0,42,42,0
11,7,2018,8,0,4,"Braga",1,"Avenida da Liberdade",13,13,0,60,60,0
11,7,2018,8,0,4,"Braga",2,"Avenida Central",35,49,14,99,71,28
11,7,2018,8,0,4,"Braga",3,"Rua de Caires",25,25,0,4,4,0
11,7,2018,8,0,4,"Braga",4,"N14 Bosch",35,47,12,64,48,16
11,7,2018,8,0,4,"Braga",5,"Avenida João Paulo II",39,39,0,9,9,0
11,7,2018,8,0,4,"Braga",6,"Avenida Padre Júlio Fragata",62,62,0,21,21,0
11,7,2018,8,0,4,"Braga",7,"Rua Nova Santa Cruz",44,44,0,39,39,0
11,7,2018,8,0,4,"Braga",8,"Rua Costa Gomes",41,41,0,42,42,0
11,7,2018,9,0,4,"Braga",1,"Avenida da Liberdade",9,13,4,86,60,26
11,7,2018,9,0,4,"Braga",2,"Avenida Central",30,49,19,115,71,44
11,7,2018,9,0,4,"Braga",3,"Rua de Caires",25,25,0,4,4,0
11,7,2018,9,0,4,"Braga",4,"N14 Bosch",29,47,18,77,48,29
11,7,2018,9,0,4,"Braga",5,"Avenida João Paulo II",39,39,0,9,9,0
11,7,2018,9,0,4,"Braga",6,"Avenida Padre Júlio Fragata",40,62,22,32,21,11
11,7,2018,9,0,4,"Braga",7,"Rua Nova Santa Cruz",20,44,24,86,39,47
11,7,2018,9,0,4,"Braga",8,"Rua Costa Gomes",32,41,9,54,42,12
11,7,2018,10,0,4,"Braga",1,"Avenida da Liberdade",13,13,0,60,60,0
11,7,2018,10,0,4,"Braga",2,"Avenida Central",49,49,0,71,71,0
11,7,2018,10,0,4,"Braga",3,"Rua de Caires",25,25,0,4,4,0
11,7,2018,10,0,4,"Braga",4,"N14 Bosch",20,47,27,112,48,64
11,7,2018,10,0,4,"Braga",5,"Avenida João Paulo II",39,39,0,9,9,0
11,7,2018,10,0,4,"Braga",6,"Avenida Padre Júlio Fragata",62,62,0,21,21,0
11,7,2018,10,0,4,"Braga",7,"Rua Nova Santa Cruz",21,44,23,82,39,43
11,7,2018,10,0,4,"Braga",8,"Rua Costa Gomes",29,41,12,60,42,18
11,7,2018,11,0,4,"Braga",1,"Avenida da Liberdade",13,13,0,60,60,0
11,7,2018,11,0,4,"Braga",2,"Avenida Central",49,49,0,71,71,0
11,7,2018,11,0,4,"Braga",3,"Rua de Caires",25,25,0,4,4,0
11,7,2018,11,0,4,"Braga",4,"N14 Bosch",47,47,0,48,48,0
11,7,2018,11,0,4,"Braga",5,"Avenida João Paulo II",39,39,0,9,9,0
11,7,2018,11,0,4,"Braga",6,"Avenida Padre Júlio Fragata",62,62,0,21,21,0
11,7,2018,11,0,4,"Braga",7,"Rua Nova Santa Cruz",31,44,13,56,39,17
11,7,2018,11,0,4,"Braga",8,"Rua Costa Gomes",20,41,21,87,42,45
11,7,2018,12,0,4,"Braga",1,"Avenida da Liberdade",13,13,0,60,60,0
11,7,2018,12,0,4,"Braga",2,"Avenida Central",49,49,0,71,71,0
11,7,2018,12,0,4,"Braga",3,"Rua de Caires",19,25,6,5,4,1
11,7,2018,12,0,4,"Braga",4,"N14 Bosch",47,47,0,48,48,0
11,7,2018,12,0,4,"Braga",5,"Avenida João Paulo II",39,39,0,9,9,0
11,7,2018,12,0,4,"Braga",6,"Avenida Padre Júlio Fragata",48,62,14,27,21,6
11,7,2018,12,0,4,"Braga",7,"Rua Nova Santa Cruz",44,44,0,39,39,0
11,7,2018,12,0,4,"Braga",8,"Rua Costa Gomes",25,41,16,69,42,27
11,7,2018,13,0,4,"Braga",1,"Avenida da Liberdade",13,13,0,60,60,0
11,7,2018,13,0,4,"Braga",2,"Avenida Central",49,49,0,71,71,0
11,7,2018,13,0,4,"Braga",3,"Rua de Caires",25,25,0,4,4,0
11,7,2018,13,0,4,"Braga",4,"N14 Bosch",32,47,15,70,48,22
11,7,2018,13,0,4,"Braga",5,"Avenida João Paulo II",39,39,0,9,9,0
11,7,2018,13,0,4,"Braga",6,"Avenida Padre Júlio Fragata",62,62,0,21,21,0
11,7,2018,13,0,4,"Braga",7,"Rua Nova Santa Cruz",7,44,37,247,39,208
11,7,2018,13,0,4,"Braga",8,"Rua Costa Gomes",41,41,0,42,42,0
11,7,2018,14,0,4,"Braga",1,"Avenida da Liberdade",13,13,0,60,60,0
11,7,2018,14,0,4,"Braga",2,"Avenida Central",49,49,0,71,71,0
11,7,2018,14,0,4,"Braga",3,"Rua de Caires",25,25,0,4,4,0
11,7,2018,14,0,4,"Braga",4,"N14 Bosch",15,47,32,150,48,102
11,7,2018,14,0,4,"Braga",5,"Avenida João Paulo II",29,39,10,12,9,3
11,7,2018,14,0,4,"Braga",6,"Avenida Padre Júlio Fragata",39,62,23,33,21,12
11,7,2018,14,0,4,"Braga",7,"Rua Nova Santa Cruz",44,44,0,39,39,0
11,7,2018,14,0,4,"Braga",8,"Rua Costa Gomes",41,41,0,42,42,0
11,7,2018,15,0,4,"Braga",1,"Avenida da Liberdade",13,13,0,60,60,0
11,7,2018,15,0,4,"Braga",2,"Avenida Central",49,49,0,71,71,0
11,7,2018,15,0,4,"Braga",3,"Rua de Caires",25,25,0,4,4,0
11,7,2018,15,0,4,"Braga",4,"N14 Bosch",31,47,16,72,48,24
11,7,2018,15,0,4,"Braga",5,"Avenida João Paulo II",29,39,10,12,9,3
11,7,2018,15,0,4,"Braga",6,"Avenida Padre Júlio Fragata",62,62,0,21,21,0
11,7,2018,15,0,4,"Braga",7,"Rua Nova Santa Cruz",29,44,15,60,39,21
11,7,2018,15,0,4,"Braga",8,"Rua Costa Gomes",29,41,12,60,42,18
11,7,2018,16,0,4,"Braga",1,"Avenida da Liberdade",13,13,0,60,60,0
11,7,2018,16,0,4,"Braga",2,"Avenida Central",33,49,16,105,71,34
11,7,2018,16,0,4,"Braga",3,"Rua de Caires",25,25,0,4,4,0
11,7,2018,16,0,4,"Braga",4,"N14 Bosch",24,47,23,94,48,46
11,7,2018,16,0,4,"Braga",5,"Avenida João Paulo II",39,39,0,9,9,0
11,7,2018,16,0,4,"Braga",6,"Avenida Padre Júlio Fragata",34,62,28,38,21,17
11,7,2018,16,0,4,"Braga",7,"Rua Nova Santa Cruz",31,44,13,56,39,17
11,7,2018,16,0,4,"Braga",8,"Rua Costa Gomes",41,41,0,42,42,0
11,7,2018,17,0,4,"Braga",1,"Avenida da Liberdade",13,13,0,60,60,0
11,7,2018,17,0,4,"Braga",2,"Avenida Central",35,49,14,99,71,28
11,7,2018,17,0,4,"Braga",3,"Rua de Caires",25,25,0,4,4,0
11,7,2018,17,0,4,"Braga",4,"N14 Bosch",7,47,40,321,48,273
11,7,2018,17,0,4,"Braga",5,"Avenida João Paulo II",26,39,13,13,9,4
11,7,2018,17,0,4,"Braga",6,"Avenida Padre Júlio Fragata",32,62,30,40,21,19
11,7,2018,17,0,4,"Braga",7,"Rua Nova Santa Cruz",16,44,28,108,39,69
11,7,2018,17,0,4,"Braga",8,"Rua Costa Gomes",41,41,0,42,42,0
11,7,2018,18,0,4,"Braga",1,"Avenida da Liberdade",13,13,0,60,60,0
11,7,2018,18,0,4,"Braga",2,"Avenida Central",38,49,11,91,71,20
11,7,2018,18,0,4,"Braga",3,"Rua de Caires",14,25,11,7,4,3
11,7,2018,18,0,4,"Braga",4,"N14 Bosch",16,47,31,140,48,92
11,7,2018,18,0,4,"Braga",5,"Avenida João Paulo II",17,39,22,21,9,12
11,7,2018,18,0,4,"Braga",6,"Avenida Padre Júlio Fragata",23,62,39,56,21,35
11,7,2018,18,0,4,"Braga",7,"Rua Nova Santa Cruz",17,44,27,102,39,63
11,7,2018,18,0,4,"Braga",8,"Rua Costa Gomes",9,41,32,192,42,150
11,7,2018,19,0,4,"Braga",1,"Avenida da Liberdade",13,13,0,60,60,0
11,7,2018,19,0,4,"Braga",2,"Avenida Central",49,49,0,71,71,0
11,7,2018,19,0,4,"Braga",3,"Rua de Caires",13,25,12,8,4,4
11,7,2018,19,0,4,"Braga",4,"N14 Bosch",22,47,25,102,48,54
11,7,2018,19,0,4,"Braga",5,"Avenida João Paulo II",24,39,15,15,9,6
11,7,2018,19,0,4,"Braga",6,"Avenida Padre Júlio Fragata",31,62,31,41,21,20
11,7,2018,19,0,4,"Braga",7,"Rua Nova Santa Cruz",17,44,27,102,39,63
11,7,2018,19,0,4,"Braga",8,"Rua Costa Gomes",9,41,32,192,42,150
11,7,2018,20,0,4,"Braga",1,"Avenida da Liberdade",13,13,0,60,60,0
11,7,2018,20,0,4,"Braga",2,"Avenida Central",49,49,0,71,71,0
11,7,2018,20,0,4,"Braga",3,"Rua de Caires",19,25,6,5,4,1
11,7,2018,20,0,4,"Braga",4,"N14 Bosch",47,47,0,48,48,0
11,7,2018,20,0,4,"Braga",5,"Avenida João Paulo II",39,39,0,9,9,0
11,7,2018,20,0,4,"Braga",6,"Avenida Padre Júlio Fragata",62,62,0,21,21,0
11,7,2018,20,0,4,"Braga",7,"Rua Nova Santa Cruz",23,44,21,75,39,36
11,7,2018,20,0,4,"Braga",8,"Rua Costa Gomes",24,41,17,72,42,30
11,7,2018,21,0,4,"Braga",1,"Avenida da Liberdade",13,13,0,60,60,0
11,7,2018,21,0,4,"Braga",2,"Avenida Central",49,49,0,71,71,0
11,7,2018,21,0,4,"Braga",3,"Rua de Caires",25,25,0,4,4,0
11,7,2018,21,0,4,"Braga",4,"N14 Bosch",47,47,0,48,48,0
11,7,2018,21,0,4,"Braga",5,"Avenida João Paulo II",39,39,0,9,9,0
11,7,2018,21,0,4,"Braga",6,"Avenida Padre Júlio Fragata",62,62,0,21,21,0
11,7,2018,21,0,4,"Braga",7,"Rua Nova Santa Cruz",33,44,11,52,39,13
11,7,2018,21,0,4,"Braga",8,"Rua Costa Gomes",41,41,0,42,42,0
11,7,2018,22,0,4,"Braga",1,"Avenida da Liberdade",13,13,0,60,60,0
11,7,2018,22,0,4,"Braga",2,"Avenida Central",49,49,0,71,71,0
11,7,2018,22,0,4,"Braga",3,"Rua de Caires",25,25,0,4,4,0
11,7,2018,22,0,4,"Braga",4,"N14 Bosch",47,47,0,48,48,0
11,7,2018,22,0,4,"Braga",5,"Avenida João Paulo II",39,39,0,9,9,0
11,7,2018,22,0,4,"Braga",6,"Avenida Padre Júlio Fragata",49,62,13,26,21,5
11,7,2018,22,0,4,"Braga",7,"Rua Nova Santa Cruz",20,44,24,86,39,47
11,7,2018,22,0,4,"Braga",8,"Rua Costa Gomes",41,41,0,42,42,0
11,7,2018,23,0,4,"Braga",1,"Avenida da Liberdade",13,13,0,60,60,0
11,7,2018,23,0,4,"Braga",2,"Avenida Central",49,49,0,71,71,0
11,7,2018,23,0,4,"Braga",3,"Rua de Caires",25,25,0,4,4,0
11,7,2018,23,0,4,"Braga",4,"N14 Bosch",47,47,0,48,48,0
11,7,2018,23,0,4,"Braga",5,"Avenida João Paulo II",39,39,0,9,9,0
11,7,2018,23,0,4,"Braga",6,"Avenida Padre Júlio Fragata",62,62,0,21,21,0
11,7,2018,23,0,4,"Braga",7,"Rua Nova Santa Cruz",44,44,0,39,39,0
11,7,2018,23,0,4,"Braga",8,"Rua Costa Gomes",41,41,0,42,42,0
11,8,2018,0,0,5,"Braga",1,"Avenida da Liberdade",13,13,0,60,60,0
11,8,2018,0,0,5,"Braga",2,"Avenida Central",49,49,0,71,71,0
11,8,2018,0,0,5,"Braga",3,"Rua de Caires",25,25,0,4,4,0
11,8,2018,0,0,5,"Braga",4,"N14 Bosch",47,47,0,48,48,0
11,8,2018,0,0,5,"Braga",5,"Avenida João Paulo II",39,39,0,9,9,0
11,8,2018,0,0,5,"Braga",6,"Avenida Padre Júlio Fragata",62,62,0,21,21,0
11,8,2018,0,0,5,"Braga",7,"Rua Nova Santa Cruz",44,44,0,39,39,0
11,8,2018,0,0,5,"Braga",8,"Rua Costa Gomes",41,41,0,42,42,0
11,8,2018,1,0,5,"Braga",1,"Avenida da Liberdade",13,13,0,60,60,0
11,8,2018,1,0,5,"Braga",2,"Avenida Central",49,49,0,71,71,0
11,8,2018,1,0,5,"Braga",3,"Rua de Caires",25,25,0,4,4,0
11,8,2018,1,0,5,"Braga",4,"N14 Bosch",47,47,0,48,48,0
11,8,2018,1,0,5,"Braga",5,"Avenida João Paulo II",39,39,0,9,9,0
11,8,2018,1,0,5,"Braga",6,"Avenida Padre Júlio Fragata",62,62,0,21,21,0
11,8,2018,1,0,5,"Braga",7,"Rua Nova Santa Cruz",44,44,0,39,39,0
11,8,2018,1,0,5,"Braga",8,"Rua Costa Gomes",41,41,0,42,42,0
11,8,2018,2,0,5,"Braga",1,"Avenida da Liberdade",13,13,0,60,60,0
11,8,2018,2,0,5,"Braga",2,"Avenida Central",49,49,0,71,71,0
11,8,2018,2,0,5,"Braga",3,"Rua de Caires",25,25,0,4,4,0
11,8,2018,2,0,5,"Braga",4,"N14 Bosch",47,47,0,48,48,0
11,8,2018,2,0,5,"Braga",5,"Avenida João Paulo II",39,39,0,9,9,0
11,8,2018,2,0,5,"Braga",6,"Avenida Padre Júlio Fragata",62,62,0,21,21,0
11,8,2018,2,0,5,"Braga",7,"Rua Nova Santa Cruz",44,44,0,39,39,0
11,8,2018,2,0,5,"Braga",8,"Rua Costa Gomes",41,41,0,42,42,0
11,8,2018,3,0,5,"Braga",1,"Avenida da Liberdade",13,13,0,60,60,0
11,8,2018,3,0,5,"Braga",2,"Avenida Central",49,49,0,71,71,0
11,8,2018,3,0,5,"Braga",3,"Rua de Caires",25,25,0,4,4,0
11,8,2018,3,0,5,"Braga",4,"N14 Bosch",47,47,0,48,48,0
11,8,2018,3,0,5,"Braga",5,"Avenida João Paulo II",39,39,0,9,9,0
11,8,2018,3,0,5,"Braga",6,"Avenida Padre Júlio Fragata",62,62,0,21,21,0
11,8,2018,3,0,5,"Braga",7,"Rua Nova Santa Cruz",44,44,0,39,39,0
11,8,2018,3,0,5,"Braga",8,"Rua Costa Gomes",41,41,0,42,42,0
11,8,2018,4,0,5,"Braga",1,"Avenida da Liberdade",13,13,0,60,60,0
11,8,2018,4,0,5,"Braga",2,"Avenida Central",49,49,0,71,71,0
11,8,2018,4,0,5,"Braga",3,"Rua de Caires",25,25,0,4,4,0
11,8,2018,4,0,5,"Braga",4,"N14 Bosch",47,47,0,48,48,0
11,8,2018,4,0,5,"Braga",5,"Avenida João Paulo II",39,39,0,9,9,0
11,8,2018,4,0,5,"Braga",6,"Avenida Padre Júlio Fragata",62,62,0,21,21,0
11,8,2018,4,0,5,"Braga",7,"Rua Nova Santa Cruz",44,44,0,39,39,0
11,8,2018,4,0,5,"Braga",8,"Rua Costa Gomes",41,41,0,42,42,0
11,8,2018,5,0,5,"Braga",1,"Avenida da Liberdade",13,13,0,60,60,0
11,8,2018,5,0,5,"Braga",2,"Avenida Central",49,49,0,71,71,0
11,8,2018,5,0,5,"Braga",3,"Rua de Caires",25,25,0,4,4,0
11,8,2018,5,0,5,"Braga",4,"N14 Bosch",47,47,0,48,48,0
11,8,2018,5,0,5,"Braga",5,"Avenida João Paulo II",39,39,0,9,9,0
11,8,2018,5,0,5,"Braga",6,"Avenida Padre Júlio Fragata",62,62,0,21,21,0
11,8,2018,5,0,5,"Braga",7,"Rua Nova Santa Cruz",44,44,0,39,39,0
11,8,2018,5,0,5,"Braga",8,"Rua Costa Gomes",41,41,0,42,42,0
11,8,2018,6,0,5,"Braga",1,"Avenida da Liberdade",13,13,0,60,60,0
11,8,2018,6,0,5,"Braga",2,"Avenida Central",49,49,0,71,71,0
11,8,2018,6,0,5,"Braga",3,"Rua de Caires",25,25,0,4,4,0
11,8,2018,6,0,5,"Braga",4,"N14 Bosch",47,47,0,48,48,0
11,8,2018,6,0,5,"Braga",5,"Avenida João Paulo II",39,39,0,9,9,0
11,8,2018,6,0,5,"Braga",6,"Avenida Padre Júlio Fragata",62,62,0,21,21,0
11,8,2018,6,0,5,"Braga",7,"Rua Nova Santa Cruz",44,44,0,39,39,0
11,8,2018,6,0,5,"Braga",8,"Rua Costa Gomes",41,41,0,42,42,0
11,8,2018,7,0,5,"Braga",1,"Avenida da Liberdade",13,13,0,60,60,0
11,8,2018,7,0,5,"Braga",2,"Avenida Central",49,49,0,71,71,0
11,8,2018,7,0,5,"Braga",3,"Rua de Caires",8,25,17,13,4,9
11,8,2018,7,0,5,"Braga",4,"N14 Bosch",47,47,0,48,48,0
11,8,2018,7,0,5,"Braga",5,"Avenida João Paulo II",39,39,0,9,9,0
11,8,2018,7,0,5,"Braga",6,"Avenida Padre Júlio Fragata",62,62,0,21,21,0
11,8,2018,7,0,5,"Braga",7,"Rua Nova Santa Cruz",44,44,0,39,39,0
11,8,2018,7,0,5,"Braga",8,"Rua Costa Gomes",41,41,0,42,42,0
11,8,2018,8,0,5,"Braga",1,"Avenida da Liberdade",13,13,0,60,60,0
11,8,2018,8,0,5,"Braga",2,"Avenida Central",37,49,12,94,71,23
11,8,2018,8,0,5,"Braga",3,"Rua de Caires",15,25,10,7,4,3
11,8,2018,8,0,5,"Braga",4,"N14 Bosch",29,47,18,77,48,29
11,8,2018,8,0,5,"Braga",5,"Avenida João Paulo II",39,39,0,9,9,0
11,8,2018,8,0,5,"Braga",6,"Avenida Padre Júlio Fragata",62,62,0,21,21,0
11,8,2018,8,0,5,"Braga",7,"Rua Nova Santa Cruz",20,44,24,86,39,47
11,8,2018,8,0,5,"Braga",8,"Rua Costa Gomes",41,41,0,42,42,0
11,8,2018,9,0,5,"Braga",1,"Avenida da Liberdade",9,13,4,86,60,26
11,8,2018,9,0,5,"Braga",2,"Avenida Central",15,49,34,231,71,160
11,8,2018,9,0,5,"Braga",3,"Rua de Caires",25,25,0,4,4,0
11,8,2018,9,0,5,"Braga",4,"N14 Bosch",25,47,22,90,48,42
11,8,2018,9,0,5,"Braga",5,"Avenida João Paulo II",4,39,35,87,9,78
11,8,2018,9,0,5,"Braga",6,"Avenida Padre Júlio Fragata",26,62,36,49,21,28
11,8,2018,9,0,5,"Braga",7,"Rua Nova Santa Cruz",2,44,42,864,39,825
11,8,2018,9,0,5,"Braga",8,"Rua Costa Gomes",29,41,12,60,42,18
11,8,2018,10,0,5,"Braga",1,"Avenida da Liberdade",13,13,0,60,60,0
11,8,2018,10,0,5,"Braga",2,"Avenida Central",49,49,0,71,71,0
11,8,2018,10,0,5,"Braga",3,"Rua de Caires",25,25,0,4,4,0
11,8,2018,10,0,5,"Braga",4,"N14 Bosch",47,47,0,48,48,0
11,8,2018,10,0,5,"Braga",5,"Avenida João Paulo II",29,39,10,12,9,3
11,8,2018,10,0,5,"Braga",6,"Avenida Padre Júlio Fragata",46,62,16,28,21,7
11,8,2018,10,0,5,"Braga",7,"Rua Nova Santa Cruz",30,44,14,58,39,19
11,8,2018,10,0,5,"Braga",8,"Rua Costa Gomes",29,41,12,60,42,18
11,8,2018,11,0,5,"Braga",1,"Avenida da Liberdade",13,13,0,60,60,0
11,8,2018,11,0,5,"Braga",2,"Avenida Central",36,49,13,96,71,25
11,8,2018,11,0,5,"Braga",3,"Rua de Caires",18,25,7,6,4,2
11,8,2018,11,0,5,"Braga",4,"N14 Bosch",30,47,17,75,48,27
11,8,2018,11,0,5,"Braga",5,"Avenida João Paulo II",30,39,9,12,9,3
11,8,2018,11,0,5,"Braga",6,"Avenida Padre Júlio Fragata",62,62,0,21,21,0
11,8,2018,11,0,5,"Braga",7,"Rua Nova Santa Cruz",24,44,20,72,39,33
11,8,2018,11,0,5,"Braga",8,"Rua Costa Gomes",41,41,0,42,42,0
11,8,2018,12,0,5,"Braga",1,"Avenida da Liberdade",13,13,0,60,60,0
11,8,2018,12,0,5,"Braga",2,"Avenida Central",49,49,0,71,71,0
11,8,2018,12,0,5,"Braga",3,"Rua de Caires",25,25,0,4,4,0
11,8,2018,12,0,5,"Braga",4,"N14 Bosch",33,47,14,68,48,20
11,8,2018,12,0,5,"Braga",5,"Avenida João Paulo II",39,39,0,9,9,0
11,8,2018,12,0,5,"Braga",6,"Avenida Padre Júlio Fragata",62,62,0,21,21,0
11,8,2018,12,0,5,"Braga",7,"Rua Nova Santa Cruz",44,44,0,39,39,0
11,8,2018,12,0,5,"Braga",8,"Rua Costa Gomes",31,41,10,56,42,14
11,8,2018,13,0,5,"Braga",1,"Avenida da Liberdade",13,13,0,60,60,0
11,8,2018,13,0,5,"Braga",2,"Avenida Central",49,49,0,71,71,0
11,8,2018,13,0,5,"Braga",3,"Rua de Caires",25,25,0,4,4,0
11,8,2018,13,0,5,"Braga",4,"N14 Bosch",30,47,17,75,48,27
11,8,2018,13,0,5,"Braga",5,"Avenida João Paulo II",39,39,0,9,9,0
11,8,2018,13,0,5,"Braga",6,"Avenida Padre Júlio Fragata",62,62,0,21,21,0
11,8,2018,13,0,5,"Braga",7,"Rua Nova Santa Cruz",25,44,19,69,39,30
11,8,2018,13,0,5,"Braga",8,"Rua Costa Gomes",15,41,26,115,42,73
11,8,2018,14,0,5,"Braga",1,"Avenida da Liberdade",8,13,5,97,60,37
11,8,2018,14,0,5,"Braga",2,"Avenida Central",49,49,0,71,71,0
11,8,2018,14,0,5,"Braga",3,"Rua de Caires",25,25,0,4,4,0
11,8,2018,14,0,5,"Braga",4,"N14 Bosch",34,47,13,66,48,18
11,8,2018,14,0,5,"Braga",5,"Avenida João Paulo II",39,39,0,9,9,0
11,8,2018,14,0,5,"Braga",6,"Avenida Padre Júlio Fragata",62,62,0,21,21,0
11,8,2018,14,0,5,"Braga",7,"Rua Nova Santa Cruz",10,44,34,173,39,134
11,8,2018,14,0,5,"Braga",8,"Rua Costa Gomes",31,41,10,56,42,14
11,8,2018,15,0,5,"Braga",1,"Avenida da Liberdade",13,13,0,60,60,0
11,8,2018,15,0,5,"Braga",2,"Avenida Central",49,49,0,71,71,0
11,8,2018,15,0,5,"Braga",3,"Rua de Caires",25,25,0,4,4,0
11,8,2018,15,0,5,"Braga",4,"N14 Bosch",17,47,30,132,48,84
11,8,2018,15,0,5,"Braga",5,"Avenida João Paulo II",39,39,0,9,9,0
11,8,2018,15,0,5,"Braga",6,"Avenida Padre Júlio Fragata",45,62,17,29,21,8
11,8,2018,15,0,5,"Braga",7,"Rua Nova Santa Cruz",33,44,11,52,39,13
11,8,2018,15,0,5,"Braga",8,"Rua Costa Gomes",29,41,12,60,42,18
11,8,2018,16,0,5,"Braga",1,"Avenida da Liberdade",13,13,0,60,60,0
11,8,2018,16,0,5,"Braga",2,"Avenida Central",49,49,0,71,71,0
11,8,2018,16,0,5,"Braga",3,"Rua de Caires",25,25,0,4,4,0
11,8,2018,16,0,5,"Braga",4,"N14 Bosch",34,47,13,66,48,18
11,8,2018,16,0,5,"Braga",5,"Avenida João Paulo II",39,39,0,9,9,0
11,8,2018,16,0,5,"Braga",6,"Avenida Padre Júlio Fragata",45,62,17,29,21,8
11,8,2018,16,0,5,"Braga",7,"Rua Nova Santa Cruz",29,44,15,60,39,21
11,8,2018,16,0,5,"Braga",8,"Rua Costa Gomes",30,41,11,58,42,16
11,8,2018,17,0,5,"Braga",1,"Avenida da Liberdade",10,13,3,78,60,18
11,8,2018,17,0,5,"Braga",2,"Avenida Central",30,49,19,115,71,44
11,8,2018,17,0,5,"Braga",3,"Rua de Caires",25,25,0,4,4,0
11,8,2018,17,0,5,"Braga",4,"N14 Bosch",24,47,23,94,48,46
11,8,2018,17,0,5,"Braga",5,"Avenida João Paulo II",39,39,0,9,9,0
11,8,2018,17,0,5,"Braga",6,"Avenida Padre Júlio Fragata",48,62,14,27,21,6
11,8,2018,17,0,5,"Braga",7,"Rua Nova Santa Cruz",21,44,23,82,39,43
11,8,2018,17,0,5,"Braga",8,"Rua Costa Gomes",31,41,10,56,42,14
11,8,2018,18,0,5,"Braga",1,"Avenida da Liberdade",7,13,6,111,60,51
11,8,2018,18,0,5,"Braga",2,"Avenida Central",30,49,19,115,71,44
11,8,2018,18,0,5,"Braga",3,"Rua de Caires",25,25,0,4,4,0
11,8,2018,18,0,5,"Braga",4,"N14 Bosch",13,47,34,173,48,125
11,8,2018,18,0,5,"Braga",5,"Avenida João Paulo II",15,39,24,23,9,14
11,8,2018,18,0,5,"Braga",6,"Avenida Padre Júlio Fragata",18,62,44,71,21,50
11,8,2018,18,0,5,"Braga",7,"Rua Nova Santa Cruz",4,44,40,432,39,393
11,8,2018,18,0,5,"Braga",8,"Rua Costa Gomes",9,41,32,192,42,150
11,8,2018,19,0,5,"Braga",1,"Avenida da Liberdade",13,13,0,60,60,0
11,8,2018,19,0,5,"Braga",2,"Avenida Central",35,49,14,99,71,28
11,8,2018,19,0,5,"Braga",3,"Rua de Caires",8,25,17,13,4,9
11,8,2018,19,0,5,"Braga",4,"N14 Bosch",47,47,0,48,48,0
11,8,2018,19,0,5,"Braga",5,"Avenida João Paulo II",9,39,30,39,9,30
11,8,2018,19,0,5,"Braga",6,"Avenida Padre Júlio Fragata",17,62,45,76,21,55
11,8,2018,19,0,5,"Braga",7,"Rua Nova Santa Cruz",30,44,14,58,39,19
11,8,2018,19,0,5,"Braga",8,"Rua Costa Gomes",8,41,33,216,42,174
11,8,2018,20,0,5,"Braga",1,"Avenida da Liberdade",13,13,0,60,60,0
11,8,2018,20,0,5,"Braga",2,"Avenida Central",49,49,0,71,71,0
11,8,2018,20,0,5,"Braga",3,"Rua de Caires",25,25,0,4,4,0
11,8,2018,20,0,5,"Braga",4,"N14 Bosch",47,47,0,48,48,0
11,8,2018,20,0,5,"Braga",5,"Avenida João Paulo II",39,39,0,9,9,0
11,8,2018,20,0,5,"Braga",6,"Avenida Padre Júlio Fragata",24,62,38,54,21,33
11,8,2018,20,0,5,"Braga",7,"Rua Nova Santa Cruz",27,44,17,64,39,25
11,8,2018,20,0,5,"Braga",8,"Rua Costa Gomes",25,41,16,69,42,27
11,8,2018,21,0,5,"Braga",1,"Avenida da Liberdade",13,13,0,60,60,0
11,8,2018,21,0,5,"Braga",2,"Avenida Central",49,49,0,71,71,0
11,8,2018,21,0,5,"Braga",3,"Rua de Caires",18,25,7,6,4,2
11,8,2018,21,0,5,"Braga",4,"N14 Bosch",47,47,0,48,48,0
11,8,2018,21,0,5,"Braga",5,"Avenida João Paulo II",39,39,0,9,9,0
11,8,2018,21,0,5,"Braga",6,"Avenida Padre Júlio Fragata",62,62,0,21,21,0
11,8,2018,21,0,5,"Braga",7,"Rua Nova Santa Cruz",44,44,0,39,39,0
11,8,2018,21,0,5,"Braga",8,"Rua Costa Gomes",41,41,0,42,42,0
11,8,2018,22,0,5,"Braga",1,"Avenida da Liberdade",13,13,0,60,60,0
11,8,2018,22,0,5,"Braga",2,"Avenida Central",49,49,0,71,71,0
11,8,2018,22,0,5,"Braga",3,"Rua de Caires",25,25,0,4,4,0
11,8,2018,22,0,5,"Braga",4,"N14 Bosch",47,47,0,48,48,0
11,8,2018,22,0,5,"Braga",5,"Avenida João Paulo II",39,39,0,9,9,0
11,8,2018,22,0,5,"Braga",6,"Avenida Padre Júlio Fragata",62,62,0,21,21,0
11,8,2018,22,0,5,"Braga",7,"Rua Nova Santa Cruz",44,44,0,39,39,0
11,8,2018,22,0,5,"Braga",8,"Rua Costa Gomes",41,41,0,42,42,0
11,8,2018,23,0,5,"Braga",1,"Avenida da Liberdade",13,13,0,60,60,0
11,8,2018,23,0,5,"Braga",2,"Avenida Central",49,49,0,71,71,0
11,8,2018,23,0,5,"Braga",3,"Rua de Caires",25,25,0,4,4,0
11,8,2018,23,0,5,"Braga",4,"N14 Bosch",47,47,0,48,48,0
11,8,2018,23,0,5,"Braga",5,"Avenida João Paulo II",39,39,0,9,9,0
11,8,2018,23,0,5,"Braga",6,"Avenida Padre Júlio Fragata",62,62,0,21,21,0
11,8,2018,23,0,5,"Braga",7,"Rua Nova Santa Cruz",44,44,0,39,39,0
11,8,2018,23,0,5,"Braga",8,"Rua Costa Gomes",41,41,0,42,42,0
11,9,2018,0,0,6,"Braga",1,"Avenida da Liberdade",13,13,0,60,60,0
11,9,2018,0,0,6,"Braga",2,"Avenida Central",49,49,0,71,71,0
11,9,2018,0,0,6,"Braga",3,"Rua de Caires",25,25,0,4,4,0
11,9,2018,0,0,6,"Braga",4,"N14 Bosch",47,47,0,48,48,0
11,9,2018,0,0,6,"Braga",5,"Avenida João Paulo II",39,39,0,9,9,0
11,9,2018,0,0,6,"Braga",6,"Avenida Padre Júlio Fragata",62,62,0,21,21,0
11,9,2018,0,0,6,"Braga",7,"Rua Nova Santa Cruz",44,44,0,39,39,0
11,9,2018,0,0,6,"Braga",8,"Rua Costa Gomes",41,41,0,42,42,0
11,9,2018,1,0,6,"Braga",1,"Avenida da Liberdade",13,13,0,60,60,0
11,9,2018,1,0,6,"Braga",2,"Avenida Central",49,49,0,71,71,0
11,9,2018,1,0,6,"Braga",3,"Rua de Caires",25,25,0,4,4,0
11,9,2018,1,0,6,"Braga",4,"N14 Bosch",47,47,0,48,48,0
11,9,2018,1,0,6,"Braga",5,"Avenida João Paulo II",39,39,0,9,9,0
11,9,2018,1,0,6,"Braga",6,"Avenida Padre Júlio Fragata",62,62,0,21,21,0
11,9,2018,1,0,6,"Braga",7,"Rua Nova Santa Cruz",44,44,0,39,39,0
11,9,2018,1,0,6,"Braga",8,"Rua Costa Gomes",41,41,0,42,42,0
11,9,2018,2,0,6,"Braga",1,"Avenida da Liberdade",13,13,0,60,60,0
11,9,2018,2,0,6,"Braga",2,"Avenida Central",49,49,0,71,71,0
11,9,2018,2,0,6,"Braga",3,"Rua de Caires",25,25,0,4,4,0
11,9,2018,2,0,6,"Braga",4,"N14 Bosch",47,47,0,48,48,0
11,9,2018,2,0,6,"Braga",5,"Avenida João Paulo II",39,39,0,9,9,0
11,9,2018,2,0,6,"Braga",6,"Avenida Padre Júlio Fragata",62,62,0,21,21,0
11,9,2018,2,0,6,"Braga",7,"Rua Nova Santa Cruz",44,44,0,39,39,0
11,9,2018,2,0,6,"Braga",8,"Rua Costa Gomes",41,41,0,42,42,0
11,9,2018,3,0,6,"Braga",1,"Avenida da Liberdade",13,13,0,60,60,0
11,9,2018,3,0,6,"Braga",2,"Avenida Central",49,49,0,71,71,0
11,9,2018,3,0,6,"Braga",3,"Rua de Caires",25,25,0,4,4,0
11,9,2018,3,0,6,"Braga",4,"N14 Bosch",47,47,0,48,48,0
11,9,2018,3,0,6,"Braga",5,"Avenida João Paulo II",39,39,0,9,9,0
11,9,2018,3,0,6,"Braga",6,"Avenida Padre Júlio Fragata",62,62,0,21,21,0
11,9,2018,3,0,6,"Braga",7,"Rua Nova Santa Cruz",44,44,0,39,39,0
11,9,2018,3,0,6,"Braga",8,"Rua Costa Gomes",41,41,0,42,42,0
11,9,2018,4,0,6,"Braga",1,"Avenida da Liberdade",13,13,0,60,60,0
11,9,2018,4,0,6,"Braga",2,"Avenida Central",49,49,0,71,71,0
11,9,2018,4,0,6,"Braga",3,"Rua de Caires",25,25,0,4,4,0
11,9,2018,4,0,6,"Braga",4,"N14 Bosch",47,47,0,48,48,0
11,9,2018,4,0,6,"Braga",5,"Avenida João Paulo II",39,39,0,9,9,0
11,9,2018,4,0,6,"Braga",6,"Avenida Padre Júlio Fragata",62,62,0,21,21,0
11,9,2018,4,0,6,"Braga",7,"Rua Nova Santa Cruz",44,44,0,39,39,0
11,9,2018,4,0,6,"Braga",8,"Rua Costa Gomes",41,41,0,42,42,0
11,9,2018,5,0,6,"Braga",1,"Avenida da Liberdade",13,13,0,60,60,0
11,9,2018,5,0,6,"Braga",2,"Avenida Central",49,49,0,71,71,0
11,9,2018,5,0,6,"Braga",3,"Rua de Caires",25,25,0,4,4,0
11,9,2018,5,0,6,"Braga",4,"N14 Bosch",47,47,0,48,48,0
11,9,2018,5,0,6,"Braga",5,"Avenida João Paulo II",39,39,0,9,9,0
11,9,2018,5,0,6,"Braga",6,"Avenida Padre Júlio Fragata",62,62,0,21,21,0
11,9,2018,5,0,6,"Braga",7,"Rua Nova Santa Cruz",44,44,0,39,39,0
11,9,2018,5,0,6,"Braga",8,"Rua Costa Gomes",41,41,0,42,42,0
11,9,2018,6,0,6,"Braga",1,"Avenida da Liberdade",13,13,0,60,60,0
11,9,2018,6,0,6,"Braga",2,"Avenida Central",49,49,0,71,71,0
11,9,2018,6,0,6,"Braga",3,"Rua de Caires",25,25,0,4,4,0
11,9,2018,6,0,6,"Braga",4,"N14 Bosch",47,47,0,48,48,0
11,9,2018,6,0,6,"Braga",5,"Avenida João Paulo II",39,39,0,9,9,0
11,9,2018,6,0,6,"Braga",6,"Avenida Padre Júlio Fragata",62,62,0,21,21,0
11,9,2018,6,0,6,"Braga",7,"Rua Nova Santa Cruz",44,44,0,39,39,0
11,9,2018,6,0,6,"Braga",8,"Rua Costa Gomes",41,41,0,42,42,0
11,9,2018,7,0,6,"Braga",1,"Avenida da Liberdade",9,13,4,86,60,26
11,9,2018,7,0,6,"Braga",2,"Avenida Central",49,49,0,71,71,0
11,9,2018,7,0,6,"Braga",3,"Rua de Caires",25,25,0,4,4,0
11,9,2018,7,0,6,"Braga",4,"N14 Bosch",47,47,0,48,48,0
11,9,2018,7,0,6,"Braga",5,"Avenida João Paulo II",39,39,0,9,9,0
11,9,2018,7,0,6,"Braga",6,"Avenida Padre Júlio Fragata",62,62,0,21,21,0
11,9,2018,7,0,6,"Braga",7,"Rua Nova Santa Cruz",44,44,0,39,39,0
11,9,2018,7,0,6,"Braga",8,"Rua Costa Gomes",41,41,0,42,42,0
11,9,2018,8,0,6,"Braga",1,"Avenida da Liberdade",10,13,3,78,60,18
11,9,2018,8,0,6,"Braga",2,"Avenida Central",34,49,15,102,71,31
11,9,2018,8,0,6,"Braga",3,"Rua de Caires",19,25,6,5,4,1
11,9,2018,8,0,6,"Braga",4,"N14 Bosch",47,47,0,48,48,0
11,9,2018,8,0,6,"Braga",5,"Avenida João Paulo II",39,39,0,9,9,0
11,9,2018,8,0,6,"Braga",6,"Avenida Padre Júlio Fragata",62,62,0,21,21,0
11,9,2018,8,0,6,"Braga",7,"Rua Nova Santa Cruz",44,44,0,39,39,0
11,9,2018,8,0,6,"Braga",8,"Rua Costa Gomes",32,41,9,54,42,12
11,9,2018,9,0,6,"Braga",1,"Avenida da Liberdade",13,13,0,60,60,0
11,9,2018,9,0,6,"Braga",2,"Avenida Central",27,49,22,128,71,57
11,9,2018,9,0,6,"Braga",3,"Rua de Caires",25,25,0,4,4,0
11,9,2018,9,0,6,"Braga",4,"N14 Bosch",21,47,26,107,48,59
11,9,2018,9,0,6,"Braga",5,"Avenida João Paulo II",39,39,0,9,9,0
11,9,2018,9,0,6,"Braga",6,"Avenida Padre Júlio Fragata",43,62,19,30,21,9
11,9,2018,9,0,6,"Braga",7,"Rua Nova Santa Cruz",19,44,25,91,39,52
11,9,2018,9,0,6,"Braga",8,"Rua Costa Gomes",41,41,0,42,42,0
11,9,2018,10,0,6,"Braga",1,"Avenida da Liberdade",13,13,0,60,60,0
11,9,2018,10,0,6,"Braga",2,"Avenida Central",49,49,0,71,71,0
11,9,2018,10,0,6,"Braga",3,"Rua de Caires",25,25,0,4,4,0
11,9,2018,10,0,6,"Braga",4,"N14 Bosch",28,47,19,80,48,32
11,9,2018,10,0,6,"Braga",5,"Avenida João Paulo II",27,39,12,13,9,4
11,9,2018,10,0,6,"Braga",6,"Avenida Padre Júlio Fragata",40,62,22,32,21,11
11,9,2018,10,0,6,"Braga",7,"Rua Nova Santa Cruz",44,44,0,39,39,0
11,9,2018,10,0,6,"Braga",8,"Rua Costa Gomes",41,41,0,42,42,0
11,9,2018,11,0,6,"Braga",1,"Avenida da Liberdade",13,13,0,60,60,0
11,9,2018,11,0,6,"Braga",2,"Avenida Central",49,49,0,71,71,0
11,9,2018,11,0,6,"Braga",3,"Rua de Caires",25,25,0,4,4,0
11,9,2018,11,0,6,"Braga",4,"N14 Bosch",32,47,15,70,48,22
11,9,2018,11,0,6,"Braga",5,"Avenida João Paulo II",39,39,0,9,9,0
11,9,2018,11,0,6,"Braga",6,"Avenida Padre Júlio Fragata",41,62,21,31,21,10
11,9,2018,11,0,6,"Braga",7,"Rua Nova Santa Cruz",44,44,0,39,39,0
11,9,2018,11,0,6,"Braga",8,"Rua Costa Gomes",41,41,0,42,42,0
11,9,2018,12,0,6,"Braga",1,"Avenida da Liberdade",13,13,0,60,60,0
11,9,2018,12,0,6,"Braga",2,"Avenida Central",49,49,0,71,71,0
11,9,2018,12,0,6,"Braga",3,"Rua de Caires",25,25,0,4,4,0
11,9,2018,12,0,6,"Braga",4,"N14 Bosch",13,47,34,173,48,125
11,9,2018,12,0,6,"Braga",5,"Avenida João Paulo II",39,39,0,9,9,0
11,9,2018,12,0,6,"Braga",6,"Avenida Padre Júlio Fragata",48,62,14,27,21,6
11,9,2018,12,0,6,"Braga",7,"Rua Nova Santa Cruz",44,44,0,39,39,0
11,9,2018,12,0,6,"Braga",8,"Rua Costa Gomes",32,41,9,54,42,12
11,9,2018,13,0,6,"Braga",1,"Avenida da Liberdade",13,13,0,60,60,0
11,9,2018,13,0,6,"Braga",2,"Avenida Central",37,49,12,94,71,23
11,9,2018,13,0,6,"Braga",3,"Rua de Caires",25,25,0,4,4,0
11,9,2018,13,0,6,"Braga",4,"N14 Bosch",31,47,16,72,48,24
11,9,2018,13,0,6,"Braga",5,"Avenida João Paulo II",39,39,0,9,9,0
11,9,2018,13,0,6,"Braga",6,"Avenida Padre Júlio Fragata",41,62,21,31,21,10
11,9,2018,13,0,6,"Braga",7,"Rua Nova Santa Cruz",16,44,28,108,39,69
11,9,2018,13,0,6,"Braga",8,"Rua Costa Gomes",30,41,11,58,42,16
11,9,2018,14,0,6,"Braga",1,"Avenida da Liberdade",13,13,0,60,60,0
11,9,2018,14,0,6,"Braga",2,"Avenida Central",49,49,0,71,71,0
11,9,2018,14,0,6,"Braga",3,"Rua de Caires",25,25,0,4,4,0
11,9,2018,14,0,6,"Braga",4,"N14 Bosch",22,47,25,102,48,54
11,9,2018,14,0,6,"Braga",5,"Avenida João Paulo II",39,39,0,9,9,0
11,9,2018,14,0,6,"Braga",6,"Avenida Padre Júlio Fragata",36,62,26,36,21,15
11,9,2018,14,0,6,"Braga",7,"Rua Nova Santa Cruz",5,44,39,346,39,307
11,9,2018,14,0,6,"Braga",8,"Rua Costa Gomes",29,41,12,60,42,18
11,9,2018,15,0,6,"Braga",1,"Avenida da Liberdade",13,13,0,60,60,0
11,9,2018,15,0,6,"Braga",2,"Avenida Central",49,49,0,71,71,0
11,9,2018,15,0,6,"Braga",3,"Rua de Caires",18,25,7,6,4,2
11,9,2018,15,0,6,"Braga",4,"N14 Bosch",35,47,12,64,48,16
11,9,2018,15,0,6,"Braga",5,"Avenida João Paulo II",17,39,22,21,9,12
11,9,2018,15,0,6,"Braga",6,"Avenida Padre Júlio Fragata",47,62,15,27,21,6
11,9,2018,15,0,6,"Braga",7,"Rua Nova Santa Cruz",44,44,0,39,39,0
11,9,2018,15,0,6,"Braga",8,"Rua Costa Gomes",30,41,11,58,42,16
11,9,2018,16,0,6,"Braga",1,"Avenida da Liberdade",13,13,0,60,60,0
11,9,2018,16,0,6,"Braga",2,"Avenida Central",49,49,0,71,71,0
11,9,2018,16,0,6,"Braga",3,"Rua de Caires",16,25,9,7,4,3
11,9,2018,16,0,6,"Braga",4,"N14 Bosch",15,47,32,150,48,102
11,9,2018,16,0,6,"Braga",5,"Avenida João Paulo II",39,39,0,9,9,0
11,9,2018,16,0,6,"Braga",6,"Avenida Padre Júlio Fragata",26,62,36,49,21,28
11,9,2018,16,0,6,"Braga",7,"Rua Nova Santa Cruz",23,44,21,75,39,36
11,9,2018,16,0,6,"Braga",8,"Rua Costa Gomes",22,41,19,79,42,37
11,9,2018,17,0,6,"Braga",1,"Avenida da Liberdade",13,13,0,60,60,0
11,9,2018,17,0,6,"Braga",2,"Avenida Central",37,49,12,94,71,23
11,9,2018,17,0,6,"Braga",3,"Rua de Caires",3,25,22,35,4,31
11,9,2018,17,0,6,"Braga",4,"N14 Bosch",10,47,37,225,48,177
11,9,2018,17,0,6,"Braga",5,"Avenida João Paulo II",39,39,0,9,9,0
11,9,2018,17,0,6,"Braga",6,"Avenida Padre Júlio Fragata",25,62,37,51,21,30
11,9,2018,17,0,6,"Braga",7,"Rua Nova Santa Cruz",13,44,31,133,39,94
11,9,2018,17,0,6,"Braga",8,"Rua Costa Gomes",17,41,24,102,42,60
11,9,2018,18,0,6,"Braga",1,"Avenida da Liberdade",13,13,0,60,60,0
11,9,2018,18,0,6,"Braga",2,"Avenida Central",49,49,0,71,71,0
11,9,2018,18,0,6,"Braga",3,"Rua de Caires",15,25,10,7,4,3
11,9,2018,18,0,6,"Braga",4,"N14 Bosch",11,47,36,204,48,156
11,9,2018,18,0,6,"Braga",5,"Avenida João Paulo II",3,39,36,116,9,107
11,9,2018,18,0,6,"Braga",6,"Avenida Padre Júlio Fragata",14,62,48,92,21,71
11,9,2018,18,0,6,"Braga",7,"Rua Nova Santa Cruz",7,44,37,247,39,208
11,9,2018,18,0,6,"Braga",8,"Rua Costa Gomes",11,41,30,157,42,115
11,9,2018,19,0,6,"Braga",1,"Avenida da Liberdade",13,13,0,60,60,0
11,9,2018,19,0,6,"Braga",2,"Avenida Central",12,49,37,289,71,218
11,9,2018,19,0,6,"Braga",3,"Rua de Caires",1,25,24,104,4,100
11,9,2018,19,0,6,"Braga",4,"N14 Bosch",27,47,20,83,48,35
11,9,2018,19,0,6,"Braga",5,"Avenida João Paulo II",39,39,0,9,9,0
11,9,2018,19,0,6,"Braga",6,"Avenida Padre Júlio Fragata",26,62,36,49,21,28
11,9,2018,19,0,6,"Braga",7,"Rua Nova Santa Cruz",33,44,11,52,39,13
11,9,2018,19,0,6,"Braga",8,"Rua Costa Gomes",4,41,37,433,42,391
11,9,2018,20,0,6,"Braga",1,"Avenida da Liberdade",13,13,0,60,60,0
11,9,2018,20,0,6,"Braga",2,"Avenida Central",37,49,12,94,71,23
11,9,2018,20,0,6,"Braga",3,"Rua de Caires",4,25,21,26,4,22
11,9,2018,20,0,6,"Braga",4,"N14 Bosch",18,47,29,125,48,77
11,9,2018,20,0,6,"Braga",5,"Avenida João Paulo II",39,39,0,9,9,0
11,9,2018,20,0,6,"Braga",6,"Avenida Padre Júlio Fragata",27,62,35,48,21,27
11,9,2018,20,0,6,"Braga",7,"Rua Nova Santa Cruz",21,44,23,82,39,43
11,9,2018,20,0,6,"Braga",8,"Rua Costa Gomes",23,41,18,75,42,33
11,9,2018,21,0,6,"Braga",1,"Avenida da Liberdade",13,13,0,60,60,0
11,9,2018,21,0,6,"Braga",2,"Avenida Central",38,49,11,91,71,20
11,9,2018,21,0,6,"Braga",3,"Rua de Caires",25,25,0,4,4,0
11,9,2018,21,0,6,"Braga",4,"N14 Bosch",47,47,0,48,48,0
11,9,2018,21,0,6,"Braga",5,"Avenida João Paulo II",39,39,0,9,9,0
11,9,2018,21,0,6,"Braga",6,"Avenida Padre Júlio Fragata",39,62,23,33,21,12
11,9,2018,21,0,6,"Braga",7,"Rua Nova Santa Cruz",28,44,16,62,39,23
11,9,2018,21,0,6,"Braga",8,"Rua Costa Gomes",41,41,0,42,42,0
11,9,2018,22,0,6,"Braga",1,"Avenida da Liberdade",13,13,0,60,60,0
11,9,2018,22,0,6,"Braga",2,"Avenida Central",49,49,0,71,71,0
11,9,2018,22,0,6,"Braga",3,"Rua de Caires",25,25,0,4,4,0
11,9,2018,22,0,6,"Braga",4,"N14 Bosch",37,47,10,61,48,13
11,9,2018,22,0,6,"Braga",5,"Avenida João Paulo II",29,39,10,12,9,3
11,9,2018,22,0,6,"Braga",6,"Avenida Padre Júlio Fragata",43,62,19,30,21,9
11,9,2018,22,0,6,"Braga",7,"Rua Nova Santa Cruz",44,44,0,39,39,0
11,9,2018,22,0,6,"Braga",8,"Rua Costa Gomes",41,41,0,42,42,0
11,9,2018,23,0,6,"Braga",1,"Avenida da Liberdade",13,13,0,60,60,0
11,9,2018,23,0,6,"Braga",2,"Avenida Central",49,49,0,71,71,0
11,9,2018,23,0,6,"Braga",3,"Rua de Caires",25,25,0,4,4,0
11,9,2018,23,0,6,"Braga",4,"N14 Bosch",47,47,0,48,48,0
11,9,2018,23,0,6,"Braga",5,"Avenida João Paulo II",39,39,0,9,9,0
11,9,2018,23,0,6,"Braga",6,"Avenida Padre Júlio Fragata",32,62,30,40,21,19
11,9,2018,23,0,6,"Braga",7,"Rua Nova Santa Cruz",44,44,0,39,39,0
11,9,2018,23,0,6,"Braga",8,"Rua Costa Gomes",31,41,10,56,42,14
11,10,2018,0,0,7,"Braga",1,"Avenida da Liberdade",13,13,0,60,60,0
11,10,2018,0,0,7,"Braga",2,"Avenida Central",49,49,0,71,71,0
11,10,2018,0,0,7,"Braga",3,"Rua de Caires",25,25,0,4,4,0
11,10,2018,0,0,7,"Braga",4,"N14 Bosch",47,47,0,48,48,0
11,10,2018,0,0,7,"Braga",5,"Avenida João Paulo II",39,39,0,9,9,0
11,10,2018,0,0,7,"Braga",6,"Avenida Padre Júlio Fragata",40,62,22,32,21,11
11,10,2018,0,0,7,"Braga",7,"Rua Nova Santa Cruz",44,44,0,39,39,0
11,10,2018,0,0,7,"Braga",8,"Rua Costa Gomes",41,41,0,42,42,0
11,10,2018,1,0,7,"Braga",1,"Avenida da Liberdade",13,13,0,60,60,0
11,10,2018,1,0,7,"Braga",2,"Avenida Central",49,49,0,71,71,0
11,10,2018,1,0,7,"Braga",3,"Rua de Caires",25,25,0,4,4,0
11,10,2018,1,0,7,"Braga",4,"N14 Bosch",47,47,0,48,48,0
11,10,2018,1,0,7,"Braga",5,"Avenida João Paulo II",30,39,9,12,9,3
11,10,2018,1,0,7,"Braga",6,"Avenida Padre Júlio Fragata",62,62,0,21,21,0
11,10,2018,1,0,7,"Braga",7,"Rua Nova Santa Cruz",44,44,0,39,39,0
11,10,2018,1,0,7,"Braga",8,"Rua Costa Gomes",41,41,0,42,42,0
11,10,2018,2,0,7,"Braga",1,"Avenida da Liberdade",13,13,0,60,60,0
11,10,2018,2,0,7,"Braga",2,"Avenida Central",49,49,0,71,71,0
11,10,2018,2,0,7,"Braga",3,"Rua de Caires",25,25,0,4,4,0
11,10,2018,2,0,7,"Braga",4,"N14 Bosch",47,47,0,48,48,0
11,10,2018,2,0,7,"Braga",5,"Avenida João Paulo II",39,39,0,9,9,0
11,10,2018,2,0,7,"Braga",6,"Avenida Padre Júlio Fragata",62,62,0,21,21,0
11,10,2018,2,0,7,"Braga",7,"Rua Nova Santa Cruz",44,44,0,39,39,0
11,10,2018,2,0,7,"Braga",8,"Rua Costa Gomes",41,41,0,42,42,0
11,10,2018,3,0,7,"Braga",1,"Avenida da Liberdade",13,13,0,60,60,0
11,10,2018,3,0,7,"Braga",2,"Avenida Central",49,49,0,71,71,0
11,10,2018,3,0,7,"Braga",3,"Rua de Caires",25,25,0,4,4,0
11,10,2018,3,0,7,"Braga",4,"N14 Bosch",47,47,0,48,48,0
11,10,2018,3,0,7,"Braga",5,"Avenida João Paulo II",39,39,0,9,9,0
11,10,2018,3,0,7,"Braga",6,"Avenida Padre Júlio Fragata",62,62,0,21,21,0
11,10,2018,3,0,7,"Braga",7,"Rua Nova Santa Cruz",44,44,0,39,39,0
11,10,2018,3,0,7,"Braga",8,"Rua Costa Gomes",41,41,0,42,42,0
11,10,2018,4,0,7,"Braga",1,"Avenida da Liberdade",13,13,0,60,60,0
11,10,2018,4,0,7,"Braga",2,"Avenida Central",49,49,0,71,71,0
11,10,2018,4,0,7,"Braga",3,"Rua de Caires",25,25,0,4,4,0
11,10,2018,4,0,7,"Braga",4,"N14 Bosch",47,47,0,48,48,0
11,10,2018,4,0,7,"Braga",5,"Avenida João Paulo II",39,39,0,9,9,0
11,10,2018,4,0,7,"Braga",6,"Avenida Padre Júlio Fragata",62,62,0,21,21,0
11,10,2018,4,0,7,"Braga",7,"Rua Nova Santa Cruz",44,44,0,39,39,0
11,10,2018,4,0,7,"Braga",8,"Rua Costa Gomes",41,41,0,42,42,0
11,10,2018,5,0,7,"Braga",1,"Avenida da Liberdade",13,13,0,60,60,0
11,10,2018,5,0,7,"Braga",2,"Avenida Central",49,49,0,71,71,0
11,10,2018,5,0,7,"Braga",3,"Rua de Caires",25,25,0,4,4,0
11,10,2018,5,0,7,"Braga",4,"N14 Bosch",47,47,0,48,48,0
11,10,2018,5,0,7,"Braga",5,"Avenida João Paulo II",39,39,0,9,9,0
11,10,2018,5,0,7,"Braga",6,"Avenida Padre Júlio Fragata",62,62,0,21,21,0
11,10,2018,5,0,7,"Braga",7,"Rua Nova Santa Cruz",44,44,0,39,39,0
11,10,2018,5,0,7,"Braga",8,"Rua Costa Gomes",41,41,0,42,42,0
11,10,2018,6,0,7,"Braga",1,"Avenida da Liberdade",13,13,0,60,60,0
11,10,2018,6,0,7,"Braga",2,"Avenida Central",49,49,0,71,71,0
11,10,2018,6,0,7,"Braga",3,"Rua de Caires",25,25,0,4,4,0
11,10,2018,6,0,7,"Braga",4,"N14 Bosch",47,47,0,48,48,0
11,10,2018,6,0,7,"Braga",5,"Avenida João Paulo II",39,39,0,9,9,0
11,10,2018,6,0,7,"Braga",6,"Avenida Padre Júlio Fragata",62,62,0,21,21,0
11,10,2018,6,0,7,"Braga",7,"Rua Nova Santa Cruz",44,44,0,39,39,0
11,10,2018,6,0,7,"Braga",8,"Rua Costa Gomes",41,41,0,42,42,0
11,10,2018,7,0,7,"Braga",1,"Avenida da Liberdade",13,13,0,60,60,0
11,10,2018,7,0,7,"Braga",2,"Avenida Central",49,49,0,71,71,0
11,10,2018,7,0,7,"Braga",3,"Rua de Caires",25,25,0,4,4,0
11,10,2018,7,0,7,"Braga",4,"N14 Bosch",47,47,0,48,48,0
11,10,2018,7,0,7,"Braga",5,"Avenida João Paulo II",39,39,0,9,9,0
11,10,2018,7,0,7,"Braga",6,"Avenida Padre Júlio Fragata",62,62,0,21,21,0
11,10,2018,7,0,7,"Braga",7,"Rua Nova Santa Cruz",44,44,0,39,39,0
11,10,2018,7,0,7,"Braga",8,"Rua Costa Gomes",41,41,0,42,42,0
11,10,2018,8,0,7,"Braga",1,"Avenida da Liberdade",13,13,0,60,60,0
11,10,2018,8,0,7,"Braga",2,"Avenida Central",49,49,0,71,71,0
11,10,2018,8,0,7,"Braga",3,"Rua de Caires",25,25,0,4,4,0
11,10,2018,8,0,7,"Braga",4,"N14 Bosch",47,47,0,48,48,0
11,10,2018,8,0,7,"Braga",5,"Avenida João Paulo II",39,39,0,9,9,0
11,10,2018,8,0,7,"Braga",6,"Avenida Padre Júlio Fragata",62,62,0,21,21,0
11,10,2018,8,0,7,"Braga",7,"Rua Nova Santa Cruz",44,44,0,39,39,0
11,10,2018,8,0,7,"Braga",8,"Rua Costa Gomes",41,41,0,42,42,0
11,10,2018,9,0,7,"Braga",1,"Avenida da Liberdade",13,13,0,60,60,0
11,10,2018,9,0,7,"Braga",2,"Avenida Central",49,49,0,71,71,0
11,10,2018,9,0,7,"Braga",3,"Rua de Caires",19,25,6,5,4,1
11,10,2018,9,0,7,"Braga",4,"N14 Bosch",47,47,0,48,48,0
11,10,2018,9,0,7,"Braga",5,"Avenida João Paulo II",39,39,0,9,9,0
11,10,2018,9,0,7,"Braga",6,"Avenida Padre Júlio Fragata",62,62,0,21,21,0
11,10,2018,9,0,7,"Braga",7,"Rua Nova Santa Cruz",44,44,0,39,39,0
11,10,2018,9,0,7,"Braga",8,"Rua Costa Gomes",29,41,12,60,42,18
11,10,2018,10,0,7,"Braga",1,"Avenida da Liberdade",13,13,0,60,60,0
11,10,2018,10,0,7,"Braga",2,"Avenida Central",49,49,0,71,71,0
11,10,2018,10,0,7,"Braga",3,"Rua de Caires",25,25,0,4,4,0
11,10,2018,10,0,7,"Braga",4,"N14 Bosch",36,47,11,62,48,14
11,10,2018,10,0,7,"Braga",5,"Avenida João Paulo II",39,39,0,9,9,0
11,10,2018,10,0,7,"Braga",6,"Avenida Padre Júlio Fragata",62,62,0,21,21,0
11,10,2018,10,0,7,"Braga",7,"Rua Nova Santa Cruz",44,44,0,39,39,0
11,10,2018,10,0,7,"Braga",8,"Rua Costa Gomes",32,41,9,54,42,12
11,10,2018,11,0,7,"Braga",1,"Avenida da Liberdade",13,13,0,60,60,0
11,10,2018,11,0,7,"Braga",2,"Avenida Central",49,49,0,71,71,0
11,10,2018,11,0,7,"Braga",3,"Rua de Caires",25,25,0,4,4,0
11,10,2018,11,0,7,"Braga",4,"N14 Bosch",37,47,10,61,48,13
11,10,2018,11,0,7,"Braga",5,"Avenida João Paulo II",39,39,0,9,9,0
11,10,2018,11,0,7,"Braga",6,"Avenida Padre Júlio Fragata",62,62,0,21,21,0
11,10,2018,11,0,7,"Braga",7,"Rua Nova Santa Cruz",44,44,0,39,39,0
11,10,2018,11,0,7,"Braga",8,"Rua Costa Gomes",27,41,14,64,42,22
11,10,2018,12,0,7,"Braga",1,"Avenida da Liberdade",13,13,0,60,60,0
11,10,2018,12,0,7,"Braga",2,"Avenida Central",49,49,0,71,71,0
11,10,2018,12,0,7,"Braga",3,"Rua de Caires",25,25,0,4,4,0
11,10,2018,12,0,7,"Braga",4,"N14 Bosch",30,47,17,75,48,27
11,10,2018,12,0,7,"Braga",5,"Avenida João Paulo II",20,39,19,17,9,8
11,10,2018,12,0,7,"Braga",6,"Avenida Padre Júlio Fragata",62,62,0,21,21,0
11,10,2018,12,0,7,"Braga",7,"Rua Nova Santa Cruz",44,44,0,39,39,0
11,10,2018,12,0,7,"Braga",8,"Rua Costa Gomes",41,41,0,42,42,0
11,10,2018,13,0,7,"Braga",1,"Avenida da Liberdade",13,13,0,60,60,0
11,10,2018,13,0,7,"Braga",2,"Avenida Central",49,49,0,71,71,0
11,10,2018,13,0,7,"Braga",3,"Rua de Caires",18,25,7,6,4,2
11,10,2018,13,0,7,"Braga",4,"N14 Bosch",47,47,0,48,48,0
11,10,2018,13,0,7,"Braga",5,"Avenida João Paulo II",39,39,0,9,9,0
11,10,2018,13,0,7,"Braga",6,"Avenida Padre Júlio Fragata",38,62,24,34,21,13
11,10,2018,13,0,7,"Braga",7,"Rua Nova Santa Cruz",44,44,0,39,39,0
11,10,2018,13,0,7,"Braga",8,"Rua Costa Gomes",28,41,13,62,42,20
11,10,2018,14,0,7,"Braga",1,"Avenida da Liberdade",13,13,0,60,60,0
11,10,2018,14,0,7,"Braga",2,"Avenida Central",49,49,0,71,71,0
11,10,2018,14,0,7,"Braga",3,"Rua de Caires",25,25,0,4,4,0
11,10,2018,14,0,7,"Braga",4,"N14 Bosch",35,47,12,64,48,16
11,10,2018,14,0,7,"Braga",5,"Avenida João Paulo II",39,39,0,9,9,0
11,10,2018,14,0,7,"Braga",6,"Avenida Padre Júlio Fragata",39,62,23,33,21,12
11,10,2018,14,0,7,"Braga",7,"Rua Nova Santa Cruz",44,44,0,39,39,0
11,10,2018,14,0,7,"Braga",8,"Rua Costa Gomes",41,41,0,42,42,0
11,10,2018,15,0,7,"Braga",1,"Avenida da Liberdade",13,13,0,60,60,0
11,10,2018,15,0,7,"Braga",2,"Avenida Central",49,49,0,71,71,0
11,10,2018,15,0,7,"Braga",3,"Rua de Caires",25,25,0,4,4,0
11,10,2018,15,0,7,"Braga",4,"N14 Bosch",47,47,0,48,48,0
11,10,2018,15,0,7,"Braga",5,"Avenida João Paulo II",6,39,33,58,9,49
11,10,2018,15,0,7,"Braga",6,"Avenida Padre Júlio Fragata",36,62,26,36,21,15
11,10,2018,15,0,7,"Braga",7,"Rua Nova Santa Cruz",44,44,0,39,39,0
11,10,2018,15,0,7,"Braga",8,"Rua Costa Gomes",31,41,10,56,42,14
11,10,2018,16,0,7,"Braga",1,"Avenida da Liberdade",13,13,0,60,60,0
11,10,2018,16,0,7,"Braga",2,"Avenida Central",49,49,0,71,71,0
11,10,2018,16,0,7,"Braga",3,"Rua de Caires",25,25,0,4,4,0
11,10,2018,16,0,7,"Braga",4,"N14 Bosch",47,47,0,48,48,0
11,10,2018,16,0,7,"Braga",5,"Avenida João Paulo II",15,39,24,23,9,14
11,10,2018,16,0,7,"Braga",6,"Avenida Padre Júlio Fragata",35,62,27,37,21,16
11,10,2018,16,0,7,"Braga",7,"Rua Nova Santa Cruz",44,44,0,39,39,0
11,10,2018,16,0,7,"Braga",8,"Rua Costa Gomes",30,41,11,58,42,16
11,10,2018,17,0,7,"Braga",1,"Avenida da Liberdade",13,13,0,60,60,0
11,10,2018,17,0,7,"Braga",2,"Avenida Central",49,49,0,71,71,0
11,10,2018,17,0,7,"Braga",3,"Rua de Caires",25,25,0,4,4,0
11,10,2018,17,0,7,"Braga",4,"N14 Bosch",33,47,14,68,48,20
11,10,2018,17,0,7,"Braga",5,"Avenida João Paulo II",39,39,0,9,9,0
11,10,2018,17,0,7,"Braga",6,"Avenida Padre Júlio Fragata",28,62,34,46,21,25
11,10,2018,17,0,7,"Braga",7,"Rua Nova Santa Cruz",44,44,0,39,39,0
11,10,2018,17,0,7,"Braga",8,"Rua Costa Gomes",31,41,10,56,42,14
11,10,2018,18,0,7,"Braga",1,"Avenida da Liberdade",13,13,0,60,60,0
11,10,2018,18,0,7,"Braga",2,"Avenida Central",38,49,11,91,71,20
11,10,2018,18,0,7,"Braga",3,"Rua de Caires",16,25,9,7,4,3
11,10,2018,18,0,7,"Braga",4,"N14 Bosch",32,47,15,70,48,22
11,10,2018,18,0,7,"Braga",5,"Avenida João Paulo II",10,39,29,35,9,26
11,10,2018,18,0,7,"Braga",6,"Avenida Padre Júlio Fragata",33,62,29,39,21,18
11,10,2018,18,0,7,"Braga",7,"Rua Nova Santa Cruz",44,44,0,39,39,0
11,10,2018,18,0,7,"Braga",8,"Rua Costa Gomes",22,41,19,79,42,37
11,10,2018,19,0,7,"Braga",1,"Avenida da Liberdade",13,13,0,60,60,0
11,10,2018,19,0,7,"Braga",2,"Avenida Central",49,49,0,71,71,0
11,10,2018,19,0,7,"Braga",3,"Rua de Caires",25,25,0,4,4,0
11,10,2018,19,0,7,"Braga",4,"N14 Bosch",47,47,0,48,48,0
11,10,2018,19,0,7,"Braga",5,"Avenida João Paulo II",31,39,8,11,9,2
11,10,2018,19,0,7,"Braga",6,"Avenida Padre Júlio Fragata",42,62,20,31,21,10
11,10,2018,19,0,7,"Braga",7,"Rua Nova Santa Cruz",44,44,0,39,39,0
11,10,2018,19,0,7,"Braga",8,"Rua Costa Gomes",25,41,16,69,42,27
11,10,2018,20,0,7,"Braga",1,"Avenida da Liberdade",13,13,0,60,60,0
11,10,2018,20,0,7,"Braga",2,"Avenida Central",49,49,0,71,71,0
11,10,2018,20,0,7,"Braga",3,"Rua de Caires",17,25,8,6,4,2
11,10,2018,20,0,7,"Braga",4,"N14 Bosch",47,47,0,48,48,0
11,10,2018,20,0,7,"Braga",5,"Avenida João Paulo II",39,39,0,9,9,0
11,10,2018,20,0,7,"Braga",6,"Avenida Padre Júlio Fragata",48,62,14,27,21,6
11,10,2018,20,0,7,"Braga",7,"Rua Nova Santa Cruz",34,44,10,51,39,12
11,10,2018,20,0,7,"Braga",8,"Rua Costa Gomes",41,41,0,42,42,0
11,10,2018,21,0,7,"Braga",1,"Avenida da Liberdade",13,13,0,60,60,0
11,10,2018,21,0,7,"Braga",2,"Avenida Central",49,49,0,71,71,0
11,10,2018,21,0,7,"Braga",3,"Rua de Caires",25,25,0,4,4,0
11,10,2018,21,0,7,"Braga",4,"N14 Bosch",47,47,0,48,48,0
11,10,2018,21,0,7,"Braga",5,"Avenida João Paulo II",39,39,0,9,9,0
11,10,2018,21,0,7,"Braga",6,"Avenida Padre Júlio Fragata",47,62,15,27,21,6
11,10,2018,21,0,7,"Braga",7,"Rua Nova Santa Cruz",44,44,0,39,39,0
11,10,2018,21,0,7,"Braga",8,"Rua Costa Gomes",41,41,0,42,42,0
11,10,2018,22,0,7,"Braga",1,"Avenida da Liberdade",13,13,0,60,60,0
11,10,2018,22,0,7,"Braga",2,"Avenida Central",49,49,0,71,71,0
11,10,2018,22,0,7,"Braga",3,"Rua de Caires",25,25,0,4,4,0
11,10,2018,22,0,7,"Braga",4,"N14 Bosch",47,47,0,48,48,0
11,10,2018,22,0,7,"Braga",5,"Avenida João Paulo II",39,39,0,9,9,0
11,10,2018,22,0,7,"Braga",6,"Avenida Padre Júlio Fragata",47,62,15,27,21,6
11,10,2018,22,0,7,"Braga",7,"Rua Nova Santa Cruz",44,44,0,39,39,0
11,10,2018,22,0,7,"Braga",8,"Rua Costa Gomes",41,41,0,42,42,0
11,10,2018,23,0,7,"Braga",1,"Avenida da Liberdade",13,13,0,60,60,0
11,10,2018,23,0,7,"Braga",2,"Avenida Central",49,49,0,71,71,0
11,10,2018,23,0,7,"Braga",3,"Rua de Caires",25,25,0,4,4,0
11,10,2018,23,0,7,"Braga",4,"N14 Bosch",47,47,0,48,48,0
11,10,2018,23,0,7,"Braga",5,"Avenida João Paulo II",39,39,0,9,9,0
11,10,2018,23,0,7,"Braga",6,"Avenida Padre Júlio Fragata",13,62,49,99,21,78
11,10,2018,23,0,7,"Braga",7,"Rua Nova Santa Cruz",44,44,0,39,39,0
11,10,2018,23,0,7,"Braga",8,"Rua Costa Gomes",41,41,0,42,42,0
11,11,2018,0,0,8,"Braga",1,"Avenida da Liberdade",13,13,0,60,60,0
11,11,2018,0,0,8,"Braga",2,"Avenida Central",49,49,0,71,71,0
11,11,2018,0,0,8,"Braga",3,"Rua de Caires",25,25,0,4,4,0
11,11,2018,0,0,8,"Braga",4,"N14 Bosch",47,47,0,48,48,0
11,11,2018,0,0,8,"Braga",5,"Avenida João Paulo II",39,39,0,9,9,0
11,11,2018,0,0,8,"Braga",6,"Avenida Padre Júlio Fragata",62,62,0,21,21,0
11,11,2018,0,0,8,"Braga",7,"Rua Nova Santa Cruz",44,44,0,39,39,0
11,11,2018,0,0,8,"Braga",8,"Rua Costa Gomes",41,41,0,42,42,0
11,11,2018,1,0,8,"Braga",1,"Avenida da Liberdade",13,13,0,60,60,0
11,11,2018,1,0,8,"Braga",2,"Avenida Central",28,49,21,124,71,53
11,11,2018,1,0,8,"Braga",3,"Rua de Caires",25,25,0,4,4,0
11,11,2018,1,0,8,"Braga",4,"N14 Bosch",47,47,0,48,48,0
11,11,2018,1,0,8,"Braga",5,"Avenida João Paulo II",39,39,0,9,9,0
11,11,2018,1,0,8,"Braga",6,"Avenida Padre Júlio Fragata",62,62,0,21,21,0
11,11,2018,1,0,8,"Braga",7,"Rua Nova Santa Cruz",44,44,0,39,39,0
11,11,2018,1,0,8,"Braga",8,"Rua Costa Gomes",41,41,0,42,42,0
11,11,2018,2,0,8,"Braga",1,"Avenida da Liberdade",13,13,0,60,60,0
11,11,2018,2,0,8,"Braga",2,"Avenida Central",49,49,0,71,71,0
11,11,2018,2,0,8,"Braga",3,"Rua de Caires",25,25,0,4,4,0
11,11,2018,2,0,8,"Braga",4,"N14 Bosch",47,47,0,48,48,0
11,11,2018,2,0,8,"Braga",5,"Avenida João Paulo II",39,39,0,9,9,0
11,11,2018,2,0,8,"Braga",6,"Avenida Padre Júlio Fragata",62,62,0,21,21,0
11,11,2018,2,0,8,"Braga",7,"Rua Nova Santa Cruz",44,44,0,39,39,0
11,11,2018,2,0,8,"Braga",8,"Rua Costa Gomes",41,41,0,42,42,0
11,11,2018,3,0,8,"Braga",1,"Avenida da Liberdade",13,13,0,60,60,0
11,11,2018,3,0,8,"Braga",2,"Avenida Central",49,49,0,71,71,0
11,11,2018,3,0,8,"Braga",3,"Rua de Caires",25,25,0,4,4,0
11,11,2018,3,0,8,"Braga",4,"N14 Bosch",47,47,0,48,48,0
11,11,2018,3,0,8,"Braga",5,"Avenida João Paulo II",39,39,0,9,9,0
11,11,2018,3,0,8,"Braga",6,"Avenida Padre Júlio Fragata",62,62,0,21,21,0
11,11,2018,3,0,8,"Braga",7,"Rua Nova Santa Cruz",44,44,0,39,39,0
11,11,2018,3,0,8,"Braga",8,"Rua Costa Gomes",41,41,0,42,42,0
11,11,2018,4,0,8,"Braga",1,"Avenida da Liberdade",13,13,0,60,60,0
11,11,2018,4,0,8,"Braga",2,"Avenida Central",49,49,0,71,71,0
11,11,2018,4,0,8,"Braga",3,"Rua de Caires",25,25,0,4,4,0
11,11,2018,4,0,8,"Braga",4,"N14 Bosch",47,47,0,48,48,0
11,11,2018,4,0,8,"Braga",5,"Avenida João Paulo II",39,39,0,9,9,0
11,11,2018,4,0,8,"Braga",6,"Avenida Padre Júlio Fragata",62,62,0,21,21,0
11,11,2018,4,0,8,"Braga",7,"Rua Nova Santa Cruz",44,44,0,39,39,0
11,11,2018,4,0,8,"Braga",8,"Rua Costa Gomes",41,41,0,42,42,0
11,11,2018,5,0,8,"Braga",1,"Avenida da Liberdade",13,13,0,60,60,0
11,11,2018,5,0,8,"Braga",2,"Avenida Central",49,49,0,71,71,0
11,11,2018,5,0,8,"Braga",3,"Rua de Caires",25,25,0,4,4,0
11,11,2018,5,0,8,"Braga",4,"N14 Bosch",47,47,0,48,48,0
11,11,2018,5,0,8,"Braga",5,"Avenida João Paulo II",39,39,0,9,9,0
11,11,2018,5,0,8,"Braga",6,"Avenida Padre Júlio Fragata",62,62,0,21,21,0
11,11,2018,5,0,8,"Braga",7,"Rua Nova Santa Cruz",44,44,0,39,39,0
11,11,2018,5,0,8,"Braga",8,"Rua Costa Gomes",41,41,0,42,42,0
11,11,2018,6,0,8,"Braga",1,"Avenida da Liberdade",13,13,0,60,60,0
11,11,2018,6,0,8,"Braga",2,"Avenida Central",49,49,0,71,71,0
11,11,2018,6,0,8,"Braga",3,"Rua de Caires",25,25,0,4,4,0
11,11,2018,6,0,8,"Braga",4,"N14 Bosch",47,47,0,48,48,0
11,11,2018,6,0,8,"Braga",5,"Avenida João Paulo II",39,39,0,9,9,0
11,11,2018,6,0,8,"Braga",6,"Avenida Padre Júlio Fragata",62,62,0,21,21,0
11,11,2018,6,0,8,"Braga",7,"Rua Nova Santa Cruz",44,44,0,39,39,0
11,11,2018,6,0,8,"Braga",8,"Rua Costa Gomes",41,41,0,42,42,0
11,11,2018,7,0,8,"Braga",1,"Avenida da Liberdade",13,13,0,60,60,0
11,11,2018,7,0,8,"Braga",2,"Avenida Central",49,49,0,71,71,0
11,11,2018,7,0,8,"Braga",3,"Rua de Caires",25,25,0,4,4,0
11,11,2018,7,0,8,"Braga",4,"N14 Bosch",47,47,0,48,48,0
11,11,2018,7,0,8,"Braga",5,"Avenida João Paulo II",39,39,0,9,9,0
11,11,2018,7,0,8,"Braga",6,"Avenida Padre Júlio Fragata",62,62,0,21,21,0
11,11,2018,7,0,8,"Braga",7,"Rua Nova Santa Cruz",44,44,0,39,39,0
11,11,2018,7,0,8,"Braga",8,"Rua Costa Gomes",41,41,0,42,42,0
11,11,2018,8,0,8,"Braga",1,"Avenida da Liberdade",13,13,0,60,60,0
11,11,2018,8,0,8,"Braga",2,"Avenida Central",49,49,0,71,71,0
11,11,2018,8,0,8,"Braga",3,"Rua de Caires",25,25,0,4,4,0
11,11,2018,8,0,8,"Braga",4,"N14 Bosch",47,47,0,48,48,0
11,11,2018,8,0,8,"Braga",5,"Avenida João Paulo II",39,39,0,9,9,0
11,11,2018,8,0,8,"Braga",6,"Avenida Padre Júlio Fragata",62,62,0,21,21,0
11,11,2018,8,0,8,"Braga",7,"Rua Nova Santa Cruz",44,44,0,39,39,0
11,11,2018,8,0,8,"Braga",8,"Rua Costa Gomes",41,41,0,42,42,0
11,11,2018,9,0,8,"Braga",1,"Avenida da Liberdade",13,13,0,60,60,0
11,11,2018,9,0,8,"Braga",2,"Avenida Central",49,49,0,71,71,0
11,11,2018,9,0,8,"Braga",3,"Rua de Caires",25,25,0,4,4,0
11,11,2018,9,0,8,"Braga",4,"N14 Bosch",47,47,0,48,48,0
11,11,2018,9,0,8,"Braga",5,"Avenida João Paulo II",39,39,0,9,9,0
11,11,2018,9,0,8,"Braga",6,"Avenida Padre Júlio Fragata",62,62,0,21,21,0
11,11,2018,9,0,8,"Braga",7,"Rua Nova Santa Cruz",44,44,0,39,39,0
11,11,2018,9,0,8,"Braga",8,"Rua Costa Gomes",41,41,0,42,42,0
11,11,2018,10,0,8,"Braga",1,"Avenida da Liberdade",13,13,0,60,60,0
11,11,2018,10,0,8,"Braga",2,"Avenida Central",49,49,0,71,71,0
11,11,2018,10,0,8,"Braga",3,"Rua de Caires",7,25,18,15,4,11
11,11,2018,10,0,8,"Braga",4,"N14 Bosch",47,47,0,48,48,0
11,11,2018,10,0,8,"Braga",5,"Avenida João Paulo II",39,39,0,9,9,0
11,11,2018,10,0,8,"Braga",6,"Avenida Padre Júlio Fragata",62,62,0,21,21,0
11,11,2018,10,0,8,"Braga",7,"Rua Nova Santa Cruz",44,44,0,39,39,0
11,11,2018,10,0,8,"Braga",8,"Rua Costa Gomes",41,41,0,42,42,0
11,11,2018,11,0,8,"Braga",1,"Avenida da Liberdade",13,13,0,60,60,0
11,11,2018,11,0,8,"Braga",2,"Avenida Central",49,49,0,71,71,0
11,11,2018,11,0,8,"Braga",3,"Rua de Caires",25,25,0,4,4,0
11,11,2018,11,0,8,"Braga",4,"N14 Bosch",47,47,0,48,48,0
11,11,2018,11,0,8,"Braga",5,"Avenida João Paulo II",39,39,0,9,9,0
11,11,2018,11,0,8,"Braga",6,"Avenida Padre Júlio Fragata",62,62,0,21,21,0
11,11,2018,11,0,8,"Braga",7,"Rua Nova Santa Cruz",44,44,0,39,39,0
11,11,2018,11,0,8,"Braga",8,"Rua Costa Gomes",41,41,0,42,42,0
11,11,2018,12,0,8,"Braga",1,"Avenida da Liberdade",13,13,0,60,60,0
11,11,2018,12,0,8,"Braga",2,"Avenida Central",49,49,0,71,71,0
11,11,2018,12,0,8,"Braga",3,"Rua de Caires",25,25,0,4,4,0
11,11,2018,12,0,8,"Braga",4,"N14 Bosch",47,47,0,48,48,0
11,11,2018,12,0,8,"Braga",5,"Avenida João Paulo II",39,39,0,9,9,0
11,11,2018,12,0,8,"Braga",6,"Avenida Padre Júlio Fragata",44,62,18,29,21,8
11,11,2018,12,0,8,"Braga",7,"Rua Nova Santa Cruz",44,44,0,39,39,0
11,11,2018,12,0,8,"Braga",8,"Rua Costa Gomes",28,41,13,62,42,20
11,11,2018,13,0,8,"Braga",1,"Avenida da Liberdade",13,13,0,60,60,0
11,11,2018,13,0,8,"Braga",2,"Avenida Central",49,49,0,71,71,0
11,11,2018,13,0,8,"Braga",3,"Rua de Caires",19,25,6,5,4,1
11,11,2018,13,0,8,"Braga",4,"N14 Bosch",47,47,0,48,48,0
11,11,2018,13,0,8,"Braga",5,"Avenida João Paulo II",39,39,0,9,9,0
11,11,2018,13,0,8,"Braga",6,"Avenida Padre Júlio Fragata",49,62,13,26,21,5
11,11,2018,13,0,8,"Braga",7,"Rua Nova Santa Cruz",44,44,0,39,39,0
11,11,2018,13,0,8,"Braga",8,"Rua Costa Gomes",27,41,14,64,42,22
11,11,2018,14,0,8,"Braga",1,"Avenida da Liberdade",13,13,0,60,60,0
11,11,2018,14,0,8,"Braga",2,"Avenida Central",49,49,0,71,71,0
11,11,2018,14,0,8,"Braga",3,"Rua de Caires",25,25,0,4,4,0
11,11,2018,14,0,8,"Braga",4,"N14 Bosch",47,47,0,48,48,0
11,11,2018,14,0,8,"Braga",5,"Avenida João Paulo II",39,39,0,9,9,0
11,11,2018,14,0,8,"Braga",6,"Avenida Padre Júlio Fragata",62,62,0,21,21,0
11,11,2018,14,0,8,"Braga",7,"Rua Nova Santa Cruz",44,44,0,39,39,0
11,11,2018,14,0,8,"Braga",8,"Rua Costa Gomes",41,41,0,42,42,0
11,11,2018,15,0,8,"Braga",1,"Avenida da Liberdade",13,13,0,60,60,0
11,11,2018,15,0,8,"Braga",2,"Avenida Central",49,49,0,71,71,0
11,11,2018,15,0,8,"Braga",3,"Rua de Caires",25,25,0,4,4,0
11,11,2018,15,0,8,"Braga",4,"N14 Bosch",47,47,0,48,48,0
11,11,2018,15,0,8,"Braga",5,"Avenida João Paulo II",31,39,8,11,9,2
11,11,2018,15,0,8,"Braga",6,"Avenida Padre Júlio Fragata",38,62,24,34,21,13
11,11,2018,15,0,8,"Braga",7,"Rua Nova Santa Cruz",44,44,0,39,39,0
11,11,2018,15,0,8,"Braga",8,"Rua Costa Gomes",32,41,9,54,42,12
11,11,2018,16,0,8,"Braga",1,"Avenida da Liberdade",13,13,0,60,60,0
11,11,2018,16,0,8,"Braga",2,"Avenida Central",49,49,0,71,71,0
11,11,2018,16,0,8,"Braga",3,"Rua de Caires",25,25,0,4,4,0
11,11,2018,16,0,8,"Braga",4,"N14 Bosch",47,47,0,48,48,0
11,11,2018,16,0,8,"Braga",5,"Avenida João Paulo II",39,39,0,9,9,0
11,11,2018,16,0,8,"Braga",6,"Avenida Padre Júlio Fragata",24,62,38,54,21,33
11,11,2018,16,0,8,"Braga",7,"Rua Nova Santa Cruz",44,44,0,39,39,0
11,11,2018,16,0,8,"Braga",8,"Rua Costa Gomes",41,41,0,42,42,0
11,11,2018,17,0,8,"Braga",1,"Avenida da Liberdade",13,13,0,60,60,0
11,11,2018,17,0,8,"Braga",2,"Avenida Central",49,49,0,71,71,0
11,11,2018,17,0,8,"Braga",3,"Rua de Caires",18,25,7,6,4,2
11,11,2018,17,0,8,"Braga",4,"N14 Bosch",47,47,0,48,48,0
11,11,2018,17,0,8,"Braga",5,"Avenida João Paulo II",29,39,10,12,9,3
11,11,2018,17,0,8,"Braga",6,"Avenida Padre Júlio Fragata",43,62,19,30,21,9
11,11,2018,17,0,8,"Braga",7,"Rua Nova Santa Cruz",34,44,10,51,39,12
11,11,2018,17,0,8,"Braga",8,"Rua Costa Gomes",31,41,10,56,42,14
11,11,2018,18,0,8,"Braga",1,"Avenida da Liberdade",13,13,0,60,60,0
11,11,2018,18,0,8,"Braga",2,"Avenida Central",49,49,0,71,71,0
11,11,2018,18,0,8,"Braga",3,"Rua de Caires",3,25,22,35,4,31
11,11,2018,18,0,8,"Braga",4,"N14 Bosch",47,47,0,48,48,0
11,11,2018,18,0,8,"Braga",5,"Avenida João Paulo II",39,39,0,9,9,0
11,11,2018,18,0,8,"Braga",6,"Avenida Padre Júlio Fragata",31,62,31,41,21,20
11,11,2018,18,0,8,"Braga",7,"Rua Nova Santa Cruz",44,44,0,39,39,0
11,11,2018,18,0,8,"Braga",8,"Rua Costa Gomes",41,41,0,42,42,0
11,11,2018,19,0,8,"Braga",1,"Avenida da Liberdade",13,13,0,60,60,0
11,11,2018,19,0,8,"Braga",2,"Avenida Central",49,49,0,71,71,0
11,11,2018,19,0,8,"Braga",3,"Rua de Caires",25,25,0,4,4,0
11,11,2018,19,0,8,"Braga",4,"N14 Bosch",47,47,0,48,48,0
11,11,2018,19,0,8,"Braga",5,"Avenida João Paulo II",39,39,0,9,9,0
11,11,2018,19,0,8,"Braga",6,"Avenida Padre Júlio Fragata",35,62,27,37,21,16
11,11,2018,19,0,8,"Braga",7,"Rua Nova Santa Cruz",44,44,0,39,39,0
11,11,2018,19,0,8,"Braga",8,"Rua Costa Gomes",41,41,0,42,42,0
11,11,2018,20,0,8,"Braga",1,"Avenida da Liberdade",8,13,5,97,60,37
11,11,2018,20,0,8,"Braga",2,"Avenida Central",49,49,0,71,71,0
11,11,2018,20,0,8,"Braga",3,"Rua de Caires",25,25,0,4,4,0
11,11,2018,20,0,8,"Braga",4,"N14 Bosch",47,47,0,48,48,0
11,11,2018,20,0,8,"Braga",5,"Avenida João Paulo II",39,39,0,9,9,0
11,11,2018,20,0,8,"Braga",6,"Avenida Padre Júlio Fragata",62,62,0,21,21,0
11,11,2018,20,0,8,"Braga",7,"Rua Nova Santa Cruz",44,44,0,39,39,0
11,11,2018,20,0,8,"Braga",8,"Rua Costa Gomes",29,41,12,60,42,18
11,11,2018,21,0,8,"Braga",1,"Avenida da Liberdade",13,13,0,60,60,0
11,11,2018,21,0,8,"Braga",2,"Avenida Central",49,49,0,71,71,0
11,11,2018,21,0,8,"Braga",3,"Rua de Caires",5,25,20,21,4,17
11,11,2018,21,0,8,"Braga",4,"N14 Bosch",47,47,0,48,48,0
11,11,2018,21,0,8,"Braga",5,"Avenida João Paulo II",39,39,0,9,9,0
11,11,2018,21,0,8,"Braga",6,"Avenida Padre Júlio Fragata",27,62,35,48,21,27
11,11,2018,21,0,8,"Braga",7,"Rua Nova Santa Cruz",44,44,0,39,39,0
11,11,2018,21,0,8,"Braga",8,"Rua Costa Gomes",41,41,0,42,42,0
11,11,2018,22,0,8,"Braga",1,"Avenida da Liberdade",13,13,0,60,60,0
11,11,2018,22,0,8,"Braga",2,"Avenida Central",49,49,0,71,71,0
11,11,2018,22,0,8,"Braga",3,"Rua de Caires",25,25,0,4,4,0
11,11,2018,22,0,8,"Braga",4,"N14 Bosch",47,47,0,48,48,0
11,11,2018,22,0,8,"Braga",5,"Avenida João Paulo II",39,39,0,9,9,0
11,11,2018,22,0,8,"Braga",6,"Avenida Padre Júlio Fragata",62,62,0,21,21,0
11,11,2018,22,0,8,"Braga",7,"Rua Nova Santa Cruz",44,44,0,39,39,0
11,11,2018,22,0,8,"Braga",8,"Rua Costa Gomes",41,41,0,42,42,0
11,11,2018,23,0,8,"Braga",1,"Avenida da Liberdade",13,13,0,60,60,0
11,11,2018,23,0,8,"Braga",2,"Avenida Central",49,49,0,71,71,0
11,11,2018,23,0,8,"Braga",3,"Rua de Caires",25,25,0,4,4,0
11,11,2018,23,0,8,"Braga",4,"N14 Bosch",47,47,0,48,48,0
11,11,2018,23,0,8,"Braga",5,"Avenida João Paulo II",39,39,0,9,9,0
11,11,2018,23,0,8,"Braga",6,"Avenida Padre Júlio Fragata",62,62,0,21,21,0
11,11,2018,23,0,8,"Braga",7,"Rua Nova Santa Cruz",44,44,0,39,39,0
11,11,2018,23,0,8,"Braga",8,"Rua Costa Gomes",41,41,0,42,42,0
11,12,2018,0,0,2,"Braga",1,"Avenida da Liberdade",13,13,0,60,60,0
11,12,2018,0,0,2,"Braga",2,"Avenida Central",49,49,0,71,71,0
11,12,2018,0,0,2,"Braga",3,"Rua de Caires",25,25,0,4,4,0
11,12,2018,0,0,2,"Braga",4,"N14 Bosch",47,47,0,48,48,0
11,12,2018,0,0,2,"Braga",5,"Avenida João Paulo II",39,39,0,9,9,0
11,12,2018,0,0,2,"Braga",6,"Avenida Padre Júlio Fragata",62,62,0,21,21,0
11,12,2018,0,0,2,"Braga",7,"Rua Nova Santa Cruz",44,44,0,39,39,0
11,12,2018,0,0,2,"Braga",8,"Rua Costa Gomes",41,41,0,42,42,0
11,12,2018,1,0,2,"Braga",1,"Avenida da Liberdade",13,13,0,60,60,0
11,12,2018,1,0,2,"Braga",2,"Avenida Central",49,49,0,71,71,0
11,12,2018,1,0,2,"Braga",3,"Rua de Caires",25,25,0,4,4,0
11,12,2018,1,0,2,"Braga",4,"N14 Bosch",47,47,0,48,48,0
11,12,2018,1,0,2,"Braga",5,"Avenida João Paulo II",39,39,0,9,9,0
11,12,2018,1,0,2,"Braga",6,"Avenida Padre Júlio Fragata",62,62,0,21,21,0
11,12,2018,1,0,2,"Braga",7,"Rua Nova Santa Cruz",44,44,0,39,39,0
11,12,2018,1,0,2,"Braga",8,"Rua Costa Gomes",41,41,0,42,42,0
11,12,2018,2,0,2,"Braga",1,"Avenida da Liberdade",13,13,0,60,60,0
11,12,2018,2,0,2,"Braga",2,"Avenida Central",49,49,0,71,71,0
11,12,2018,2,0,2,"Braga",3,"Rua de Caires",25,25,0,4,4,0
11,12,2018,2,0,2,"Braga",4,"N14 Bosch",47,47,0,48,48,0
11,12,2018,2,0,2,"Braga",5,"Avenida João Paulo II",39,39,0,9,9,0
11,12,2018,2,0,2,"Braga",6,"Avenida Padre Júlio Fragata",62,62,0,21,21,0
11,12,2018,2,0,2,"Braga",7,"Rua Nova Santa Cruz",44,44,0,39,39,0
11,12,2018,2,0,2,"Braga",8,"Rua Costa Gomes",41,41,0,42,42,0
11,12,2018,4,0,2,"Braga",1,"Avenida da Liberdade",13,13,0,60,60,0
11,12,2018,4,0,2,"Braga",2,"Avenida Central",49,49,0,71,71,0
11,12,2018,4,0,2,"Braga",3,"Rua de Caires",25,25,0,4,4,0
11,12,2018,4,0,2,"Braga",4,"N14 Bosch",47,47,0,48,48,0
11,12,2018,4,0,2,"Braga",5,"Avenida João Paulo II",39,39,0,9,9,0
11,12,2018,4,0,2,"Braga",6,"Avenida Padre Júlio Fragata",62,62,0,21,21,0
11,12,2018,4,0,2,"Braga",7,"Rua Nova Santa Cruz",44,44,0,39,39,0
11,12,2018,4,0,2,"Braga",8,"Rua Costa Gomes",41,41,0,42,42,0
11,12,2018,6,0,2,"Braga",1,"Avenida da Liberdade",13,13,0,60,60,0
11,12,2018,6,0,2,"Braga",2,"Avenida Central",49,49,0,71,71,0
11,12,2018,6,0,2,"Braga",3,"Rua de Caires",25,25,0,4,4,0
11,12,2018,6,0,2,"Braga",4,"N14 Bosch",47,47,0,48,48,0
11,12,2018,6,0,2,"Braga",5,"Avenida João Paulo II",39,39,0,9,9,0
11,12,2018,6,0,2,"Braga",6,"Avenida Padre Júlio Fragata",62,62,0,21,21,0
11,12,2018,6,0,2,"Braga",7,"Rua Nova Santa Cruz",44,44,0,39,39,0
11,12,2018,6,0,2,"Braga",8,"Rua Costa Gomes",41,41,0,42,42,0
11,12,2018,7,0,2,"Braga",1,"Avenida da Liberdade",13,13,0,60,60,0
11,12,2018,7,0,2,"Braga",2,"Avenida Central",49,49,0,71,71,0
11,12,2018,7,0,2,"Braga",3,"Rua de Caires",25,25,0,4,4,0
11,12,2018,7,0,2,"Braga",4,"N14 Bosch",47,47,0,48,48,0
11,12,2018,7,0,2,"Braga",5,"Avenida João Paulo II",39,39,0,9,9,0
11,12,2018,7,0,2,"Braga",6,"Avenida Padre Júlio Fragata",62,62,0,21,21,0
11,12,2018,7,0,2,"Braga",7,"Rua Nova Santa Cruz",44,44,0,39,39,0
11,12,2018,7,0,2,"Braga",8,"Rua Costa Gomes",41,41,0,42,42,0
11,12,2018,8,0,2,"Braga",1,"Avenida da Liberdade",13,13,0,60,60,0
11,12,2018,8,0,2,"Braga",2,"Avenida Central",35,49,14,99,71,28
11,12,2018,8,0,2,"Braga",3,"Rua de Caires",25,25,0,4,4,0
11,12,2018,8,0,2,"Braga",4,"N14 Bosch",34,47,13,66,48,18
11,12,2018,8,0,2,"Braga",5,"Avenida João Paulo II",39,39,0,9,9,0
11,12,2018,8,0,2,"Braga",6,"Avenida Padre Júlio Fragata",62,62,0,21,21,0
11,12,2018,8,0,2,"Braga",7,"Rua Nova Santa Cruz",20,44,24,86,39,47
11,12,2018,8,0,2,"Braga",8,"Rua Costa Gomes",41,41,0,42,42,0
11,12,2018,9,0,2,"Braga",1,"Avenida da Liberdade",13,13,0,60,60,0
11,12,2018,9,0,2,"Braga",2,"Avenida Central",34,49,15,102,71,31
11,12,2018,9,0,2,"Braga",3,"Rua de Caires",25,25,0,4,4,0
11,12,2018,9,0,2,"Braga",4,"N14 Bosch",31,47,16,72,48,24
11,12,2018,9,0,2,"Braga",5,"Avenida João Paulo II",39,39,0,9,9,0
11,12,2018,9,0,2,"Braga",6,"Avenida Padre Júlio Fragata",29,62,33,44,21,23
11,12,2018,9,0,2,"Braga",7,"Rua Nova Santa Cruz",8,44,36,216,39,177
11,12,2018,9,0,2,"Braga",8,"Rua Costa Gomes",41,41,0,42,42,0
11,12,2018,10,0,2,"Braga",1,"Avenida da Liberdade",13,13,0,60,60,0
11,12,2018,10,0,2,"Braga",2,"Avenida Central",49,49,0,71,71,0
11,12,2018,10,0,2,"Braga",3,"Rua de Caires",19,25,6,5,4,1
11,12,2018,10,0,2,"Braga",4,"N14 Bosch",26,47,21,86,48,38
11,12,2018,10,0,2,"Braga",5,"Avenida João Paulo II",39,39,0,9,9,0
11,12,2018,10,0,2,"Braga",6,"Avenida Padre Júlio Fragata",32,62,30,40,21,19
11,12,2018,10,0,2,"Braga",7,"Rua Nova Santa Cruz",33,44,11,52,39,13
11,12,2018,10,0,2,"Braga",8,"Rua Costa Gomes",32,41,9,54,42,12
11,12,2018,11,0,2,"Braga",1,"Avenida da Liberdade",13,13,0,60,60,0
11,12,2018,11,0,2,"Braga",2,"Avenida Central",49,49,0,71,71,0
11,12,2018,11,0,2,"Braga",3,"Rua de Caires",25,25,0,4,4,0
11,12,2018,11,0,2,"Braga",4,"N14 Bosch",31,47,16,72,48,24
11,12,2018,11,0,2,"Braga",5,"Avenida João Paulo II",24,39,15,15,9,6
11,12,2018,11,0,2,"Braga",6,"Avenida Padre Júlio Fragata",62,62,0,21,21,0
11,12,2018,11,0,2,"Braga",7,"Rua Nova Santa Cruz",44,44,0,39,39,0
11,12,2018,11,0,2,"Braga",8,"Rua Costa Gomes",29,41,12,60,42,18
11,12,2018,12,0,2,"Braga",1,"Avenida da Liberdade",13,13,0,60,60,0
11,12,2018,12,0,2,"Braga",2,"Avenida Central",49,49,0,71,71,0
11,12,2018,12,0,2,"Braga",3,"Rua de Caires",18,25,7,6,4,2
11,12,2018,12,0,2,"Braga",4,"N14 Bosch",34,47,13,66,48,18
11,12,2018,12,0,2,"Braga",5,"Avenida João Paulo II",28,39,11,12,9,3
11,12,2018,12,0,2,"Braga",6,"Avenida Padre Júlio Fragata",62,62,0,21,21,0
11,12,2018,12,0,2,"Braga",7,"Rua Nova Santa Cruz",31,44,13,56,39,17
11,12,2018,12,0,2,"Braga",8,"Rua Costa Gomes",41,41,0,42,42,0
11,12,2018,13,0,2,"Braga",1,"Avenida da Liberdade",13,13,0,60,60,0
11,12,2018,13,0,2,"Braga",2,"Avenida Central",38,49,11,91,71,20
11,12,2018,13,0,2,"Braga",3,"Rua de Caires",16,25,9,7,4,3
11,12,2018,13,0,2,"Braga",4,"N14 Bosch",37,47,10,61,48,13
11,12,2018,13,0,2,"Braga",5,"Avenida João Paulo II",39,39,0,9,9,0
11,12,2018,13,0,2,"Braga",6,"Avenida Padre Júlio Fragata",62,62,0,21,21,0
11,12,2018,13,0,2,"Braga",7,"Rua Nova Santa Cruz",17,44,27,102,39,63
11,12,2018,13,0,2,"Braga",8,"Rua Costa Gomes",18,41,23,96,42,54
11,12,2018,14,0,2,"Braga",1,"Avenida da Liberdade",13,13,0,60,60,0
11,12,2018,14,0,2,"Braga",2,"Avenida Central",36,49,13,96,71,25
11,12,2018,14,0,2,"Braga",3,"Rua de Caires",25,25,0,4,4,0
11,12,2018,14,0,2,"Braga",4,"N14 Bosch",24,47,23,94,48,46
11,12,2018,14,0,2,"Braga",5,"Avenida João Paulo II",39,39,0,9,9,0
11,12,2018,14,0,2,"Braga",6,"Avenida Padre Júlio Fragata",62,62,0,21,21,0
11,12,2018,14,0,2,"Braga",7,"Rua Nova Santa Cruz",34,44,10,51,39,12
11,12,2018,14,0,2,"Braga",8,"Rua Costa Gomes",41,41,0,42,42,0
11,12,2018,15,0,2,"Braga",1,"Avenida da Liberdade",13,13,0,60,60,0
11,12,2018,15,0,2,"Braga",2,"Avenida Central",49,49,0,71,71,0
11,12,2018,15,0,2,"Braga",3,"Rua de Caires",25,25,0,4,4,0
11,12,2018,15,0,2,"Braga",4,"N14 Bosch",15,47,32,150,48,102
11,12,2018,15,0,2,"Braga",5,"Avenida João Paulo II",39,39,0,9,9,0
11,12,2018,15,0,2,"Braga",6,"Avenida Padre Júlio Fragata",62,62,0,21,21,0
11,12,2018,15,0,2,"Braga",7,"Rua Nova Santa Cruz",29,44,15,60,39,21
11,12,2018,15,0,2,"Braga",8,"Rua Costa Gomes",31,41,10,56,42,14
11,12,2018,16,0,2,"Braga",1,"Avenida da Liberdade",13,13,0,60,60,0
11,12,2018,16,0,2,"Braga",2,"Avenida Central",49,49,0,71,71,0
11,12,2018,16,0,2,"Braga",3,"Rua de Caires",25,25,0,4,4,0
11,12,2018,16,0,2,"Braga",4,"N14 Bosch",18,47,29,125,48,77
11,12,2018,16,0,2,"Braga",5,"Avenida João Paulo II",39,39,0,9,9,0
11,12,2018,16,0,2,"Braga",6,"Avenida Padre Júlio Fragata",62,62,0,21,21,0
11,12,2018,16,0,2,"Braga",7,"Rua Nova Santa Cruz",23,44,21,75,39,36
11,12,2018,16,0,2,"Braga",8,"Rua Costa Gomes",31,41,10,56,42,14
11,12,2018,17,0,2,"Braga",1,"Avenida da Liberdade",13,13,0,60,60,0
11,12,2018,17,0,2,"Braga",2,"Avenida Central",49,49,0,71,71,0
11,12,2018,17,0,2,"Braga",3,"Rua de Caires",25,25,0,4,4,0
11,12,2018,17,0,2,"Braga",4,"N14 Bosch",13,47,34,173,48,125
11,12,2018,17,0,2,"Braga",5,"Avenida João Paulo II",25,39,14,14,9,5
11,12,2018,17,0,2,"Braga",6,"Avenida Padre Júlio Fragata",48,62,14,27,21,6
11,12,2018,17,0,2,"Braga",7,"Rua Nova Santa Cruz",16,44,28,108,39,69
11,12,2018,17,0,2,"Braga",8,"Rua Costa Gomes",21,41,20,82,42,40
11,12,2018,18,0,2,"Braga",1,"Avenida da Liberdade",13,13,0,60,60,0
11,12,2018,18,0,2,"Braga",2,"Avenida Central",35,49,14,99,71,28
11,12,2018,18,0,2,"Braga",3,"Rua de Caires",12,25,13,9,4,5
11,12,2018,18,0,2,"Braga",4,"N14 Bosch",14,47,33,160,48,112
11,12,2018,18,0,2,"Braga",5,"Avenida João Paulo II",39,39,0,9,9,0
11,12,2018,18,0,2,"Braga",6,"Avenida Padre Júlio Fragata",30,62,32,43,21,22
11,12,2018,18,0,2,"Braga",7,"Rua Nova Santa Cruz",6,44,38,288,39,249
11,12,2018,18,0,2,"Braga",8,"Rua Costa Gomes",10,41,31,173,42,131
11,12,2018,19,0,2,"Braga",1,"Avenida da Liberdade",8,13,5,97,60,37
11,12,2018,19,0,2,"Braga",2,"Avenida Central",49,49,0,71,71,0
11,12,2018,19,0,2,"Braga",3,"Rua de Caires",18,25,7,6,4,2
11,12,2018,19,0,2,"Braga",4,"N14 Bosch",31,47,16,72,48,24
11,12,2018,19,0,2,"Braga",5,"Avenida João Paulo II",39,39,0,9,9,0
11,12,2018,19,0,2,"Braga",6,"Avenida Padre Júlio Fragata",32,62,30,40,21,19
11,12,2018,19,0,2,"Braga",7,"Rua Nova Santa Cruz",27,44,17,64,39,25
11,12,2018,19,0,2,"Braga",8,"Rua Costa Gomes",41,41,0,42,42,0
11,12,2018,20,0,2,"Braga",1,"Avenida da Liberdade",13,13,0,60,60,0
11,12,2018,20,0,2,"Braga",2,"Avenida Central",36,49,13,96,71,25
11,12,2018,20,0,2,"Braga",3,"Rua de Caires",25,25,0,4,4,0
11,12,2018,20,0,2,"Braga",4,"N14 Bosch",47,47,0,48,48,0
11,12,2018,20,0,2,"Braga",5,"Avenida João Paulo II",39,39,0,9,9,0
11,12,2018,20,0,2,"Braga",6,"Avenida Padre Júlio Fragata",42,62,20,31,21,10
11,12,2018,20,0,2,"Braga",7,"Rua Nova Santa Cruz",33,44,11,52,39,13
11,12,2018,20,0,2,"Braga",8,"Rua Costa Gomes",41,41,0,42,42,0
11,12,2018,21,0,2,"Braga",1,"Avenida da Liberdade",13,13,0,60,60,0
11,12,2018,21,0,2,"Braga",2,"Avenida Central",49,49,0,71,71,0
11,12,2018,21,0,2,"Braga",3,"Rua de Caires",25,25,0,4,4,0
11,12,2018,21,0,2,"Braga",4,"N14 Bosch",47,47,0,48,48,0
11,12,2018,21,0,2,"Braga",5,"Avenida João Paulo II",39,39,0,9,9,0
11,12,2018,21,0,2,"Braga",6,"Avenida Padre Júlio Fragata",62,62,0,21,21,0
11,12,2018,21,0,2,"Braga",7,"Rua Nova Santa Cruz",44,44,0,39,39,0
11,12,2018,21,0,2,"Braga",8,"Rua Costa Gomes",41,41,0,42,42,0
11,12,2018,22,0,2,"Braga",1,"Avenida da Liberdade",13,13,0,60,60,0
11,12,2018,22,0,2,"Braga",2,"Avenida Central",49,49,0,71,71,0
11,12,2018,22,0,2,"Braga",3,"Rua de Caires",25,25,0,4,4,0
11,12,2018,22,0,2,"Braga",4,"N14 Bosch",47,47,0,48,48,0
11,12,2018,22,0,2,"Braga",5,"Avenida João Paulo II",39,39,0,9,9,0
11,12,2018,22,0,2,"Braga",6,"Avenida Padre Júlio Fragata",62,62,0,21,21,0
11,12,2018,22,0,2,"Braga",7,"Rua Nova Santa Cruz",44,44,0,39,39,0
11,12,2018,22,0,2,"Braga",8,"Rua Costa Gomes",41,41,0,42,42,0
11,12,2018,23,0,2,"Braga",1,"Avenida da Liberdade",13,13,0,60,60,0
11,12,2018,23,0,2,"Braga",2,"Avenida Central",49,49,0,71,71,0
11,12,2018,23,0,2,"Braga",3,"Rua de Caires",25,25,0,4,4,0
11,12,2018,23,0,2,"Braga",4,"N14 Bosch",47,47,0,48,48,0
11,12,2018,23,0,2,"Braga",5,"Avenida João Paulo II",39,39,0,9,9,0
11,12,2018,23,0,2,"Braga",6,"Avenida Padre Júlio Fragata",62,62,0,21,21,0
11,12,2018,23,0,2,"Braga",7,"Rua Nova Santa Cruz",44,44,0,39,39,0
11,12,2018,23,0,2,"Braga",8,"Rua Costa Gomes",41,41,0,42,42,0
11,13,2018,0,0,3,"Braga",1,"Avenida da Liberdade",13,13,0,60,60,0
11,13,2018,0,0,3,"Braga",2,"Avenida Central",49,49,0,71,71,0
11,13,2018,0,0,3,"Braga",3,"Rua de Caires",25,25,0,4,4,0
11,13,2018,0,0,3,"Braga",4,"N14 Bosch",47,47,0,48,48,0
11,13,2018,0,0,3,"Braga",5,"Avenida João Paulo II",39,39,0,9,9,0
11,13,2018,0,0,3,"Braga",6,"Avenida Padre Júlio Fragata",62,62,0,21,21,0
11,13,2018,0,0,3,"Braga",7,"Rua Nova Santa Cruz",44,44,0,39,39,0
11,13,2018,0,0,3,"Braga",8,"Rua Costa Gomes",41,41,0,42,42,0
11,13,2018,1,0,3,"Braga",1,"Avenida da Liberdade",13,13,0,60,60,0
11,13,2018,1,0,3,"Braga",2,"Avenida Central",49,49,0,71,71,0
11,13,2018,1,0,3,"Braga",3,"Rua de Caires",25,25,0,4,4,0
11,13,2018,1,0,3,"Braga",4,"N14 Bosch",47,47,0,48,48,0
11,13,2018,1,0,3,"Braga",5,"Avenida João Paulo II",39,39,0,9,9,0
11,13,2018,1,0,3,"Braga",6,"Avenida Padre Júlio Fragata",62,62,0,21,21,0
11,13,2018,1,0,3,"Braga",7,"Rua Nova Santa Cruz",44,44,0,39,39,0
11,13,2018,1,0,3,"Braga",8,"Rua Costa Gomes",41,41,0,42,42,0
11,13,2018,2,0,3,"Braga",1,"Avenida da Liberdade",13,13,0,60,60,0
11,13,2018,2,0,3,"Braga",2,"Avenida Central",49,49,0,71,71,0
11,13,2018,2,0,3,"Braga",3,"Rua de Caires",25,25,0,4,4,0
11,13,2018,2,0,3,"Braga",4,"N14 Bosch",47,47,0,48,48,0
11,13,2018,2,0,3,"Braga",5,"Avenida João Paulo II",39,39,0,9,9,0
11,13,2018,2,0,3,"Braga",6,"Avenida Padre Júlio Fragata",62,62,0,21,21,0
11,13,2018,2,0,3,"Braga",7,"Rua Nova Santa Cruz",44,44,0,39,39,0
11,13,2018,2,0,3,"Braga",8,"Rua Costa Gomes",41,41,0,42,42,0
11,13,2018,3,0,3,"Braga",1,"Avenida da Liberdade",13,13,0,60,60,0
11,13,2018,3,0,3,"Braga",2,"Avenida Central",49,49,0,71,71,0
11,13,2018,3,0,3,"Braga",3,"Rua de Caires",25,25,0,4,4,0
11,13,2018,3,0,3,"Braga",4,"N14 Bosch",47,47,0,48,48,0
11,13,2018,3,0,3,"Braga",5,"Avenida João Paulo II",39,39,0,9,9,0
11,13,2018,3,0,3,"Braga",6,"Avenida Padre Júlio Fragata",62,62,0,21,21,0
11,13,2018,3,0,3,"Braga",7,"Rua Nova Santa Cruz",44,44,0,39,39,0
11,13,2018,3,0,3,"Braga",8,"Rua Costa Gomes",41,41,0,42,42,0
11,13,2018,4,0,3,"Braga",1,"Avenida da Liberdade",13,13,0,60,60,0
11,13,2018,4,0,3,"Braga",2,"Avenida Central",49,49,0,71,71,0
11,13,2018,4,0,3,"Braga",3,"Rua de Caires",25,25,0,4,4,0
11,13,2018,4,0,3,"Braga",4,"N14 Bosch",47,47,0,48,48,0
11,13,2018,4,0,3,"Braga",5,"Avenida João Paulo II",39,39,0,9,9,0
11,13,2018,4,0,3,"Braga",6,"Avenida Padre Júlio Fragata",62,62,0,21,21,0
11,13,2018,4,0,3,"Braga",7,"Rua Nova Santa Cruz",44,44,0,39,39,0
11,13,2018,4,0,3,"Braga",8,"Rua Costa Gomes",41,41,0,42,42,0
11,13,2018,5,0,3,"Braga",1,"Avenida da Liberdade",13,13,0,60,60,0
11,13,2018,5,0,3,"Braga",2,"Avenida Central",49,49,0,71,71,0
11,13,2018,5,0,3,"Braga",3,"Rua de Caires",25,25,0,4,4,0
11,13,2018,5,0,3,"Braga",4,"N14 Bosch",47,47,0,48,48,0
11,13,2018,5,0,3,"Braga",5,"Avenida João Paulo II",39,39,0,9,9,0
11,13,2018,5,0,3,"Braga",6,"Avenida Padre Júlio Fragata",62,62,0,21,21,0
11,13,2018,5,0,3,"Braga",7,"Rua Nova Santa Cruz",44,44,0,39,39,0
11,13,2018,5,0,3,"Braga",8,"Rua Costa Gomes",41,41,0,42,42,0
11,13,2018,6,0,3,"Braga",1,"Avenida da Liberdade",13,13,0,60,60,0
11,13,2018,6,0,3,"Braga",2,"Avenida Central",49,49,0,71,71,0
11,13,2018,6,0,3,"Braga",3,"Rua de Caires",25,25,0,4,4,0
11,13,2018,6,0,3,"Braga",4,"N14 Bosch",47,47,0,48,48,0
11,13,2018,6,0,3,"Braga",5,"Avenida João Paulo II",39,39,0,9,9,0
11,13,2018,6,0,3,"Braga",6,"Avenida Padre Júlio Fragata",62,62,0,21,21,0
11,13,2018,6,0,3,"Braga",7,"Rua Nova Santa Cruz",44,44,0,39,39,0
11,13,2018,6,0,3,"Braga",8,"Rua Costa Gomes",41,41,0,42,42,0
11,13,2018,7,0,3,"Braga",1,"Avenida da Liberdade",13,13,0,60,60,0
11,13,2018,7,0,3,"Braga",2,"Avenida Central",49,49,0,71,71,0
11,13,2018,7,0,3,"Braga",3,"Rua de Caires",25,25,0,4,4,0
11,13,2018,7,0,3,"Braga",4,"N14 Bosch",47,47,0,48,48,0
11,13,2018,7,0,3,"Braga",5,"Avenida João Paulo II",39,39,0,9,9,0
11,13,2018,7,0,3,"Braga",6,"Avenida Padre Júlio Fragata",62,62,0,21,21,0
11,13,2018,7,0,3,"Braga",7,"Rua Nova Santa Cruz",44,44,0,39,39,0
11,13,2018,7,0,3,"Braga",8,"Rua Costa Gomes",41,41,0,42,42,0
11,13,2018,8,0,3,"Braga",1,"Avenida da Liberdade",10,13,3,78,60,18
11,13,2018,8,0,3,"Braga",2,"Avenida Central",38,49,11,91,71,20
11,13,2018,8,0,3,"Braga",3,"Rua de Caires",16,25,9,7,4,3
11,13,2018,8,0,3,"Braga",4,"N14 Bosch",34,47,13,66,48,18
11,13,2018,8,0,3,"Braga",5,"Avenida João Paulo II",39,39,0,9,9,0
11,13,2018,8,0,3,"Braga",6,"Avenida Padre Júlio Fragata",62,62,0,21,21,0
11,13,2018,8,0,3,"Braga",7,"Rua Nova Santa Cruz",44,44,0,39,39,0
11,13,2018,8,0,3,"Braga",8,"Rua Costa Gomes",41,41,0,42,42,0
11,13,2018,9,0,3,"Braga",1,"Avenida da Liberdade",9,13,4,86,60,26
11,13,2018,9,0,3,"Braga",2,"Avenida Central",31,49,18,112,71,41
11,13,2018,9,0,3,"Braga",3,"Rua de Caires",19,25,6,5,4,1
11,13,2018,9,0,3,"Braga",4,"N14 Bosch",19,47,28,118,48,70
11,13,2018,9,0,3,"Braga",5,"Avenida João Paulo II",39,39,0,9,9,0
11,13,2018,9,0,3,"Braga",6,"Avenida Padre Júlio Fragata",33,62,29,39,21,18
11,13,2018,9,0,3,"Braga",7,"Rua Nova Santa Cruz",14,44,30,123,39,84
11,13,2018,9,0,3,"Braga",8,"Rua Costa Gomes",27,41,14,64,42,22
11,13,2018,10,0,3,"Braga",1,"Avenida da Liberdade",13,13,0,60,60,0
11,13,2018,10,0,3,"Braga",2,"Avenida Central",49,49,0,71,71,0
11,13,2018,10,0,3,"Braga",3,"Rua de Caires",25,25,0,4,4,0
11,13,2018,10,0,3,"Braga",4,"N14 Bosch",47,47,0,48,48,0
11,13,2018,10,0,3,"Braga",5,"Avenida João Paulo II",27,39,12,13,9,4
11,13,2018,10,0,3,"Braga",6,"Avenida Padre Júlio Fragata",62,62,0,21,21,0
11,13,2018,10,0,3,"Braga",7,"Rua Nova Santa Cruz",30,44,14,58,39,19
11,13,2018,10,0,3,"Braga",8,"Rua Costa Gomes",28,41,13,62,42,20
11,13,2018,11,0,3,"Braga",1,"Avenida da Liberdade",13,13,0,60,60,0
11,13,2018,11,0,3,"Braga",2,"Avenida Central",49,49,0,71,71,0
11,13,2018,11,0,3,"Braga",3,"Rua de Caires",25,25,0,4,4,0
11,13,2018,11,0,3,"Braga",4,"N14 Bosch",36,47,11,62,48,14
11,13,2018,11,0,3,"Braga",5,"Avenida João Paulo II",39,39,0,9,9,0
11,13,2018,11,0,3,"Braga",6,"Avenida Padre Júlio Fragata",62,62,0,21,21,0
11,13,2018,11,0,3,"Braga",7,"Rua Nova Santa Cruz",44,44,0,39,39,0
11,13,2018,11,0,3,"Braga",8,"Rua Costa Gomes",32,41,9,54,42,12
11,13,2018,12,0,3,"Braga",1,"Avenida da Liberdade",13,13,0,60,60,0
11,13,2018,12,0,3,"Braga",2,"Avenida Central",49,49,0,71,71,0
11,13,2018,12,0,3,"Braga",3,"Rua de Caires",25,25,0,4,4,0
11,13,2018,12,0,3,"Braga",4,"N14 Bosch",31,47,16,72,48,24
11,13,2018,12,0,3,"Braga",5,"Avenida João Paulo II",39,39,0,9,9,0
11,13,2018,12,0,3,"Braga",6,"Avenida Padre Júlio Fragata",62,62,0,21,21,0
11,13,2018,12,0,3,"Braga",7,"Rua Nova Santa Cruz",30,44,14,58,39,19
11,13,2018,12,0,3,"Braga",8,"Rua Costa Gomes",28,41,13,62,42,20
11,13,2018,13,0,3,"Braga",1,"Avenida da Liberdade",13,13,0,60,60,0
11,13,2018,13,0,3,"Braga",2,"Avenida Central",49,49,0,71,71,0
11,13,2018,13,0,3,"Braga",3,"Rua de Caires",25,25,0,4,4,0
11,13,2018,13,0,3,"Braga",4,"N14 Bosch",18,47,29,125,48,77
11,13,2018,13,0,3,"Braga",5,"Avenida João Paulo II",39,39,0,9,9,0
11,13,2018,13,0,3,"Braga",6,"Avenida Padre Júlio Fragata",62,62,0,21,21,0
11,13,2018,13,0,3,"Braga",7,"Rua Nova Santa Cruz",25,44,19,69,39,30
11,13,2018,13,0,3,"Braga",8,"Rua Costa Gomes",26,41,15,67,42,25
11,13,2018,14,0,3,"Braga",1,"Avenida da Liberdade",13,13,0,60,60,0
11,13,2018,14,0,3,"Braga",2,"Avenida Central",49,49,0,71,71,0
11,13,2018,14,0,3,"Braga",3,"Rua de Caires",25,25,0,4,4,0
11,13,2018,14,0,3,"Braga",4,"N14 Bosch",23,47,24,98,48,50
11,13,2018,14,0,3,"Braga",5,"Avenida João Paulo II",39,39,0,9,9,0
11,13,2018,14,0,3,"Braga",6,"Avenida Padre Júlio Fragata",62,62,0,21,21,0
11,13,2018,14,0,3,"Braga",7,"Rua Nova Santa Cruz",9,44,35,192,39,153
11,13,2018,14,0,3,"Braga",8,"Rua Costa Gomes",31,41,10,56,42,14
11,13,2018,15,0,3,"Braga",1,"Avenida da Liberdade",13,13,0,60,60,0
11,13,2018,15,0,3,"Braga",2,"Avenida Central",49,49,0,71,71,0
11,13,2018,15,0,3,"Braga",3,"Rua de Caires",25,25,0,4,4,0
11,13,2018,15,0,3,"Braga",4,"N14 Bosch",32,47,15,70,48,22
11,13,2018,15,0,3,"Braga",5,"Avenida João Paulo II",39,39,0,9,9,0
11,13,2018,15,0,3,"Braga",6,"Avenida Padre Júlio Fragata",49,62,13,26,21,5
11,13,2018,15,0,3,"Braga",7,"Rua Nova Santa Cruz",27,44,17,64,39,25
11,13,2018,15,0,3,"Braga",8,"Rua Costa Gomes",30,41,11,58,42,16
11,13,2018,16,0,3,"Braga",1,"Avenida da Liberdade",13,13,0,60,60,0
11,13,2018,16,0,3,"Braga",2,"Avenida Central",49,49,0,71,71,0
11,13,2018,16,0,3,"Braga",3,"Rua de Caires",25,25,0,4,4,0
11,13,2018,16,0,3,"Braga",4,"N14 Bosch",26,47,21,86,48,38
11,13,2018,16,0,3,"Braga",5,"Avenida João Paulo II",28,39,11,12,9,3
11,13,2018,16,0,3,"Braga",6,"Avenida Padre Júlio Fragata",62,62,0,21,21,0
11,13,2018,16,0,3,"Braga",7,"Rua Nova Santa Cruz",44,44,0,39,39,0
11,13,2018,16,0,3,"Braga",8,"Rua Costa Gomes",28,41,13,62,42,20
11,13,2018,17,0,3,"Braga",1,"Avenida da Liberdade",8,13,5,97,60,37
11,13,2018,17,0,3,"Braga",2,"Avenida Central",37,49,12,94,71,23
11,13,2018,17,0,3,"Braga",3,"Rua de Caires",25,25,0,4,4,0
11,13,2018,17,0,3,"Braga",4,"N14 Bosch",22,47,25,102,48,54
11,13,2018,17,0,3,"Braga",5,"Avenida João Paulo II",28,39,11,12,9,3
11,13,2018,17,0,3,"Braga",6,"Avenida Padre Júlio Fragata",43,62,19,30,21,9
11,13,2018,17,0,3,"Braga",7,"Rua Nova Santa Cruz",44,44,0,39,39,0
11,13,2018,17,0,3,"Braga",8,"Rua Costa Gomes",28,41,13,62,42,20
11,13,2018,18,0,3,"Braga",1,"Avenida da Liberdade",9,13,4,86,60,26
11,13,2018,18,0,3,"Braga",2,"Avenida Central",49,49,0,71,71,0
11,13,2018,18,0,3,"Braga",3,"Rua de Caires",17,25,8,6,4,2
11,13,2018,18,0,3,"Braga",4,"N14 Bosch",8,47,39,281,48,233
11,13,2018,18,0,3,"Braga",5,"Avenida João Paulo II",28,39,11,12,9,3
11,13,2018,18,0,3,"Braga",6,"Avenida Padre Júlio Fragata",34,62,28,38,21,17
11,13,2018,18,0,3,"Braga",7,"Rua Nova Santa Cruz",10,44,34,173,39,134
11,13,2018,18,0,3,"Braga",8,"Rua Costa Gomes",13,41,28,133,42,91
11,13,2018,19,0,3,"Braga",1,"Avenida da Liberdade",13,13,0,60,60,0
11,13,2018,19,0,3,"Braga",2,"Avenida Central",32,49,17,108,71,37
11,13,2018,19,0,3,"Braga",3,"Rua de Caires",17,25,8,6,4,2
11,13,2018,19,0,3,"Braga",4,"N14 Bosch",16,47,31,140,48,92
11,13,2018,19,0,3,"Braga",5,"Avenida João Paulo II",15,39,24,23,9,14
11,13,2018,19,0,3,"Braga",6,"Avenida Padre Júlio Fragata",23,62,39,56,21,35
11,13,2018,19,0,3,"Braga",7,"Rua Nova Santa Cruz",27,44,17,64,39,25
11,13,2018,19,0,3,"Braga",8,"Rua Costa Gomes",10,41,31,173,42,131
11,13,2018,20,0,3,"Braga",1,"Avenida da Liberdade",13,13,0,60,60,0
11,13,2018,20,0,3,"Braga",2,"Avenida Central",49,49,0,71,71,0
11,13,2018,20,0,3,"Braga",3,"Rua de Caires",25,25,0,4,4,0
11,13,2018,20,0,3,"Braga",4,"N14 Bosch",47,47,0,48,48,0
11,13,2018,20,0,3,"Braga",5,"Avenida João Paulo II",39,39,0,9,9,0
11,13,2018,20,0,3,"Braga",6,"Avenida Padre Júlio Fragata",62,62,0,21,21,0
11,13,2018,20,0,3,"Braga",7,"Rua Nova Santa Cruz",32,44,12,54,39,15
11,13,2018,20,0,3,"Braga",8,"Rua Costa Gomes",28,41,13,62,42,20
11,13,2018,21,0,3,"Braga",1,"Avenida da Liberdade",13,13,0,60,60,0
11,13,2018,21,0,3,"Braga",2,"Avenida Central",49,49,0,71,71,0
11,13,2018,21,0,3,"Braga",3,"Rua de Caires",19,25,6,5,4,1
11,13,2018,21,0,3,"Braga",4,"N14 Bosch",47,47,0,48,48,0
11,13,2018,21,0,3,"Braga",5,"Avenida João Paulo II",39,39,0,9,9,0
11,13,2018,21,0,3,"Braga",6,"Avenida Padre Júlio Fragata",62,62,0,21,21,0
11,13,2018,21,0,3,"Braga",7,"Rua Nova Santa Cruz",44,44,0,39,39,0
11,13,2018,21,0,3,"Braga",8,"Rua Costa Gomes",41,41,0,42,42,0
11,13,2018,22,0,3,"Braga",1,"Avenida da Liberdade",13,13,0,60,60,0
11,13,2018,22,0,3,"Braga",2,"Avenida Central",49,49,0,71,71,0
11,13,2018,22,0,3,"Braga",3,"Rua de Caires",16,25,9,7,4,3
11,13,2018,22,0,3,"Braga",4,"N14 Bosch",47,47,0,48,48,0
11,13,2018,22,0,3,"Braga",5,"Avenida João Paulo II",39,39,0,9,9,0
11,13,2018,22,0,3,"Braga",6,"Avenida Padre Júlio Fragata",62,62,0,21,21,0
11,13,2018,22,0,3,"Braga",7,"Rua Nova Santa Cruz",44,44,0,39,39,0
11,13,2018,22,0,3,"Braga",8,"Rua Costa Gomes",41,41,0,42,42,0
11,13,2018,23,0,3,"Braga",1,"Avenida da Liberdade",13,13,0,60,60,0
11,13,2018,23,0,3,"Braga",2,"Avenida Central",49,49,0,71,71,0
11,13,2018,23,0,3,"Braga",3,"Rua de Caires",25,25,0,4,4,0
11,13,2018,23,0,3,"Braga",4,"N14 Bosch",47,47,0,48,48,0
11,13,2018,23,0,3,"Braga",5,"Avenida João Paulo II",39,39,0,9,9,0
11,13,2018,23,0,3,"Braga",6,"Avenida Padre Júlio Fragata",62,62,0,21,21,0
11,13,2018,23,0,3,"Braga",7,"Rua Nova Santa Cruz",44,44,0,39,39,0
11,13,2018,23,0,3,"Braga",8,"Rua Costa Gomes",41,41,0,42,42,0
11,14,2018,0,0,4,"Braga",1,"Avenida da Liberdade",13,13,0,60,60,0
11,14,2018,0,0,4,"Braga",2,"Avenida Central",49,49,0,71,71,0
11,14,2018,0,0,4,"Braga",3,"Rua de Caires",25,25,0,4,4,0
11,14,2018,0,0,4,"Braga",4,"N14 Bosch",47,47,0,48,48,0
11,14,2018,0,0,4,"Braga",5,"Avenida João Paulo II",39,39,0,9,9,0
11,14,2018,0,0,4,"Braga",6,"Avenida Padre Júlio Fragata",24,62,38,54,21,33
11,14,2018,0,0,4,"Braga",7,"Rua Nova Santa Cruz",44,44,0,39,39,0
11,14,2018,0,0,4,"Braga",8,"Rua Costa Gomes",41,41,0,42,42,0
11,14,2018,1,0,4,"Braga",1,"Avenida da Liberdade",13,13,0,60,60,0
11,14,2018,1,0,4,"Braga",2,"Avenida Central",49,49,0,71,71,0
11,14,2018,1,0,4,"Braga",3,"Rua de Caires",25,25,0,4,4,0
11,14,2018,1,0,4,"Braga",4,"N14 Bosch",47,47,0,48,48,0
11,14,2018,1,0,4,"Braga",5,"Avenida João Paulo II",39,39,0,9,9,0
11,14,2018,1,0,4,"Braga",6,"Avenida Padre Júlio Fragata",62,62,0,21,21,0
11,14,2018,1,0,4,"Braga",7,"Rua Nova Santa Cruz",44,44,0,39,39,0
11,14,2018,1,0,4,"Braga",8,"Rua Costa Gomes",41,41,0,42,42,0
11,14,2018,2,0,4,"Braga",1,"Avenida da Liberdade",13,13,0,60,60,0
11,14,2018,2,0,4,"Braga",2,"Avenida Central",49,49,0,71,71,0
11,14,2018,2,0,4,"Braga",3,"Rua de Caires",25,25,0,4,4,0
11,14,2018,2,0,4,"Braga",4,"N14 Bosch",47,47,0,48,48,0
11,14,2018,2,0,4,"Braga",5,"Avenida João Paulo II",39,39,0,9,9,0
11,14,2018,2,0,4,"Braga",6,"Avenida Padre Júlio Fragata",62,62,0,21,21,0
11,14,2018,2,0,4,"Braga",7,"Rua Nova Santa Cruz",44,44,0,39,39,0
11,14,2018,2,0,4,"Braga",8,"Rua Costa Gomes",41,41,0,42,42,0
11,14,2018,3,0,4,"Braga",1,"Avenida da Liberdade",13,13,0,60,60,0
11,14,2018,3,0,4,"Braga",2,"Avenida Central",49,49,0,71,71,0
11,14,2018,3,0,4,"Braga",3,"Rua de Caires",25,25,0,4,4,0
11,14,2018,3,0,4,"Braga",4,"N14 Bosch",47,47,0,48,48,0
11,14,2018,3,0,4,"Braga",5,"Avenida João Paulo II",39,39,0,9,9,0
11,14,2018,3,0,4,"Braga",6,"Avenida Padre Júlio Fragata",62,62,0,21,21,0
11,14,2018,3,0,4,"Braga",7,"Rua Nova Santa Cruz",44,44,0,39,39,0
11,14,2018,3,0,4,"Braga",8,"Rua Costa Gomes",41,41,0,42,42,0
11,14,2018,4,0,4,"Braga",1,"Avenida da Liberdade",13,13,0,60,60,0
11,14,2018,4,0,4,"Braga",2,"Avenida Central",49,49,0,71,71,0
11,14,2018,4,0,4,"Braga",3,"Rua de Caires",25,25,0,4,4,0
11,14,2018,4,0,4,"Braga",4,"N14 Bosch",47,47,0,48,48,0
11,14,2018,4,0,4,"Braga",5,"Avenida João Paulo II",39,39,0,9,9,0
11,14,2018,4,0,4,"Braga",6,"Avenida Padre Júlio Fragata",62,62,0,21,21,0
11,14,2018,4,0,4,"Braga",7,"Rua Nova Santa Cruz",44,44,0,39,39,0
11,14,2018,4,0,4,"Braga",8,"Rua Costa Gomes",41,41,0,42,42,0
11,14,2018,5,0,4,"Braga",1,"Avenida da Liberdade",13,13,0,60,60,0
11,14,2018,5,0,4,"Braga",2,"Avenida Central",49,49,0,71,71,0
11,14,2018,5,0,4,"Braga",3,"Rua de Caires",25,25,0,4,4,0
11,14,2018,5,0,4,"Braga",4,"N14 Bosch",47,47,0,48,48,0
11,14,2018,5,0,4,"Braga",5,"Avenida João Paulo II",39,39,0,9,9,0
11,14,2018,5,0,4,"Braga",6,"Avenida Padre Júlio Fragata",62,62,0,21,21,0
11,14,2018,5,0,4,"Braga",7,"Rua Nova Santa Cruz",44,44,0,39,39,0
11,14,2018,5,0,4,"Braga",8,"Rua Costa Gomes",41,41,0,42,42,0
11,14,2018,6,0,4,"Braga",1,"Avenida da Liberdade",13,13,0,60,60,0
11,14,2018,6,0,4,"Braga",2,"Avenida Central",49,49,0,71,71,0
11,14,2018,6,0,4,"Braga",3,"Rua de Caires",25,25,0,4,4,0
11,14,2018,6,0,4,"Braga",4,"N14 Bosch",47,47,0,48,48,0
11,14,2018,6,0,4,"Braga",5,"Avenida João Paulo II",39,39,0,9,9,0
11,14,2018,6,0,4,"Braga",6,"Avenida Padre Júlio Fragata",62,62,0,21,21,0
11,14,2018,6,0,4,"Braga",7,"Rua Nova Santa Cruz",44,44,0,39,39,0
11,14,2018,6,0,4,"Braga",8,"Rua Costa Gomes",41,41,0,42,42,0
11,14,2018,7,0,4,"Braga",1,"Avenida da Liberdade",13,13,0,60,60,0
11,14,2018,7,0,4,"Braga",2,"Avenida Central",49,49,0,71,71,0
11,14,2018,7,0,4,"Braga",3,"Rua de Caires",25,25,0,4,4,0
11,14,2018,7,0,4,"Braga",4,"N14 Bosch",47,47,0,48,48,0
11,14,2018,7,0,4,"Braga",5,"Avenida João Paulo II",39,39,0,9,9,0
11,14,2018,7,0,4,"Braga",6,"Avenida Padre Júlio Fragata",62,62,0,21,21,0
11,14,2018,7,0,4,"Braga",7,"Rua Nova Santa Cruz",44,44,0,39,39,0
11,14,2018,7,0,4,"Braga",8,"Rua Costa Gomes",41,41,0,42,42,0
11,14,2018,8,0,4,"Braga",1,"Avenida da Liberdade",9,13,4,86,60,26
11,14,2018,8,0,4,"Braga",2,"Avenida Central",38,49,11,91,71,20
11,14,2018,8,0,4,"Braga",3,"Rua de Caires",25,25,0,4,4,0
11,14,2018,8,0,4,"Braga",4,"N14 Bosch",47,47,0,48,48,0
11,14,2018,8,0,4,"Braga",5,"Avenida João Paulo II",39,39,0,9,9,0
11,14,2018,8,0,4,"Braga",6,"Avenida Padre Júlio Fragata",62,62,0,21,21,0
11,14,2018,8,0,4,"Braga",7,"Rua Nova Santa Cruz",44,44,0,39,39,0
11,14,2018,8,0,4,"Braga",8,"Rua Costa Gomes",41,41,0,42,42,0
11,14,2018,9,0,4,"Braga",1,"Avenida da Liberdade",13,13,0,60,60,0
11,14,2018,9,0,4,"Braga",2,"Avenida Central",33,49,16,105,71,34
11,14,2018,9,0,4,"Braga",3,"Rua de Caires",19,25,6,5,4,1
11,14,2018,9,0,4,"Braga",4,"N14 Bosch",36,47,11,62,48,14
11,14,2018,9,0,4,"Braga",5,"Avenida João Paulo II",39,39,0,9,9,0
11,14,2018,9,0,4,"Braga",6,"Avenida Padre Júlio Fragata",31,62,31,41,21,20
11,14,2018,9,0,4,"Braga",7,"Rua Nova Santa Cruz",13,44,31,133,39,94
11,14,2018,9,0,4,"Braga",8,"Rua Costa Gomes",31,41,10,56,42,14
11,14,2018,10,0,4,"Braga",1,"Avenida da Liberdade",13,13,0,60,60,0
11,14,2018,10,0,4,"Braga",2,"Avenida Central",49,49,0,71,71,0
11,14,2018,10,0,4,"Braga",3,"Rua de Caires",25,25,0,4,4,0
11,14,2018,10,0,4,"Braga",4,"N14 Bosch",33,47,14,68,48,20
11,14,2018,10,0,4,"Braga",5,"Avenida João Paulo II",39,39,0,9,9,0
11,14,2018,10,0,4,"Braga",6,"Avenida Padre Júlio Fragata",62,62,0,21,21,0
11,14,2018,10,0,4,"Braga",7,"Rua Nova Santa Cruz",25,44,19,69,39,30
11,14,2018,10,0,4,"Braga",8,"Rua Costa Gomes",30,41,11,58,42,16
11,14,2018,11,0,4,"Braga",1,"Avenida da Liberdade",13,13,0,60,60,0
11,14,2018,11,0,4,"Braga",2,"Avenida Central",49,49,0,71,71,0
11,14,2018,11,0,4,"Braga",3,"Rua de Caires",25,25,0,4,4,0
11,14,2018,11,0,4,"Braga",4,"N14 Bosch",47,47,0,48,48,0
11,14,2018,11,0,4,"Braga",5,"Avenida João Paulo II",39,39,0,9,9,0
11,14,2018,11,0,4,"Braga",6,"Avenida Padre Júlio Fragata",62,62,0,21,21,0
11,14,2018,11,0,4,"Braga",7,"Rua Nova Santa Cruz",44,44,0,39,39,0
11,14,2018,11,0,4,"Braga",8,"Rua Costa Gomes",26,41,15,67,42,25
11,14,2018,12,0,4,"Braga",1,"Avenida da Liberdade",13,13,0,60,60,0
11,14,2018,12,0,4,"Braga",2,"Avenida Central",49,49,0,71,71,0
11,14,2018,12,0,4,"Braga",3,"Rua de Caires",25,25,0,4,4,0
11,14,2018,12,0,4,"Braga",4,"N14 Bosch",47,47,0,48,48,0
11,14,2018,12,0,4,"Braga",5,"Avenida João Paulo II",39,39,0,9,9,0
11,14,2018,12,0,4,"Braga",6,"Avenida Padre Júlio Fragata",62,62,0,21,21,0
11,14,2018,12,0,4,"Braga",7,"Rua Nova Santa Cruz",34,44,10,51,39,12
11,14,2018,12,0,4,"Braga",8,"Rua Costa Gomes",41,41,0,42,42,0
11,14,2018,13,0,4,"Braga",1,"Avenida da Liberdade",13,13,0,60,60,0
11,14,2018,13,0,4,"Braga",2,"Avenida Central",37,49,12,94,71,23
11,14,2018,13,0,4,"Braga",3,"Rua de Caires",25,25,0,4,4,0
11,14,2018,13,0,4,"Braga",4,"N14 Bosch",17,47,30,132,48,84
11,14,2018,13,0,4,"Braga",5,"Avenida João Paulo II",39,39,0,9,9,0
11,14,2018,13,0,4,"Braga",6,"Avenida Padre Júlio Fragata",62,62,0,21,21,0
11,14,2018,13,0,4,"Braga",7,"Rua Nova Santa Cruz",12,44,32,144,39,105
11,14,2018,13,0,4,"Braga",8,"Rua Costa Gomes",30,41,11,58,42,16
11,14,2018,14,0,4,"Braga",1,"Avenida da Liberdade",25,25,0,26,26,0
11,14,2018,14,0,4,"Braga",2,"Avenida Central",18,18,0,257,257,0
11,14,2018,14,0,4,"Braga",3,"Rua de Caires",26,26,0,4,4,0
11,14,2018,14,0,4,"Braga",4,"N14 Bosch",23,47,24,97,47,50
11,14,2018,14,0,4,"Braga",5,"Avenida João Paulo II",39,39,0,8,8,0
11,14,2018,14,0,4,"Braga",6,"Avenida Padre Júlio Fragata",62,62,0,21,21,0
11,14,2018,14,0,4,"Braga",7,"Rua Nova Santa Cruz",20,29,9,152,104,48
11,14,2018,14,0,4,"Braga",8,"Rua Costa Gomes",41,41,0,42,42,0
11,14,2018,15,0,4,"Braga",1,"Avenida da Liberdade",25,25,0,26,26,0
11,14,2018,15,0,4,"Braga",2,"Avenida Central",10,18,8,463,257,206
11,14,2018,15,0,4,"Braga",3,"Rua de Caires",26,26,0,4,4,0
11,14,2018,15,0,4,"Braga",4,"N14 Bosch",36,46,10,62,48,14
11,14,2018,15,0,4,"Braga",5,"Avenida João Paulo II",38,38,0,9,9,0
11,14,2018,15,0,4,"Braga",6,"Avenida Padre Júlio Fragata",47,61,14,28,21,7
11,14,2018,15,0,4,"Braga",7,"Rua Nova Santa Cruz",12,30,18,253,101,152
11,14,2018,15,0,4,"Braga",8,"Rua Costa Gomes",27,40,13,64,43,21
11,14,2018,16,0,4,"Braga",1,"Avenida da Liberdade",25,25,0,26,26,0
11,14,2018,16,0,4,"Braga",2,"Avenida Central",17,17,0,272,272,0
11,14,2018,16,0,4,"Braga",3,"Rua de Caires",26,26,0,4,4,0
11,14,2018,16,0,4,"Braga",4,"N14 Bosch",33,46,13,68,48,20
11,14,2018,16,0,4,"Braga",5,"Avenida João Paulo II",38,38,0,9,9,0
11,14,2018,16,0,4,"Braga",6,"Avenida Padre Júlio Fragata",45,61,16,29,21,8
11,14,2018,16,0,4,"Braga",7,"Rua Nova Santa Cruz",15,28,13,202,108,94
11,14,2018,16,0,4,"Braga",8,"Rua Costa Gomes",29,41,12,59,42,17
11,14,2018,17,0,4,"Braga",1,"Avenida da Liberdade",25,25,0,26,26,0
11,14,2018,17,0,4,"Braga",2,"Avenida Central",10,17,7,463,272,191
11,14,2018,17,0,4,"Braga",3,"Rua de Caires",25,25,0,4,4,0
11,14,2018,17,0,4,"Braga",4,"N14 Bosch",28,46,18,80,48,32
11,14,2018,17,0,4,"Braga",5,"Avenida João Paulo II",38,38,0,9,9,0
11,14,2018,17,0,4,"Braga",6,"Avenida Padre Júlio Fragata",35,62,27,38,21,17
11,14,2018,17,0,4,"Braga",7,"Rua Nova Santa Cruz",15,30,15,202,101,101
11,14,2018,17,0,4,"Braga",8,"Rua Costa Gomes",22,41,19,78,42,36
11,14,2018,18,0,4,"Braga",1,"Avenida da Liberdade",17,25,8,39,26,13
11,14,2018,18,0,4,"Braga",2,"Avenida Central",8,18,10,579,257,322
11,14,2018,18,0,4,"Braga",3,"Rua de Caires",24,24,0,4,4,0
11,14,2018,18,0,4,"Braga",4,"N14 Bosch",29,47,18,77,47,30
11,14,2018,18,0,4,"Braga",5,"Avenida João Paulo II",39,39,0,8,8,0
11,14,2018,18,0,4,"Braga",6,"Avenida Padre Júlio Fragata",31,61,30,42,21,21
11,14,2018,18,0,4,"Braga",7,"Rua Nova Santa Cruz",15,30,15,202,101,101
11,14,2018,18,0,4,"Braga",8,"Rua Costa Gomes",10,40,30,172,43,129
11,14,2018,19,0,4,"Braga",1,"Avenida da Liberdade",25,25,0,26,26,0
11,14,2018,19,0,4,"Braga",2,"Avenida Central",6,18,12,772,257,515
11,14,2018,19,0,4,"Braga",3,"Rua de Caires",25,25,0,4,4,0
11,14,2018,19,0,4,"Braga",4,"N14 Bosch",24,46,22,93,48,45
11,14,2018,19,0,4,"Braga",5,"Avenida João Paulo II",30,39,9,11,8,3
11,14,2018,19,0,4,"Braga",6,"Avenida Padre Júlio Fragata",37,62,25,35,21,14
11,14,2018,19,0,4,"Braga",7,"Rua Nova Santa Cruz",12,29,17,253,104,149
11,14,2018,19,0,4,"Braga",8,"Rua Costa Gomes",15,41,26,115,42,73
11,14,2018,20,0,4,"Braga",1,"Avenida da Liberdade",25,25,0,26,26,0
11,14,2018,20,0,4,"Braga",2,"Avenida Central",18,18,0,257,257,0
11,14,2018,20,0,4,"Braga",3,"Rua de Caires",24,24,0,4,4,0
11,14,2018,20,0,4,"Braga",4,"N14 Bosch",47,47,0,47,47,0
11,14,2018,20,0,4,"Braga",5,"Avenida João Paulo II",31,39,8,11,8,3
11,14,2018,20,0,4,"Braga",6,"Avenida Padre Júlio Fragata",44,62,18,30,21,9
11,14,2018,20,0,4,"Braga",7,"Rua Nova Santa Cruz",23,29,6,132,104,28
11,14,2018,20,0,4,"Braga",8,"Rua Costa Gomes",40,40,0,43,43,0
11,14,2018,21,0,4,"Braga",1,"Avenida da Liberdade",25,25,0,26,26,0
11,14,2018,21,0,4,"Braga",2,"Avenida Central",18,18,0,257,257,0
11,14,2018,21,0,4,"Braga",3,"Rua de Caires",8,25,17,13,4,9
11,14,2018,21,0,4,"Braga",4,"N14 Bosch",47,47,0,47,47,0
11,14,2018,21,0,4,"Braga",5,"Avenida João Paulo II",39,39,0,8,8,0
11,14,2018,21,0,4,"Braga",6,"Avenida Padre Júlio Fragata",45,61,16,29,21,8
11,14,2018,21,0,4,"Braga",7,"Rua Nova Santa Cruz",21,28,7,144,108,36
11,14,2018,21,0,4,"Braga",8,"Rua Costa Gomes",40,40,0,43,43,0
11,14,2018,22,0,4,"Braga",1,"Avenida da Liberdade",25,25,0,26,26,0
11,14,2018,22,0,4,"Braga",2,"Avenida Central",18,18,0,257,257,0
11,14,2018,22,0,4,"Braga",3,"Rua de Caires",24,24,0,4,4,0
11,14,2018,22,0,4,"Braga",4,"N14 Bosch",46,46,0,48,48,0
11,14,2018,22,0,4,"Braga",5,"Avenida João Paulo II",39,39,0,8,8,0
11,14,2018,22,0,4,"Braga",6,"Avenida Padre Júlio Fragata",61,61,0,21,21,0
11,14,2018,22,0,4,"Braga",7,"Rua Nova Santa Cruz",18,28,10,169,108,61
11,14,2018,22,0,4,"Braga",8,"Rua Costa Gomes",40,40,0,43,43,0
11,14,2018,23,0,4,"Braga",1,"Avenida da Liberdade",25,25,0,26,26,0
11,14,2018,23,0,4,"Braga",2,"Avenida Central",17,17,0,272,272,0
11,14,2018,23,0,4,"Braga",3,"Rua de Caires",24,24,0,4,4,0
11,14,2018,23,0,4,"Braga",4,"N14 Bosch",46,46,0,48,48,0
11,14,2018,23,0,4,"Braga",5,"Avenida João Paulo II",39,39,0,8,8,0
11,14,2018,23,0,4,"Braga",6,"Avenida Padre Júlio Fragata",26,62,36,51,21,30
11,14,2018,23,0,4,"Braga",7,"Rua Nova Santa Cruz",29,29,0,104,104,0
11,14,2018,23,0,4,"Braga",8,"Rua Costa Gomes",40,40,0,43,43,0
11,15,2018,0,0,5,"Braga",1,"Avenida da Liberdade",25,25,0,26,26,0
11,15,2018,0,0,5,"Braga",2,"Avenida Central",17,17,0,272,272,0
11,15,2018,0,0,5,"Braga",3,"Rua de Caires",24,24,0,4,4,0
11,15,2018,0,0,5,"Braga",4,"N14 Bosch",46,46,0,48,48,0
11,15,2018,0,0,5,"Braga",5,"Avenida João Paulo II",39,39,0,8,8,0
11,15,2018,0,0,5,"Braga",6,"Avenida Padre Júlio Fragata",61,61,0,21,21,0
11,15,2018,0,0,5,"Braga",7,"Rua Nova Santa Cruz",29,29,0,104,104,0
11,15,2018,0,0,5,"Braga",8,"Rua Costa Gomes",40,40,0,43,43,0
11,15,2018,1,0,5,"Braga",1,"Avenida da Liberdade",25,25,0,26,26,0
11,15,2018,1,0,5,"Braga",2,"Avenida Central",17,17,0,272,272,0
11,15,2018,1,0,5,"Braga",3,"Rua de Caires",24,24,0,4,4,0
11,15,2018,1,0,5,"Braga",4,"N14 Bosch",46,46,0,48,48,0
11,15,2018,1,0,5,"Braga",5,"Avenida João Paulo II",38,38,0,9,9,0
11,15,2018,1,0,5,"Braga",6,"Avenida Padre Júlio Fragata",61,61,0,21,21,0
11,15,2018,1,0,5,"Braga",7,"Rua Nova Santa Cruz",21,28,7,144,108,36
11,15,2018,1,0,5,"Braga",8,"Rua Costa Gomes",40,40,0,43,43,0
11,15,2018,2,0,5,"Braga",1,"Avenida da Liberdade",25,25,0,26,26,0
11,15,2018,2,0,5,"Braga",2,"Avenida Central",17,17,0,272,272,0
11,15,2018,2,0,5,"Braga",3,"Rua de Caires",24,24,0,4,4,0
11,15,2018,2,0,5,"Braga",4,"N14 Bosch",46,46,0,48,48,0
11,15,2018,2,0,5,"Braga",5,"Avenida João Paulo II",38,38,0,9,9,0
11,15,2018,2,0,5,"Braga",6,"Avenida Padre Júlio Fragata",61,61,0,21,21,0
11,15,2018,2,0,5,"Braga",7,"Rua Nova Santa Cruz",28,28,0,108,108,0
11,15,2018,2,0,5,"Braga",8,"Rua Costa Gomes",40,40,0,43,43,0
11,15,2018,3,0,5,"Braga",1,"Avenida da Liberdade",25,25,0,26,26,0
11,15,2018,3,0,5,"Braga",2,"Avenida Central",17,17,0,272,272,0
11,15,2018,3,0,5,"Braga",3,"Rua de Caires",24,24,0,4,4,0
11,15,2018,3,0,5,"Braga",4,"N14 Bosch",46,46,0,48,48,0
11,15,2018,3,0,5,"Braga",5,"Avenida João Paulo II",38,38,0,9,9,0
11,15,2018,3,0,5,"Braga",6,"Avenida Padre Júlio Fragata",61,61,0,21,21,0
11,15,2018,3,0,5,"Braga",7,"Rua Nova Santa Cruz",17,29,12,179,104,75
11,15,2018,3,0,5,"Braga",8,"Rua Costa Gomes",40,40,0,43,43,0
11,15,2018,4,0,5,"Braga",1,"Avenida da Liberdade",25,25,0,26,26,0
11,15,2018,4,0,5,"Braga",2,"Avenida Central",17,17,0,272,272,0
11,15,2018,4,0,5,"Braga",3,"Rua de Caires",24,24,0,4,4,0
11,15,2018,4,0,5,"Braga",4,"N14 Bosch",46,46,0,48,48,0
11,15,2018,4,0,5,"Braga",5,"Avenida João Paulo II",38,38,0,9,9,0
11,15,2018,4,0,5,"Braga",6,"Avenida Padre Júlio Fragata",61,61,0,21,21,0
11,15,2018,4,0,5,"Braga",7,"Rua Nova Santa Cruz",28,28,0,108,108,0
11,15,2018,4,0,5,"Braga",8,"Rua Costa Gomes",40,40,0,43,43,0
11,15,2018,5,0,5,"Braga",1,"Avenida da Liberdade",25,25,0,26,26,0
11,15,2018,5,0,5,"Braga",2,"Avenida Central",17,17,0,272,272,0
11,15,2018,5,0,5,"Braga",3,"Rua de Caires",24,24,0,4,4,0
11,15,2018,5,0,5,"Braga",4,"N14 Bosch",46,46,0,48,48,0
11,15,2018,5,0,5,"Braga",5,"Avenida João Paulo II",38,38,0,9,9,0
11,15,2018,5,0,5,"Braga",6,"Avenida Padre Júlio Fragata",61,61,0,21,21,0
11,15,2018,5,0,5,"Braga",7,"Rua Nova Santa Cruz",28,28,0,108,108,0
11,15,2018,5,0,5,"Braga",8,"Rua Costa Gomes",40,40,0,43,43,0
11,15,2018,6,0,5,"Braga",1,"Avenida da Liberdade",25,25,0,26,26,0
11,15,2018,6,0,5,"Braga",2,"Avenida Central",17,17,0,272,272,0
11,15,2018,6,0,5,"Braga",3,"Rua de Caires",24,24,0,4,4,0
11,15,2018,6,0,5,"Braga",4,"N14 Bosch",46,46,0,48,48,0
11,15,2018,6,0,5,"Braga",5,"Avenida João Paulo II",38,38,0,9,9,0
11,15,2018,6,0,5,"Braga",6,"Avenida Padre Júlio Fragata",61,61,0,21,21,0
11,15,2018,6,0,5,"Braga",7,"Rua Nova Santa Cruz",28,28,0,108,108,0
11,15,2018,6,0,5,"Braga",8,"Rua Costa Gomes",40,40,0,43,43,0
11,15,2018,7,0,5,"Braga",1,"Avenida da Liberdade",25,25,0,26,26,0
11,15,2018,7,0,5,"Braga",2,"Avenida Central",17,17,0,272,272,0
11,15,2018,7,0,5,"Braga",3,"Rua de Caires",24,24,0,4,4,0
11,15,2018,7,0,5,"Braga",4,"N14 Bosch",46,46,0,48,48,0
11,15,2018,7,0,5,"Braga",5,"Avenida João Paulo II",38,38,0,9,9,0
11,15,2018,7,0,5,"Braga",6,"Avenida Padre Júlio Fragata",61,61,0,21,21,0
11,15,2018,7,0,5,"Braga",7,"Rua Nova Santa Cruz",28,28,0,108,108,0
11,15,2018,7,0,5,"Braga",8,"Rua Costa Gomes",40,40,0,43,43,0
11,15,2018,8,0,5,"Braga",1,"Avenida da Liberdade",25,25,0,26,26,0
11,15,2018,8,0,5,"Braga",2,"Avenida Central",17,17,0,272,272,0
11,15,2018,8,0,5,"Braga",3,"Rua de Caires",19,24,5,5,4,1
11,15,2018,8,0,5,"Braga",4,"N14 Bosch",32,46,14,70,48,22
11,15,2018,8,0,5,"Braga",5,"Avenida João Paulo II",38,38,0,9,9,0
11,15,2018,8,0,5,"Braga",6,"Avenida Padre Júlio Fragata",61,61,0,21,21,0
11,15,2018,8,0,5,"Braga",7,"Rua Nova Santa Cruz",28,28,0,108,108,0
11,15,2018,8,0,5,"Braga",8,"Rua Costa Gomes",28,40,12,61,43,18
11,15,2018,9,0,5,"Braga",1,"Avenida da Liberdade",25,25,0,26,26,0
11,15,2018,9,0,5,"Braga",2,"Avenida Central",8,19,11,579,244,335
11,15,2018,9,0,5,"Braga",3,"Rua de Caires",25,25,0,4,4,0
11,15,2018,9,0,5,"Braga",4,"N14 Bosch",33,46,13,68,48,20
11,15,2018,9,0,5,"Braga",5,"Avenida João Paulo II",23,38,15,15,9,6
11,15,2018,9,0,5,"Braga",6,"Avenida Padre Júlio Fragata",42,62,20,31,21,10
11,15,2018,9,0,5,"Braga",7,"Rua Nova Santa Cruz",28,28,0,108,108,0
11,15,2018,9,0,5,"Braga",8,"Rua Costa Gomes",20,41,21,86,42,44
11,15,2018,10,0,5,"Braga",1,"Avenida da Liberdade",18,24,6,36,27,9
11,15,2018,10,0,5,"Braga",2,"Avenida Central",18,18,0,257,257,0
11,15,2018,10,0,5,"Braga",3,"Rua de Caires",25,25,0,4,4,0
11,15,2018,10,0,5,"Braga",4,"N14 Bosch",24,47,23,93,47,46
11,15,2018,10,0,5,"Braga",5,"Avenida João Paulo II",31,39,8,11,8,3
11,15,2018,10,0,5,"Braga",6,"Avenida Padre Júlio Fragata",62,62,0,21,21,0
11,15,2018,10,0,5,"Braga",7,"Rua Nova Santa Cruz",20,29,9,152,104,48
11,15,2018,10,0,5,"Braga",8,"Rua Costa Gomes",25,41,16,69,42,27
11,15,2018,11,0,5,"Braga",1,"Avenida da Liberdade",19,24,5,34,27,7
11,15,2018,11,0,5,"Braga",2,"Avenida Central",13,18,5,356,257,99
11,15,2018,11,0,5,"Braga",3,"Rua de Caires",25,25,0,4,4,0
11,15,2018,11,0,5,"Braga",4,"N14 Bosch",30,47,17,74,47,27
11,15,2018,11,0,5,"Braga",5,"Avenida João Paulo II",38,38,0,9,9,0
11,15,2018,11,0,5,"Braga",6,"Avenida Padre Júlio Fragata",62,62,0,21,21,0
11,15,2018,11,0,5,"Braga",7,"Rua Nova Santa Cruz",29,29,0,104,104,0
11,15,2018,11,0,5,"Braga",8,"Rua Costa Gomes",31,40,9,55,43,12
11,15,2018,12,0,5,"Braga",1,"Avenida da Liberdade",20,25,5,33,26,7
11,15,2018,12,0,5,"Braga",2,"Avenida Central",9,17,8,515,272,243
11,15,2018,12,0,5,"Braga",3,"Rua de Caires",25,25,0,4,4,0
11,15,2018,12,0,5,"Braga",4,"N14 Bosch",46,46,0,48,48,0
11,15,2018,12,0,5,"Braga",5,"Avenida João Paulo II",38,38,0,9,9,0
11,15,2018,12,0,5,"Braga",6,"Avenida Padre Júlio Fragata",62,62,0,21,21,0
11,15,2018,12,0,5,"Braga",7,"Rua Nova Santa Cruz",29,29,0,104,104,0
11,15,2018,12,0,5,"Braga",8,"Rua Costa Gomes",41,41,0,42,42,0
11,15,2018,13,0,5,"Braga",1,"Avenida da Liberdade",25,25,0,26,26,0
11,15,2018,13,0,5,"Braga",2,"Avenida Central",13,17,4,356,272,84
11,15,2018,13,0,5,"Braga",3,"Rua de Caires",25,25,0,4,4,0
11,15,2018,13,0,5,"Braga",4,"N14 Bosch",16,46,30,140,48,92
11,15,2018,13,0,5,"Braga",5,"Avenida João Paulo II",22,38,16,15,9,6
11,15,2018,13,0,5,"Braga",6,"Avenida Padre Júlio Fragata",49,61,12,27,21,6
11,15,2018,13,0,5,"Braga",7,"Rua Nova Santa Cruz",13,29,16,234,104,130
11,15,2018,13,0,5,"Braga",8,"Rua Costa Gomes",40,40,0,43,43,0
11,15,2018,14,0,5,"Braga",1,"Avenida da Liberdade",25,25,0,26,26,0
11,15,2018,14,0,5,"Braga",2,"Avenida Central",14,18,4,331,257,74
11,15,2018,14,0,5,"Braga",3,"Rua de Caires",25,25,0,4,4,0
11,15,2018,14,0,5,"Braga",4,"N14 Bosch",24,47,23,93,47,46
11,15,2018,14,0,5,"Braga",5,"Avenida João Paulo II",39,39,0,8,8,0
11,15,2018,14,0,5,"Braga",6,"Avenida Padre Júlio Fragata",47,62,15,28,21,7
11,15,2018,14,0,5,"Braga",7,"Rua Nova Santa Cruz",9,30,21,338,101,237
11,15,2018,14,0,5,"Braga",8,"Rua Costa Gomes",29,41,12,59,42,17
11,15,2018,15,0,5,"Braga",1,"Avenida da Liberdade",20,25,5,33,26,7
11,15,2018,15,0,5,"Braga",2,"Avenida Central",11,18,7,421,257,164
11,15,2018,15,0,5,"Braga",3,"Rua de Caires",17,25,8,6,4,2
11,15,2018,15,0,5,"Braga",4,"N14 Bosch",27,46,19,83,48,35
11,15,2018,15,0,5,"Braga",5,"Avenida João Paulo II",39,39,0,8,8,0
11,15,2018,15,0,5,"Braga",6,"Avenida Padre Júlio Fragata",61,61,0,21,21,0
11,15,2018,15,0,5,"Braga",7,"Rua Nova Santa Cruz",29,29,0,104,104,0
11,15,2018,15,0,5,"Braga",8,"Rua Costa Gomes",40,40,0,43,43,0
11,15,2018,17,0,5,"Braga",1,"Avenida da Liberdade",19,25,6,34,26,8
11,15,2018,17,0,5,"Braga",2,"Avenida Central",11,18,7,421,257,164
11,15,2018,17,0,5,"Braga",3,"Rua de Caires",8,26,18,13,4,9
11,15,2018,17,0,5,"Braga",4,"N14 Bosch",22,47,25,102,47,55
11,15,2018,17,0,5,"Braga",5,"Avenida João Paulo II",29,38,9,12,9,3
11,15,2018,17,0,5,"Braga",6,"Avenida Padre Júlio Fragata",48,62,14,27,21,6
11,15,2018,17,0,5,"Braga",7,"Rua Nova Santa Cruz",14,28,14,217,108,109
11,15,2018,17,0,5,"Braga",8,"Rua Costa Gomes",22,41,19,78,42,36
11,15,2018,18,0,5,"Braga",1,"Avenida da Liberdade",15,24,9,44,27,17
11,15,2018,18,0,5,"Braga",2,"Avenida Central",10,18,8,463,257,206
11,15,2018,18,0,5,"Braga",3,"Rua de Caires",5,26,21,20,4,16
11,15,2018,18,0,5,"Braga",4,"N14 Bosch",17,46,29,132,48,84
11,15,2018,18,0,5,"Braga",5,"Avenida João Paulo II",31,38,7,11,9,2
11,15,2018,18,0,5,"Braga",6,"Avenida Padre Júlio Fragata",27,61,34,49,21,28
11,15,2018,18,0,5,"Braga",7,"Rua Nova Santa Cruz",12,30,18,253,101,152
11,15,2018,18,0,5,"Braga",8,"Rua Costa Gomes",9,41,32,192,42,150
11,15,2018,19,0,5,"Braga",1,"Avenida da Liberdade",19,24,5,34,27,7
11,15,2018,19,0,5,"Braga",2,"Avenida Central",10,17,7,463,272,191
11,15,2018,19,0,5,"Braga",3,"Rua de Caires",9,24,15,11,4,7
11,15,2018,19,0,5,"Braga",4,"N14 Bosch",21,46,25,107,48,59
11,15,2018,19,0,5,"Braga",5,"Avenida João Paulo II",11,40,29,31,8,23
11,15,2018,19,0,5,"Braga",6,"Avenida Padre Júlio Fragata",23,63,40,57,21,36
11,15,2018,19,0,5,"Braga",7,"Rua Nova Santa Cruz",11,29,18,276,104,172
11,15,2018,19,0,5,"Braga",8,"Rua Costa Gomes",13,41,28,132,42,90
11,15,2018,20,0,5,"Braga",1,"Avenida da Liberdade",25,25,0,26,26,0
11,15,2018,20,0,5,"Braga",2,"Avenida Central",17,17,0,272,272,0
11,15,2018,20,0,5,"Braga",3,"Rua de Caires",24,24,0,4,4,0
11,15,2018,20,0,5,"Braga",4,"N14 Bosch",46,46,0,48,48,0
11,15,2018,20,0,5,"Braga",5,"Avenida João Paulo II",39,39,0,8,8,0
11,15,2018,20,0,5,"Braga",6,"Avenida Padre Júlio Fragata",49,62,13,27,21,6
11,15,2018,20,0,5,"Braga",7,"Rua Nova Santa Cruz",21,28,7,144,108,36
11,15,2018,20,0,5,"Braga",8,"Rua Costa Gomes",40,40,0,43,43,0
11,15,2018,21,0,5,"Braga",1,"Avenida da Liberdade",25,25,0,26,26,0
11,15,2018,21,0,5,"Braga",2,"Avenida Central",18,18,0,257,257,0
11,15,2018,21,0,5,"Braga",3,"Rua de Caires",24,24,0,4,4,0
11,15,2018,21,0,5,"Braga",4,"N14 Bosch",46,46,0,48,48,0
11,15,2018,21,0,5,"Braga",5,"Avenida João Paulo II",39,39,0,8,8,0
11,15,2018,21,0,5,"Braga",6,"Avenida Padre Júlio Fragata",61,61,0,21,21,0
11,15,2018,21,0,5,"Braga",7,"Rua Nova Santa Cruz",28,28,0,108,108,0
11,15,2018,21,0,5,"Braga",8,"Rua Costa Gomes",40,40,0,43,43,0
11,15,2018,22,0,5,"Braga",1,"Avenida da Liberdade",25,25,0,26,26,0
11,15,2018,22,0,5,"Braga",2,"Avenida Central",18,18,0,257,257,0
11,15,2018,22,0,5,"Braga",3,"Rua de Caires",24,24,0,4,4,0
11,15,2018,22,0,5,"Braga",4,"N14 Bosch",46,46,0,48,48,0
11,15,2018,22,0,5,"Braga",5,"Avenida João Paulo II",39,39,0,8,8,0
11,15,2018,22,0,5,"Braga",6,"Avenida Padre Júlio Fragata",61,61,0,21,21,0
11,15,2018,22,0,5,"Braga",7,"Rua Nova Santa Cruz",28,28,0,108,108,0
11,15,2018,22,0,5,"Braga",8,"Rua Costa Gomes",40,40,0,43,43,0
11,15,2018,23,0,5,"Braga",1,"Avenida da Liberdade",25,25,0,26,26,0
11,15,2018,23,0,5,"Braga",2,"Avenida Central",18,18,0,257,257,0
11,15,2018,23,0,5,"Braga",3,"Rua de Caires",24,24,0,4,4,0
11,15,2018,23,0,5,"Braga",4,"N14 Bosch",46,46,0,48,48,0
11,15,2018,23,0,5,"Braga",5,"Avenida João Paulo II",39,39,0,8,8,0
11,15,2018,23,0,5,"Braga",6,"Avenida Padre Júlio Fragata",44,62,18,30,21,9
11,15,2018,23,0,5,"Braga",7,"Rua Nova Santa Cruz",28,28,0,108,108,0
11,15,2018,23,0,5,"Braga",8,"Rua Costa Gomes",40,40,0,43,43,0
11,16,2018,0,0,6,"Braga",1,"Avenida da Liberdade",25,25,0,26,26,0
11,16,2018,0,0,6,"Braga",2,"Avenida Central",18,18,0,257,257,0
11,16,2018,0,0,6,"Braga",3,"Rua de Caires",24,24,0,4,4,0
11,16,2018,0,0,6,"Braga",4,"N14 Bosch",46,46,0,48,48,0
11,16,2018,0,0,6,"Braga",5,"Avenida João Paulo II",39,39,0,8,8,0
11,16,2018,0,0,6,"Braga",6,"Avenida Padre Júlio Fragata",61,61,0,21,21,0
11,16,2018,0,0,6,"Braga",7,"Rua Nova Santa Cruz",28,28,0,108,108,0
11,16,2018,0,0,6,"Braga",8,"Rua Costa Gomes",40,40,0,43,43,0
11,16,2018,1,0,6,"Braga",1,"Avenida da Liberdade",25,25,0,26,26,0
11,16,2018,1,0,6,"Braga",2,"Avenida Central",18,18,0,257,257,0
11,16,2018,1,0,6,"Braga",3,"Rua de Caires",24,24,0,4,4,0
11,16,2018,1,0,6,"Braga",4,"N14 Bosch",46,46,0,48,48,0
11,16,2018,1,0,6,"Braga",5,"Avenida João Paulo II",39,39,0,8,8,0
11,16,2018,1,0,6,"Braga",6,"Avenida Padre Júlio Fragata",61,61,0,21,21,0
11,16,2018,1,0,6,"Braga",7,"Rua Nova Santa Cruz",28,28,0,108,108,0
11,16,2018,1,0,6,"Braga",8,"Rua Costa Gomes",40,40,0,43,43,0
11,16,2018,2,0,6,"Braga",1,"Avenida da Liberdade",25,25,0,26,26,0
11,16,2018,2,0,6,"Braga",2,"Avenida Central",18,18,0,257,257,0
11,16,2018,2,0,6,"Braga",3,"Rua de Caires",24,24,0,4,4,0
11,16,2018,2,0,6,"Braga",4,"N14 Bosch",46,46,0,48,48,0
11,16,2018,2,0,6,"Braga",5,"Avenida João Paulo II",39,39,0,8,8,0
11,16,2018,2,0,6,"Braga",6,"Avenida Padre Júlio Fragata",61,61,0,21,21,0
11,16,2018,2,0,6,"Braga",7,"Rua Nova Santa Cruz",28,28,0,108,108,0
11,16,2018,2,0,6,"Braga",8,"Rua Costa Gomes",40,40,0,43,43,0
11,16,2018,3,0,6,"Braga",1,"Avenida da Liberdade",25,25,0,26,26,0
11,16,2018,3,0,6,"Braga",2,"Avenida Central",18,18,0,257,257,0
11,16,2018,3,0,6,"Braga",3,"Rua de Caires",24,24,0,4,4,0
11,16,2018,3,0,6,"Braga",4,"N14 Bosch",46,46,0,48,48,0
11,16,2018,3,0,6,"Braga",5,"Avenida João Paulo II",39,39,0,8,8,0
11,16,2018,3,0,6,"Braga",6,"Avenida Padre Júlio Fragata",61,61,0,21,21,0
11,16,2018,3,0,6,"Braga",7,"Rua Nova Santa Cruz",28,28,0,108,108,0
11,16,2018,3,0,6,"Braga",8,"Rua Costa Gomes",40,40,0,43,43,0
11,16,2018,4,0,6,"Braga",1,"Avenida da Liberdade",25,25,0,26,26,0
11,16,2018,4,0,6,"Braga",2,"Avenida Central",18,18,0,257,257,0
11,16,2018,4,0,6,"Braga",3,"Rua de Caires",24,24,0,4,4,0
11,16,2018,4,0,6,"Braga",4,"N14 Bosch",46,46,0,48,48,0
11,16,2018,4,0,6,"Braga",5,"Avenida João Paulo II",39,39,0,8,8,0
11,16,2018,4,0,6,"Braga",6,"Avenida Padre Júlio Fragata",61,61,0,21,21,0
11,16,2018,4,0,6,"Braga",7,"Rua Nova Santa Cruz",28,28,0,108,108,0
11,16,2018,4,0,6,"Braga",8,"Rua Costa Gomes",40,40,0,43,43,0
11,16,2018,5,0,6,"Braga",1,"Avenida da Liberdade",25,25,0,26,26,0
11,16,2018,5,0,6,"Braga",2,"Avenida Central",18,18,0,257,257,0
11,16,2018,5,0,6,"Braga",3,"Rua de Caires",24,24,0,4,4,0
11,16,2018,5,0,6,"Braga",4,"N14 Bosch",46,46,0,48,48,0
11,16,2018,5,0,6,"Braga",5,"Avenida João Paulo II",39,39,0,8,8,0
11,16,2018,5,0,6,"Braga",6,"Avenida Padre Júlio Fragata",61,61,0,21,21,0
11,16,2018,5,0,6,"Braga",7,"Rua Nova Santa Cruz",28,28,0,108,108,0
11,16,2018,5,0,6,"Braga",8,"Rua Costa Gomes",40,40,0,43,43,0
11,16,2018,6,0,6,"Braga",1,"Avenida da Liberdade",25,25,0,26,26,0
11,16,2018,6,0,6,"Braga",2,"Avenida Central",18,18,0,257,257,0
11,16,2018,6,0,6,"Braga",3,"Rua de Caires",24,24,0,4,4,0
11,16,2018,6,0,6,"Braga",4,"N14 Bosch",46,46,0,48,48,0
11,16,2018,6,0,6,"Braga",5,"Avenida João Paulo II",39,39,0,8,8,0
11,16,2018,6,0,6,"Braga",6,"Avenida Padre Júlio Fragata",61,61,0,21,21,0
11,16,2018,6,0,6,"Braga",7,"Rua Nova Santa Cruz",28,28,0,108,108,0
11,16,2018,6,0,6,"Braga",8,"Rua Costa Gomes",40,40,0,43,43,0
11,16,2018,7,0,6,"Braga",1,"Avenida da Liberdade",25,25,0,26,26,0
11,16,2018,7,0,6,"Braga",2,"Avenida Central",18,18,0,257,257,0
11,16,2018,7,0,6,"Braga",3,"Rua de Caires",24,24,0,4,4,0
11,16,2018,7,0,6,"Braga",4,"N14 Bosch",46,46,0,48,48,0
11,16,2018,7,0,6,"Braga",5,"Avenida João Paulo II",39,39,0,8,8,0
11,16,2018,7,0,6,"Braga",6,"Avenida Padre Júlio Fragata",61,61,0,21,21,0
11,16,2018,7,0,6,"Braga",7,"Rua Nova Santa Cruz",28,28,0,108,108,0
11,16,2018,7,0,6,"Braga",8,"Rua Costa Gomes",40,40,0,43,43,0
11,16,2018,8,0,6,"Braga",1,"Avenida da Liberdade",25,25,0,26,26,0
11,16,2018,8,0,6,"Braga",2,"Avenida Central",18,18,0,257,257,0
11,16,2018,8,0,6,"Braga",3,"Rua de Caires",24,24,0,4,4,0
11,16,2018,8,0,6,"Braga",4,"N14 Bosch",37,47,10,60,47,13
11,16,2018,8,0,6,"Braga",5,"Avenida João Paulo II",39,39,0,8,8,0
11,16,2018,8,0,6,"Braga",6,"Avenida Padre Júlio Fragata",61,61,0,21,21,0
11,16,2018,8,0,6,"Braga",7,"Rua Nova Santa Cruz",28,28,0,108,108,0
11,16,2018,8,0,6,"Braga",8,"Rua Costa Gomes",40,40,0,43,43,0
11,16,2018,9,0,6,"Braga",1,"Avenida da Liberdade",18,25,7,36,26,10
11,16,2018,9,0,6,"Braga",2,"Avenida Central",7,17,10,662,272,390
11,16,2018,9,0,6,"Braga",3,"Rua de Caires",24,24,0,4,4,0
11,16,2018,9,0,6,"Braga",4,"N14 Bosch",28,46,18,80,48,32
11,16,2018,9,0,6,"Braga",5,"Avenida João Paulo II",39,39,0,8,8,0
11,16,2018,9,0,6,"Braga",6,"Avenida Padre Júlio Fragata",48,62,14,27,21,6
11,16,2018,9,0,6,"Braga",7,"Rua Nova Santa Cruz",15,29,14,202,104,98
11,16,2018,9,0,6,"Braga",8,"Rua Costa Gomes",24,40,16,72,43,29
11,16,2018,10,0,6,"Braga",1,"Avenida da Liberdade",20,25,5,33,26,7
11,16,2018,10,0,6,"Braga",2,"Avenida Central",17,17,0,272,272,0
11,16,2018,10,0,6,"Braga",3,"Rua de Caires",25,25,0,4,4,0
11,16,2018,10,0,6,"Braga",4,"N14 Bosch",31,47,16,72,47,25
11,16,2018,10,0,6,"Braga",5,"Avenida João Paulo II",38,38,0,9,9,0
11,16,2018,10,0,6,"Braga",6,"Avenida Padre Júlio Fragata",62,62,0,21,21,0
11,16,2018,10,0,6,"Braga",7,"Rua Nova Santa Cruz",23,29,6,132,104,28
11,16,2018,10,0,6,"Braga",8,"Rua Costa Gomes",41,41,0,42,42,0
11,16,2018,11,0,6,"Braga",1,"Avenida da Liberdade",25,25,0,26,26,0
11,16,2018,11,0,6,"Braga",2,"Avenida Central",14,18,4,331,257,74
11,16,2018,11,0,6,"Braga",3,"Rua de Caires",25,25,0,4,4,0
11,16,2018,11,0,6,"Braga",4,"N14 Bosch",46,46,0,48,48,0
11,16,2018,11,0,6,"Braga",5,"Avenida João Paulo II",38,38,0,9,9,0
11,16,2018,11,0,6,"Braga",6,"Avenida Padre Júlio Fragata",62,62,0,21,21,0
11,16,2018,11,0,6,"Braga",7,"Rua Nova Santa Cruz",23,28,5,132,108,24
11,16,2018,11,0,6,"Braga",8,"Rua Costa Gomes",41,41,0,42,42,0
11,16,2018,12,0,6,"Braga",1,"Avenida da Liberdade",25,25,0,26,26,0
11,16,2018,12,0,6,"Braga",2,"Avenida Central",17,17,0,272,272,0
11,16,2018,12,0,6,"Braga",3,"Rua de Caires",25,25,0,4,4,0
11,16,2018,12,0,6,"Braga",4,"N14 Bosch",28,47,19,80,47,33
11,16,2018,12,0,6,"Braga",5,"Avenida João Paulo II",38,38,0,9,9,0
11,16,2018,12,0,6,"Braga",6,"Avenida Padre Júlio Fragata",43,62,19,30,21,9
11,16,2018,12,0,6,"Braga",7,"Rua Nova Santa Cruz",28,28,0,108,108,0
11,16,2018,12,0,6,"Braga",8,"Rua Costa Gomes",25,40,15,69,43,26
11,16,2018,13,0,6,"Braga",1,"Avenida da Liberdade",25,25,0,26,26,0
11,16,2018,13,0,6,"Braga",2,"Avenida Central",13,17,4,356,272,84
11,16,2018,13,0,6,"Braga",3,"Rua de Caires",20,25,5,5,4,1
11,16,2018,13,0,6,"Braga",4,"N14 Bosch",19,47,28,118,47,71
11,16,2018,13,0,6,"Braga",5,"Avenida João Paulo II",21,38,17,16,9,7
11,16,2018,13,0,6,"Braga",6,"Avenida Padre Júlio Fragata",62,62,0,21,21,0
11,16,2018,13,0,6,"Braga",7,"Rua Nova Santa Cruz",19,29,10,160,104,56
11,16,2018,13,0,6,"Braga",8,"Rua Costa Gomes",22,40,18,78,43,35
11,16,2018,14,0,6,"Braga",1,"Avenida da Liberdade",25,25,0,26,26,0
11,16,2018,14,0,6,"Braga",2,"Avenida Central",13,17,4,356,272,84
11,16,2018,14,0,6,"Braga",3,"Rua de Caires",25,25,0,4,4,0
11,16,2018,14,0,6,"Braga",4,"N14 Bosch",22,46,24,102,48,54
11,16,2018,14,0,6,"Braga",5,"Avenida João Paulo II",38,38,0,9,9,0
11,16,2018,14,0,6,"Braga",6,"Avenida Padre Júlio Fragata",46,61,15,28,21,7
11,16,2018,14,0,6,"Braga",7,"Rua Nova Santa Cruz",28,28,0,108,108,0
11,16,2018,14,0,6,"Braga",8,"Rua Costa Gomes",40,40,0,43,43,0
11,16,2018,15,0,6,"Braga",1,"Avenida da Liberdade",25,25,0,26,26,0
11,16,2018,15,0,6,"Braga",2,"Avenida Central",17,17,0,272,272,0
11,16,2018,15,0,6,"Braga",3,"Rua de Caires",25,25,0,4,4,0
11,16,2018,15,0,6,"Braga",4,"N14 Bosch",20,46,26,112,48,64
11,16,2018,15,0,6,"Braga",5,"Avenida João Paulo II",39,39,0,8,8,0
11,16,2018,15,0,6,"Braga",6,"Avenida Padre Júlio Fragata",38,61,23,35,21,14
11,16,2018,15,0,6,"Braga",7,"Rua Nova Santa Cruz",22,28,6,138,108,30
11,16,2018,15,0,6,"Braga",8,"Rua Costa Gomes",30,41,11,57,42,15
11,16,2018,16,0,6,"Braga",1,"Avenida da Liberdade",19,25,6,34,26,8
11,16,2018,16,0,6,"Braga",2,"Avenida Central",17,17,0,272,272,0
11,16,2018,16,0,6,"Braga",3,"Rua de Caires",18,25,7,5,4,1
11,16,2018,16,0,6,"Braga",4,"N14 Bosch",18,46,28,124,48,76
11,16,2018,16,0,6,"Braga",5,"Avenida João Paulo II",30,39,9,11,8,3
11,16,2018,16,0,6,"Braga",6,"Avenida Padre Júlio Fragata",62,62,0,21,21,0
11,16,2018,16,0,6,"Braga",7,"Rua Nova Santa Cruz",22,29,7,138,104,34
11,16,2018,16,0,6,"Braga",8,"Rua Costa Gomes",41,41,0,42,42,0
11,16,2018,17,0,6,"Braga",1,"Avenida da Liberdade",19,25,6,34,26,8
11,16,2018,17,0,6,"Braga",2,"Avenida Central",8,17,9,579,272,307
11,16,2018,17,0,6,"Braga",3,"Rua de Caires",24,24,0,4,4,0
11,16,2018,17,0,6,"Braga",4,"N14 Bosch",21,48,27,107,46,61
11,16,2018,17,0,6,"Braga",5,"Avenida João Paulo II",27,38,11,12,9,3
11,16,2018,17,0,6,"Braga",6,"Avenida Padre Júlio Fragata",48,61,13,27,21,6
11,16,2018,17,0,6,"Braga",7,"Rua Nova Santa Cruz",18,29,11,169,104,65
11,16,2018,17,0,6,"Braga",8,"Rua Costa Gomes",18,40,22,96,43,53
11,16,2018,18,0,6,"Braga",1,"Avenida da Liberdade",16,25,9,41,26,15
11,16,2018,18,0,6,"Braga",2,"Avenida Central",9,17,8,515,272,243
11,16,2018,18,0,6,"Braga",3,"Rua de Caires",25,25,0,4,4,0
11,16,2018,18,0,6,"Braga",4,"N14 Bosch",19,47,28,118,47,71
11,16,2018,18,0,6,"Braga",5,"Avenida João Paulo II",8,37,29,43,9,34
11,16,2018,18,0,6,"Braga",6,"Avenida Padre Júlio Fragata",24,60,36,55,22,33
11,16,2018,18,0,6,"Braga",7,"Rua Nova Santa Cruz",20,29,9,152,104,48
11,16,2018,18,0,6,"Braga",8,"Rua Costa Gomes",16,41,25,108,42,66
11,16,2018,19,0,6,"Braga",1,"Avenida da Liberdade",25,25,0,26,26,0
11,16,2018,19,0,6,"Braga",2,"Avenida Central",6,19,13,772,244,528
11,16,2018,19,0,6,"Braga",3,"Rua de Caires",6,27,21,17,3,14
11,16,2018,19,0,6,"Braga",4,"N14 Bosch",36,47,11,62,47,15
11,16,2018,19,0,6,"Braga",5,"Avenida João Paulo II",28,39,11,12,8,4
11,16,2018,19,0,6,"Braga",6,"Avenida Padre Júlio Fragata",26,62,36,51,21,30
11,16,2018,19,0,6,"Braga",7,"Rua Nova Santa Cruz",11,29,18,276,104,172
11,16,2018,19,0,6,"Braga",8,"Rua Costa Gomes",6,41,35,288,42,246
11,16,2018,20,0,6,"Braga",1,"Avenida da Liberdade",25,25,0,26,26,0
11,16,2018,20,0,6,"Braga",2,"Avenida Central",17,17,0,272,272,0
11,16,2018,20,0,6,"Braga",3,"Rua de Caires",24,24,0,4,4,0
11,16,2018,20,0,6,"Braga",4,"N14 Bosch",26,46,20,86,48,38
11,16,2018,20,0,6,"Braga",5,"Avenida João Paulo II",26,39,13,13,8,5
11,16,2018,20,0,6,"Braga",6,"Avenida Padre Júlio Fragata",37,61,24,35,21,14
11,16,2018,20,0,6,"Braga",7,"Rua Nova Santa Cruz",18,29,11,169,104,65
11,16,2018,20,0,6,"Braga",8,"Rua Costa Gomes",21,40,19,82,43,39
11,16,2018,21,0,6,"Braga",1,"Avenida da Liberdade",25,25,0,26,26,0
11,16,2018,21,0,6,"Braga",2,"Avenida Central",17,17,0,272,272,0
11,16,2018,21,0,6,"Braga",3,"Rua de Caires",24,24,0,4,4,0
11,16,2018,21,0,6,"Braga",4,"N14 Bosch",36,47,11,62,47,15
11,16,2018,21,0,6,"Braga",5,"Avenida João Paulo II",39,39,0,8,8,0
11,16,2018,21,0,6,"Braga",6,"Avenida Padre Júlio Fragata",39,62,23,34,21,13
11,16,2018,21,0,6,"Braga",7,"Rua Nova Santa Cruz",29,29,0,104,104,0
11,16,2018,21,0,6,"Braga",8,"Rua Costa Gomes",40,40,0,43,43,0
11,16,2018,22,0,6,"Braga",6,"Avenida Padre Júlio Fragata",47,62,15,28,21,7
11,16,2018,22,0,6,"Braga",7,"Rua Nova Santa Cruz",29,29,0,104,104,0
11,16,2018,22,0,6,"Braga",8,"Rua Costa Gomes",40,40,0,43,43,0
11,16,2018,22,0,6,"Braga",1,"Avenida da Liberdade",25,25,0,26,26,0
11,16,2018,22,0,6,"Braga",2,"Avenida Central",17,17,0,272,272,0
11,16,2018,22,0,6,"Braga",3,"Rua de Caires",19,24,5,5,4,1
11,16,2018,22,0,6,"Braga",4,"N14 Bosch",47,47,0,47,47,0
11,16,2018,22,0,6,"Braga",5,"Avenida João Paulo II",39,39,0,8,8,0
11,16,2018,22,0,6,"Braga",6,"Avenida Padre Júlio Fragata",47,62,15,28,21,7
11,16,2018,23,0,6,"Braga",1,"Avenida da Liberdade",25,25,0,26,26,0
11,16,2018,23,0,6,"Braga",2,"Avenida Central",17,17,0,272,272,0
11,16,2018,23,0,6,"Braga",3,"Rua de Caires",25,25,0,4,4,0
11,16,2018,23,0,6,"Braga",4,"N14 Bosch",47,47,0,47,47,0
11,16,2018,23,0,6,"Braga",5,"Avenida João Paulo II",39,39,0,8,8,0
11,16,2018,23,0,6,"Braga",6,"Avenida Padre Júlio Fragata",48,62,14,27,21,6
11,16,2018,23,0,6,"Braga",7,"Rua Nova Santa Cruz",29,29,0,104,104,0
11,16,2018,23,0,6,"Braga",8,"Rua Costa Gomes",41,41,0,42,42,0
11,17,2018,0,0,7,"Braga",1,"Avenida da Liberdade",25,25,0,26,26,0
11,17,2018,0,0,7,"Braga",2,"Avenida Central",17,17,0,272,272,0
11,17,2018,0,0,7,"Braga",3,"Rua de Caires",25,25,0,4,4,0
11,17,2018,0,0,7,"Braga",4,"N14 Bosch",46,46,0,48,48,0
11,17,2018,0,0,7,"Braga",5,"Avenida João Paulo II",39,39,0,8,8,0
11,17,2018,0,0,7,"Braga",6,"Avenida Padre Júlio Fragata",62,62,0,21,21,0
11,17,2018,0,0,7,"Braga",7,"Rua Nova Santa Cruz",29,29,0,104,104,0
11,17,2018,0,0,7,"Braga",8,"Rua Costa Gomes",41,41,0,42,42,0
11,17,2018,1,0,7,"Braga",1,"Avenida da Liberdade",25,25,0,26,26,0
11,17,2018,1,0,7,"Braga",2,"Avenida Central",17,17,0,272,272,0
11,17,2018,1,0,7,"Braga",3,"Rua de Caires",25,25,0,4,4,0
11,17,2018,1,0,7,"Braga",4,"N14 Bosch",46,46,0,48,48,0
11,17,2018,1,0,7,"Braga",5,"Avenida João Paulo II",39,39,0,8,8,0
11,17,2018,1,0,7,"Braga",6,"Avenida Padre Júlio Fragata",62,62,0,21,21,0
11,17,2018,1,0,7,"Braga",7,"Rua Nova Santa Cruz",29,29,0,104,104,0
11,17,2018,1,0,7,"Braga",8,"Rua Costa Gomes",41,41,0,42,42,0
11,17,2018,2,0,7,"Braga",1,"Avenida da Liberdade",25,25,0,26,26,0
11,17,2018,2,0,7,"Braga",2,"Avenida Central",17,17,0,272,272,0
11,17,2018,2,0,7,"Braga",3,"Rua de Caires",1,19,18,104,5,99
11,17,2018,2,0,7,"Braga",4,"N14 Bosch",46,46,0,48,48,0
11,17,2018,2,0,7,"Braga",5,"Avenida João Paulo II",39,39,0,8,8,0
11,17,2018,2,0,7,"Braga",6,"Avenida Padre Júlio Fragata",61,61,0,21,21,0
11,17,2018,2,0,7,"Braga",7,"Rua Nova Santa Cruz",29,29,0,104,104,0
11,17,2018,2,0,7,"Braga",8,"Rua Costa Gomes",41,41,0,42,42,0
11,17,2018,3,0,7,"Braga",1,"Avenida da Liberdade",25,25,0,26,26,0
11,17,2018,3,0,7,"Braga",2,"Avenida Central",17,17,0,272,272,0
11,17,2018,3,0,7,"Braga",3,"Rua de Caires",26,26,0,4,4,0
11,17,2018,3,0,7,"Braga",4,"N14 Bosch",46,46,0,48,48,0
11,17,2018,3,0,7,"Braga",5,"Avenida João Paulo II",39,39,0,8,8,0
11,17,2018,3,0,7,"Braga",6,"Avenida Padre Júlio Fragata",61,61,0,21,21,0
11,17,2018,3,0,7,"Braga",7,"Rua Nova Santa Cruz",29,29,0,104,104,0
11,17,2018,3,0,7,"Braga",8,"Rua Costa Gomes",41,41,0,42,42,0
11,17,2018,4,0,7,"Braga",1,"Avenida da Liberdade",25,25,0,26,26,0
11,17,2018,4,0,7,"Braga",2,"Avenida Central",17,17,0,272,272,0
11,17,2018,4,0,7,"Braga",3,"Rua de Caires",26,26,0,4,4,0
11,17,2018,4,0,7,"Braga",4,"N14 Bosch",46,46,0,48,48,0
11,17,2018,4,0,7,"Braga",5,"Avenida João Paulo II",39,39,0,8,8,0
11,17,2018,4,0,7,"Braga",6,"Avenida Padre Júlio Fragata",61,61,0,21,21,0
11,17,2018,4,0,7,"Braga",7,"Rua Nova Santa Cruz",29,29,0,104,104,0
11,17,2018,4,0,7,"Braga",8,"Rua Costa Gomes",41,41,0,42,42,0
11,17,2018,5,0,7,"Braga",1,"Avenida da Liberdade",25,25,0,26,26,0
11,17,2018,5,0,7,"Braga",2,"Avenida Central",17,17,0,272,272,0
11,17,2018,5,0,7,"Braga",3,"Rua de Caires",26,26,0,4,4,0
11,17,2018,5,0,7,"Braga",4,"N14 Bosch",46,46,0,48,48,0
11,17,2018,5,0,7,"Braga",5,"Avenida João Paulo II",39,39,0,8,8,0
11,17,2018,5,0,7,"Braga",6,"Avenida Padre Júlio Fragata",61,61,0,21,21,0
11,17,2018,5,0,7,"Braga",7,"Rua Nova Santa Cruz",29,29,0,104,104,0
11,17,2018,5,0,7,"Braga",8,"Rua Costa Gomes",41,41,0,42,42,0
11,17,2018,6,0,7,"Braga",1,"Avenida da Liberdade",25,25,0,26,26,0
11,17,2018,6,0,7,"Braga",2,"Avenida Central",17,17,0,272,272,0
11,17,2018,6,0,7,"Braga",3,"Rua de Caires",26,26,0,4,4,0
11,17,2018,6,0,7,"Braga",4,"N14 Bosch",46,46,0,48,48,0
11,17,2018,6,0,7,"Braga",5,"Avenida João Paulo II",39,39,0,8,8,0
11,17,2018,6,0,7,"Braga",6,"Avenida Padre Júlio Fragata",61,61,0,21,21,0
11,17,2018,6,0,7,"Braga",7,"Rua Nova Santa Cruz",29,29,0,104,104,0
11,17,2018,6,0,7,"Braga",8,"Rua Costa Gomes",41,41,0,42,42,0
11,17,2018,7,0,7,"Braga",1,"Avenida da Liberdade",25,25,0,26,26,0
11,17,2018,7,0,7,"Braga",2,"Avenida Central",17,17,0,272,272,0
11,17,2018,7,0,7,"Braga",3,"Rua de Caires",26,26,0,4,4,0
11,17,2018,7,0,7,"Braga",4,"N14 Bosch",46,46,0,48,48,0
11,17,2018,7,0,7,"Braga",5,"Avenida João Paulo II",39,39,0,8,8,0
11,17,2018,7,0,7,"Braga",6,"Avenida Padre Júlio Fragata",61,61,0,21,21,0
11,17,2018,7,0,7,"Braga",7,"Rua Nova Santa Cruz",29,29,0,104,104,0
11,17,2018,7,0,7,"Braga",8,"Rua Costa Gomes",41,41,0,42,42,0
11,17,2018,8,0,7,"Braga",1,"Avenida da Liberdade",25,25,0,26,26,0
11,17,2018,8,0,7,"Braga",2,"Avenida Central",17,17,0,272,272,0
11,17,2018,8,0,7,"Braga",3,"Rua de Caires",26,26,0,4,4,0
11,17,2018,8,0,7,"Braga",4,"N14 Bosch",46,46,0,48,48,0
11,17,2018,8,0,7,"Braga",5,"Avenida João Paulo II",25,38,13,13,9,4
11,17,2018,8,0,7,"Braga",6,"Avenida Padre Júlio Fragata",61,61,0,21,21,0
11,17,2018,8,0,7,"Braga",7,"Rua Nova Santa Cruz",29,29,0,104,104,0
11,17,2018,8,0,7,"Braga",8,"Rua Costa Gomes",41,41,0,42,42,0
11,17,2018,9,0,7,"Braga",1,"Avenida da Liberdade",25,25,0,26,26,0
11,17,2018,9,0,7,"Braga",2,"Avenida Central",17,17,0,272,272,0
11,17,2018,9,0,7,"Braga",3,"Rua de Caires",26,26,0,4,4,0
11,17,2018,9,0,7,"Braga",4,"N14 Bosch",46,46,0,48,48,0
11,17,2018,9,0,7,"Braga",5,"Avenida João Paulo II",39,39,0,8,8,0
11,17,2018,9,0,7,"Braga",6,"Avenida Padre Júlio Fragata",61,61,0,21,21,0
11,17,2018,9,0,7,"Braga",7,"Rua Nova Santa Cruz",29,29,0,104,104,0
11,17,2018,9,0,7,"Braga",8,"Rua Costa Gomes",27,40,13,64,43,21
11,17,2018,10,0,7,"Braga",1,"Avenida da Liberdade",25,25,0,26,26,0
11,17,2018,10,0,7,"Braga",2,"Avenida Central",14,18,4,331,257,74
11,17,2018,10,0,7,"Braga",3,"Rua de Caires",20,25,5,5,4,1
11,17,2018,10,0,7,"Braga",4,"N14 Bosch",46,46,0,48,48,0
11,17,2018,10,0,7,"Braga",5,"Avenida João Paulo II",39,39,0,8,8,0
11,17,2018,10,0,7,"Braga",6,"Avenida Padre Júlio Fragata",61,61,0,21,21,0
11,17,2018,10,0,7,"Braga",7,"Rua Nova Santa Cruz",29,29,0,104,104,0
11,17,2018,10,0,7,"Braga",8,"Rua Costa Gomes",31,41,10,55,42,13
11,17,2018,11,0,7,"Braga",1,"Avenida da Liberdade",25,25,0,26,26,0
11,17,2018,11,0,7,"Braga",2,"Avenida Central",11,17,6,421,272,149
11,17,2018,11,0,7,"Braga",3,"Rua de Caires",25,25,0,4,4,0
11,17,2018,11,0,7,"Braga",4,"N14 Bosch",46,46,0,48,48,0
11,17,2018,11,0,7,"Braga",5,"Avenida João Paulo II",39,39,0,8,8,0
11,17,2018,11,0,7,"Braga",6,"Avenida Padre Júlio Fragata",62,62,0,21,21,0
11,17,2018,11,0,7,"Braga",7,"Rua Nova Santa Cruz",29,29,0,104,104,0
11,17,2018,11,0,7,"Braga",8,"Rua Costa Gomes",32,40,8,54,43,11
11,17,2018,12,0,7,"Braga",1,"Avenida da Liberdade",25,25,0,26,26,0
11,17,2018,12,0,7,"Braga",2,"Avenida Central",6,18,12,772,257,515
11,17,2018,12,0,7,"Braga",3,"Rua de Caires",25,25,0,4,4,0
11,17,2018,12,0,7,"Braga",4,"N14 Bosch",46,46,0,48,48,0
11,17,2018,12,0,7,"Braga",5,"Avenida João Paulo II",39,39,0,8,8,0
11,17,2018,12,0,7,"Braga",6,"Avenida Padre Júlio Fragata",62,62,0,21,21,0
11,17,2018,12,0,7,"Braga",7,"Rua Nova Santa Cruz",29,29,0,104,104,0
11,17,2018,12,0,7,"Braga",8,"Rua Costa Gomes",31,41,10,55,42,13
11,17,2018,13,0,7,"Braga",1,"Avenida da Liberdade",25,25,0,26,26,0
11,17,2018,13,0,7,"Braga",2,"Avenida Central",14,18,4,331,257,74
11,17,2018,13,0,7,"Braga",3,"Rua de Caires",25,25,0,4,4,0
11,17,2018,13,0,7,"Braga",4,"N14 Bosch",35,47,12,64,47,17
11,17,2018,13,0,7,"Braga",5,"Avenida João Paulo II",39,39,0,8,8,0
11,17,2018,13,0,7,"Braga",6,"Avenida Padre Júlio Fragata",62,62,0,21,21,0
11,17,2018,13,0,7,"Braga",7,"Rua Nova Santa Cruz",23,29,6,132,104,28
11,17,2018,13,0,7,"Braga",8,"Rua Costa Gomes",41,41,0,42,42,0
11,17,2018,14,0,7,"Braga",1,"Avenida da Liberdade",25,25,0,26,26,0
11,17,2018,14,0,7,"Braga",2,"Avenida Central",12,18,6,386,257,129
11,17,2018,14,0,7,"Braga",3,"Rua de Caires",25,25,0,4,4,0
11,17,2018,14,0,7,"Braga",4,"N14 Bosch",46,46,0,48,48,0
11,17,2018,14,0,7,"Braga",5,"Avenida João Paulo II",39,39,0,8,8,0
11,17,2018,14,0,7,"Braga",6,"Avenida Padre Júlio Fragata",61,61,0,21,21,0
11,17,2018,14,0,7,"Braga",7,"Rua Nova Santa Cruz",29,29,0,104,104,0
11,17,2018,14,0,7,"Braga",8,"Rua Costa Gomes",40,40,0,43,43,0
11,17,2018,15,0,7,"Braga",1,"Avenida da Liberdade",25,25,0,26,26,0
11,17,2018,15,0,7,"Braga",2,"Avenida Central",12,18,6,386,257,129
11,17,2018,15,0,7,"Braga",3,"Rua de Caires",25,25,0,4,4,0
11,17,2018,15,0,7,"Braga",4,"N14 Bosch",36,46,10,62,48,14
11,17,2018,15,0,7,"Braga",5,"Avenida João Paulo II",38,38,0,9,9,0
11,17,2018,15,0,7,"Braga",6,"Avenida Padre Júlio Fragata",45,61,16,29,21,8
11,17,2018,15,0,7,"Braga",7,"Rua Nova Santa Cruz",19,29,10,160,104,56
11,17,2018,15,0,7,"Braga",8,"Rua Costa Gomes",40,40,0,43,43,0
11,17,2018,16,0,7,"Braga",1,"Avenida da Liberdade",25,25,0,26,26,0
11,17,2018,16,0,7,"Braga",2,"Avenida Central",9,17,8,515,272,243
11,17,2018,16,0,7,"Braga",3,"Rua de Caires",20,25,5,5,4,1
11,17,2018,16,0,7,"Braga",4,"N14 Bosch",31,47,16,72,47,25
11,17,2018,16,0,7,"Braga",5,"Avenida João Paulo II",39,39,0,8,8,0
11,17,2018,16,0,7,"Braga",6,"Avenida Padre Júlio Fragata",61,61,0,21,21,0
11,17,2018,16,0,7,"Braga",7,"Rua Nova Santa Cruz",29,29,0,104,104,0
11,17,2018,16,0,7,"Braga",8,"Rua Costa Gomes",40,40,0,43,43,0
11,17,2018,17,0,7,"Braga",1,"Avenida da Liberdade",25,25,0,26,26,0
11,17,2018,17,0,7,"Braga",2,"Avenida Central",10,17,7,463,272,191
11,17,2018,17,0,7,"Braga",3,"Rua de Caires",25,25,0,4,4,0
11,17,2018,17,0,7,"Braga",4,"N14 Bosch",34,47,13,66,47,19
11,17,2018,17,0,7,"Braga",5,"Avenida João Paulo II",39,39,0,8,8,0
11,17,2018,17,0,7,"Braga",6,"Avenida Padre Júlio Fragata",49,62,13,27,21,6
11,17,2018,17,0,7,"Braga",7,"Rua Nova Santa Cruz",19,29,10,160,104,56
11,17,2018,17,0,7,"Braga",8,"Rua Costa Gomes",41,41,0,42,42,0
11,17,2018,18,0,7,"Braga",1,"Avenida da Liberdade",25,25,0,26,26,0
11,17,2018,18,0,7,"Braga",2,"Avenida Central",11,18,7,421,257,164
11,17,2018,18,0,7,"Braga",3,"Rua de Caires",25,25,0,4,4,0
11,17,2018,18,0,7,"Braga",4,"N14 Bosch",15,47,32,149,47,102
11,17,2018,18,0,7,"Braga",5,"Avenida João Paulo II",39,39,0,8,8,0
11,17,2018,18,0,7,"Braga",6,"Avenida Padre Júlio Fragata",40,61,21,33,21,12
11,17,2018,18,0,7,"Braga",7,"Rua Nova Santa Cruz",28,28,0,108,108,0
11,17,2018,18,0,7,"Braga",8,"Rua Costa Gomes",40,40,0,43,43,0
11,17,2018,19,0,7,"Braga",1,"Avenida da Liberdade",25,25,0,26,26,0
11,17,2018,19,0,7,"Braga",2,"Avenida Central",10,17,7,463,272,191
11,17,2018,19,0,7,"Braga",3,"Rua de Caires",24,24,0,4,4,0
11,17,2018,19,0,7,"Braga",4,"N14 Bosch",46,46,0,48,48,0
11,17,2018,19,0,7,"Braga",5,"Avenida João Paulo II",38,38,0,9,9,0
11,17,2018,19,0,7,"Braga",6,"Avenida Padre Júlio Fragata",34,61,27,39,21,18
11,17,2018,19,0,7,"Braga",7,"Rua Nova Santa Cruz",28,28,0,108,108,0
11,17,2018,19,0,7,"Braga",8,"Rua Costa Gomes",24,40,16,72,43,29
11,17,2018,20,0,7,"Braga",1,"Avenida da Liberdade",25,25,0,26,26,0
11,17,2018,20,0,7,"Braga",2,"Avenida Central",18,18,0,257,257,0
11,17,2018,20,0,7,"Braga",3,"Rua de Caires",19,24,5,5,4,1
11,17,2018,20,0,7,"Braga",4,"N14 Bosch",47,47,0,47,47,0
11,17,2018,20,0,7,"Braga",5,"Avenida João Paulo II",39,39,0,8,8,0
11,17,2018,20,0,7,"Braga",6,"Avenida Padre Júlio Fragata",62,62,0,21,21,0
11,17,2018,20,0,7,"Braga",7,"Rua Nova Santa Cruz",28,28,0,108,108,0
11,17,2018,20,0,7,"Braga",8,"Rua Costa Gomes",41,41,0,42,42,0
11,17,2018,21,0,7,"Braga",1,"Avenida da Liberdade",25,25,0,26,26,0
11,17,2018,21,0,7,"Braga",2,"Avenida Central",17,17,0,272,272,0
11,17,2018,21,0,7,"Braga",3,"Rua de Caires",24,24,0,4,4,0
11,17,2018,21,0,7,"Braga",4,"N14 Bosch",47,47,0,47,47,0
11,17,2018,21,0,7,"Braga",5,"Avenida João Paulo II",39,39,0,8,8,0
11,17,2018,21,0,7,"Braga",6,"Avenida Padre Júlio Fragata",45,61,16,29,21,8
11,17,2018,21,0,7,"Braga",7,"Rua Nova Santa Cruz",28,28,0,108,108,0
11,17,2018,21,0,7,"Braga",8,"Rua Costa Gomes",41,41,0,42,42,0
11,17,2018,22,0,7,"Braga",1,"Avenida da Liberdade",25,25,0,26,26,0
11,17,2018,22,0,7,"Braga",2,"Avenida Central",17,17,0,272,272,0
11,17,2018,22,0,7,"Braga",3,"Rua de Caires",24,24,0,4,4,0
11,17,2018,22,0,7,"Braga",4,"N14 Bosch",47,47,0,47,47,0
11,17,2018,22,0,7,"Braga",5,"Avenida João Paulo II",38,38,0,9,9,0
11,17,2018,22,0,7,"Braga",6,"Avenida Padre Júlio Fragata",62,62,0,21,21,0
11,17,2018,22,0,7,"Braga",7,"Rua Nova Santa Cruz",21,28,7,144,108,36
11,17,2018,22,0,7,"Braga",8,"Rua Costa Gomes",41,41,0,42,42,0
11,17,2018,23,0,7,"Braga",1,"Avenida da Liberdade",25,25,0,26,26,0
11,17,2018,23,0,7,"Braga",2,"Avenida Central",17,17,0,272,272,0
11,17,2018,23,0,7,"Braga",3,"Rua de Caires",24,24,0,4,4,0
11,17,2018,23,0,7,"Braga",4,"N14 Bosch",47,47,0,47,47,0
11,17,2018,23,0,7,"Braga",5,"Avenida João Paulo II",38,38,0,9,9,0
11,17,2018,23,0,7,"Braga",6,"Avenida Padre Júlio Fragata",45,61,16,29,21,8
11,17,2018,23,0,7,"Braga",7,"Rua Nova Santa Cruz",21,28,7,144,108,36
11,17,2018,23,0,7,"Braga",8,"Rua Costa Gomes",41,41,0,42,42,0
11,18,2018,0,0,8,"Braga",1,"Avenida da Liberdade",25,25,0,26,26,0
11,18,2018,0,0,8,"Braga",2,"Avenida Central",17,17,0,272,272,0
11,18,2018,0,0,8,"Braga",3,"Rua de Caires",19,24,5,5,4,1
11,18,2018,0,0,8,"Braga",4,"N14 Bosch",47,47,0,47,47,0
11,18,2018,0,0,8,"Braga",5,"Avenida João Paulo II",38,38,0,9,9,0
11,18,2018,0,0,8,"Braga",6,"Avenida Padre Júlio Fragata",24,62,38,55,21,34
11,18,2018,0,0,8,"Braga",7,"Rua Nova Santa Cruz",29,29,0,104,104,0
11,18,2018,0,0,8,"Braga",8,"Rua Costa Gomes",41,41,0,42,42,0
11,18,2018,1,0,8,"Braga",1,"Avenida da Liberdade",25,25,0,26,26,0
11,18,2018,1,0,8,"Braga",2,"Avenida Central",17,17,0,272,272,0
11,18,2018,1,0,8,"Braga",3,"Rua de Caires",25,25,0,4,4,0
11,18,2018,1,0,8,"Braga",4,"N14 Bosch",47,47,0,47,47,0
11,18,2018,1,0,8,"Braga",5,"Avenida João Paulo II",38,38,0,9,9,0
11,18,2018,1,0,8,"Braga",6,"Avenida Padre Júlio Fragata",61,61,0,21,21,0
11,18,2018,1,0,8,"Braga",7,"Rua Nova Santa Cruz",29,29,0,104,104,0
11,18,2018,1,0,8,"Braga",8,"Rua Costa Gomes",29,41,12,59,42,17
11,18,2018,2,0,8,"Braga",1,"Avenida da Liberdade",25,25,0,26,26,0
11,18,2018,2,0,8,"Braga",2,"Avenida Central",17,17,0,272,272,0
11,18,2018,2,0,8,"Braga",3,"Rua de Caires",25,25,0,4,4,0
11,18,2018,2,0,8,"Braga",4,"N14 Bosch",47,47,0,47,47,0
11,18,2018,2,0,8,"Braga",5,"Avenida João Paulo II",38,38,0,9,9,0
11,18,2018,2,0,8,"Braga",6,"Avenida Padre Júlio Fragata",61,61,0,21,21,0
11,18,2018,2,0,8,"Braga",7,"Rua Nova Santa Cruz",29,29,0,104,104,0
11,18,2018,2,0,8,"Braga",8,"Rua Costa Gomes",41,41,0,42,42,0
11,18,2018,3,0,8,"Braga",1,"Avenida da Liberdade",25,25,0,26,26,0
11,18,2018,3,0,8,"Braga",2,"Avenida Central",17,17,0,272,272,0
11,18,2018,3,0,8,"Braga",3,"Rua de Caires",25,25,0,4,4,0
11,18,2018,3,0,8,"Braga",4,"N14 Bosch",47,47,0,47,47,0
11,18,2018,3,0,8,"Braga",5,"Avenida João Paulo II",38,38,0,9,9,0
11,18,2018,3,0,8,"Braga",6,"Avenida Padre Júlio Fragata",61,61,0,21,21,0
11,18,2018,3,0,8,"Braga",7,"Rua Nova Santa Cruz",29,29,0,104,104,0
11,18,2018,3,0,8,"Braga",8,"Rua Costa Gomes",41,41,0,42,42,0
11,18,2018,4,0,8,"Braga",1,"Avenida da Liberdade",25,25,0,26,26,0
11,18,2018,4,0,8,"Braga",2,"Avenida Central",17,17,0,272,272,0
11,18,2018,4,0,8,"Braga",3,"Rua de Caires",25,25,0,4,4,0
11,18,2018,4,0,8,"Braga",4,"N14 Bosch",47,47,0,47,47,0
11,18,2018,4,0,8,"Braga",5,"Avenida João Paulo II",38,38,0,9,9,0
11,18,2018,4,0,8,"Braga",6,"Avenida Padre Júlio Fragata",61,61,0,21,21,0
11,18,2018,4,0,8,"Braga",7,"Rua Nova Santa Cruz",29,29,0,104,104,0
11,18,2018,4,0,8,"Braga",8,"Rua Costa Gomes",41,41,0,42,42,0
11,18,2018,5,0,8,"Braga",1,"Avenida da Liberdade",25,25,0,26,26,0
11,18,2018,5,0,8,"Braga",2,"Avenida Central",17,17,0,272,272,0
11,18,2018,5,0,8,"Braga",3,"Rua de Caires",25,25,0,4,4,0
11,18,2018,5,0,8,"Braga",4,"N14 Bosch",47,47,0,47,47,0
11,18,2018,5,0,8,"Braga",5,"Avenida João Paulo II",38,38,0,9,9,0
11,18,2018,5,0,8,"Braga",6,"Avenida Padre Júlio Fragata",61,61,0,21,21,0
11,18,2018,5,0,8,"Braga",7,"Rua Nova Santa Cruz",29,29,0,104,104,0
11,18,2018,5,0,8,"Braga",8,"Rua Costa Gomes",41,41,0,42,42,0
11,18,2018,6,0,8,"Braga",1,"Avenida da Liberdade",25,25,0,26,26,0
11,18,2018,6,0,8,"Braga",2,"Avenida Central",17,17,0,272,272,0
11,18,2018,6,0,8,"Braga",3,"Rua de Caires",25,25,0,4,4,0
11,18,2018,6,0,8,"Braga",4,"N14 Bosch",47,47,0,47,47,0
11,18,2018,6,0,8,"Braga",5,"Avenida João Paulo II",38,38,0,9,9,0
11,18,2018,6,0,8,"Braga",6,"Avenida Padre Júlio Fragata",61,61,0,21,21,0
11,18,2018,6,0,8,"Braga",7,"Rua Nova Santa Cruz",29,29,0,104,104,0
11,18,2018,6,0,8,"Braga",8,"Rua Costa Gomes",41,41,0,42,42,0
11,18,2018,7,0,8,"Braga",1,"Avenida da Liberdade",25,25,0,26,26,0
11,18,2018,7,0,8,"Braga",2,"Avenida Central",17,17,0,272,272,0
11,18,2018,7,0,8,"Braga",3,"Rua de Caires",25,25,0,4,4,0
11,18,2018,7,0,8,"Braga",4,"N14 Bosch",47,47,0,47,47,0
11,18,2018,7,0,8,"Braga",5,"Avenida João Paulo II",38,38,0,9,9,0
11,18,2018,7,0,8,"Braga",6,"Avenida Padre Júlio Fragata",61,61,0,21,21,0
11,18,2018,7,0,8,"Braga",7,"Rua Nova Santa Cruz",29,29,0,104,104,0
11,18,2018,7,0,8,"Braga",8,"Rua Costa Gomes",41,41,0,42,42,0
11,18,2018,7,0,8,"Braga",1,"Avenida da Liberdade",25,25,0,26,26,0
11,18,2018,8,0,8,"Braga",1,"Avenida da Liberdade",25,25,0,26,26,0
11,18,2018,8,0,8,"Braga",2,"Avenida Central",17,17,0,272,272,0
11,18,2018,8,0,8,"Braga",3,"Rua de Caires",25,25,0,4,4,0
11,18,2018,8,0,8,"Braga",4,"N14 Bosch",47,47,0,47,47,0
11,18,2018,8,0,8,"Braga",5,"Avenida João Paulo II",38,38,0,9,9,0
11,18,2018,8,0,8,"Braga",6,"Avenida Padre Júlio Fragata",61,61,0,21,21,0
11,18,2018,8,0,8,"Braga",7,"Rua Nova Santa Cruz",29,29,0,104,104,0
11,18,2018,8,0,8,"Braga",8,"Rua Costa Gomes",41,41,0,42,42,0
11,18,2018,9,0,8,"Braga",1,"Avenida da Liberdade",25,25,0,26,26,0
11,18,2018,9,0,8,"Braga",2,"Avenida Central",17,17,0,272,272,0
11,18,2018,9,0,8,"Braga",3,"Rua de Caires",25,25,0,4,4,0
11,18,2018,9,0,8,"Braga",4,"N14 Bosch",47,47,0,47,47,0
11,18,2018,9,0,8,"Braga",5,"Avenida João Paulo II",38,38,0,9,9,0
11,18,2018,9,0,8,"Braga",6,"Avenida Padre Júlio Fragata",61,61,0,21,21,0
11,18,2018,9,0,8,"Braga",7,"Rua Nova Santa Cruz",29,29,0,104,104,0
11,18,2018,9,0,8,"Braga",8,"Rua Costa Gomes",41,41,0,42,42,0
11,18,2018,10,0,8,"Braga",1,"Avenida da Liberdade",25,25,0,26,26,0
11,18,2018,10,0,8,"Braga",2,"Avenida Central",17,17,0,272,272,0
11,18,2018,10,0,8,"Braga",3,"Rua de Caires",25,25,0,4,4,0
11,18,2018,10,0,8,"Braga",4,"N14 Bosch",47,47,0,47,47,0
11,18,2018,10,0,8,"Braga",5,"Avenida João Paulo II",38,38,0,9,9,0
11,18,2018,10,0,8,"Braga",6,"Avenida Padre Júlio Fragata",61,61,0,21,21,0
11,18,2018,10,0,8,"Braga",7,"Rua Nova Santa Cruz",29,29,0,104,104,0
11,18,2018,10,0,8,"Braga",8,"Rua Costa Gomes",41,41,0,42,42,0
11,18,2018,11,0,8,"Braga",1,"Avenida da Liberdade",25,25,0,26,26,0
11,18,2018,11,0,8,"Braga",2,"Avenida Central",17,17,0,272,272,0
11,18,2018,11,0,8,"Braga",3,"Rua de Caires",25,25,0,4,4,0
11,18,2018,11,0,8,"Braga",4,"N14 Bosch",47,47,0,47,47,0
11,18,2018,11,0,8,"Braga",5,"Avenida João Paulo II",38,38,0,9,9,0
11,18,2018,11,0,8,"Braga",6,"Avenida Padre Júlio Fragata",37,61,24,35,21,14
11,18,2018,11,0,8,"Braga",7,"Rua Nova Santa Cruz",29,29,0,104,104,0
11,18,2018,11,0,8,"Braga",8,"Rua Costa Gomes",30,40,10,57,43,14
11,18,2018,12,0,8,"Braga",1,"Avenida da Liberdade",25,25,0,26,26,0
11,18,2018,12,0,8,"Braga",2,"Avenida Central",17,17,0,272,272,0
11,18,2018,12,0,8,"Braga",3,"Rua de Caires",25,25,0,4,4,0
11,18,2018,12,0,8,"Braga",4,"N14 Bosch",47,47,0,47,47,0
11,18,2018,12,0,8,"Braga",5,"Avenida João Paulo II",24,38,14,14,9,5
11,18,2018,12,0,8,"Braga",6,"Avenida Padre Júlio Fragata",62,62,0,21,21,0
11,18,2018,12,0,8,"Braga",7,"Rua Nova Santa Cruz",29,29,0,104,104,0
11,18,2018,12,0,8,"Braga",8,"Rua Costa Gomes",41,41,0,42,42,0
11,18,2018,13,0,8,"Braga",1,"Avenida da Liberdade",25,25,0,26,26,0
11,18,2018,13,0,8,"Braga",2,"Avenida Central",18,18,0,257,257,0
11,18,2018,13,0,8,"Braga",3,"Rua de Caires",25,25,0,4,4,0
11,18,2018,13,0,8,"Braga",4,"N14 Bosch",47,47,0,47,47,0
11,18,2018,13,0,8,"Braga",5,"Avenida João Paulo II",38,38,0,9,9,0
11,18,2018,13,0,8,"Braga",6,"Avenida Padre Júlio Fragata",61,61,0,21,21,0
11,18,2018,13,0,8,"Braga",7,"Rua Nova Santa Cruz",29,29,0,104,104,0
11,18,2018,13,0,8,"Braga",8,"Rua Costa Gomes",32,40,8,54,43,11
11,18,2018,14,0,8,"Braga",1,"Avenida da Liberdade",25,25,0,26,26,0
11,18,2018,14,0,8,"Braga",2,"Avenida Central",17,17,0,272,272,0
11,18,2018,14,0,8,"Braga",3,"Rua de Caires",25,25,0,4,4,0
11,18,2018,14,0,8,"Braga",4,"N14 Bosch",47,47,0,47,47,0
11,18,2018,14,0,8,"Braga",5,"Avenida João Paulo II",38,38,0,9,9,0
11,18,2018,14,0,8,"Braga",6,"Avenida Padre Júlio Fragata",44,61,17,30,21,9
11,18,2018,14,0,8,"Braga",7,"Rua Nova Santa Cruz",29,29,0,104,104,0
11,18,2018,14,0,8,"Braga",8,"Rua Costa Gomes",33,41,8,52,42,10
11,18,2018,15,0,8,"Braga",1,"Avenida da Liberdade",25,25,0,26,26,0
11,18,2018,15,0,8,"Braga",2,"Avenida Central",17,17,0,272,272,0
11,18,2018,15,0,8,"Braga",3,"Rua de Caires",24,24,0,4,4,0
11,18,2018,15,0,8,"Braga",4,"N14 Bosch",47,47,0,47,47,0
11,18,2018,15,0,8,"Braga",5,"Avenida João Paulo II",6,38,32,58,9,49
11,18,2018,15,0,8,"Braga",6,"Avenida Padre Júlio Fragata",42,61,19,31,21,10
11,18,2018,15,0,8,"Braga",7,"Rua Nova Santa Cruz",29,29,0,104,104,0
11,18,2018,15,0,8,"Braga",8,"Rua Costa Gomes",41,41,0,42,42,0
11,18,2018,16,0,8,"Braga",1,"Avenida da Liberdade",25,25,0,26,26,0
11,18,2018,16,0,8,"Braga",2,"Avenida Central",13,17,4,356,272,84
11,18,2018,16,0,8,"Braga",3,"Rua de Caires",25,25,0,4,4,0
11,18,2018,16,0,8,"Braga",4,"N14 Bosch",46,46,0,48,48,0
11,18,2018,16,0,8,"Braga",5,"Avenida João Paulo II",3,34,31,116,10,106
11,18,2018,16,0,8,"Braga",6,"Avenida Padre Júlio Fragata",36,62,26,36,21,15
11,18,2018,16,0,8,"Braga",7,"Rua Nova Santa Cruz",29,29,0,104,104,0
11,18,2018,16,0,8,"Braga",8,"Rua Costa Gomes",30,41,11,57,42,15
11,18,2018,17,0,8,"Braga",1,"Avenida da Liberdade",25,25,0,26,26,0
11,18,2018,17,0,8,"Braga",2,"Avenida Central",17,17,0,272,272,0
11,18,2018,17,0,8,"Braga",3,"Rua de Caires",25,25,0,4,4,0
11,18,2018,17,0,8,"Braga",4,"N14 Bosch",46,46,0,48,48,0
11,18,2018,17,0,8,"Braga",5,"Avenida João Paulo II",39,39,0,8,8,0
11,18,2018,17,0,8,"Braga",6,"Avenida Padre Júlio Fragata",35,62,27,38,21,17
11,18,2018,17,0,8,"Braga",7,"Rua Nova Santa Cruz",29,29,0,104,104,0
11,18,2018,17,0,8,"Braga",8,"Rua Costa Gomes",41,41,0,42,42,0
11,18,2018,18,0,8,"Braga",1,"Avenida da Liberdade",25,25,0,26,26,0
11,18,2018,18,0,8,"Braga",2,"Avenida Central",17,17,0,272,272,0
11,18,2018,18,0,8,"Braga",3,"Rua de Caires",16,25,9,6,4,2
11,18,2018,18,0,8,"Braga",4,"N14 Bosch",46,46,0,48,48,0
11,18,2018,18,0,8,"Braga",5,"Avenida João Paulo II",21,38,17,16,9,7
11,18,2018,18,0,8,"Braga",6,"Avenida Padre Júlio Fragata",38,62,24,35,21,14
11,18,2018,18,0,8,"Braga",7,"Rua Nova Santa Cruz",29,29,0,104,104,0
11,18,2018,18,0,8,"Braga",8,"Rua Costa Gomes",30,40,10,57,43,14
11,18,2018,19,0,8,"Braga",1,"Avenida da Liberdade",25,25,0,26,26,0
11,18,2018,19,0,8,"Braga",2,"Avenida Central",17,17,0,272,272,0
11,18,2018,19,0,8,"Braga",3,"Rua de Caires",25,25,0,4,4,0
11,18,2018,19,0,8,"Braga",4,"N14 Bosch",47,47,0,47,47,0
11,18,2018,19,0,8,"Braga",5,"Avenida João Paulo II",29,39,10,12,8,4
11,18,2018,19,0,8,"Braga",6,"Avenida Padre Júlio Fragata",42,61,19,31,21,10
11,18,2018,19,0,8,"Braga",7,"Rua Nova Santa Cruz",29,29,0,104,104,0
11,18,2018,19,0,8,"Braga",8,"Rua Costa Gomes",31,40,9,55,43,12
11,18,2018,20,0,8,"Braga",1,"Avenida da Liberdade",25,25,0,26,26,0
11,18,2018,20,0,8,"Braga",2,"Avenida Central",17,17,0,272,272,0
11,18,2018,20,0,8,"Braga",3,"Rua de Caires",25,25,0,4,4,0
11,18,2018,20,0,8,"Braga",4,"N14 Bosch",47,47,0,47,47,0
11,18,2018,20,0,8,"Braga",5,"Avenida João Paulo II",38,38,0,9,9,0
11,18,2018,20,0,8,"Braga",6,"Avenida Padre Júlio Fragata",62,62,0,21,21,0
11,18,2018,20,0,8,"Braga",7,"Rua Nova Santa Cruz",28,28,0,108,108,0
11,18,2018,20,0,8,"Braga",8,"Rua Costa Gomes",40,40,0,43,43,0
11,18,2018,21,0,8,"Braga",1,"Avenida da Liberdade",25,25,0,26,26,0
11,18,2018,21,0,8,"Braga",2,"Avenida Central",17,17,0,272,272,0
11,18,2018,21,0,8,"Braga",3,"Rua de Caires",25,25,0,4,4,0
11,18,2018,21,0,8,"Braga",4,"N14 Bosch",47,47,0,47,47,0
11,18,2018,21,0,8,"Braga",5,"Avenida João Paulo II",38,38,0,9,9,0
11,18,2018,21,0,8,"Braga",6,"Avenida Padre Júlio Fragata",35,61,26,38,21,17
11,18,2018,21,0,8,"Braga",7,"Rua Nova Santa Cruz",28,28,0,108,108,0
11,18,2018,21,0,8,"Braga",8,"Rua Costa Gomes",33,41,8,52,42,10
11,18,2018,22,0,8,"Braga",1,"Avenida da Liberdade",25,25,0,26,26,0
11,18,2018,22,0,8,"Braga",2,"Avenida Central",17,17,0,272,272,0
11,18,2018,22,0,8,"Braga",3,"Rua de Caires",25,25,0,4,4,0
11,18,2018,22,0,8,"Braga",4,"N14 Bosch",47,47,0,47,47,0
11,18,2018,22,0,8,"Braga",5,"Avenida João Paulo II",38,38,0,9,9,0
11,18,2018,22,0,8,"Braga",6,"Avenida Padre Júlio Fragata",61,61,0,21,21,0
11,18,2018,22,0,8,"Braga",7,"Rua Nova Santa Cruz",28,28,0,108,108,0
11,18,2018,22,0,8,"Braga",8,"Rua Costa Gomes",41,41,0,42,42,0
11,18,2018,23,0,8,"Braga",1,"Avenida da Liberdade",25,25,0,26,26,0
11,18,2018,23,0,8,"Braga",2,"Avenida Central",17,17,0,272,272,0
11,18,2018,23,0,8,"Braga",3,"Rua de Caires",25,25,0,4,4,0
11,18,2018,23,0,8,"Braga",4,"N14 Bosch",47,47,0,47,47,0
11,18,2018,23,0,8,"Braga",5,"Avenida João Paulo II",38,38,0,9,9,0
11,18,2018,23,0,8,"Braga",6,"Avenida Padre Júlio Fragata",61,61,0,21,21,0
11,18,2018,23,0,8,"Braga",7,"Rua Nova Santa Cruz",28,28,0,108,108,0
11,18,2018,23,0,8,"Braga",8,"Rua Costa Gomes",41,41,0,42,42,0
11,19,2018,0,0,2,"Braga",1,"Avenida da Liberdade",25,25,0,26,26,0
11,19,2018,0,0,2,"Braga",2,"Avenida Central",17,17,0,272,272,0
11,19,2018,0,0,2,"Braga",3,"Rua de Caires",25,25,0,4,4,0
11,19,2018,0,0,2,"Braga",4,"N14 Bosch",47,47,0,47,47,0
11,19,2018,0,0,2,"Braga",5,"Avenida João Paulo II",38,38,0,9,9,0
11,19,2018,0,0,2,"Braga",6,"Avenida Padre Júlio Fragata",61,61,0,21,21,0
11,19,2018,0,0,2,"Braga",7,"Rua Nova Santa Cruz",28,28,0,108,108,0
11,19,2018,0,0,2,"Braga",8,"Rua Costa Gomes",41,41,0,42,42,0
11,19,2018,1,0,2,"Braga",1,"Avenida da Liberdade",25,25,0,26,26,0
11,19,2018,1,0,2,"Braga",2,"Avenida Central",17,17,0,272,272,0
11,19,2018,1,0,2,"Braga",3,"Rua de Caires",25,25,0,4,4,0
11,19,2018,1,0,2,"Braga",4,"N14 Bosch",47,47,0,47,47,0
11,19,2018,1,0,2,"Braga",5,"Avenida João Paulo II",38,38,0,9,9,0
11,19,2018,1,0,2,"Braga",6,"Avenida Padre Júlio Fragata",61,61,0,21,21,0
11,19,2018,1,0,2,"Braga",7,"Rua Nova Santa Cruz",28,28,0,108,108,0
11,19,2018,1,0,2,"Braga",8,"Rua Costa Gomes",41,41,0,42,42,0
11,19,2018,2,0,2,"Braga",1,"Avenida da Liberdade",25,25,0,26,26,0
11,19,2018,2,0,2,"Braga",2,"Avenida Central",17,17,0,272,272,0
11,19,2018,2,0,2,"Braga",3,"Rua de Caires",25,25,0,4,4,0
11,19,2018,2,0,2,"Braga",4,"N14 Bosch",47,47,0,47,47,0
11,19,2018,2,0,2,"Braga",5,"Avenida João Paulo II",38,38,0,9,9,0
11,19,2018,2,0,2,"Braga",6,"Avenida Padre Júlio Fragata",61,61,0,21,21,0
11,19,2018,2,0,2,"Braga",7,"Rua Nova Santa Cruz",28,28,0,108,108,0
11,19,2018,2,0,2,"Braga",8,"Rua Costa Gomes",41,41,0,42,42,0
11,19,2018,3,0,2,"Braga",1,"Avenida da Liberdade",25,25,0,26,26,0
11,19,2018,3,0,2,"Braga",2,"Avenida Central",17,17,0,272,272,0
11,19,2018,3,0,2,"Braga",3,"Rua de Caires",25,25,0,4,4,0
11,19,2018,3,0,2,"Braga",4,"N14 Bosch",47,47,0,47,47,0
11,19,2018,3,0,2,"Braga",5,"Avenida João Paulo II",38,38,0,9,9,0
11,19,2018,3,0,2,"Braga",6,"Avenida Padre Júlio Fragata",61,61,0,21,21,0
11,19,2018,3,0,2,"Braga",7,"Rua Nova Santa Cruz",28,28,0,108,108,0
11,19,2018,3,0,2,"Braga",8,"Rua Costa Gomes",41,41,0,42,42,0
11,19,2018,4,0,2,"Braga",1,"Avenida da Liberdade",25,25,0,26,26,0
11,19,2018,4,0,2,"Braga",2,"Avenida Central",17,17,0,272,272,0
11,19,2018,4,0,2,"Braga",3,"Rua de Caires",25,25,0,4,4,0
11,19,2018,4,0,2,"Braga",4,"N14 Bosch",47,47,0,47,47,0
11,19,2018,4,0,2,"Braga",5,"Avenida João Paulo II",38,38,0,9,9,0
11,19,2018,4,0,2,"Braga",6,"Avenida Padre Júlio Fragata",61,61,0,21,21,0
11,19,2018,4,0,2,"Braga",7,"Rua Nova Santa Cruz",28,28,0,108,108,0
11,19,2018,4,0,2,"Braga",8,"Rua Costa Gomes",41,41,0,42,42,0
11,19,2018,5,0,2,"Braga",1,"Avenida da Liberdade",25,25,0,26,26,0
11,19,2018,5,0,2,"Braga",2,"Avenida Central",17,17,0,272,272,0
11,19,2018,5,0,2,"Braga",3,"Rua de Caires",25,25,0,4,4,0
11,19,2018,5,0,2,"Braga",4,"N14 Bosch",47,47,0,47,47,0
11,19,2018,5,0,2,"Braga",5,"Avenida João Paulo II",38,38,0,9,9,0
11,19,2018,5,0,2,"Braga",6,"Avenida Padre Júlio Fragata",61,61,0,21,21,0
11,19,2018,5,0,2,"Braga",7,"Rua Nova Santa Cruz",28,28,0,108,108,0
11,19,2018,5,0,2,"Braga",8,"Rua Costa Gomes",41,41,0,42,42,0
11,19,2018,6,0,2,"Braga",1,"Avenida da Liberdade",25,25,0,26,26,0
11,19,2018,6,0,2,"Braga",2,"Avenida Central",17,17,0,272,272,0
11,19,2018,6,0,2,"Braga",3,"Rua de Caires",25,25,0,4,4,0
11,19,2018,6,0,2,"Braga",4,"N14 Bosch",47,47,0,47,47,0
11,19,2018,6,0,2,"Braga",5,"Avenida João Paulo II",38,38,0,9,9,0
11,19,2018,6,0,2,"Braga",6,"Avenida Padre Júlio Fragata",61,61,0,21,21,0
11,19,2018,6,0,2,"Braga",7,"Rua Nova Santa Cruz",28,28,0,108,108,0
11,19,2018,6,0,2,"Braga",8,"Rua Costa Gomes",41,41,0,42,42,0
11,19,2018,7,0,2,"Braga",1,"Avenida da Liberdade",25,25,0,26,26,0
11,19,2018,7,0,2,"Braga",2,"Avenida Central",17,17,0,272,272,0
11,19,2018,7,0,2,"Braga",3,"Rua de Caires",25,25,0,4,4,0
11,19,2018,7,0,2,"Braga",4,"N14 Bosch",47,47,0,47,47,0
11,19,2018,7,0,2,"Braga",5,"Avenida João Paulo II",38,38,0,9,9,0
11,19,2018,7,0,2,"Braga",6,"Avenida Padre Júlio Fragata",61,61,0,21,21,0
11,19,2018,7,0,2,"Braga",7,"Rua Nova Santa Cruz",28,28,0,108,108,0
11,19,2018,7,0,2,"Braga",8,"Rua Costa Gomes",41,41,0,42,42,0
11,19,2018,8,0,2,"Braga",1,"Avenida da Liberdade",25,25,0,26,26,0
11,19,2018,8,0,2,"Braga",2,"Avenida Central",11,18,7,421,257,164
11,19,2018,8,0,2,"Braga",3,"Rua de Caires",25,25,0,4,4,0
11,19,2018,8,0,2,"Braga",4,"N14 Bosch",34,47,13,66,47,19
11,19,2018,8,0,2,"Braga",5,"Avenida João Paulo II",38,38,0,9,9,0
11,19,2018,8,0,2,"Braga",6,"Avenida Padre Júlio Fragata",61,61,0,21,21,0
11,19,2018,8,0,2,"Braga",7,"Rua Nova Santa Cruz",28,28,0,108,108,0
11,19,2018,8,0,2,"Braga",8,"Rua Costa Gomes",41,41,0,42,42,0
11,19,2018,9,0,2,"Braga",1,"Avenida da Liberdade",17,25,8,39,26,13
11,19,2018,9,0,2,"Braga",2,"Avenida Central",8,19,11,579,244,335
11,19,2018,9,0,2,"Braga",3,"Rua de Caires",24,24,0,4,4,0
11,19,2018,9,0,2,"Braga",4,"N14 Bosch",26,47,21,86,47,39
11,19,2018,9,0,2,"Braga",5,"Avenida João Paulo II",28,39,11,12,8,4
11,19,2018,9,0,2,"Braga",6,"Avenida Padre Júlio Fragata",24,61,37,55,21,34
11,19,2018,9,0,2,"Braga",7,"Rua Nova Santa Cruz",11,27,16,276,112,164
11,19,2018,9,0,2,"Braga",8,"Rua Costa Gomes",22,40,18,78,43,35
11,19,2018,10,0,2,"Braga",1,"Avenida da Liberdade",25,25,0,26,26,0
11,19,2018,10,0,2,"Braga",2,"Avenida Central",13,17,4,356,272,84
11,19,2018,10,0,2,"Braga",3,"Rua de Caires",25,25,0,4,4,0
11,19,2018,10,0,2,"Braga",4,"N14 Bosch",47,47,0,47,47,0
11,19,2018,10,0,2,"Braga",5,"Avenida João Paulo II",39,39,0,8,8,0
11,19,2018,10,0,2,"Braga",6,"Avenida Padre Júlio Fragata",61,61,0,21,21,0
11,19,2018,10,0,2,"Braga",7,"Rua Nova Santa Cruz",23,28,5,132,108,24
11,19,2018,10,0,2,"Braga",8,"Rua Costa Gomes",27,40,13,64,43,21
11,19,2018,11,0,2,"Braga",1,"Avenida da Liberdade",14,25,11,47,26,21
11,19,2018,11,0,2,"Braga",2,"Avenida Central",17,17,0,272,272,0
11,19,2018,11,0,2,"Braga",3,"Rua de Caires",25,25,0,4,4,0
11,19,2018,11,0,2,"Braga",4,"N14 Bosch",47,47,0,47,47,0
11,19,2018,11,0,2,"Braga",5,"Avenida João Paulo II",39,39,0,8,8,0
11,19,2018,11,0,2,"Braga",6,"Avenida Padre Júlio Fragata",61,61,0,21,21,0
11,19,2018,11,0,2,"Braga",7,"Rua Nova Santa Cruz",28,28,0,108,108,0
11,19,2018,11,0,2,"Braga",8,"Rua Costa Gomes",40,40,0,43,43,0
11,19,2018,13,0,2,"Braga",1,"Avenida da Liberdade",25,25,0,26,26,0
11,19,2018,13,0,2,"Braga",2,"Avenida Central",18,18,0,257,257,0
11,19,2018,13,0,2,"Braga",3,"Rua de Caires",25,25,0,4,4,0
11,19,2018,13,0,2,"Braga",4,"N14 Bosch",46,46,0,48,48,0
11,19,2018,13,0,2,"Braga",5,"Avenida João Paulo II",38,38,0,9,9,0
11,19,2018,13,0,2,"Braga",6,"Avenida Padre Júlio Fragata",48,62,14,27,21,6
11,19,2018,13,0,2,"Braga",7,"Rua Nova Santa Cruz",23,29,6,132,104,28
11,19,2018,13,0,2,"Braga",8,"Rua Costa Gomes",41,41,0,42,42,0
11,19,2018,14,0,2,"Braga",1,"Avenida da Liberdade",25,25,0,26,26,0
11,19,2018,14,0,2,"Braga",2,"Avenida Central",18,18,0,257,257,0
11,19,2018,14,0,2,"Braga",3,"Rua de Caires",25,25,0,4,4,0
11,19,2018,14,0,2,"Braga",4,"N14 Bosch",47,47,0,47,47,0
11,19,2018,14,0,2,"Braga",5,"Avenida João Paulo II",38,38,0,9,9,0
11,19,2018,14,0,2,"Braga",6,"Avenida Padre Júlio Fragata",62,62,0,21,21,0
11,19,2018,14,0,2,"Braga",7,"Rua Nova Santa Cruz",28,28,0,108,108,0
11,19,2018,14,0,2,"Braga",8,"Rua Costa Gomes",29,41,12,59,42,17
11,19,2018,15,0,2,"Braga",1,"Avenida da Liberdade",24,24,0,27,27,0
11,19,2018,15,0,2,"Braga",2,"Avenida Central",18,18,0,257,257,0
11,19,2018,15,0,2,"Braga",3,"Rua de Caires",25,25,0,4,4,0
11,19,2018,15,0,2,"Braga",4,"N14 Bosch",33,46,13,68,48,20
11,19,2018,15,0,2,"Braga",5,"Avenida João Paulo II",38,38,0,9,9,0
11,19,2018,15,0,2,"Braga",6,"Avenida Padre Júlio Fragata",62,62,0,21,21,0
11,19,2018,15,0,2,"Braga",7,"Rua Nova Santa Cruz",20,29,9,152,104,48
11,19,2018,15,0,2,"Braga",8,"Rua Costa Gomes",30,40,10,57,43,14
11,19,2018,16,0,2,"Braga",1,"Avenida da Liberdade",25,25,0,26,26,0
11,19,2018,16,0,2,"Braga",2,"Avenida Central",8,17,9,579,272,307
11,19,2018,16,0,2,"Braga",3,"Rua de Caires",25,25,0,4,4,0
11,19,2018,16,0,2,"Braga",4,"N14 Bosch",35,47,12,64,47,17
11,19,2018,16,0,2,"Braga",5,"Avenida João Paulo II",39,39,0,8,8,0
11,19,2018,16,0,2,"Braga",6,"Avenida Padre Júlio Fragata",62,62,0,21,21,0
11,19,2018,16,0,2,"Braga",7,"Rua Nova Santa Cruz",17,29,12,179,104,75
11,19,2018,16,0,2,"Braga",8,"Rua Costa Gomes",33,41,8,52,42,10
11,19,2018,17,0,2,"Braga",1,"Avenida da Liberdade",18,24,6,36,27,9
11,19,2018,17,0,2,"Braga",2,"Avenida Central",10,17,7,463,272,191
11,19,2018,17,0,2,"Braga",3,"Rua de Caires",25,25,0,4,4,0
11,19,2018,17,0,2,"Braga",4,"N14 Bosch",19,46,27,118,48,70
11,19,2018,17,0,2,"Braga",5,"Avenida João Paulo II",26,39,13,13,8,5
11,19,2018,17,0,2,"Braga",6,"Avenida Padre Júlio Fragata",61,61,0,21,21,0
11,19,2018,17,0,2,"Braga",7,"Rua Nova Santa Cruz",14,28,14,217,108,109
11,19,2018,17,0,2,"Braga",8,"Rua Costa Gomes",29,41,12,59,42,17
11,19,2018,18,0,2,"Braga",1,"Avenida da Liberdade",25,25,0,26,26,0
11,19,2018,18,0,2,"Braga",2,"Avenida Central",18,18,0,257,257,0
11,19,2018,18,0,2,"Braga",3,"Rua de Caires",13,24,11,8,4,4
11,19,2018,18,0,2,"Braga",4,"N14 Bosch",13,46,33,172,48,124
11,19,2018,18,0,2,"Braga",5,"Avenida João Paulo II",28,38,10,12,9,3
11,19,2018,18,0,2,"Braga",6,"Avenida Padre Júlio Fragata",32,61,29,41,21,20
11,19,2018,18,0,2,"Braga",7,"Rua Nova Santa Cruz",11,30,19,276,101,175
11,19,2018,18,0,2,"Braga",8,"Rua Costa Gomes",19,40,21,90,43,47
11,19,2018,19,0,2,"Braga",1,"Avenida da Liberdade",24,24,0,27,27,0
11,19,2018,19,0,2,"Braga",2,"Avenida Central",6,18,12,772,257,515
11,19,2018,19,0,2,"Braga",3,"Rua de Caires",11,25,14,9,4,5
11,19,2018,19,0,2,"Braga",4,"N14 Bosch",24,46,22,93,48,45
11,19,2018,19,0,2,"Braga",5,"Avenida João Paulo II",39,39,0,8,8,0
11,19,2018,19,0,2,"Braga",6,"Avenida Padre Júlio Fragata",45,61,16,29,21,8
11,19,2018,19,0,2,"Braga",7,"Rua Nova Santa Cruz",22,28,6,138,108,30
11,19,2018,19,0,2,"Braga",8,"Rua Costa Gomes",24,41,17,72,42,30
11,19,2018,20,0,2,"Braga",1,"Avenida da Liberdade",24,24,0,27,27,0
11,19,2018,20,0,2,"Braga",2,"Avenida Central",17,17,0,272,272,0
11,19,2018,20,0,2,"Braga",3,"Rua de Caires",24,24,0,4,4,0
11,19,2018,20,0,2,"Braga",4,"N14 Bosch",47,47,0,47,47,0
11,19,2018,20,0,2,"Braga",5,"Avenida João Paulo II",38,38,0,9,9,0
11,19,2018,20,0,2,"Braga",6,"Avenida Padre Júlio Fragata",62,62,0,21,21,0
11,19,2018,20,0,2,"Braga",7,"Rua Nova Santa Cruz",29,29,0,104,104,0
11,19,2018,20,0,2,"Braga",8,"Rua Costa Gomes",26,41,15,66,42,24
11,19,2018,21,0,2,"Braga",1,"Avenida da Liberdade",24,24,0,27,27,0
11,19,2018,21,0,2,"Braga",2,"Avenida Central",17,17,0,272,272,0
11,19,2018,21,0,2,"Braga",3,"Rua de Caires",24,24,0,4,4,0
11,19,2018,21,0,2,"Braga",4,"N14 Bosch",47,47,0,47,47,0
11,19,2018,21,0,2,"Braga",5,"Avenida João Paulo II",39,39,0,8,8,0
11,19,2018,21,0,2,"Braga",6,"Avenida Padre Júlio Fragata",62,62,0,21,21,0
11,19,2018,21,0,2,"Braga",7,"Rua Nova Santa Cruz",29,29,0,104,104,0
11,19,2018,21,0,2,"Braga",8,"Rua Costa Gomes",41,41,0,42,42,0
11,19,2018,22,0,2,"Braga",1,"Avenida da Liberdade",24,24,0,27,27,0
11,19,2018,22,0,2,"Braga",2,"Avenida Central",17,17,0,272,272,0
11,19,2018,22,0,2,"Braga",3,"Rua de Caires",24,24,0,4,4,0
11,19,2018,22,0,2,"Braga",4,"N14 Bosch",47,47,0,47,47,0
11,19,2018,22,0,2,"Braga",5,"Avenida João Paulo II",39,39,0,8,8,0
11,19,2018,22,0,2,"Braga",6,"Avenida Padre Júlio Fragata",62,62,0,21,21,0
11,19,2018,22,0,2,"Braga",7,"Rua Nova Santa Cruz",29,29,0,104,104,0
11,19,2018,22,0,2,"Braga",8,"Rua Costa Gomes",41,41,0,42,42,0
11,19,2018,23,0,2,"Braga",1,"Avenida da Liberdade",24,24,0,27,27,0
11,19,2018,23,0,2,"Braga",2,"Avenida Central",17,17,0,272,272,0
11,19,2018,23,0,2,"Braga",3,"Rua de Caires",24,24,0,4,4,0
11,19,2018,23,0,2,"Braga",4,"N14 Bosch",47,47,0,47,47,0
11,19,2018,23,0,2,"Braga",5,"Avenida João Paulo II",39,39,0,8,8,0
11,19,2018,23,0,2,"Braga",6,"Avenida Padre Júlio Fragata",62,62,0,21,21,0
11,19,2018,23,0,2,"Braga",7,"Rua Nova Santa Cruz",29,29,0,104,104,0
11,19,2018,23,0,2,"Braga",8,"Rua Costa Gomes",41,41,0,42,42,0
11,19,2018,23,0,2,"Braga",1,"Avenida da Liberdade",24,24,0,27,27,0
11,20,2018,0,0,3,"Braga",1,"Avenida da Liberdade",24,24,0,27,27,0
11,20,2018,0,0,3,"Braga",2,"Avenida Central",17,17,0,272,272,0
11,20,2018,0,0,3,"Braga",3,"Rua de Caires",24,24,0,4,4,0
11,20,2018,0,0,3,"Braga",4,"N14 Bosch",47,47,0,47,47,0
11,20,2018,0,0,3,"Braga",5,"Avenida João Paulo II",27,38,11,12,9,3
11,20,2018,0,0,3,"Braga",6,"Avenida Padre Júlio Fragata",62,62,0,21,21,0
11,20,2018,0,0,3,"Braga",7,"Rua Nova Santa Cruz",29,29,0,104,104,0
11,20,2018,0,0,3,"Braga",8,"Rua Costa Gomes",41,41,0,42,42,0
11,20,2018,1,0,3,"Braga",1,"Avenida da Liberdade",24,24,0,27,27,0
11,20,2018,1,0,3,"Braga",2,"Avenida Central",17,17,0,272,272,0
11,20,2018,1,0,3,"Braga",3,"Rua de Caires",24,24,0,4,4,0
11,20,2018,1,0,3,"Braga",4,"N14 Bosch",47,47,0,47,47,0
11,20,2018,1,0,3,"Braga",5,"Avenida João Paulo II",39,39,0,8,8,0
11,20,2018,1,0,3,"Braga",6,"Avenida Padre Júlio Fragata",62,62,0,21,21,0
11,20,2018,1,0,3,"Braga",7,"Rua Nova Santa Cruz",29,29,0,104,104,0
11,20,2018,1,0,3,"Braga",8,"Rua Costa Gomes",41,41,0,42,42,0
11,20,2018,2,0,3,"Braga",1,"Avenida da Liberdade",24,24,0,27,27,0
11,20,2018,2,0,3,"Braga",2,"Avenida Central",17,17,0,272,272,0
11,20,2018,2,0,3,"Braga",3,"Rua de Caires",24,24,0,4,4,0
11,20,2018,2,0,3,"Braga",4,"N14 Bosch",47,47,0,47,47,0
11,20,2018,2,0,3,"Braga",5,"Avenida João Paulo II",39,39,0,8,8,0
11,20,2018,2,0,3,"Braga",6,"Avenida Padre Júlio Fragata",62,62,0,21,21,0
11,20,2018,2,0,3,"Braga",7,"Rua Nova Santa Cruz",29,29,0,104,104,0
11,20,2018,2,0,3,"Braga",8,"Rua Costa Gomes",41,41,0,42,42,0
11,20,2018,3,0,3,"Braga",1,"Avenida da Liberdade",24,24,0,27,27,0
11,20,2018,3,0,3,"Braga",2,"Avenida Central",17,17,0,272,272,0
11,20,2018,3,0,3,"Braga",3,"Rua de Caires",24,24,0,4,4,0
11,20,2018,3,0,3,"Braga",4,"N14 Bosch",47,47,0,47,47,0
11,20,2018,3,0,3,"Braga",5,"Avenida João Paulo II",39,39,0,8,8,0
11,20,2018,3,0,3,"Braga",6,"Avenida Padre Júlio Fragata",62,62,0,21,21,0
11,20,2018,3,0,3,"Braga",7,"Rua Nova Santa Cruz",29,29,0,104,104,0
11,20,2018,3,0,3,"Braga",8,"Rua Costa Gomes",41,41,0,42,42,0
11,20,2018,4,0,3,"Braga",1,"Avenida da Liberdade",24,24,0,27,27,0
11,20,2018,4,0,3,"Braga",2,"Avenida Central",17,17,0,272,272,0
11,20,2018,4,0,3,"Braga",3,"Rua de Caires",24,24,0,4,4,0
11,20,2018,4,0,3,"Braga",4,"N14 Bosch",47,47,0,47,47,0
11,20,2018,4,0,3,"Braga",5,"Avenida João Paulo II",39,39,0,8,8,0
11,20,2018,4,0,3,"Braga",6,"Avenida Padre Júlio Fragata",62,62,0,21,21,0
11,20,2018,4,0,3,"Braga",7,"Rua Nova Santa Cruz",29,29,0,104,104,0
11,20,2018,4,0,3,"Braga",8,"Rua Costa Gomes",41,41,0,42,42,0
11,20,2018,5,0,3,"Braga",1,"Avenida da Liberdade",24,24,0,27,27,0
11,20,2018,5,0,3,"Braga",2,"Avenida Central",17,17,0,272,272,0
11,20,2018,5,0,3,"Braga",3,"Rua de Caires",24,24,0,4,4,0
11,20,2018,5,0,3,"Braga",4,"N14 Bosch",47,47,0,47,47,0
11,20,2018,5,0,3,"Braga",5,"Avenida João Paulo II",39,39,0,8,8,0
11,20,2018,5,0,3,"Braga",6,"Avenida Padre Júlio Fragata",62,62,0,21,21,0
11,20,2018,5,0,3,"Braga",7,"Rua Nova Santa Cruz",29,29,0,104,104,0
11,20,2018,5,0,3,"Braga",8,"Rua Costa Gomes",41,41,0,42,42,0
11,20,2018,6,0,3,"Braga",1,"Avenida da Liberdade",24,24,0,27,27,0
11,20,2018,6,0,3,"Braga",2,"Avenida Central",17,17,0,272,272,0
11,20,2018,6,0,3,"Braga",3,"Rua de Caires",24,24,0,4,4,0
11,20,2018,6,0,3,"Braga",4,"N14 Bosch",47,47,0,47,47,0
11,20,2018,6,0,3,"Braga",5,"Avenida João Paulo II",39,39,0,8,8,0
11,20,2018,6,0,3,"Braga",6,"Avenida Padre Júlio Fragata",62,62,0,21,21,0
11,20,2018,6,0,3,"Braga",7,"Rua Nova Santa Cruz",29,29,0,104,104,0
11,20,2018,6,0,3,"Braga",8,"Rua Costa Gomes",41,41,0,42,42,0
11,20,2018,7,0,3,"Braga",1,"Avenida da Liberdade",24,24,0,27,27,0
11,20,2018,7,0,3,"Braga",2,"Avenida Central",17,17,0,272,272,0
11,20,2018,7,0,3,"Braga",3,"Rua de Caires",24,24,0,4,4,0
11,20,2018,7,0,3,"Braga",4,"N14 Bosch",47,47,0,47,47,0
11,20,2018,7,0,3,"Braga",5,"Avenida João Paulo II",39,39,0,8,8,0
11,20,2018,7,0,3,"Braga",6,"Avenida Padre Júlio Fragata",62,62,0,21,21,0
11,20,2018,7,0,3,"Braga",7,"Rua Nova Santa Cruz",29,29,0,104,104,0
11,20,2018,7,0,3,"Braga",8,"Rua Costa Gomes",41,41,0,42,42,0
11,20,2018,8,0,3,"Braga",1,"Avenida da Liberdade",24,24,0,27,27,0
11,20,2018,8,0,3,"Braga",2,"Avenida Central",17,17,0,272,272,0
11,20,2018,8,0,3,"Braga",3,"Rua de Caires",24,24,0,4,4,0
11,20,2018,8,0,3,"Braga",4,"N14 Bosch",31,47,16,72,47,25
11,20,2018,8,0,3,"Braga",5,"Avenida João Paulo II",39,39,0,8,8,0
11,20,2018,8,0,3,"Braga",6,"Avenida Padre Júlio Fragata",62,62,0,21,21,0
11,20,2018,8,0,3,"Braga",7,"Rua Nova Santa Cruz",29,29,0,104,104,0
11,20,2018,8,0,3,"Braga",8,"Rua Costa Gomes",41,41,0,42,42,0
11,20,2018,9,0,3,"Braga",1,"Avenida da Liberdade",25,25,0,26,26,0
11,20,2018,9,0,3,"Braga",2,"Avenida Central",11,18,7,421,257,164
11,20,2018,9,0,3,"Braga",3,"Rua de Caires",6,23,17,17,4,13
11,20,2018,9,0,3,"Braga",4,"N14 Bosch",21,48,27,107,46,61
11,20,2018,9,0,3,"Braga",5,"Avenida João Paulo II",15,39,24,23,8,15
11,20,2018,9,0,3,"Braga",6,"Avenida Padre Júlio Fragata",29,62,33,45,21,24
11,20,2018,9,0,3,"Braga",7,"Rua Nova Santa Cruz",23,29,6,132,104,28
11,20,2018,9,0,3,"Braga",8,"Rua Costa Gomes",25,40,15,69,43,26
11,20,2018,10,0,3,"Braga",1,"Avenida da Liberdade",25,25,0,26,26,0
11,20,2018,10,0,3,"Braga",2,"Avenida Central",17,17,0,272,272,0
11,20,2018,10,0,3,"Braga",3,"Rua de Caires",25,25,0,4,4,0
11,20,2018,10,0,3,"Braga",4,"N14 Bosch",24,46,22,93,48,45
11,20,2018,10,0,3,"Braga",5,"Avenida João Paulo II",39,39,0,8,8,0
11,20,2018,10,0,3,"Braga",6,"Avenida Padre Júlio Fragata",46,61,15,28,21,7
11,20,2018,10,0,3,"Braga",7,"Rua Nova Santa Cruz",28,28,0,108,108,0
11,20,2018,10,0,3,"Braga",8,"Rua Costa Gomes",31,40,9,55,43,12
11,20,2018,11,0,3,"Braga",1,"Avenida da Liberdade",25,25,0,26,26,0
11,20,2018,11,0,3,"Braga",2,"Avenida Central",14,17,3,331,272,59
11,20,2018,11,0,3,"Braga",3,"Rua de Caires",25,25,0,4,4,0
11,20,2018,11,0,3,"Braga",4,"N14 Bosch",47,47,0,47,47,0
11,20,2018,11,0,3,"Braga",5,"Avenida João Paulo II",39,39,0,8,8,0
11,20,2018,11,0,3,"Braga",6,"Avenida Padre Júlio Fragata",61,61,0,21,21,0
11,20,2018,11,0,3,"Braga",7,"Rua Nova Santa Cruz",29,29,0,104,104,0
11,20,2018,11,0,3,"Braga",8,"Rua Costa Gomes",41,41,0,42,42,0
11,20,2018,12,0,3,"Braga",1,"Avenida da Liberdade",24,24,0,27,27,0
11,20,2018,12,0,3,"Braga",2,"Avenida Central",13,19,6,356,244,112
11,20,2018,12,0,3,"Braga",3,"Rua de Caires",25,25,0,4,4,0
11,20,2018,12,0,3,"Braga",4,"N14 Bosch",31,46,15,72,48,24
11,20,2018,12,0,3,"Braga",5,"Avenida João Paulo II",39,39,0,8,8,0
11,20,2018,12,0,3,"Braga",6,"Avenida Padre Júlio Fragata",61,61,0,21,21,0
11,20,2018,12,0,3,"Braga",7,"Rua Nova Santa Cruz",22,28,6,138,108,30
11,20,2018,12,0,3,"Braga",8,"Rua Costa Gomes",26,40,14,66,43,23
11,20,2018,13,0,3,"Braga",1,"Avenida da Liberdade",25,25,0,26,26,0
11,20,2018,13,0,3,"Braga",2,"Avenida Central",19,19,0,244,244,0
11,20,2018,13,0,3,"Braga",3,"Rua de Caires",25,25,0,4,4,0
11,20,2018,13,0,3,"Braga",4,"N14 Bosch",47,47,0,47,47,0
11,20,2018,13,0,3,"Braga",5,"Avenida João Paulo II",39,39,0,8,8,0
11,20,2018,13,0,3,"Braga",6,"Avenida Padre Júlio Fragata",61,61,0,21,21,0
11,20,2018,13,0,3,"Braga",7,"Rua Nova Santa Cruz",28,28,0,108,108,0
11,20,2018,13,0,3,"Braga",8,"Rua Costa Gomes",40,40,0,43,43,0
11,20,2018,14,0,3,"Braga",1,"Avenida da Liberdade",25,25,0,26,26,0
11,20,2018,14,0,3,"Braga",2,"Avenida Central",13,19,6,356,244,112
11,20,2018,14,0,3,"Braga",3,"Rua de Caires",25,25,0,4,4,0
11,20,2018,14,0,3,"Braga",4,"N14 Bosch",27,46,19,83,48,35
11,20,2018,14,0,3,"Braga",5,"Avenida João Paulo II",38,38,0,9,9,0
11,20,2018,14,0,3,"Braga",6,"Avenida Padre Júlio Fragata",34,62,28,39,21,18
11,20,2018,14,0,3,"Braga",7,"Rua Nova Santa Cruz",29,29,0,104,104,0
11,20,2018,14,0,3,"Braga",8,"Rua Costa Gomes",28,40,12,61,43,18
11,20,2018,15,0,3,"Braga",1,"Avenida da Liberdade",25,25,0,26,26,0
11,20,2018,15,0,3,"Braga",2,"Avenida Central",14,18,4,331,257,74
11,20,2018,15,0,3,"Braga",3,"Rua de Caires",18,25,7,5,4,1
11,20,2018,15,0,3,"Braga",4,"N14 Bosch",24,46,22,93,48,45
11,20,2018,15,0,3,"Braga",5,"Avenida João Paulo II",27,38,11,12,9,3
11,20,2018,15,0,3,"Braga",6,"Avenida Padre Júlio Fragata",61,61,0,21,21,0
11,20,2018,15,0,3,"Braga",7,"Rua Nova Santa Cruz",18,29,11,169,104,65
11,20,2018,15,0,3,"Braga",8,"Rua Costa Gomes",24,41,17,72,42,30
11,20,2018,16,0,3,"Braga",1,"Avenida da Liberdade",25,25,0,26,26,0
11,20,2018,16,0,3,"Braga",2,"Avenida Central",8,17,9,579,272,307
11,20,2018,16,0,3,"Braga",3,"Rua de Caires",19,24,5,5,4,1
11,20,2018,16,0,3,"Braga",4,"N14 Bosch",27,46,19,83,48,35
11,20,2018,16,0,3,"Braga",5,"Avenida João Paulo II",38,38,0,9,9,0
11,20,2018,16,0,3,"Braga",6,"Avenida Padre Júlio Fragata",37,62,25,35,21,14
11,20,2018,16,0,3,"Braga",7,"Rua Nova Santa Cruz",29,29,0,104,104,0
11,20,2018,16,0,3,"Braga",8,"Rua Costa Gomes",40,40,0,43,43,0
11,20,2018,17,0,3,"Braga",1,"Avenida da Liberdade",25,25,0,26,26,0
11,20,2018,17,0,3,"Braga",2,"Avenida Central",11,18,7,421,257,164
11,20,2018,17,0,3,"Braga",3,"Rua de Caires",25,25,0,4,4,0
11,20,2018,17,0,3,"Braga",4,"N14 Bosch",25,47,22,89,47,42
11,20,2018,17,0,3,"Braga",5,"Avenida João Paulo II",39,39,0,8,8,0
11,20,2018,17,0,3,"Braga",6,"Avenida Padre Júlio Fragata",35,61,26,38,21,17
11,20,2018,17,0,3,"Braga",7,"Rua Nova Santa Cruz",19,29,10,160,104,56
11,20,2018,17,0,3,"Braga",8,"Rua Costa Gomes",25,41,16,69,42,27
11,20,2018,18,0,3,"Braga",1,"Avenida da Liberdade",17,24,7,39,27,12
11,20,2018,18,0,3,"Braga",2,"Avenida Central",6,17,11,772,272,500
11,20,2018,18,0,3,"Braga",3,"Rua de Caires",25,25,0,4,4,0
11,20,2018,18,0,3,"Braga",4,"N14 Bosch",26,46,20,86,48,38
11,20,2018,18,0,3,"Braga",5,"Avenida João Paulo II",30,39,9,11,8,3
11,20,2018,18,0,3,"Braga",6,"Avenida Padre Júlio Fragata",29,61,32,45,21,24
11,20,2018,18,0,3,"Braga",7,"Rua Nova Santa Cruz",9,30,21,338,101,237
11,20,2018,18,0,3,"Braga",8,"Rua Costa Gomes",22,40,18,78,43,35
11,20,2018,19,0,3,"Braga",1,"Avenida da Liberdade",25,25,0,26,26,0
11,20,2018,19,0,3,"Braga",2,"Avenida Central",6,19,13,772,244,528
11,20,2018,19,0,3,"Braga",3,"Rua de Caires",24,24,0,4,4,0
11,20,2018,19,0,3,"Braga",4,"N14 Bosch",35,46,11,64,48,16
11,20,2018,19,0,3,"Braga",5,"Avenida João Paulo II",39,39,0,8,8,0
11,20,2018,19,0,3,"Braga",6,"Avenida Padre Júlio Fragata",25,62,37,53,21,32
11,20,2018,19,0,3,"Braga",7,"Rua Nova Santa Cruz",17,29,12,179,104,75
11,20,2018,19,0,3,"Braga",8,"Rua Costa Gomes",25,40,15,69,43,26
11,20,2018,20,0,3,"Braga",1,"Avenida da Liberdade",25,25,0,26,26,0
11,20,2018,20,0,3,"Braga",2,"Avenida Central",14,17,3,331,272,59
11,20,2018,20,0,3,"Braga",3,"Rua de Caires",25,25,0,4,4,0
11,20,2018,20,0,3,"Braga",4,"N14 Bosch",47,47,0,47,47,0
11,20,2018,20,0,3,"Braga",5,"Avenida João Paulo II",39,39,0,8,8,0
11,20,2018,20,0,3,"Braga",6,"Avenida Padre Júlio Fragata",62,62,0,21,21,0
11,20,2018,20,0,3,"Braga",7,"Rua Nova Santa Cruz",29,29,0,104,104,0
11,20,2018,20,0,3,"Braga",8,"Rua Costa Gomes",27,40,13,64,43,21
11,20,2018,21,0,3,"Braga",1,"Avenida da Liberdade",25,25,0,26,26,0
11,20,2018,21,0,3,"Braga",2,"Avenida Central",17,17,0,272,272,0
11,20,2018,21,0,3,"Braga",3,"Rua de Caires",6,25,19,17,4,13
11,20,2018,21,0,3,"Braga",4,"N14 Bosch",47,47,0,47,47,0
11,20,2018,21,0,3,"Braga",5,"Avenida João Paulo II",39,39,0,8,8,0
11,20,2018,21,0,3,"Braga",6,"Avenida Padre Júlio Fragata",47,62,15,28,21,7
11,20,2018,21,0,3,"Braga",7,"Rua Nova Santa Cruz",29,29,0,104,104,0
11,20,2018,21,0,3,"Braga",8,"Rua Costa Gomes",41,41,0,42,42,0
11,20,2018,22,0,3,"Braga",1,"Avenida da Liberdade",25,25,0,26,26,0
11,20,2018,22,0,3,"Braga",2,"Avenida Central",17,17,0,272,272,0
11,20,2018,22,0,3,"Braga",3,"Rua de Caires",23,23,0,4,4,0
11,20,2018,22,0,3,"Braga",4,"N14 Bosch",47,47,0,47,47,0
11,20,2018,22,0,3,"Braga",5,"Avenida João Paulo II",39,39,0,8,8,0
11,20,2018,22,0,3,"Braga",6,"Avenida Padre Júlio Fragata",62,62,0,21,21,0
11,20,2018,22,0,3,"Braga",7,"Rua Nova Santa Cruz",29,29,0,104,104,0
11,20,2018,22,0,3,"Braga",8,"Rua Costa Gomes",41,41,0,42,42,0
11,20,2018,23,0,3,"Braga",1,"Avenida da Liberdade",25,25,0,26,26,0
11,20,2018,23,0,3,"Braga",2,"Avenida Central",17,17,0,272,272,0
11,20,2018,23,0,3,"Braga",3,"Rua de Caires",23,23,0,4,4,0
11,20,2018,23,0,3,"Braga",4,"N14 Bosch",47,47,0,47,47,0
11,20,2018,23,0,3,"Braga",5,"Avenida João Paulo II",39,39,0,8,8,0
11,20,2018,23,0,3,"Braga",6,"Avenida Padre Júlio Fragata",61,61,0,21,21,0
11,20,2018,23,0,3,"Braga",7,"Rua Nova Santa Cruz",29,29,0,104,104,0
11,20,2018,23,0,3,"Braga",8,"Rua Costa Gomes",41,41,0,42,42,0
11,21,2018,0,0,4,"Braga",1,"Avenida da Liberdade",25,25,0,26,26,0
11,21,2018,0,0,4,"Braga",2,"Avenida Central",17,17,0,272,272,0
11,21,2018,0,0,4,"Braga",3,"Rua de Caires",23,23,0,4,4,0
11,21,2018,0,0,4,"Braga",4,"N14 Bosch",47,47,0,47,47,0
11,21,2018,0,0,4,"Braga",5,"Avenida João Paulo II",39,39,0,8,8,0
11,21,2018,0,0,4,"Braga",6,"Avenida Padre Júlio Fragata",61,61,0,21,21,0
11,21,2018,0,0,4,"Braga",7,"Rua Nova Santa Cruz",29,29,0,104,104,0
11,21,2018,0,0,4,"Braga",8,"Rua Costa Gomes",41,41,0,42,42,0
11,21,2018,1,0,4,"Braga",1,"Avenida da Liberdade",25,25,0,26,26,0
11,21,2018,1,0,4,"Braga",2,"Avenida Central",17,17,0,272,272,0
11,21,2018,1,0,4,"Braga",3,"Rua de Caires",23,23,0,4,4,0
11,21,2018,1,0,4,"Braga",4,"N14 Bosch",47,47,0,47,47,0
11,21,2018,1,0,4,"Braga",5,"Avenida João Paulo II",39,39,0,8,8,0
11,21,2018,1,0,4,"Braga",6,"Avenida Padre Júlio Fragata",61,61,0,21,21,0
11,21,2018,1,0,4,"Braga",7,"Rua Nova Santa Cruz",29,29,0,104,104,0
11,21,2018,1,0,4,"Braga",8,"Rua Costa Gomes",41,41,0,42,42,0
11,21,2018,2,0,4,"Braga",1,"Avenida da Liberdade",25,25,0,26,26,0
11,21,2018,2,0,4,"Braga",2,"Avenida Central",17,17,0,272,272,0
11,21,2018,2,0,4,"Braga",3,"Rua de Caires",23,23,0,4,4,0
11,21,2018,2,0,4,"Braga",4,"N14 Bosch",47,47,0,47,47,0
11,21,2018,2,0,4,"Braga",5,"Avenida João Paulo II",39,39,0,8,8,0
11,21,2018,2,0,4,"Braga",6,"Avenida Padre Júlio Fragata",61,61,0,21,21,0
11,21,2018,2,0,4,"Braga",7,"Rua Nova Santa Cruz",29,29,0,104,104,0
11,21,2018,2,0,4,"Braga",8,"Rua Costa Gomes",41,41,0,42,42,0
11,21,2018,3,0,4,"Braga",1,"Avenida da Liberdade",25,25,0,26,26,0
11,21,2018,3,0,4,"Braga",2,"Avenida Central",17,17,0,272,272,0
11,21,2018,3,0,4,"Braga",3,"Rua de Caires",23,23,0,4,4,0
11,21,2018,3,0,4,"Braga",4,"N14 Bosch",47,47,0,47,47,0
11,21,2018,3,0,4,"Braga",5,"Avenida João Paulo II",39,39,0,8,8,0
11,21,2018,3,0,4,"Braga",6,"Avenida Padre Júlio Fragata",61,61,0,21,21,0
11,21,2018,3,0,4,"Braga",7,"Rua Nova Santa Cruz",29,29,0,104,104,0
11,21,2018,3,0,4,"Braga",8,"Rua Costa Gomes",41,41,0,42,42,0
11,21,2018,4,0,4,"Braga",1,"Avenida da Liberdade",25,25,0,26,26,0
11,21,2018,4,0,4,"Braga",2,"Avenida Central",17,17,0,272,272,0
11,21,2018,4,0,4,"Braga",3,"Rua de Caires",23,23,0,4,4,0
11,21,2018,4,0,4,"Braga",4,"N14 Bosch",47,47,0,47,47,0
11,21,2018,4,0,4,"Braga",5,"Avenida João Paulo II",39,39,0,8,8,0
11,21,2018,4,0,4,"Braga",6,"Avenida Padre Júlio Fragata",61,61,0,21,21,0
11,21,2018,4,0,4,"Braga",7,"Rua Nova Santa Cruz",29,29,0,104,104,0
11,21,2018,4,0,4,"Braga",8,"Rua Costa Gomes",41,41,0,42,42,0
11,21,2018,5,0,4,"Braga",1,"Avenida da Liberdade",25,25,0,26,26,0
11,21,2018,5,0,4,"Braga",2,"Avenida Central",17,17,0,272,272,0
11,21,2018,5,0,4,"Braga",3,"Rua de Caires",23,23,0,4,4,0
11,21,2018,5,0,4,"Braga",4,"N14 Bosch",47,47,0,47,47,0
11,21,2018,5,0,4,"Braga",5,"Avenida João Paulo II",39,39,0,8,8,0
11,21,2018,5,0,4,"Braga",6,"Avenida Padre Júlio Fragata",61,61,0,21,21,0
11,21,2018,5,0,4,"Braga",7,"Rua Nova Santa Cruz",29,29,0,104,104,0
11,21,2018,5,0,4,"Braga",8,"Rua Costa Gomes",41,41,0,42,42,0
11,21,2018,6,0,4,"Braga",1,"Avenida da Liberdade",25,25,0,26,26,0
11,21,2018,6,0,4,"Braga",2,"Avenida Central",17,17,0,272,272,0
11,21,2018,6,0,4,"Braga",3,"Rua de Caires",23,23,0,4,4,0
11,21,2018,6,0,4,"Braga",4,"N14 Bosch",47,47,0,47,47,0
11,21,2018,6,0,4,"Braga",5,"Avenida João Paulo II",39,39,0,8,8,0
11,21,2018,6,0,4,"Braga",6,"Avenida Padre Júlio Fragata",61,61,0,21,21,0
11,21,2018,6,0,4,"Braga",7,"Rua Nova Santa Cruz",29,29,0,104,104,0
11,21,2018,6,0,4,"Braga",8,"Rua Costa Gomes",41,41,0,42,42,0
11,21,2018,7,0,4,"Braga",1,"Avenida da Liberdade",25,25,0,26,26,0
11,21,2018,7,0,4,"Braga",2,"Avenida Central",17,17,0,272,272,0
11,21,2018,7,0,4,"Braga",3,"Rua de Caires",23,23,0,4,4,0
11,21,2018,7,0,4,"Braga",4,"N14 Bosch",47,47,0,47,47,0
11,21,2018,7,0,4,"Braga",5,"Avenida João Paulo II",39,39,0,8,8,0
11,21,2018,7,0,4,"Braga",6,"Avenida Padre Júlio Fragata",61,61,0,21,21,0
11,21,2018,7,0,4,"Braga",7,"Rua Nova Santa Cruz",29,29,0,104,104,0
11,21,2018,7,0,4,"Braga",8,"Rua Costa Gomes",41,41,0,42,42,0
11,21,2018,8,0,4,"Braga",1,"Avenida da Liberdade",25,25,0,26,26,0
11,21,2018,8,0,4,"Braga",2,"Avenida Central",17,17,0,272,272,0
11,21,2018,8,0,4,"Braga",3,"Rua de Caires",19,25,6,5,4,1
11,21,2018,8,0,4,"Braga",4,"N14 Bosch",47,47,0,47,47,0
11,21,2018,8,0,4,"Braga",5,"Avenida João Paulo II",39,39,0,8,8,0
11,21,2018,8,0,4,"Braga",6,"Avenida Padre Júlio Fragata",61,61,0,21,21,0
11,21,2018,8,0,4,"Braga",7,"Rua Nova Santa Cruz",29,29,0,104,104,0
11,21,2018,8,0,4,"Braga",8,"Rua Costa Gomes",41,41,0,42,42,0
11,21,2018,9,0,4,"Braga",1,"Avenida da Liberdade",18,24,6,36,27,9
11,21,2018,9,0,4,"Braga",2,"Avenida Central",13,17,4,356,272,84
11,21,2018,9,0,4,"Braga",3,"Rua de Caires",19,24,5,5,4,1
11,21,2018,9,0,4,"Braga",4,"N14 Bosch",20,46,26,112,48,64
11,21,2018,9,0,4,"Braga",5,"Avenida João Paulo II",17,38,21,20,9,11
11,21,2018,9,0,4,"Braga",6,"Avenida Padre Júlio Fragata",26,61,35,51,21,30
11,21,2018,9,0,4,"Braga",7,"Rua Nova Santa Cruz",14,28,14,217,108,109
11,21,2018,9,0,4,"Braga",8,"Rua Costa Gomes",31,41,10,55,42,13
11,21,2018,10,0,4,"Braga",1,"Avenida da Liberdade",24,24,0,27,27,0
11,21,2018,10,0,4,"Braga",2,"Avenida Central",11,18,7,421,257,164
11,21,2018,10,0,4,"Braga",3,"Rua de Caires",25,25,0,4,4,0
11,21,2018,10,0,4,"Braga",4,"N14 Bosch",36,46,10,62,48,14
11,21,2018,10,0,4,"Braga",5,"Avenida João Paulo II",39,39,0,8,8,0
11,21,2018,10,0,4,"Braga",6,"Avenida Padre Júlio Fragata",62,62,0,21,21,0
11,21,2018,10,0,4,"Braga",7,"Rua Nova Santa Cruz",28,28,0,108,108,0
11,21,2018,10,0,4,"Braga",8,"Rua Costa Gomes",28,40,12,61,43,18
11,21,2018,11,0,4,"Braga",1,"Avenida da Liberdade",20,25,5,33,26,7
11,21,2018,11,0,4,"Braga",2,"Avenida Central",12,17,5,386,272,114
11,21,2018,11,0,4,"Braga",3,"Rua de Caires",19,25,6,5,4,1
11,21,2018,11,0,4,"Braga",4,"N14 Bosch",36,46,10,62,48,14
11,21,2018,11,0,4,"Braga",5,"Avenida João Paulo II",38,38,0,9,9,0
11,21,2018,11,0,4,"Braga",6,"Avenida Padre Júlio Fragata",62,62,0,21,21,0
11,21,2018,11,0,4,"Braga",7,"Rua Nova Santa Cruz",29,29,0,104,104,0
11,21,2018,11,0,4,"Braga",8,"Rua Costa Gomes",31,41,10,55,42,13
11,21,2018,12,0,4,"Braga",1,"Avenida da Liberdade",25,25,0,26,26,0
11,21,2018,12,0,4,"Braga",2,"Avenida Central",17,17,0,272,272,0
11,21,2018,12,0,4,"Braga",3,"Rua de Caires",24,24,0,4,4,0
11,21,2018,12,0,4,"Braga",4,"N14 Bosch",33,46,13,68,48,20
11,21,2018,12,0,4,"Braga",5,"Avenida João Paulo II",39,39,0,8,8,0
11,21,2018,12,0,4,"Braga",6,"Avenida Padre Júlio Fragata",49,62,13,27,21,6
11,21,2018,12,0,4,"Braga",7,"Rua Nova Santa Cruz",29,29,0,104,104,0
11,21,2018,12,0,4,"Braga",8,"Rua Costa Gomes",32,41,9,54,42,12
11,21,2018,13,0,4,"Braga",1,"Avenida da Liberdade",25,25,0,26,26,0
11,21,2018,13,0,4,"Braga",2,"Avenida Central",17,17,0,272,272,0
11,21,2018,13,0,4,"Braga",3,"Rua de Caires",24,24,0,4,4,0
11,21,2018,13,0,4,"Braga",4,"N14 Bosch",20,47,27,112,47,65
11,21,2018,13,0,4,"Braga",5,"Avenida João Paulo II",38,38,0,9,9,0
11,21,2018,13,0,4,"Braga",6,"Avenida Padre Júlio Fragata",47,62,15,28,21,7
11,21,2018,13,0,4,"Braga",7,"Rua Nova Santa Cruz",23,29,6,132,104,28
11,21,2018,13,0,4,"Braga",8,"Rua Costa Gomes",30,40,10,57,43,14
11,21,2018,14,0,4,"Braga",1,"Avenida da Liberdade",25,25,0,26,26,0
11,21,2018,14,0,4,"Braga",2,"Avenida Central",13,18,5,356,257,99
11,21,2018,14,0,4,"Braga",3,"Rua de Caires",17,24,7,6,4,2
11,21,2018,14,0,4,"Braga",4,"N14 Bosch",29,47,18,77,47,30
11,21,2018,14,0,4,"Braga",5,"Avenida João Paulo II",22,39,17,15,8,7
11,21,2018,14,0,4,"Braga",6,"Avenida Padre Júlio Fragata",46,61,15,28,21,7
11,21,2018,14,0,4,"Braga",7,"Rua Nova Santa Cruz",28,28,0,108,108,0
11,21,2018,14,0,4,"Braga",8,"Rua Costa Gomes",41,41,0,42,42,0
11,21,2018,15,0,4,"Braga",1,"Avenida da Liberdade",20,25,5,33,26,7
11,21,2018,15,0,4,"Braga",2,"Avenida Central",13,18,5,356,257,99
11,21,2018,15,0,4,"Braga",3,"Rua de Caires",24,24,0,4,4,0
11,21,2018,15,0,4,"Braga",4,"N14 Bosch",26,46,20,86,48,38
11,21,2018,15,0,4,"Braga",5,"Avenida João Paulo II",31,38,7,11,9,2
11,21,2018,15,0,4,"Braga",6,"Avenida Padre Júlio Fragata",44,62,18,30,21,9
11,21,2018,15,0,4,"Braga",7,"Rua Nova Santa Cruz",22,28,6,138,108,30
11,21,2018,15,0,4,"Braga",8,"Rua Costa Gomes",41,41,0,42,42,0
11,21,2018,16,0,4,"Braga",1,"Avenida da Liberdade",24,24,0,27,27,0
11,21,2018,16,0,4,"Braga",2,"Avenida Central",9,18,9,515,257,258
11,21,2018,16,0,4,"Braga",3,"Rua de Caires",20,25,5,5,4,1
11,21,2018,16,0,4,"Braga",4,"N14 Bosch",19,46,27,118,48,70
11,21,2018,16,0,4,"Braga",5,"Avenida João Paulo II",30,38,8,11,9,2
11,21,2018,16,0,4,"Braga",6,"Avenida Padre Júlio Fragata",27,61,34,49,21,28
11,21,2018,16,0,4,"Braga",7,"Rua Nova Santa Cruz",17,28,11,179,108,71
11,21,2018,16,0,4,"Braga",8,"Rua Costa Gomes",27,41,14,64,42,22
11,21,2018,17,0,4,"Braga",1,"Avenida da Liberdade",19,24,5,34,27,7
11,21,2018,17,0,4,"Braga",2,"Avenida Central",11,18,7,421,257,164
11,21,2018,17,0,4,"Braga",3,"Rua de Caires",19,25,6,5,4,1
11,21,2018,17,0,4,"Braga",4,"N14 Bosch",21,48,27,107,46,61
11,21,2018,17,0,4,"Braga",5,"Avenida João Paulo II",38,38,0,9,9,0
11,21,2018,17,0,4,"Braga",6,"Avenida Padre Júlio Fragata",33,62,29,40,21,19
11,21,2018,17,0,4,"Braga",7,"Rua Nova Santa Cruz",13,29,16,234,104,130
11,21,2018,17,0,4,"Braga",8,"Rua Costa Gomes",17,40,23,101,43,58
11,21,2018,18,0,4,"Braga",1,"Avenida da Liberdade",15,24,9,44,27,17
11,21,2018,18,0,4,"Braga",2,"Avenida Central",8,19,11,579,244,335
11,21,2018,18,0,4,"Braga",3,"Rua de Caires",14,25,11,7,4,3
11,21,2018,18,0,4,"Braga",4,"N14 Bosch",13,47,34,172,47,125
11,21,2018,18,0,4,"Braga",5,"Avenida João Paulo II",38,38,0,9,9,0
11,21,2018,18,0,4,"Braga",6,"Avenida Padre Júlio Fragata",25,62,37,53,21,32
11,21,2018,18,0,4,"Braga",7,"Rua Nova Santa Cruz",11,30,19,276,101,175
11,21,2018,18,0,4,"Braga",8,"Rua Costa Gomes",11,42,31,157,41,116
11,21,2018,19,0,4,"Braga",1,"Avenida da Liberdade",17,24,7,39,27,12
11,21,2018,19,0,4,"Braga",2,"Avenida Central",6,17,11,772,272,500
11,21,2018,19,0,4,"Braga",3,"Rua de Caires",16,25,9,6,4,2
11,21,2018,19,0,4,"Braga",4,"N14 Bosch",22,46,24,102,48,54
11,21,2018,19,0,4,"Braga",5,"Avenida João Paulo II",30,39,9,11,8,3
11,21,2018,19,0,4,"Braga",6,"Avenida Padre Júlio Fragata",41,62,21,32,21,11
11,21,2018,19,0,4,"Braga",7,"Rua Nova Santa Cruz",12,28,16,253,108,145
11,21,2018,19,0,4,"Braga",8,"Rua Costa Gomes",9,41,32,192,42,150
11,21,2018,20,0,4,"Braga",1,"Avenida da Liberdade",25,25,0,26,26,0
11,21,2018,20,0,4,"Braga",2,"Avenida Central",18,18,0,257,257,0
11,21,2018,20,0,4,"Braga",3,"Rua de Caires",18,25,7,5,4,1
11,21,2018,20,0,4,"Braga",4,"N14 Bosch",47,47,0,47,47,0
11,21,2018,20,0,4,"Braga",5,"Avenida João Paulo II",25,39,14,13,8,5
11,21,2018,20,0,4,"Braga",6,"Avenida Padre Júlio Fragata",49,61,12,27,21,6
11,21,2018,20,0,4,"Braga",7,"Rua Nova Santa Cruz",17,29,12,179,104,75
11,21,2018,20,0,4,"Braga",8,"Rua Costa Gomes",39,39,0,44,44,0
11,21,2018,21,0,4,"Braga",1,"Avenida da Liberdade",25,25,0,26,26,0
11,21,2018,21,0,4,"Braga",2,"Avenida Central",18,18,0,257,257,0
11,21,2018,21,0,4,"Braga",3,"Rua de Caires",25,25,0,4,4,0
11,21,2018,21,0,4,"Braga",4,"N14 Bosch",47,47,0,47,47,0
11,21,2018,21,0,4,"Braga",5,"Avenida João Paulo II",38,38,0,9,9,0
11,21,2018,21,0,4,"Braga",6,"Avenida Padre Júlio Fragata",50,62,12,26,21,5
11,21,2018,21,0,4,"Braga",7,"Rua Nova Santa Cruz",29,29,0,104,104,0
11,21,2018,21,0,4,"Braga",8,"Rua Costa Gomes",41,41,0,42,42,0
11,21,2018,22,0,4,"Braga",1,"Avenida da Liberdade",25,25,0,26,26,0
11,21,2018,22,0,4,"Braga",2,"Avenida Central",18,18,0,257,257,0
11,21,2018,22,0,4,"Braga",3,"Rua de Caires",25,25,0,4,4,0
11,21,2018,22,0,4,"Braga",4,"N14 Bosch",47,47,0,47,47,0
11,21,2018,22,0,4,"Braga",5,"Avenida João Paulo II",38,38,0,9,9,0
11,21,2018,22,0,4,"Braga",6,"Avenida Padre Júlio Fragata",62,62,0,21,21,0
11,21,2018,22,0,4,"Braga",7,"Rua Nova Santa Cruz",29,29,0,104,104,0
11,21,2018,22,0,4,"Braga",8,"Rua Costa Gomes",41,41,0,42,42,0
11,21,2018,23,0,4,"Braga",1,"Avenida da Liberdade",25,25,0,26,26,0
11,21,2018,23,0,4,"Braga",2,"Avenida Central",18,18,0,257,257,0
11,21,2018,23,0,4,"Braga",3,"Rua de Caires",25,25,0,4,4,0
11,21,2018,23,0,4,"Braga",4,"N14 Bosch",47,47,0,47,47,0
11,21,2018,23,0,4,"Braga",5,"Avenida João Paulo II",38,38,0,9,9,0
11,21,2018,23,0,4,"Braga",6,"Avenida Padre Júlio Fragata",62,62,0,21,21,0
11,21,2018,23,0,4,"Braga",7,"Rua Nova Santa Cruz",29,29,0,104,104,0
11,21,2018,23,0,4,"Braga",8,"Rua Costa Gomes",41,41,0,42,42,0
11,22,2018,0,0,5,"Braga",1,"Avenida da Liberdade",25,25,0,26,26,0
11,22,2018,0,0,5,"Braga",2,"Avenida Central",18,18,0,257,257,0
11,22,2018,0,0,5,"Braga",3,"Rua de Caires",25,25,0,4,4,0
11,22,2018,0,0,5,"Braga",4,"N14 Bosch",47,47,0,47,47,0
11,22,2018,0,0,5,"Braga",5,"Avenida João Paulo II",38,38,0,9,9,0
11,22,2018,0,0,5,"Braga",6,"Avenida Padre Júlio Fragata",62,62,0,21,21,0
11,22,2018,0,0,5,"Braga",7,"Rua Nova Santa Cruz",29,29,0,104,104,0
11,22,2018,0,0,5,"Braga",8,"Rua Costa Gomes",41,41,0,42,42,0
11,22,2018,1,0,5,"Braga",4,"N14 Bosch",47,47,0,47,47,0
11,22,2018,1,0,5,"Braga",5,"Avenida João Paulo II",38,38,0,9,9,0
11,22,2018,1,0,5,"Braga",6,"Avenida Padre Júlio Fragata",62,62,0,21,21,0
11,22,2018,1,0,5,"Braga",7,"Rua Nova Santa Cruz",23,28,5,132,108,24
11,22,2018,1,0,5,"Braga",8,"Rua Costa Gomes",41,41,0,42,42,0
11,22,2018,1,0,5,"Braga",1,"Avenida da Liberdade",25,25,0,26,26,0
11,22,2018,1,0,5,"Braga",2,"Avenida Central",18,18,0,257,257,0
11,22,2018,1,0,5,"Braga",3,"Rua de Caires",25,25,0,4,4,0
11,22,2018,1,0,5,"Braga",4,"N14 Bosch",47,47,0,47,47,0
11,22,2018,2,0,5,"Braga",1,"Avenida da Liberdade",25,25,0,26,26,0
11,22,2018,2,0,5,"Braga",2,"Avenida Central",18,18,0,257,257,0
11,22,2018,2,0,5,"Braga",3,"Rua de Caires",25,25,0,4,4,0
11,22,2018,2,0,5,"Braga",4,"N14 Bosch",47,47,0,47,47,0
11,22,2018,2,0,5,"Braga",5,"Avenida João Paulo II",38,38,0,9,9,0
11,22,2018,2,0,5,"Braga",6,"Avenida Padre Júlio Fragata",62,62,0,21,21,0
11,22,2018,2,0,5,"Braga",7,"Rua Nova Santa Cruz",29,29,0,104,104,0
11,22,2018,2,0,5,"Braga",8,"Rua Costa Gomes",41,41,0,42,42,0
11,22,2018,3,0,5,"Braga",8,"Rua Costa Gomes",41,41,0,42,42,0
11,22,2018,3,0,5,"Braga",1,"Avenida da Liberdade",25,25,0,26,26,0
11,22,2018,3,0,5,"Braga",2,"Avenida Central",18,18,0,257,257,0
11,22,2018,3,0,5,"Braga",3,"Rua de Caires",25,25,0,4,4,0
11,22,2018,3,0,5,"Braga",4,"N14 Bosch",47,47,0,47,47,0
11,22,2018,3,0,5,"Braga",5,"Avenida João Paulo II",38,38,0,9,9,0
11,22,2018,3,0,5,"Braga",6,"Avenida Padre Júlio Fragata",62,62,0,21,21,0
11,22,2018,3,0,5,"Braga",7,"Rua Nova Santa Cruz",29,29,0,104,104,0
11,22,2018,3,0,5,"Braga",8,"Rua Costa Gomes",41,41,0,42,42,0
11,22,2018,4,0,5,"Braga",1,"Avenida da Liberdade",25,25,0,26,26,0
11,22,2018,4,0,5,"Braga",2,"Avenida Central",18,18,0,257,257,0
11,22,2018,4,0,5,"Braga",3,"Rua de Caires",25,25,0,4,4,0
11,22,2018,4,0,5,"Braga",4,"N14 Bosch",47,47,0,47,47,0
11,22,2018,4,0,5,"Braga",5,"Avenida João Paulo II",38,38,0,9,9,0
11,22,2018,4,0,5,"Braga",6,"Avenida Padre Júlio Fragata",62,62,0,21,21,0
11,22,2018,4,0,5,"Braga",7,"Rua Nova Santa Cruz",29,29,0,104,104,0
11,22,2018,4,0,5,"Braga",8,"Rua Costa Gomes",41,41,0,42,42,0
11,22,2018,5,0,5,"Braga",1,"Avenida da Liberdade",25,25,0,26,26,0
11,22,2018,5,0,5,"Braga",2,"Avenida Central",18,18,0,257,257,0
11,22,2018,5,0,5,"Braga",3,"Rua de Caires",25,25,0,4,4,0
11,22,2018,5,0,5,"Braga",4,"N14 Bosch",47,47,0,47,47,0
11,22,2018,5,0,5,"Braga",5,"Avenida João Paulo II",38,38,0,9,9,0
11,22,2018,5,0,5,"Braga",6,"Avenida Padre Júlio Fragata",62,62,0,21,21,0
11,22,2018,5,0,5,"Braga",7,"Rua Nova Santa Cruz",29,29,0,104,104,0
11,22,2018,5,0,5,"Braga",8,"Rua Costa Gomes",41,41,0,42,42,0
11,22,2018,6,0,5,"Braga",1,"Avenida da Liberdade",25,25,0,26,26,0
11,22,2018,6,0,5,"Braga",2,"Avenida Central",18,18,0,257,257,0
11,22,2018,6,0,5,"Braga",3,"Rua de Caires",25,25,0,4,4,0
11,22,2018,6,0,5,"Braga",4,"N14 Bosch",47,47,0,47,47,0
11,22,2018,6,0,5,"Braga",5,"Avenida João Paulo II",38,38,0,9,9,0
11,22,2018,6,0,5,"Braga",6,"Avenida Padre Júlio Fragata",62,62,0,21,21,0
11,22,2018,6,0,5,"Braga",7,"Rua Nova Santa Cruz",29,29,0,104,104,0
11,22,2018,6,0,5,"Braga",8,"Rua Costa Gomes",41,41,0,42,42,0
11,22,2018,7,0,5,"Braga",1,"Avenida da Liberdade",25,25,0,26,26,0
11,22,2018,7,0,5,"Braga",2,"Avenida Central",18,18,0,257,257,0
11,22,2018,7,0,5,"Braga",3,"Rua de Caires",25,25,0,4,4,0
11,22,2018,7,0,5,"Braga",4,"N14 Bosch",47,47,0,47,47,0
11,22,2018,7,0,5,"Braga",5,"Avenida João Paulo II",38,38,0,9,9,0
11,22,2018,7,0,5,"Braga",6,"Avenida Padre Júlio Fragata",62,62,0,21,21,0
11,22,2018,7,0,5,"Braga",7,"Rua Nova Santa Cruz",29,29,0,104,104,0
11,22,2018,7,0,5,"Braga",8,"Rua Costa Gomes",41,41,0,42,42,0
11,22,2018,8,0,5,"Braga",1,"Avenida da Liberdade",19,24,5,34,27,7
11,22,2018,8,0,5,"Braga",2,"Avenida Central",18,18,0,257,257,0
11,22,2018,8,0,5,"Braga",3,"Rua de Caires",16,25,9,6,4,2
11,22,2018,8,0,5,"Braga",4,"N14 Bosch",31,47,16,72,47,25
11,22,2018,8,0,5,"Braga",5,"Avenida João Paulo II",38,38,0,9,9,0
11,22,2018,8,0,5,"Braga",6,"Avenida Padre Júlio Fragata",62,62,0,21,21,0
11,22,2018,8,0,5,"Braga",7,"Rua Nova Santa Cruz",29,29,0,104,104,0
11,22,2018,8,0,5,"Braga",8,"Rua Costa Gomes",32,41,9,54,42,12
11,22,2018,9,0,5,"Braga",1,"Avenida da Liberdade",15,25,10,44,26,18
11,22,2018,9,0,5,"Braga",2,"Avenida Central",7,18,11,662,257,405
11,22,2018,9,0,5,"Braga",3,"Rua de Caires",24,24,0,4,4,0
11,22,2018,9,0,5,"Braga",4,"N14 Bosch",32,47,15,70,47,23
11,22,2018,9,0,5,"Braga",5,"Avenida João Paulo II",7,41,34,49,8,41
11,22,2018,9,0,5,"Braga",6,"Avenida Padre Júlio Fragata",28,63,35,47,21,26
11,22,2018,9,0,5,"Braga",7,"Rua Nova Santa Cruz",22,29,7,138,104,34
11,22,2018,9,0,5,"Braga",8,"Rua Costa Gomes",41,41,0,42,42,0
11,22,2018,10,0,5,"Braga",1,"Avenida da Liberdade",14,24,10,47,27,20
11,22,2018,10,0,5,"Braga",2,"Avenida Central",11,18,7,421,257,164
11,22,2018,10,0,5,"Braga",3,"Rua de Caires",24,24,0,4,4,0
11,22,2018,10,0,5,"Braga",4,"N14 Bosch",47,47,0,47,47,0
11,22,2018,10,0,5,"Braga",5,"Avenida João Paulo II",38,38,0,9,9,0
11,22,2018,10,0,5,"Braga",6,"Avenida Padre Júlio Fragata",61,61,0,21,21,0
11,22,2018,10,0,5,"Braga",7,"Rua Nova Santa Cruz",28,28,0,108,108,0
11,22,2018,10,0,5,"Braga",8,"Rua Costa Gomes",41,41,0,42,42,0
11,22,2018,11,0,5,"Braga",1,"Avenida da Liberdade",18,25,7,36,26,10
11,22,2018,11,0,5,"Braga",2,"Avenida Central",17,17,0,272,272,0
11,22,2018,11,0,5,"Braga",3,"Rua de Caires",24,24,0,4,4,0
11,22,2018,11,0,5,"Braga",4,"N14 Bosch",33,46,13,68,48,20
11,22,2018,11,0,5,"Braga",5,"Avenida João Paulo II",38,38,0,9,9,0
11,22,2018,11,0,5,"Braga",6,"Avenida Padre Júlio Fragata",62,62,0,21,21,0
11,22,2018,11,0,5,"Braga",7,"Rua Nova Santa Cruz",28,28,0,108,108,0
11,22,2018,11,0,5,"Braga",8,"Rua Costa Gomes",23,40,17,75,43,32
11,22,2018,12,0,5,"Braga",1,"Avenida da Liberdade",20,25,5,33,26,7
11,22,2018,12,0,5,"Braga",2,"Avenida Central",13,18,5,356,257,99
11,22,2018,12,0,5,"Braga",3,"Rua de Caires",24,24,0,4,4,0
11,22,2018,12,0,5,"Braga",4,"N14 Bosch",36,46,10,62,48,14
11,22,2018,12,0,5,"Braga",5,"Avenida João Paulo II",38,38,0,9,9,0
11,22,2018,12,0,5,"Braga",6,"Avenida Padre Júlio Fragata",62,62,0,21,21,0
11,22,2018,12,0,5,"Braga",7,"Rua Nova Santa Cruz",22,29,7,138,104,34
11,22,2018,12,0,5,"Braga",8,"Rua Costa Gomes",32,41,9,54,42,12
11,22,2018,13,0,5,"Braga",6,"Avenida Padre Júlio Fragata",33,62,29,40,21,19
11,22,2018,13,0,5,"Braga",7,"Rua Nova Santa Cruz",21,28,7,144,108,36
11,22,2018,13,0,5,"Braga",8,"Rua Costa Gomes",19,40,21,90,43,47
11,22,2018,13,0,5,"Braga",1,"Avenida da Liberdade",25,25,0,26,26,0
11,22,2018,13,0,5,"Braga",2,"Avenida Central",10,17,7,463,272,191
11,22,2018,13,0,5,"Braga",3,"Rua de Caires",20,25,5,5,4,1
11,22,2018,13,0,5,"Braga",4,"N14 Bosch",25,46,21,89,48,41
11,22,2018,13,0,5,"Braga",5,"Avenida João Paulo II",38,38,0,9,9,0
11,22,2018,13,0,5,"Braga",6,"Avenida Padre Júlio Fragata",33,62,29,40,21,19
11,22,2018,14,0,5,"Braga",1,"Avenida da Liberdade",20,25,5,33,26,7
11,22,2018,14,0,5,"Braga",2,"Avenida Central",17,17,0,272,272,0
11,22,2018,14,0,5,"Braga",3,"Rua de Caires",25,25,0,4,4,0
11,22,2018,14,0,5,"Braga",4,"N14 Bosch",13,46,33,172,48,124
11,22,2018,14,0,5,"Braga",5,"Avenida João Paulo II",38,38,0,9,9,0
11,22,2018,14,0,5,"Braga",6,"Avenida Padre Júlio Fragata",32,61,29,41,21,20
11,22,2018,14,0,5,"Braga",7,"Rua Nova Santa Cruz",22,29,7,138,104,34
11,22,2018,14,0,5,"Braga",8,"Rua Costa Gomes",26,40,14,66,43,23
11,22,2018,15,0,5,"Braga",1,"Avenida da Liberdade",25,25,0,26,26,0
11,22,2018,15,0,5,"Braga",2,"Avenida Central",17,17,0,272,272,0
11,22,2018,15,0,5,"Braga",3,"Rua de Caires",18,24,6,5,4,1
11,22,2018,15,0,5,"Braga",4,"N14 Bosch",22,46,24,102,48,54
11,22,2018,15,0,5,"Braga",5,"Avenida João Paulo II",31,39,8,11,8,3
11,22,2018,15,0,5,"Braga",6,"Avenida Padre Júlio Fragata",40,61,21,33,21,12
11,22,2018,15,0,5,"Braga",7,"Rua Nova Santa Cruz",21,29,8,144,104,40
11,22,2018,15,0,5,"Braga",8,"Rua Costa Gomes",26,40,14,66,43,23
11,22,2018,16,0,5,"Braga",4,"N14 Bosch",34,46,12,66,48,18
11,22,2018,16,0,5,"Braga",5,"Avenida João Paulo II",27,39,12,12,8,4
11,22,2018,16,0,5,"Braga",6,"Avenida Padre Júlio Fragata",61,61,0,21,21,0
11,22,2018,16,0,5,"Braga",7,"Rua Nova Santa Cruz",19,29,10,160,104,56
11,22,2018,16,0,5,"Braga",8,"Rua Costa Gomes",18,40,22,96,43,53
11,22,2018,16,0,5,"Braga",1,"Avenida da Liberdade",20,25,5,33,26,7
11,22,2018,16,0,5,"Braga",2,"Avenida Central",13,18,5,356,257,99
11,22,2018,16,0,5,"Braga",3,"Rua de Caires",24,24,0,4,4,0
11,22,2018,16,0,5,"Braga",4,"N14 Bosch",34,46,12,66,48,18
11,22,2018,17,0,5,"Braga",1,"Avenida da Liberdade",19,25,6,34,26,8
11,22,2018,17,0,5,"Braga",2,"Avenida Central",13,17,4,356,272,84
11,22,2018,17,0,5,"Braga",3,"Rua de Caires",24,24,0,4,4,0
11,22,2018,17,0,5,"Braga",4,"N14 Bosch",24,48,24,93,46,47
11,22,2018,17,0,5,"Braga",5,"Avenida João Paulo II",38,38,0,9,9,0
11,22,2018,17,0,5,"Braga",6,"Avenida Padre Júlio Fragata",32,62,30,41,21,20
11,22,2018,17,0,5,"Braga",7,"Rua Nova Santa Cruz",19,29,10,160,104,56
11,22,2018,17,0,5,"Braga",8,"Rua Costa Gomes",26,41,15,66,42,24
11,22,2018,18,0,5,"Braga",1,"Avenida da Liberdade",18,24,6,36,27,9
11,22,2018,18,0,5,"Braga",2,"Avenida Central",6,18,12,772,257,515
11,22,2018,18,0,5,"Braga",3,"Rua de Caires",4,23,19,26,4,22
11,22,2018,18,0,5,"Braga",4,"N14 Bosch",10,45,35,224,49,175
11,22,2018,18,0,5,"Braga",5,"Avenida João Paulo II",10,39,29,34,8,26
11,22,2018,18,0,5,"Braga",6,"Avenida Padre Júlio Fragata",18,62,44,73,21,52
11,22,2018,18,0,5,"Braga",7,"Rua Nova Santa Cruz",10,28,18,304,108,196
11,22,2018,18,0,5,"Braga",8,"Rua Costa Gomes",19,42,23,90,41,49
11,22,2018,19,0,5,"Braga",1,"Avenida da Liberdade",19,24,5,34,27,7
11,22,2018,19,0,5,"Braga",2,"Avenida Central",5,17,12,927,272,655
11,22,2018,19,0,5,"Braga",3,"Rua de Caires",20,25,5,5,4,1
11,22,2018,19,0,5,"Braga",4,"N14 Bosch",25,46,21,89,48,41
11,22,2018,19,0,5,"Braga",5,"Avenida João Paulo II",14,39,25,24,8,16
11,22,2018,19,0,5,"Braga",6,"Avenida Padre Júlio Fragata",19,61,42,70,21,49
11,22,2018,19,0,5,"Braga",7,"Rua Nova Santa Cruz",5,28,23,608,108,500
11,22,2018,19,0,5,"Braga",8,"Rua Costa Gomes",17,41,24,101,42,59
11,22,2018,20,0,5,"Braga",1,"Avenida da Liberdade",25,25,0,26,26,0
11,22,2018,20,0,5,"Braga",2,"Avenida Central",8,18,10,579,257,322
11,22,2018,20,0,5,"Braga",3,"Rua de Caires",19,25,6,5,4,1
11,22,2018,20,0,5,"Braga",4,"N14 Bosch",46,46,0,48,48,0
11,22,2018,20,0,5,"Braga",5,"Avenida João Paulo II",39,39,0,8,8,0
11,22,2018,20,0,5,"Braga",6,"Avenida Padre Júlio Fragata",49,62,13,27,21,6
11,22,2018,20,0,5,"Braga",7,"Rua Nova Santa Cruz",13,29,16,234,104,130
11,22,2018,20,0,5,"Braga",8,"Rua Costa Gomes",40,40,0,43,43,0
11,22,2018,21,0,5,"Braga",1,"Avenida da Liberdade",25,25,0,26,26,0
11,22,2018,21,0,5,"Braga",2,"Avenida Central",17,17,0,272,272,0
11,22,2018,21,0,5,"Braga",3,"Rua de Caires",25,25,0,4,4,0
11,22,2018,21,0,5,"Braga",4,"N14 Bosch",47,47,0,47,47,0
11,22,2018,21,0,5,"Braga",5,"Avenida João Paulo II",39,39,0,8,8,0
11,22,2018,21,0,5,"Braga",6,"Avenida Padre Júlio Fragata",62,62,0,21,21,0
11,22,2018,21,0,5,"Braga",7,"Rua Nova Santa Cruz",29,29,0,104,104,0
11,22,2018,21,0,5,"Braga",8,"Rua Costa Gomes",40,40,0,43,43,0
11,22,2018,22,0,5,"Braga",1,"Avenida da Liberdade",25,25,0,26,26,0
11,22,2018,22,0,5,"Braga",2,"Avenida Central",17,17,0,272,272,0
11,22,2018,22,0,5,"Braga",3,"Rua de Caires",25,25,0,4,4,0
11,22,2018,22,0,5,"Braga",4,"N14 Bosch",47,47,0,47,47,0
11,22,2018,22,0,5,"Braga",5,"Avenida João Paulo II",39,39,0,8,8,0
11,22,2018,22,0,5,"Braga",6,"Avenida Padre Júlio Fragata",46,61,15,28,21,7
11,22,2018,22,0,5,"Braga",7,"Rua Nova Santa Cruz",29,29,0,104,104,0
11,22,2018,22,0,5,"Braga",8,"Rua Costa Gomes",40,40,0,43,43,0
11,22,2018,23,0,5,"Braga",1,"Avenida da Liberdade",25,25,0,26,26,0
11,22,2018,23,0,5,"Braga",2,"Avenida Central",17,17,0,272,272,0
11,22,2018,23,0,5,"Braga",3,"Rua de Caires",27,27,0,3,3,0
11,22,2018,23,0,5,"Braga",4,"N14 Bosch",47,47,0,47,47,0
11,22,2018,23,0,5,"Braga",5,"Avenida João Paulo II",39,39,0,8,8,0
11,22,2018,23,0,5,"Braga",6,"Avenida Padre Júlio Fragata",48,61,13,27,21,6
11,22,2018,23,0,5,"Braga",7,"Rua Nova Santa Cruz",29,29,0,104,104,0
11,22,2018,23,0,5,"Braga",8,"Rua Costa Gomes",40,40,0,43,43,0
11,23,2018,0,0,6,"Braga",1,"Avenida da Liberdade",25,25,0,26,26,0
11,23,2018,0,0,6,"Braga",2,"Avenida Central",17,17,0,272,272,0
11,23,2018,0,0,6,"Braga",3,"Rua de Caires",27,27,0,3,3,0
11,23,2018,0,0,6,"Braga",4,"N14 Bosch",47,47,0,47,47,0
11,23,2018,0,0,6,"Braga",5,"Avenida João Paulo II",39,39,0,8,8,0
11,23,2018,0,0,6,"Braga",6,"Avenida Padre Júlio Fragata",61,61,0,21,21,0
11,23,2018,0,0,6,"Braga",7,"Rua Nova Santa Cruz",29,29,0,104,104,0
11,23,2018,0,0,6,"Braga",8,"Rua Costa Gomes",40,40,0,43,43,0
11,23,2018,1,0,6,"Braga",1,"Avenida da Liberdade",25,25,0,26,26,0
11,23,2018,1,0,6,"Braga",2,"Avenida Central",17,17,0,272,272,0
11,23,2018,1,0,6,"Braga",3,"Rua de Caires",27,27,0,3,3,0
11,23,2018,1,0,6,"Braga",4,"N14 Bosch",47,47,0,47,47,0
11,23,2018,1,0,6,"Braga",5,"Avenida João Paulo II",39,39,0,8,8,0
11,23,2018,1,0,6,"Braga",6,"Avenida Padre Júlio Fragata",61,61,0,21,21,0
11,23,2018,1,0,6,"Braga",7,"Rua Nova Santa Cruz",29,29,0,104,104,0
11,23,2018,1,0,6,"Braga",8,"Rua Costa Gomes",40,40,0,43,43,0
11,23,2018,2,0,6,"Braga",1,"Avenida da Liberdade",25,25,0,26,26,0
11,23,2018,2,0,6,"Braga",2,"Avenida Central",17,17,0,272,272,0
11,23,2018,2,0,6,"Braga",3,"Rua de Caires",27,27,0,3,3,0
11,23,2018,2,0,6,"Braga",4,"N14 Bosch",47,47,0,47,47,0
11,23,2018,2,0,6,"Braga",5,"Avenida João Paulo II",39,39,0,8,8,0
11,23,2018,2,0,6,"Braga",6,"Avenida Padre Júlio Fragata",61,61,0,21,21,0
11,23,2018,2,0,6,"Braga",7,"Rua Nova Santa Cruz",29,29,0,104,104,0
11,23,2018,2,0,6,"Braga",8,"Rua Costa Gomes",40,40,0,43,43,0
11,23,2018,3,0,6,"Braga",1,"Avenida da Liberdade",25,25,0,26,26,0
11,23,2018,3,0,6,"Braga",2,"Avenida Central",17,17,0,272,272,0
11,23,2018,3,0,6,"Braga",3,"Rua de Caires",27,27,0,3,3,0
11,23,2018,3,0,6,"Braga",4,"N14 Bosch",47,47,0,47,47,0
11,23,2018,3,0,6,"Braga",5,"Avenida João Paulo II",39,39,0,8,8,0
11,23,2018,3,0,6,"Braga",6,"Avenida Padre Júlio Fragata",61,61,0,21,21,0
11,23,2018,3,0,6,"Braga",7,"Rua Nova Santa Cruz",29,29,0,104,104,0
11,23,2018,3,0,6,"Braga",8,"Rua Costa Gomes",40,40,0,43,43,0
11,23,2018,4,0,6,"Braga",1,"Avenida da Liberdade",25,25,0,26,26,0
11,23,2018,4,0,6,"Braga",2,"Avenida Central",17,17,0,272,272,0
11,23,2018,4,0,6,"Braga",3,"Rua de Caires",27,27,0,3,3,0
11,23,2018,4,0,6,"Braga",4,"N14 Bosch",47,47,0,47,47,0
11,23,2018,4,0,6,"Braga",5,"Avenida João Paulo II",39,39,0,8,8,0
11,23,2018,4,0,6,"Braga",6,"Avenida Padre Júlio Fragata",61,61,0,21,21,0
11,23,2018,4,0,6,"Braga",7,"Rua Nova Santa Cruz",29,29,0,104,104,0
11,23,2018,4,0,6,"Braga",8,"Rua Costa Gomes",40,40,0,43,43,0
11,23,2018,5,0,6,"Braga",1,"Avenida da Liberdade",25,25,0,26,26,0
11,23,2018,5,0,6,"Braga",2,"Avenida Central",17,17,0,272,272,0
11,23,2018,5,0,6,"Braga",3,"Rua de Caires",27,27,0,3,3,0
11,23,2018,5,0,6,"Braga",4,"N14 Bosch",47,47,0,47,47,0
11,23,2018,5,0,6,"Braga",5,"Avenida João Paulo II",39,39,0,8,8,0
11,23,2018,5,0,6,"Braga",6,"Avenida Padre Júlio Fragata",61,61,0,21,21,0
11,23,2018,5,0,6,"Braga",7,"Rua Nova Santa Cruz",29,29,0,104,104,0
11,23,2018,5,0,6,"Braga",8,"Rua Costa Gomes",40,40,0,43,43,0
11,23,2018,6,0,6,"Braga",1,"Avenida da Liberdade",25,25,0,26,26,0
11,23,2018,6,0,6,"Braga",2,"Avenida Central",17,17,0,272,272,0
11,23,2018,6,0,6,"Braga",3,"Rua de Caires",27,27,0,3,3,0
11,23,2018,6,0,6,"Braga",4,"N14 Bosch",47,47,0,47,47,0
11,23,2018,6,0,6,"Braga",5,"Avenida João Paulo II",39,39,0,8,8,0
11,23,2018,6,0,6,"Braga",6,"Avenida Padre Júlio Fragata",61,61,0,21,21,0
11,23,2018,6,0,6,"Braga",7,"Rua Nova Santa Cruz",29,29,0,104,104,0
11,23,2018,6,0,6,"Braga",8,"Rua Costa Gomes",40,40,0,43,43,0
11,23,2018,7,0,6,"Braga",1,"Avenida da Liberdade",25,25,0,26,26,0
11,23,2018,7,0,6,"Braga",2,"Avenida Central",17,17,0,272,272,0
11,23,2018,7,0,6,"Braga",3,"Rua de Caires",27,27,0,3,3,0
11,23,2018,7,0,6,"Braga",4,"N14 Bosch",47,47,0,47,47,0
11,23,2018,7,0,6,"Braga",5,"Avenida João Paulo II",39,39,0,8,8,0
11,23,2018,7,0,6,"Braga",6,"Avenida Padre Júlio Fragata",61,61,0,21,21,0
11,23,2018,7,0,6,"Braga",7,"Rua Nova Santa Cruz",29,29,0,104,104,0
11,23,2018,7,0,6,"Braga",8,"Rua Costa Gomes",40,40,0,43,43,0
11,23,2018,8,0,6,"Braga",1,"Avenida da Liberdade",25,25,0,26,26,0
11,23,2018,8,0,6,"Braga",2,"Avenida Central",17,17,0,272,272,0
11,23,2018,8,0,6,"Braga",3,"Rua de Caires",4,27,23,26,3,23
11,23,2018,8,0,6,"Braga",4,"N14 Bosch",20,46,26,112,48,64
11,23,2018,8,0,6,"Braga",5,"Avenida João Paulo II",39,39,0,8,8,0
11,23,2018,8,0,6,"Braga",6,"Avenida Padre Júlio Fragata",61,61,0,21,21,0
11,23,2018,8,0,6,"Braga",7,"Rua Nova Santa Cruz",29,29,0,104,104,0
11,23,2018,8,0,6,"Braga",8,"Rua Costa Gomes",31,40,9,55,43,12
11,23,2018,9,0,6,"Braga",1,"Avenida da Liberdade",25,25,0,26,26,0
11,23,2018,9,0,6,"Braga",2,"Avenida Central",6,18,12,772,257,515
11,23,2018,9,0,6,"Braga",3,"Rua de Caires",27,27,0,3,3,0
11,23,2018,9,0,6,"Braga",4,"N14 Bosch",30,47,17,74,47,27
11,23,2018,9,0,6,"Braga",5,"Avenida João Paulo II",24,38,14,14,9,5
11,23,2018,9,0,6,"Braga",6,"Avenida Padre Júlio Fragata",48,62,14,27,21,6
11,23,2018,9,0,6,"Braga",7,"Rua Nova Santa Cruz",29,29,0,104,104,0
11,23,2018,9,0,6,"Braga",8,"Rua Costa Gomes",41,41,0,42,42,0
11,23,2018,10,0,6,"Braga",1,"Avenida da Liberdade",18,25,7,36,26,10
11,23,2018,10,0,6,"Braga",2,"Avenida Central",12,17,5,386,272,114
11,23,2018,10,0,6,"Braga",3,"Rua de Caires",27,27,0,3,3,0
11,23,2018,10,0,6,"Braga",4,"N14 Bosch",35,47,12,64,47,17
11,23,2018,10,0,6,"Braga",5,"Avenida João Paulo II",39,39,0,8,8,0
11,23,2018,10,0,6,"Braga",6,"Avenida Padre Júlio Fragata",44,62,18,30,21,9
11,23,2018,10,0,6,"Braga",7,"Rua Nova Santa Cruz",5,28,23,608,108,500
11,23,2018,10,0,6,"Braga",8,"Rua Costa Gomes",30,41,11,57,42,15
11,23,2018,11,0,6,"Braga",1,"Avenida da Liberdade",20,25,5,33,26,7
11,23,2018,11,0,6,"Braga",2,"Avenida Central",10,17,7,463,272,191
11,23,2018,11,0,6,"Braga",3,"Rua de Caires",25,25,0,4,4,0
11,23,2018,11,0,6,"Braga",4,"N14 Bosch",27,47,20,83,47,36
11,23,2018,11,0,6,"Braga",5,"Avenida João Paulo II",40,40,0,8,8,0
11,23,2018,11,0,6,"Braga",6,"Avenida Padre Júlio Fragata",37,62,25,35,21,14
11,23,2018,11,0,6,"Braga",7,"Rua Nova Santa Cruz",19,29,10,160,104,56
11,23,2018,11,0,6,"Braga",8,"Rua Costa Gomes",41,41,0,42,42,0
11,23,2018,12,0,6,"Braga",1,"Avenida da Liberdade",20,25,5,33,26,7
11,23,2018,12,0,6,"Braga",2,"Avenida Central",13,17,4,356,272,84
11,23,2018,12,0,6,"Braga",3,"Rua de Caires",25,25,0,4,4,0
11,23,2018,12,0,6,"Braga",4,"N14 Bosch",36,47,11,62,47,15
11,23,2018,12,0,6,"Braga",5,"Avenida João Paulo II",30,39,9,11,8,3
11,23,2018,12,0,6,"Braga",6,"Avenida Padre Júlio Fragata",36,61,25,36,21,15
11,23,2018,12,0,6,"Braga",7,"Rua Nova Santa Cruz",21,28,7,144,108,36
11,23,2018,12,0,6,"Braga",8,"Rua Costa Gomes",41,41,0,42,42,0
11,23,2018,13,0,6,"Braga",1,"Avenida da Liberdade",25,25,0,26,26,0
11,23,2018,13,0,6,"Braga",2,"Avenida Central",10,17,7,463,272,191
11,23,2018,13,0,6,"Braga",3,"Rua de Caires",25,25,0,4,4,0
11,23,2018,13,0,6,"Braga",4,"N14 Bosch",34,47,13,66,47,19
11,23,2018,13,0,6,"Braga",5,"Avenida João Paulo II",26,39,13,13,8,5
11,23,2018,13,0,6,"Braga",6,"Avenida Padre Júlio Fragata",25,63,38,53,21,32
11,23,2018,13,0,6,"Braga",7,"Rua Nova Santa Cruz",4,28,24,760,108,652
11,23,2018,13,0,6,"Braga",8,"Rua Costa Gomes",29,41,12,59,42,17
11,23,2018,14,0,6,"Braga",1,"Avenida da Liberdade",19,25,6,34,26,8
11,23,2018,14,0,6,"Braga",2,"Avenida Central",17,17,0,272,272,0
11,23,2018,14,0,6,"Braga",3,"Rua de Caires",25,25,0,4,4,0
11,23,2018,14,0,6,"Braga",4,"N14 Bosch",19,47,28,118,47,71
11,23,2018,14,0,6,"Braga",5,"Avenida João Paulo II",10,38,28,34,9,25
11,23,2018,14,0,6,"Braga",6,"Avenida Padre Júlio Fragata",33,62,29,40,21,19
11,23,2018,14,0,6,"Braga",7,"Rua Nova Santa Cruz",11,30,19,276,101,175
11,23,2018,14,0,6,"Braga",8,"Rua Costa Gomes",30,41,11,57,42,15
11,23,2018,15,0,6,"Braga",1,"Avenida da Liberdade",17,25,8,39,26,13
11,23,2018,15,0,6,"Braga",2,"Avenida Central",11,17,6,421,272,149
11,23,2018,15,0,6,"Braga",3,"Rua de Caires",25,25,0,4,4,0
11,23,2018,15,0,6,"Braga",4,"N14 Bosch",26,47,21,86,47,39
11,23,2018,15,0,6,"Braga",5,"Avenida João Paulo II",6,37,31,58,9,49
11,23,2018,15,0,6,"Braga",6,"Avenida Padre Júlio Fragata",32,61,29,41,21,20
11,23,2018,15,0,6,"Braga",7,"Rua Nova Santa Cruz",18,29,11,169,104,65
11,23,2018,15,0,6,"Braga",8,"Rua Costa Gomes",24,41,17,72,42,30
11,23,2018,16,0,6,"Braga",1,"Avenida da Liberdade",19,24,5,34,27,7
11,23,2018,16,0,6,"Braga",2,"Avenida Central",9,17,8,515,272,243
11,23,2018,16,0,6,"Braga",3,"Rua de Caires",25,25,0,4,4,0
11,23,2018,16,0,6,"Braga",4,"N14 Bosch",29,46,17,77,48,29
11,23,2018,16,0,6,"Braga",5,"Avenida João Paulo II",22,38,16,15,9,6
11,23,2018,16,0,6,"Braga",6,"Avenida Padre Júlio Fragata",36,61,25,36,21,15
11,23,2018,16,0,6,"Braga",7,"Rua Nova Santa Cruz",10,28,18,304,108,196
11,23,2018,16,0,6,"Braga",8,"Rua Costa Gomes",28,40,12,61,43,18
11,23,2018,17,0,6,"Braga",1,"Avenida da Liberdade",20,25,5,33,26,7
11,23,2018,17,0,6,"Braga",2,"Avenida Central",11,18,7,421,257,164
11,23,2018,17,0,6,"Braga",3,"Rua de Caires",16,24,8,6,4,2
11,23,2018,17,0,6,"Braga",4,"N14 Bosch",16,46,30,140,48,92
11,23,2018,17,0,6,"Braga",5,"Avenida João Paulo II",12,38,26,29,9,20
11,23,2018,17,0,6,"Braga",6,"Avenida Padre Júlio Fragata",16,62,46,83,21,62
11,23,2018,17,0,6,"Braga",7,"Rua Nova Santa Cruz",10,30,20,304,101,203
11,23,2018,17,0,6,"Braga",8,"Rua Costa Gomes",26,41,15,66,42,24
11,23,2018,18,0,6,"Braga",1,"Avenida da Liberdade",19,24,5,34,27,7
11,23,2018,18,0,6,"Braga",2,"Avenida Central",7,17,10,662,272,390
11,23,2018,18,0,6,"Braga",3,"Rua de Caires",5,25,20,20,4,16
11,23,2018,18,0,6,"Braga",4,"N14 Bosch",31,46,15,72,48,24
11,23,2018,18,0,6,"Braga",5,"Avenida João Paulo II",7,40,33,49,8,41
11,23,2018,18,0,6,"Braga",6,"Avenida Padre Júlio Fragata",19,62,43,70,21,49
11,23,2018,18,0,6,"Braga",7,"Rua Nova Santa Cruz",3,29,26,1014,104,910
11,23,2018,18,0,6,"Braga",8,"Rua Costa Gomes",11,42,31,157,41,116
11,23,2018,19,0,6,"Braga",1,"Avenida da Liberdade",15,25,10,44,26,18
11,23,2018,19,0,6,"Braga",2,"Avenida Central",6,16,10,772,289,483
11,23,2018,19,0,6,"Braga",3,"Rua de Caires",7,23,16,14,4,10
11,23,2018,19,0,6,"Braga",4,"N14 Bosch",19,47,28,118,47,71
11,23,2018,19,0,6,"Braga",5,"Avenida João Paulo II",11,39,28,31,8,23
11,23,2018,19,0,6,"Braga",6,"Avenida Padre Júlio Fragata",18,63,45,73,21,52
11,23,2018,19,0,6,"Braga",7,"Rua Nova Santa Cruz",6,31,25,507,98,409
11,23,2018,19,0,6,"Braga",8,"Rua Costa Gomes",15,41,26,115,42,73
11,23,2018,20,0,6,"Braga",1,"Avenida da Liberdade",18,24,6,36,27,9
11,23,2018,20,0,6,"Braga",2,"Avenida Central",9,18,9,515,257,258
11,23,2018,20,0,6,"Braga",3,"Rua de Caires",10,24,14,10,4,6
11,23,2018,20,0,6,"Braga",4,"N14 Bosch",47,47,0,47,47,0
11,23,2018,20,0,6,"Braga",5,"Avenida João Paulo II",7,40,33,49,8,41
11,23,2018,20,0,6,"Braga",6,"Avenida Padre Júlio Fragata",35,62,27,38,21,17
11,23,2018,20,0,6,"Braga",7,"Rua Nova Santa Cruz",9,28,19,338,108,230
11,23,2018,20,0,6,"Braga",8,"Rua Costa Gomes",27,40,13,64,43,21
11,23,2018,21,0,6,"Braga",1,"Avenida da Liberdade",25,25,0,26,26,0
11,23,2018,21,0,6,"Braga",2,"Avenida Central",17,17,0,272,272,0
11,23,2018,21,0,6,"Braga",3,"Rua de Caires",13,25,12,8,4,4
11,23,2018,21,0,6,"Braga",4,"N14 Bosch",47,47,0,47,47,0
11,23,2018,21,0,6,"Braga",5,"Avenida João Paulo II",31,39,8,11,8,3
11,23,2018,21,0,6,"Braga",6,"Avenida Padre Júlio Fragata",40,62,22,33,21,12
11,23,2018,21,0,6,"Braga",7,"Rua Nova Santa Cruz",28,28,0,108,108,0
11,23,2018,21,0,6,"Braga",8,"Rua Costa Gomes",40,40,0,43,43,0
11,23,2018,22,0,6,"Braga",1,"Avenida da Liberdade",25,25,0,26,26,0
11,23,2018,22,0,6,"Braga",2,"Avenida Central",17,17,0,272,272,0
11,23,2018,22,0,6,"Braga",3,"Rua de Caires",13,25,12,8,4,4
11,23,2018,22,0,6,"Braga",4,"N14 Bosch",47,47,0,47,47,0
11,23,2018,22,0,6,"Braga",5,"Avenida João Paulo II",38,38,0,9,9,0
11,23,2018,22,0,6,"Braga",6,"Avenida Padre Júlio Fragata",62,62,0,21,21,0
11,23,2018,22,0,6,"Braga",7,"Rua Nova Santa Cruz",13,28,15,234,108,126
11,23,2018,22,0,6,"Braga",8,"Rua Costa Gomes",40,40,0,43,43,0
11,23,2018,23,0,6,"Braga",1,"Avenida da Liberdade",25,25,0,26,26,0
11,23,2018,23,0,6,"Braga",2,"Avenida Central",17,17,0,272,272,0
11,23,2018,23,0,6,"Braga",3,"Rua de Caires",25,25,0,4,4,0
11,23,2018,23,0,6,"Braga",4,"N14 Bosch",47,47,0,47,47,0
11,23,2018,23,0,6,"Braga",5,"Avenida João Paulo II",38,38,0,9,9,0
11,23,2018,23,0,6,"Braga",6,"Avenida Padre Júlio Fragata",49,62,13,27,21,6
11,23,2018,23,0,6,"Braga",7,"Rua Nova Santa Cruz",29,29,0,104,104,0
11,23,2018,23,0,6,"Braga",8,"Rua Costa Gomes",40,40,0,43,43,0
11,24,2018,0,0,7,"Braga",1,"Avenida da Liberdade",25,25,0,26,26,0
11,24,2018,0,0,7,"Braga",2,"Avenida Central",17,17,0,272,272,0
11,24,2018,0,0,7,"Braga",3,"Rua de Caires",25,25,0,4,4,0
11,24,2018,0,0,7,"Braga",4,"N14 Bosch",47,47,0,47,47,0
11,24,2018,0,0,7,"Braga",5,"Avenida João Paulo II",39,39,0,8,8,0
11,24,2018,0,0,7,"Braga",6,"Avenida Padre Júlio Fragata",39,62,23,34,21,13
11,24,2018,0,0,7,"Braga",7,"Rua Nova Santa Cruz",29,29,0,104,104,0
11,24,2018,0,0,7,"Braga",8,"Rua Costa Gomes",40,40,0,43,43,0
11,24,2018,1,0,7,"Braga",1,"Avenida da Liberdade",25,25,0,26,26,0
11,24,2018,1,0,7,"Braga",2,"Avenida Central",17,17,0,272,272,0
11,24,2018,1,0,7,"Braga",3,"Rua de Caires",25,25,0,4,4,0
11,24,2018,1,0,7,"Braga",4,"N14 Bosch",47,47,0,47,47,0
11,24,2018,1,0,7,"Braga",5,"Avenida João Paulo II",39,39,0,8,8,0
11,24,2018,1,0,7,"Braga",6,"Avenida Padre Júlio Fragata",62,62,0,21,21,0
11,24,2018,1,0,7,"Braga",7,"Rua Nova Santa Cruz",29,29,0,104,104,0
11,24,2018,1,0,7,"Braga",8,"Rua Costa Gomes",40,40,0,43,43,0
11,24,2018,2,0,7,"Braga",1,"Avenida da Liberdade",25,25,0,26,26,0
11,24,2018,2,0,7,"Braga",2,"Avenida Central",17,17,0,272,272,0
11,24,2018,2,0,7,"Braga",3,"Rua de Caires",25,25,0,4,4,0
11,24,2018,2,0,7,"Braga",4,"N14 Bosch",47,47,0,47,47,0
11,24,2018,2,0,7,"Braga",5,"Avenida João Paulo II",39,39,0,8,8,0
11,24,2018,2,0,7,"Braga",6,"Avenida Padre Júlio Fragata",62,62,0,21,21,0
11,24,2018,2,0,7,"Braga",7,"Rua Nova Santa Cruz",29,29,0,104,104,0
11,24,2018,2,0,7,"Braga",8,"Rua Costa Gomes",40,40,0,43,43,0
11,24,2018,3,0,7,"Braga",1,"Avenida da Liberdade",25,25,0,26,26,0
11,24,2018,3,0,7,"Braga",2,"Avenida Central",17,17,0,272,272,0
11,24,2018,3,0,7,"Braga",3,"Rua de Caires",25,25,0,4,4,0
11,24,2018,3,0,7,"Braga",4,"N14 Bosch",47,47,0,47,47,0
11,24,2018,3,0,7,"Braga",5,"Avenida João Paulo II",39,39,0,8,8,0
11,24,2018,3,0,7,"Braga",6,"Avenida Padre Júlio Fragata",62,62,0,21,21,0
11,24,2018,3,0,7,"Braga",7,"Rua Nova Santa Cruz",29,29,0,104,104,0
11,24,2018,3,0,7,"Braga",8,"Rua Costa Gomes",40,40,0,43,43,0
11,24,2018,4,0,7,"Braga",1,"Avenida da Liberdade",25,25,0,26,26,0
11,24,2018,4,0,7,"Braga",2,"Avenida Central",17,17,0,272,272,0
11,24,2018,4,0,7,"Braga",3,"Rua de Caires",25,25,0,4,4,0
11,24,2018,4,0,7,"Braga",4,"N14 Bosch",47,47,0,47,47,0
11,24,2018,4,0,7,"Braga",5,"Avenida João Paulo II",39,39,0,8,8,0
11,24,2018,4,0,7,"Braga",6,"Avenida Padre Júlio Fragata",62,62,0,21,21,0
11,24,2018,4,0,7,"Braga",7,"Rua Nova Santa Cruz",29,29,0,104,104,0
11,24,2018,4,0,7,"Braga",8,"Rua Costa Gomes",40,40,0,43,43,0
11,24,2018,5,0,7,"Braga",1,"Avenida da Liberdade",25,25,0,26,26,0
11,24,2018,5,0,7,"Braga",2,"Avenida Central",17,17,0,272,272,0
11,24,2018,5,0,7,"Braga",3,"Rua de Caires",25,25,0,4,4,0
11,24,2018,5,0,7,"Braga",4,"N14 Bosch",47,47,0,47,47,0
11,24,2018,5,0,7,"Braga",5,"Avenida João Paulo II",39,39,0,8,8,0
11,24,2018,5,0,7,"Braga",6,"Avenida Padre Júlio Fragata",62,62,0,21,21,0
11,24,2018,5,0,7,"Braga",7,"Rua Nova Santa Cruz",29,29,0,104,104,0
11,24,2018,5,0,7,"Braga",8,"Rua Costa Gomes",40,40,0,43,43,0
11,24,2018,6,0,7,"Braga",1,"Avenida da Liberdade",25,25,0,26,26,0
11,24,2018,6,0,7,"Braga",2,"Avenida Central",17,17,0,272,272,0
11,24,2018,6,0,7,"Braga",3,"Rua de Caires",25,25,0,4,4,0
11,24,2018,6,0,7,"Braga",4,"N14 Bosch",47,47,0,47,47,0
11,24,2018,6,0,7,"Braga",5,"Avenida João Paulo II",39,39,0,8,8,0
11,24,2018,6,0,7,"Braga",6,"Avenida Padre Júlio Fragata",62,62,0,21,21,0
11,24,2018,6,0,7,"Braga",7,"Rua Nova Santa Cruz",29,29,0,104,104,0
11,24,2018,6,0,7,"Braga",8,"Rua Costa Gomes",40,40,0,43,43,0
11,24,2018,7,0,7,"Braga",1,"Avenida da Liberdade",25,25,0,26,26,0
11,24,2018,7,0,7,"Braga",2,"Avenida Central",17,17,0,272,272,0
11,24,2018,7,0,7,"Braga",3,"Rua de Caires",25,25,0,4,4,0
11,24,2018,7,0,7,"Braga",4,"N14 Bosch",47,47,0,47,47,0
11,24,2018,7,0,7,"Braga",5,"Avenida João Paulo II",39,39,0,8,8,0
11,24,2018,7,0,7,"Braga",6,"Avenida Padre Júlio Fragata",62,62,0,21,21,0
11,24,2018,7,0,7,"Braga",7,"Rua Nova Santa Cruz",29,29,0,104,104,0
11,24,2018,7,0,7,"Braga",8,"Rua Costa Gomes",40,40,0,43,43,0
11,24,2018,8,0,7,"Braga",1,"Avenida da Liberdade",25,25,0,26,26,0
11,24,2018,8,0,7,"Braga",2,"Avenida Central",17,17,0,272,272,0
11,24,2018,8,0,7,"Braga",3,"Rua de Caires",25,25,0,4,4,0
11,24,2018,8,0,7,"Braga",4,"N14 Bosch",47,47,0,47,47,0
11,24,2018,8,0,7,"Braga",5,"Avenida João Paulo II",39,39,0,8,8,0
11,24,2018,8,0,7,"Braga",6,"Avenida Padre Júlio Fragata",62,62,0,21,21,0
11,24,2018,8,0,7,"Braga",7,"Rua Nova Santa Cruz",29,29,0,104,104,0
11,24,2018,8,0,7,"Braga",8,"Rua Costa Gomes",40,40,0,43,43,0
11,24,2018,9,0,7,"Braga",1,"Avenida da Liberdade",25,25,0,26,26,0
11,24,2018,9,0,7,"Braga",2,"Avenida Central",18,18,0,257,257,0
11,24,2018,9,0,7,"Braga",3,"Rua de Caires",25,25,0,4,4,0
11,24,2018,9,0,7,"Braga",4,"N14 Bosch",47,47,0,47,47,0
11,24,2018,9,0,7,"Braga",5,"Avenida João Paulo II",39,39,0,8,8,0
11,24,2018,9,0,7,"Braga",6,"Avenida Padre Júlio Fragata",62,62,0,21,21,0
11,24,2018,9,0,7,"Braga",7,"Rua Nova Santa Cruz",29,29,0,104,104,0
11,24,2018,9,0,7,"Braga",8,"Rua Costa Gomes",40,40,0,43,43,0
11,24,2018,10,0,7,"Braga",1,"Avenida da Liberdade",25,25,0,26,26,0
11,24,2018,10,0,7,"Braga",2,"Avenida Central",18,18,0,257,257,0
11,24,2018,10,0,7,"Braga",3,"Rua de Caires",25,25,0,4,4,0
11,24,2018,10,0,7,"Braga",4,"N14 Bosch",36,46,10,62,48,14
11,24,2018,10,0,7,"Braga",5,"Avenida João Paulo II",39,39,0,8,8,0
11,24,2018,10,0,7,"Braga",6,"Avenida Padre Júlio Fragata",62,62,0,21,21,0
11,24,2018,10,0,7,"Braga",7,"Rua Nova Santa Cruz",29,29,0,104,104,0
11,24,2018,10,0,7,"Braga",8,"Rua Costa Gomes",41,41,0,42,42,0
11,24,2018,11,0,7,"Braga",1,"Avenida da Liberdade",25,25,0,26,26,0
11,24,2018,11,0,7,"Braga",2,"Avenida Central",10,17,7,463,272,191
11,24,2018,11,0,7,"Braga",3,"Rua de Caires",25,25,0,4,4,0
11,24,2018,11,0,7,"Braga",4,"N14 Bosch",46,46,0,48,48,0
11,24,2018,11,0,7,"Braga",5,"Avenida João Paulo II",39,39,0,8,8,0
11,24,2018,11,0,7,"Braga",6,"Avenida Padre Júlio Fragata",49,62,13,27,21,6
11,24,2018,11,0,7,"Braga",7,"Rua Nova Santa Cruz",29,29,0,104,104,0
11,24,2018,11,0,7,"Braga",8,"Rua Costa Gomes",30,40,10,57,43,14
11,24,2018,12,0,7,"Braga",1,"Avenida da Liberdade",25,25,0,26,26,0
11,24,2018,12,0,7,"Braga",2,"Avenida Central",8,17,9,579,272,307
11,24,2018,12,0,7,"Braga",3,"Rua de Caires",3,23,20,34,4,30
11,24,2018,12,0,7,"Braga",4,"N14 Bosch",35,46,11,64,48,16
11,24,2018,12,0,7,"Braga",5,"Avenida João Paulo II",22,39,17,15,8,7
11,24,2018,12,0,7,"Braga",6,"Avenida Padre Júlio Fragata",46,61,15,28,21,7
11,24,2018,12,0,7,"Braga",7,"Rua Nova Santa Cruz",29,29,0,104,104,0
11,24,2018,12,0,7,"Braga",8,"Rua Costa Gomes",29,41,12,59,42,17
11,24,2018,13,0,7,"Braga",1,"Avenida da Liberdade",25,25,0,26,26,0
11,24,2018,13,0,7,"Braga",2,"Avenida Central",13,17,4,356,272,84
11,24,2018,13,0,7,"Braga",3,"Rua de Caires",28,28,0,3,3,0
11,24,2018,13,0,7,"Braga",4,"N14 Bosch",21,46,25,107,48,59
11,24,2018,13,0,7,"Braga",5,"Avenida João Paulo II",39,39,0,8,8,0
11,24,2018,13,0,7,"Braga",6,"Avenida Padre Júlio Fragata",40,61,21,33,21,12
11,24,2018,13,0,7,"Braga",7,"Rua Nova Santa Cruz",29,29,0,104,104,0
11,24,2018,13,0,7,"Braga",8,"Rua Costa Gomes",42,42,0,41,41,0
11,24,2018,14,0,7,"Braga",1,"Avenida da Liberdade",25,25,0,26,26,0
11,24,2018,14,0,7,"Braga",2,"Avenida Central",11,17,6,421,272,149
11,24,2018,14,0,7,"Braga",3,"Rua de Caires",28,28,0,3,3,0
11,24,2018,14,0,7,"Braga",4,"N14 Bosch",46,46,0,48,48,0
11,24,2018,14,0,7,"Braga",5,"Avenida João Paulo II",39,39,0,8,8,0
11,24,2018,14,0,7,"Braga",6,"Avenida Padre Júlio Fragata",47,61,14,28,21,7
11,24,2018,14,0,7,"Braga",7,"Rua Nova Santa Cruz",29,29,0,104,104,0
11,24,2018,14,0,7,"Braga",8,"Rua Costa Gomes",31,40,9,55,43,12
11,24,2018,15,0,7,"Braga",1,"Avenida da Liberdade",25,25,0,26,26,0
11,24,2018,15,0,7,"Braga",2,"Avenida Central",12,18,6,386,257,129
11,24,2018,15,0,7,"Braga",3,"Rua de Caires",14,25,11,7,4,3
11,24,2018,15,0,7,"Braga",4,"N14 Bosch",47,47,0,47,47,0
11,24,2018,15,0,7,"Braga",5,"Avenida João Paulo II",38,38,0,9,9,0
11,24,2018,15,0,7,"Braga",6,"Avenida Padre Júlio Fragata",33,62,29,40,21,19
11,24,2018,15,0,7,"Braga",7,"Rua Nova Santa Cruz",29,29,0,104,104,0
11,24,2018,15,0,7,"Braga",8,"Rua Costa Gomes",41,41,0,42,42,0
11,24,2018,16,0,7,"Braga",1,"Avenida da Liberdade",25,25,0,26,26,0
11,24,2018,16,0,7,"Braga",2,"Avenida Central",14,17,3,331,272,59
11,24,2018,16,0,7,"Braga",3,"Rua de Caires",21,21,0,4,4,0
11,24,2018,16,0,7,"Braga",4,"N14 Bosch",34,47,13,66,47,19
11,24,2018,16,0,7,"Braga",5,"Avenida João Paulo II",26,39,13,13,8,5
11,24,2018,16,0,7,"Braga",6,"Avenida Padre Júlio Fragata",23,62,39,57,21,36
11,24,2018,16,0,7,"Braga",7,"Rua Nova Santa Cruz",29,29,0,104,104,0
11,24,2018,16,0,7,"Braga",8,"Rua Costa Gomes",24,41,17,72,42,30
11,24,2018,17,0,7,"Braga",1,"Avenida da Liberdade",25,25,0,26,26,0
11,24,2018,17,0,7,"Braga",2,"Avenida Central",14,18,4,331,257,74
11,24,2018,17,0,7,"Braga",3,"Rua de Caires",21,21,0,4,4,0
11,24,2018,17,0,7,"Braga",4,"N14 Bosch",47,47,0,47,47,0
11,24,2018,17,0,7,"Braga",5,"Avenida João Paulo II",16,39,23,21,8,13
11,24,2018,17,0,7,"Braga",6,"Avenida Padre Júlio Fragata",32,61,29,41,21,20
11,24,2018,17,0,7,"Braga",7,"Rua Nova Santa Cruz",29,29,0,104,104,0
11,24,2018,17,0,7,"Braga",8,"Rua Costa Gomes",41,41,0,42,42,0
11,24,2018,18,0,7,"Braga",1,"Avenida da Liberdade",25,25,0,26,26,0
11,24,2018,18,0,7,"Braga",2,"Avenida Central",14,17,3,331,272,59
11,24,2018,18,0,7,"Braga",3,"Rua de Caires",1,20,19,104,5,99
11,24,2018,18,0,7,"Braga",4,"N14 Bosch",30,46,16,74,48,26
11,24,2018,18,0,7,"Braga",5,"Avenida João Paulo II",27,39,12,12,8,4
11,24,2018,18,0,7,"Braga",6,"Avenida Padre Júlio Fragata",32,62,30,41,21,20
11,24,2018,18,0,7,"Braga",7,"Rua Nova Santa Cruz",29,29,0,104,104,0
11,24,2018,18,0,7,"Braga",8,"Rua Costa Gomes",41,41,0,42,42,0
11,24,2018,19,0,7,"Braga",1,"Avenida da Liberdade",25,25,0,26,26,0
11,24,2018,19,0,7,"Braga",2,"Avenida Central",17,17,0,272,272,0
11,24,2018,19,0,7,"Braga",3,"Rua de Caires",23,23,0,4,4,0
11,24,2018,19,0,7,"Braga",4,"N14 Bosch",34,46,12,66,48,18
11,24,2018,19,0,7,"Braga",5,"Avenida João Paulo II",13,40,27,26,8,18
11,24,2018,19,0,7,"Braga",6,"Avenida Padre Júlio Fragata",37,61,24,35,21,14
11,24,2018,19,0,7,"Braga",7,"Rua Nova Santa Cruz",29,29,0,104,104,0
11,24,2018,19,0,7,"Braga",8,"Rua Costa Gomes",26,40,14,66,43,23
11,24,2018,20,0,7,"Braga",1,"Avenida da Liberdade",25,25,0,26,26,0
11,24,2018,20,0,7,"Braga",2,"Avenida Central",14,18,4,331,257,74
11,24,2018,20,0,7,"Braga",3,"Rua de Caires",23,23,0,4,4,0
11,24,2018,20,0,7,"Braga",4,"N14 Bosch",47,47,0,47,47,0
11,24,2018,20,0,7,"Braga",5,"Avenida João Paulo II",40,40,0,8,8,0
11,24,2018,20,0,7,"Braga",6,"Avenida Padre Júlio Fragata",29,61,32,45,21,24
11,24,2018,20,0,7,"Braga",7,"Rua Nova Santa Cruz",29,29,0,104,104,0
11,24,2018,20,0,7,"Braga",8,"Rua Costa Gomes",40,40,0,43,43,0
11,24,2018,21,0,7,"Braga",1,"Avenida da Liberdade",25,25,0,26,26,0
11,24,2018,21,0,7,"Braga",2,"Avenida Central",17,17,0,272,272,0
11,24,2018,21,0,7,"Braga",3,"Rua de Caires",23,23,0,4,4,0
11,24,2018,21,0,7,"Braga",4,"N14 Bosch",28,46,18,80,48,32
11,24,2018,21,0,7,"Braga",5,"Avenida João Paulo II",40,40,0,8,8,0
11,24,2018,21,0,7,"Braga",6,"Avenida Padre Júlio Fragata",40,62,22,33,21,12
11,24,2018,21,0,7,"Braga",7,"Rua Nova Santa Cruz",23,29,6,132,104,28
11,24,2018,21,0,7,"Braga",8,"Rua Costa Gomes",40,40,0,43,43,0
11,24,2018,22,0,7,"Braga",1,"Avenida da Liberdade",25,25,0,26,26,0
11,24,2018,22,0,7,"Braga",2,"Avenida Central",17,17,0,272,272,0
11,24,2018,22,0,7,"Braga",3,"Rua de Caires",16,25,9,6,4,2
11,24,2018,22,0,7,"Braga",4,"N14 Bosch",46,46,0,48,48,0
11,24,2018,22,0,7,"Braga",5,"Avenida João Paulo II",38,38,0,9,9,0
11,24,2018,22,0,7,"Braga",6,"Avenida Padre Júlio Fragata",49,62,13,27,21,6
11,24,2018,22,0,7,"Braga",7,"Rua Nova Santa Cruz",28,28,0,108,108,0
11,24,2018,22,0,7,"Braga",8,"Rua Costa Gomes",40,40,0,43,43,0
11,24,2018,23,0,7,"Braga",1,"Avenida da Liberdade",25,25,0,26,26,0
11,24,2018,23,0,7,"Braga",2,"Avenida Central",17,17,0,272,272,0
11,24,2018,23,0,7,"Braga",3,"Rua de Caires",25,25,0,4,4,0
11,24,2018,23,0,7,"Braga",4,"N14 Bosch",46,46,0,48,48,0
11,24,2018,23,0,7,"Braga",5,"Avenida João Paulo II",38,38,0,9,9,0
11,24,2018,23,0,7,"Braga",6,"Avenida Padre Júlio Fragata",61,61,0,21,21,0
11,24,2018,23,0,7,"Braga",7,"Rua Nova Santa Cruz",28,28,0,108,108,0
11,24,2018,23,0,7,"Braga",8,"Rua Costa Gomes",40,40,0,43,43,0
11,25,2018,0,0,8,"Braga",1,"Avenida da Liberdade",25,25,0,26,26,0
11,25,2018,0,0,8,"Braga",2,"Avenida Central",17,17,0,272,272,0
11,25,2018,0,0,8,"Braga",3,"Rua de Caires",25,25,0,4,4,0
11,25,2018,0,0,8,"Braga",4,"N14 Bosch",46,46,0,48,48,0
11,25,2018,0,0,8,"Braga",5,"Avenida João Paulo II",38,38,0,9,9,0
11,25,2018,0,0,8,"Braga",6,"Avenida Padre Júlio Fragata",18,60,42,73,22,51
11,25,2018,0,0,8,"Braga",7,"Rua Nova Santa Cruz",28,28,0,108,108,0
11,25,2018,0,0,8,"Braga",8,"Rua Costa Gomes",40,40,0,43,43,0
11,25,2018,1,0,8,"Braga",1,"Avenida da Liberdade",19,25,6,34,26,8
11,25,2018,1,0,8,"Braga",2,"Avenida Central",17,17,0,272,272,0
11,25,2018,1,0,8,"Braga",3,"Rua de Caires",25,25,0,4,4,0
11,25,2018,1,0,8,"Braga",4,"N14 Bosch",46,46,0,48,48,0
11,25,2018,1,0,8,"Braga",5,"Avenida João Paulo II",38,38,0,9,9,0
11,25,2018,1,0,8,"Braga",6,"Avenida Padre Júlio Fragata",62,62,0,21,21,0
11,25,2018,1,0,8,"Braga",7,"Rua Nova Santa Cruz",28,28,0,108,108,0
11,25,2018,1,0,8,"Braga",8,"Rua Costa Gomes",40,40,0,43,43,0
11,25,2018,2,0,8,"Braga",1,"Avenida da Liberdade",24,24,0,27,27,0
11,25,2018,2,0,8,"Braga",2,"Avenida Central",17,17,0,272,272,0
11,25,2018,2,0,8,"Braga",3,"Rua de Caires",25,25,0,4,4,0
11,25,2018,2,0,8,"Braga",4,"N14 Bosch",46,46,0,48,48,0
11,25,2018,2,0,8,"Braga",5,"Avenida João Paulo II",38,38,0,9,9,0
11,25,2018,2,0,8,"Braga",6,"Avenida Padre Júlio Fragata",62,62,0,21,21,0
11,25,2018,2,0,8,"Braga",7,"Rua Nova Santa Cruz",28,28,0,108,108,0
11,25,2018,2,0,8,"Braga",8,"Rua Costa Gomes",40,40,0,43,43,0
11,25,2018,3,0,8,"Braga",1,"Avenida da Liberdade",24,24,0,27,27,0
11,25,2018,3,0,8,"Braga",2,"Avenida Central",17,17,0,272,272,0
11,25,2018,3,0,8,"Braga",3,"Rua de Caires",25,25,0,4,4,0
11,25,2018,3,0,8,"Braga",4,"N14 Bosch",46,46,0,48,48,0
11,25,2018,3,0,8,"Braga",5,"Avenida João Paulo II",38,38,0,9,9,0
11,25,2018,3,0,8,"Braga",6,"Avenida Padre Júlio Fragata",62,62,0,21,21,0
11,25,2018,3,0,8,"Braga",7,"Rua Nova Santa Cruz",28,28,0,108,108,0
11,25,2018,3,0,8,"Braga",8,"Rua Costa Gomes",40,40,0,43,43,0
11,25,2018,4,0,8,"Braga",2,"Avenida Central",17,17,0,272,272,0
11,25,2018,4,0,8,"Braga",3,"Rua de Caires",25,25,0,4,4,0
11,25,2018,4,0,8,"Braga",4,"N14 Bosch",46,46,0,48,48,0
11,25,2018,4,0,8,"Braga",5,"Avenida João Paulo II",38,38,0,9,9,0
11,25,2018,4,0,8,"Braga",6,"Avenida Padre Júlio Fragata",62,62,0,21,21,0
11,25,2018,4,0,8,"Braga",7,"Rua Nova Santa Cruz",28,28,0,108,108,0
11,25,2018,4,0,8,"Braga",8,"Rua Costa Gomes",40,40,0,43,43,0
11,25,2018,4,0,8,"Braga",1,"Avenida da Liberdade",24,24,0,27,27,0
11,25,2018,4,0,8,"Braga",2,"Avenida Central",17,17,0,272,272,0
11,25,2018,5,0,8,"Braga",1,"Avenida da Liberdade",24,24,0,27,27,0
11,25,2018,5,0,8,"Braga",2,"Avenida Central",17,17,0,272,272,0
11,25,2018,5,0,8,"Braga",3,"Rua de Caires",25,25,0,4,4,0
11,25,2018,5,0,8,"Braga",4,"N14 Bosch",46,46,0,48,48,0
11,25,2018,5,0,8,"Braga",5,"Avenida João Paulo II",38,38,0,9,9,0
11,25,2018,5,0,8,"Braga",6,"Avenida Padre Júlio Fragata",62,62,0,21,21,0
11,25,2018,5,0,8,"Braga",7,"Rua Nova Santa Cruz",28,28,0,108,108,0
11,25,2018,5,0,8,"Braga",8,"Rua Costa Gomes",40,40,0,43,43,0
11,25,2018,6,0,8,"Braga",1,"Avenida da Liberdade",24,24,0,27,27,0
11,25,2018,6,0,8,"Braga",2,"Avenida Central",17,17,0,272,272,0
11,25,2018,6,0,8,"Braga",3,"Rua de Caires",25,25,0,4,4,0
11,25,2018,6,0,8,"Braga",4,"N14 Bosch",46,46,0,48,48,0
11,25,2018,6,0,8,"Braga",5,"Avenida João Paulo II",38,38,0,9,9,0
11,25,2018,6,0,8,"Braga",6,"Avenida Padre Júlio Fragata",62,62,0,21,21,0
11,25,2018,6,0,8,"Braga",7,"Rua Nova Santa Cruz",28,28,0,108,108,0
11,25,2018,6,0,8,"Braga",8,"Rua Costa Gomes",40,40,0,43,43,0
11,25,2018,7,0,8,"Braga",1,"Avenida da Liberdade",24,24,0,27,27,0
11,25,2018,7,0,8,"Braga",2,"Avenida Central",17,17,0,272,272,0
11,25,2018,7,0,8,"Braga",3,"Rua de Caires",25,25,0,4,4,0
11,25,2018,7,0,8,"Braga",4,"N14 Bosch",46,46,0,48,48,0
11,25,2018,7,0,8,"Braga",5,"Avenida João Paulo II",38,38,0,9,9,0
11,25,2018,7,0,8,"Braga",6,"Avenida Padre Júlio Fragata",62,62,0,21,21,0
11,25,2018,7,0,8,"Braga",7,"Rua Nova Santa Cruz",28,28,0,108,108,0
11,25,2018,7,0,8,"Braga",8,"Rua Costa Gomes",40,40,0,43,43,0
11,25,2018,8,0,8,"Braga",1,"Avenida da Liberdade",24,24,0,27,27,0
11,25,2018,8,0,8,"Braga",2,"Avenida Central",17,17,0,272,272,0
11,25,2018,8,0,8,"Braga",3,"Rua de Caires",25,25,0,4,4,0
11,25,2018,8,0,8,"Braga",4,"N14 Bosch",46,46,0,48,48,0
11,25,2018,8,0,8,"Braga",5,"Avenida João Paulo II",38,38,0,9,9,0
11,25,2018,8,0,8,"Braga",6,"Avenida Padre Júlio Fragata",62,62,0,21,21,0
11,25,2018,8,0,8,"Braga",7,"Rua Nova Santa Cruz",28,28,0,108,108,0
11,25,2018,8,0,8,"Braga",8,"Rua Costa Gomes",40,40,0,43,43,0
11,25,2018,9,0,8,"Braga",1,"Avenida da Liberdade",24,24,0,27,27,0
11,25,2018,9,0,8,"Braga",2,"Avenida Central",17,17,0,272,272,0
11,25,2018,9,0,8,"Braga",3,"Rua de Caires",25,25,0,4,4,0
11,25,2018,9,0,8,"Braga",4,"N14 Bosch",46,46,0,48,48,0
11,25,2018,9,0,8,"Braga",5,"Avenida João Paulo II",38,38,0,9,9,0
11,25,2018,9,0,8,"Braga",6,"Avenida Padre Júlio Fragata",62,62,0,21,21,0
11,25,2018,9,0,8,"Braga",7,"Rua Nova Santa Cruz",28,28,0,108,108,0
11,25,2018,9,0,8,"Braga",8,"Rua Costa Gomes",40,40,0,43,43,0
11,25,2018,10,0,8,"Braga",1,"Avenida da Liberdade",24,24,0,27,27,0
11,25,2018,10,0,8,"Braga",2,"Avenida Central",17,17,0,272,272,0
11,25,2018,10,0,8,"Braga",3,"Rua de Caires",25,25,0,4,4,0
11,25,2018,10,0,8,"Braga",4,"N14 Bosch",46,46,0,48,48,0
11,25,2018,10,0,8,"Braga",5,"Avenida João Paulo II",38,38,0,9,9,0
11,25,2018,10,0,8,"Braga",6,"Avenida Padre Júlio Fragata",62,62,0,21,21,0
11,25,2018,10,0,8,"Braga",7,"Rua Nova Santa Cruz",28,28,0,108,108,0
11,25,2018,10,0,8,"Braga",8,"Rua Costa Gomes",40,40,0,43,43,0
11,25,2018,11,0,8,"Braga",1,"Avenida da Liberdade",24,24,0,27,27,0
11,25,2018,11,0,8,"Braga",2,"Avenida Central",17,17,0,272,272,0
11,25,2018,11,0,8,"Braga",3,"Rua de Caires",19,24,5,5,4,1
11,25,2018,11,0,8,"Braga",4,"N14 Bosch",46,46,0,48,48,0
11,25,2018,11,0,8,"Braga",5,"Avenida João Paulo II",39,39,0,8,8,0
11,25,2018,11,0,8,"Braga",6,"Avenida Padre Júlio Fragata",61,61,0,21,21,0
11,25,2018,11,0,8,"Braga",7,"Rua Nova Santa Cruz",28,28,0,108,108,0
11,25,2018,11,0,8,"Braga",8,"Rua Costa Gomes",40,40,0,43,43,0
11,25,2018,12,0,8,"Braga",1,"Avenida da Liberdade",24,24,0,27,27,0
11,25,2018,12,0,8,"Braga",2,"Avenida Central",17,17,0,272,272,0
11,25,2018,12,0,8,"Braga",3,"Rua de Caires",25,25,0,4,4,0
11,25,2018,12,0,8,"Braga",4,"N14 Bosch",46,46,0,48,48,0
11,25,2018,12,0,8,"Braga",5,"Avenida João Paulo II",30,39,9,11,8,3
11,25,2018,12,0,8,"Braga",6,"Avenida Padre Júlio Fragata",43,62,19,30,21,9
11,25,2018,12,0,8,"Braga",7,"Rua Nova Santa Cruz",28,28,0,108,108,0
11,25,2018,12,0,8,"Braga",8,"Rua Costa Gomes",40,40,0,43,43,0
11,25,2018,13,0,8,"Braga",1,"Avenida da Liberdade",24,24,0,27,27,0
11,25,2018,13,0,8,"Braga",2,"Avenida Central",18,18,0,257,257,0
11,25,2018,13,0,8,"Braga",3,"Rua de Caires",25,25,0,4,4,0
11,25,2018,13,0,8,"Braga",4,"N14 Bosch",46,46,0,48,48,0
11,25,2018,13,0,8,"Braga",5,"Avenida João Paulo II",38,38,0,9,9,0
11,25,2018,13,0,8,"Braga",6,"Avenida Padre Júlio Fragata",46,61,15,28,21,7
11,25,2018,13,0,8,"Braga",7,"Rua Nova Santa Cruz",28,28,0,108,108,0
11,25,2018,13,0,8,"Braga",8,"Rua Costa Gomes",41,41,0,42,42,0
11,25,2018,14,0,8,"Braga",1,"Avenida da Liberdade",24,24,0,27,27,0
11,25,2018,14,0,8,"Braga",2,"Avenida Central",17,17,0,272,272,0
11,25,2018,14,0,8,"Braga",3,"Rua de Caires",25,25,0,4,4,0
11,25,2018,14,0,8,"Braga",4,"N14 Bosch",46,46,0,48,48,0
11,25,2018,14,0,8,"Braga",5,"Avenida João Paulo II",38,38,0,9,9,0
11,25,2018,14,0,8,"Braga",6,"Avenida Padre Júlio Fragata",30,63,33,44,21,23
11,25,2018,14,0,8,"Braga",7,"Rua Nova Santa Cruz",28,28,0,108,108,0
11,25,2018,14,0,8,"Braga",8,"Rua Costa Gomes",18,40,22,96,43,53
11,25,2018,15,0,8,"Braga",1,"Avenida da Liberdade",24,24,0,27,27,0
11,25,2018,15,0,8,"Braga",2,"Avenida Central",17,17,0,272,272,0
11,25,2018,15,0,8,"Braga",3,"Rua de Caires",25,25,0,4,4,0
11,25,2018,15,0,8,"Braga",4,"N14 Bosch",47,47,0,47,47,0
11,25,2018,15,0,8,"Braga",5,"Avenida João Paulo II",5,39,34,69,8,61
11,25,2018,15,0,8,"Braga",6,"Avenida Padre Júlio Fragata",31,62,31,42,21,21
11,25,2018,15,0,8,"Braga",7,"Rua Nova Santa Cruz",28,28,0,108,108,0
11,25,2018,15,0,8,"Braga",8,"Rua Costa Gomes",31,40,9,55,43,12
11,25,2018,16,0,8,"Braga",1,"Avenida da Liberdade",24,24,0,27,27,0
11,25,2018,16,0,8,"Braga",2,"Avenida Central",18,18,0,257,257,0
11,25,2018,16,0,8,"Braga",3,"Rua de Caires",25,25,0,4,4,0
11,25,2018,16,0,8,"Braga",4,"N14 Bosch",33,47,14,68,47,21
11,25,2018,16,0,8,"Braga",5,"Avenida João Paulo II",5,39,34,69,8,61
11,25,2018,16,0,8,"Braga",6,"Avenida Padre Júlio Fragata",36,61,25,36,21,15
11,25,2018,16,0,8,"Braga",7,"Rua Nova Santa Cruz",28,28,0,108,108,0
11,25,2018,16,0,8,"Braga",8,"Rua Costa Gomes",28,40,12,61,43,18
11,25,2018,17,0,8,"Braga",1,"Avenida da Liberdade",25,25,0,26,26,0
11,25,2018,17,0,8,"Braga",2,"Avenida Central",18,18,0,257,257,0
11,25,2018,17,0,8,"Braga",3,"Rua de Caires",24,24,0,4,4,0
11,25,2018,17,0,8,"Braga",4,"N14 Bosch",37,46,9,60,48,12
11,25,2018,17,0,8,"Braga",5,"Avenida João Paulo II",3,38,35,116,9,107
11,25,2018,17,0,8,"Braga",6,"Avenida Padre Júlio Fragata",22,60,38,60,22,38
11,25,2018,17,0,8,"Braga",7,"Rua Nova Santa Cruz",28,28,0,108,108,0
11,25,2018,17,0,8,"Braga",8,"Rua Costa Gomes",28,40,12,61,43,18
11,25,2018,18,0,8,"Braga",1,"Avenida da Liberdade",25,25,0,26,26,0
11,25,2018,18,0,8,"Braga",2,"Avenida Central",18,18,0,257,257,0
11,25,2018,18,0,8,"Braga",3,"Rua de Caires",4,25,21,26,4,22
11,25,2018,18,0,8,"Braga",4,"N14 Bosch",33,47,14,68,47,21
11,25,2018,18,0,8,"Braga",5,"Avenida João Paulo II",39,39,0,8,8,0
11,25,2018,18,0,8,"Braga",6,"Avenida Padre Júlio Fragata",28,63,35,47,21,26
11,25,2018,18,0,8,"Braga",7,"Rua Nova Santa Cruz",28,28,0,108,108,0
11,25,2018,18,0,8,"Braga",8,"Rua Costa Gomes",31,40,9,55,43,12
11,25,2018,19,0,8,"Braga",1,"Avenida da Liberdade",25,25,0,26,26,0
11,25,2018,19,0,8,"Braga",2,"Avenida Central",17,17,0,272,272,0
11,25,2018,19,0,8,"Braga",3,"Rua de Caires",22,22,0,4,4,0
11,25,2018,19,0,8,"Braga",4,"N14 Bosch",47,47,0,47,47,0
11,25,2018,19,0,8,"Braga",5,"Avenida João Paulo II",39,39,0,8,8,0
11,25,2018,19,0,8,"Braga",6,"Avenida Padre Júlio Fragata",32,61,29,41,21,20
11,25,2018,19,0,8,"Braga",7,"Rua Nova Santa Cruz",28,28,0,108,108,0
11,25,2018,19,0,8,"Braga",8,"Rua Costa Gomes",40,40,0,43,43,0
11,25,2018,20,0,8,"Braga",1,"Avenida da Liberdade",25,25,0,26,26,0
11,25,2018,20,0,8,"Braga",2,"Avenida Central",18,18,0,257,257,0
11,25,2018,20,0,8,"Braga",3,"Rua de Caires",4,25,21,26,4,22
11,25,2018,20,0,8,"Braga",4,"N14 Bosch",46,46,0,48,48,0
11,25,2018,20,0,8,"Braga",5,"Avenida João Paulo II",39,39,0,8,8,0
11,25,2018,20,0,8,"Braga",6,"Avenida Padre Júlio Fragata",41,61,20,32,21,11
11,25,2018,20,0,8,"Braga",7,"Rua Nova Santa Cruz",28,28,0,108,108,0
11,25,2018,20,0,8,"Braga",8,"Rua Costa Gomes",27,40,13,64,43,21
11,25,2018,21,0,8,"Braga",1,"Avenida da Liberdade",25,25,0,26,26,0
11,25,2018,21,0,8,"Braga",2,"Avenida Central",18,18,0,257,257,0
11,25,2018,21,0,8,"Braga",3,"Rua de Caires",25,25,0,4,4,0
11,25,2018,21,0,8,"Braga",4,"N14 Bosch",46,46,0,48,48,0
11,25,2018,21,0,8,"Braga",5,"Avenida João Paulo II",39,39,0,8,8,0
11,25,2018,21,0,8,"Braga",6,"Avenida Padre Júlio Fragata",62,62,0,21,21,0
11,25,2018,21,0,8,"Braga",7,"Rua Nova Santa Cruz",28,28,0,108,108,0
11,25,2018,21,0,8,"Braga",8,"Rua Costa Gomes",40,40,0,43,43,0
11,25,2018,22,0,8,"Braga",1,"Avenida da Liberdade",25,25,0,26,26,0
11,25,2018,22,0,8,"Braga",2,"Avenida Central",18,18,0,257,257,0
11,25,2018,22,0,8,"Braga",3,"Rua de Caires",25,25,0,4,4,0
11,25,2018,22,0,8,"Braga",4,"N14 Bosch",46,46,0,48,48,0
11,25,2018,22,0,8,"Braga",5,"Avenida João Paulo II",39,39,0,8,8,0
11,25,2018,22,0,8,"Braga",6,"Avenida Padre Júlio Fragata",62,62,0,21,21,0
11,25,2018,22,0,8,"Braga",7,"Rua Nova Santa Cruz",28,28,0,108,108,0
11,25,2018,22,0,8,"Braga",8,"Rua Costa Gomes",40,40,0,43,43,0
11,25,2018,23,0,8,"Braga",1,"Avenida da Liberdade",25,25,0,26,26,0
11,25,2018,23,0,8,"Braga",2,"Avenida Central",18,18,0,257,257,0
11,25,2018,23,0,8,"Braga",3,"Rua de Caires",25,25,0,4,4,0
11,25,2018,23,0,8,"Braga",4,"N14 Bosch",46,46,0,48,48,0
11,25,2018,23,0,8,"Braga",5,"Avenida João Paulo II",39,39,0,8,8,0
11,25,2018,23,0,8,"Braga",6,"Avenida Padre Júlio Fragata",62,62,0,21,21,0
11,25,2018,23,0,8,"Braga",7,"Rua Nova Santa Cruz",28,28,0,108,108,0
11,25,2018,23,0,8,"Braga",8,"Rua Costa Gomes",40,40,0,43,43,0
11,26,2018,0,0,2,"Braga",1,"Avenida da Liberdade",25,25,0,26,26,0
11,26,2018,0,0,2,"Braga",2,"Avenida Central",18,18,0,257,257,0
11,26,2018,0,0,2,"Braga",3,"Rua de Caires",25,25,0,4,4,0
11,26,2018,0,0,2,"Braga",4,"N14 Bosch",46,46,0,48,48,0
11,26,2018,0,0,2,"Braga",5,"Avenida João Paulo II",39,39,0,8,8,0
11,26,2018,0,0,2,"Braga",6,"Avenida Padre Júlio Fragata",62,62,0,21,21,0
11,26,2018,0,0,2,"Braga",7,"Rua Nova Santa Cruz",28,28,0,108,108,0
11,26,2018,0,0,2,"Braga",8,"Rua Costa Gomes",40,40,0,43,43,0
11,26,2018,1,0,2,"Braga",1,"Avenida da Liberdade",25,25,0,26,26,0
11,26,2018,1,0,2,"Braga",2,"Avenida Central",18,18,0,257,257,0
11,26,2018,1,0,2,"Braga",3,"Rua de Caires",25,25,0,4,4,0
11,26,2018,1,0,2,"Braga",4,"N14 Bosch",46,46,0,48,48,0
11,26,2018,1,0,2,"Braga",5,"Avenida João Paulo II",38,38,0,9,9,0
11,26,2018,1,0,2,"Braga",6,"Avenida Padre Júlio Fragata",62,62,0,21,21,0
11,26,2018,1,0,2,"Braga",7,"Rua Nova Santa Cruz",28,28,0,108,108,0
11,26,2018,1,0,2,"Braga",8,"Rua Costa Gomes",40,40,0,43,43,0
11,26,2018,2,0,2,"Braga",1,"Avenida da Liberdade",25,25,0,26,26,0
11,26,2018,2,0,2,"Braga",2,"Avenida Central",18,18,0,257,257,0
11,26,2018,2,0,2,"Braga",3,"Rua de Caires",25,25,0,4,4,0
11,26,2018,2,0,2,"Braga",4,"N14 Bosch",46,46,0,48,48,0
11,26,2018,2,0,2,"Braga",5,"Avenida João Paulo II",38,38,0,9,9,0
11,26,2018,2,0,2,"Braga",6,"Avenida Padre Júlio Fragata",62,62,0,21,21,0
11,26,2018,2,0,2,"Braga",7,"Rua Nova Santa Cruz",28,28,0,108,108,0
11,26,2018,2,0,2,"Braga",8,"Rua Costa Gomes",40,40,0,43,43,0
11,26,2018,3,0,2,"Braga",1,"Avenida da Liberdade",25,25,0,26,26,0
11,26,2018,3,0,2,"Braga",2,"Avenida Central",18,18,0,257,257,0
11,26,2018,3,0,2,"Braga",3,"Rua de Caires",25,25,0,4,4,0
11,26,2018,3,0,2,"Braga",4,"N14 Bosch",46,46,0,48,48,0
11,26,2018,3,0,2,"Braga",5,"Avenida João Paulo II",38,38,0,9,9,0
11,26,2018,3,0,2,"Braga",6,"Avenida Padre Júlio Fragata",62,62,0,21,21,0
11,26,2018,3,0,2,"Braga",7,"Rua Nova Santa Cruz",28,28,0,108,108,0
11,26,2018,3,0,2,"Braga",8,"Rua Costa Gomes",40,40,0,43,43,0
11,26,2018,4,0,2,"Braga",1,"Avenida da Liberdade",25,25,0,26,26,0
11,26,2018,4,0,2,"Braga",2,"Avenida Central",18,18,0,257,257,0
11,26,2018,4,0,2,"Braga",3,"Rua de Caires",25,25,0,4,4,0
11,26,2018,4,0,2,"Braga",4,"N14 Bosch",46,46,0,48,48,0
11,26,2018,4,0,2,"Braga",5,"Avenida João Paulo II",38,38,0,9,9,0
11,26,2018,4,0,2,"Braga",6,"Avenida Padre Júlio Fragata",62,62,0,21,21,0
11,26,2018,4,0,2,"Braga",7,"Rua Nova Santa Cruz",28,28,0,108,108,0
11,26,2018,4,0,2,"Braga",8,"Rua Costa Gomes",40,40,0,43,43,0
11,26,2018,5,0,2,"Braga",1,"Avenida da Liberdade",25,25,0,26,26,0
11,26,2018,5,0,2,"Braga",2,"Avenida Central",18,18,0,257,257,0
11,26,2018,5,0,2,"Braga",3,"Rua de Caires",25,25,0,4,4,0
11,26,2018,5,0,2,"Braga",4,"N14 Bosch",46,46,0,48,48,0
11,26,2018,5,0,2,"Braga",5,"Avenida João Paulo II",38,38,0,9,9,0
11,26,2018,5,0,2,"Braga",6,"Avenida Padre Júlio Fragata",62,62,0,21,21,0
11,26,2018,5,0,2,"Braga",7,"Rua Nova Santa Cruz",28,28,0,108,108,0
11,26,2018,5,0,2,"Braga",8,"Rua Costa Gomes",40,40,0,43,43,0
11,26,2018,6,0,2,"Braga",1,"Avenida da Liberdade",25,25,0,26,26,0
11,26,2018,6,0,2,"Braga",2,"Avenida Central",18,18,0,257,257,0
11,26,2018,6,0,2,"Braga",3,"Rua de Caires",25,25,0,4,4,0
11,26,2018,6,0,2,"Braga",4,"N14 Bosch",46,46,0,48,48,0
11,26,2018,6,0,2,"Braga",5,"Avenida João Paulo II",38,38,0,9,9,0
11,26,2018,6,0,2,"Braga",6,"Avenida Padre Júlio Fragata",62,62,0,21,21,0
11,26,2018,6,0,2,"Braga",7,"Rua Nova Santa Cruz",28,28,0,108,108,0
11,26,2018,6,0,2,"Braga",8,"Rua Costa Gomes",40,40,0,43,43,0
11,26,2018,7,0,2,"Braga",1,"Avenida da Liberdade",25,25,0,26,26,0
11,26,2018,7,0,2,"Braga",2,"Avenida Central",18,18,0,257,257,0
11,26,2018,7,0,2,"Braga",3,"Rua de Caires",25,25,0,4,4,0
11,26,2018,7,0,2,"Braga",4,"N14 Bosch",46,46,0,48,48,0
11,26,2018,7,0,2,"Braga",5,"Avenida João Paulo II",38,38,0,9,9,0
11,26,2018,7,0,2,"Braga",6,"Avenida Padre Júlio Fragata",62,62,0,21,21,0
11,26,2018,7,0,2,"Braga",7,"Rua Nova Santa Cruz",28,28,0,108,108,0
11,26,2018,7,0,2,"Braga",8,"Rua Costa Gomes",40,40,0,43,43,0
11,26,2018,8,0,2,"Braga",1,"Avenida da Liberdade",25,25,0,26,26,0
11,26,2018,8,0,2,"Braga",2,"Avenida Central",18,18,0,257,257,0
11,26,2018,8,0,2,"Braga",3,"Rua de Caires",25,25,0,4,4,0
11,26,2018,8,0,2,"Braga",4,"N14 Bosch",35,46,11,64,48,16
11,26,2018,8,0,2,"Braga",5,"Avenida João Paulo II",38,38,0,9,9,0
11,26,2018,8,0,2,"Braga",6,"Avenida Padre Júlio Fragata",62,62,0,21,21,0
11,26,2018,8,0,2,"Braga",7,"Rua Nova Santa Cruz",28,28,0,108,108,0
11,26,2018,8,0,2,"Braga",8,"Rua Costa Gomes",40,40,0,43,43,0
11,26,2018,9,0,2,"Braga",1,"Avenida da Liberdade",17,24,7,39,27,12
11,26,2018,9,0,2,"Braga",2,"Avenida Central",18,18,0,257,257,0
11,26,2018,9,0,2,"Braga",3,"Rua de Caires",11,24,13,9,4,5
11,26,2018,9,0,2,"Braga",4,"N14 Bosch",26,47,21,86,47,39
11,26,2018,9,0,2,"Braga",5,"Avenida João Paulo II",30,38,8,11,9,2
11,26,2018,9,0,2,"Braga",6,"Avenida Padre Júlio Fragata",35,62,27,38,21,17
11,26,2018,9,0,2,"Braga",7,"Rua Nova Santa Cruz",19,29,10,160,104,56
11,26,2018,9,0,2,"Braga",8,"Rua Costa Gomes",40,40,0,43,43,0
11,26,2018,10,0,2,"Braga",1,"Avenida da Liberdade",19,24,5,34,27,7
11,26,2018,10,0,2,"Braga",2,"Avenida Central",14,17,3,331,272,59
11,26,2018,10,0,2,"Braga",3,"Rua de Caires",24,24,0,4,4,0
11,26,2018,10,0,2,"Braga",4,"N14 Bosch",30,46,16,74,48,26
11,26,2018,10,0,2,"Braga",5,"Avenida João Paulo II",39,39,0,8,8,0
11,26,2018,10,0,2,"Braga",6,"Avenida Padre Júlio Fragata",62,62,0,21,21,0
11,26,2018,10,0,2,"Braga",7,"Rua Nova Santa Cruz",28,28,0,108,108,0
11,26,2018,10,0,2,"Braga",8,"Rua Costa Gomes",30,40,10,57,43,14
11,26,2018,11,0,2,"Braga",1,"Avenida da Liberdade",24,24,0,27,27,0
11,26,2018,11,0,2,"Braga",2,"Avenida Central",14,17,3,331,272,59
11,26,2018,11,0,2,"Braga",3,"Rua de Caires",24,24,0,4,4,0
11,26,2018,11,0,2,"Braga",4,"N14 Bosch",35,47,12,64,47,17
11,26,2018,11,0,2,"Braga",5,"Avenida João Paulo II",39,39,0,8,8,0
11,26,2018,11,0,2,"Braga",6,"Avenida Padre Júlio Fragata",61,61,0,21,21,0
11,26,2018,11,0,2,"Braga",7,"Rua Nova Santa Cruz",28,28,0,108,108,0
11,26,2018,11,0,2,"Braga",8,"Rua Costa Gomes",33,41,8,52,42,10
11,26,2018,12,0,2,"Braga",1,"Avenida da Liberdade",20,25,5,33,26,7
11,26,2018,12,0,2,"Braga",2,"Avenida Central",17,17,0,272,272,0
11,26,2018,12,0,2,"Braga",3,"Rua de Caires",24,24,0,4,4,0
11,26,2018,12,0,2,"Braga",4,"N14 Bosch",34,47,13,66,47,19
11,26,2018,12,0,2,"Braga",5,"Avenida João Paulo II",39,39,0,8,8,0
11,26,2018,12,0,2,"Braga",6,"Avenida Padre Júlio Fragata",61,61,0,21,21,0
11,26,2018,12,0,2,"Braga",7,"Rua Nova Santa Cruz",23,29,6,132,104,28
11,26,2018,12,0,2,"Braga",8,"Rua Costa Gomes",41,41,0,42,42,0
11,26,2018,13,0,2,"Braga",1,"Avenida da Liberdade",25,25,0,26,26,0
11,26,2018,13,0,2,"Braga",2,"Avenida Central",14,18,4,331,257,74
11,26,2018,13,0,2,"Braga",3,"Rua de Caires",25,25,0,4,4,0
11,26,2018,13,0,2,"Braga",4,"N14 Bosch",25,46,21,89,48,41
11,26,2018,13,0,2,"Braga",5,"Avenida João Paulo II",39,39,0,8,8,0
11,26,2018,13,0,2,"Braga",6,"Avenida Padre Júlio Fragata",62,62,0,21,21,0
11,26,2018,13,0,2,"Braga",7,"Rua Nova Santa Cruz",22,28,6,138,108,30
11,26,2018,13,0,2,"Braga",8,"Rua Costa Gomes",41,41,0,42,42,0
11,26,2018,14,0,2,"Braga",1,"Avenida da Liberdade",25,25,0,26,26,0
11,26,2018,14,0,2,"Braga",2,"Avenida Central",18,18,0,257,257,0
11,26,2018,14,0,2,"Braga",3,"Rua de Caires",25,25,0,4,4,0
11,26,2018,14,0,2,"Braga",4,"N14 Bosch",14,48,34,160,46,114
11,26,2018,14,0,2,"Braga",5,"Avenida João Paulo II",39,39,0,8,8,0
11,26,2018,14,0,2,"Braga",6,"Avenida Padre Júlio Fragata",62,62,0,21,21,0
11,26,2018,14,0,2,"Braga",7,"Rua Nova Santa Cruz",22,28,6,138,108,30
11,26,2018,14,0,2,"Braga",8,"Rua Costa Gomes",40,40,0,43,43,0
11,26,2018,15,0,2,"Braga",1,"Avenida da Liberdade",20,25,5,33,26,7
11,26,2018,15,0,2,"Braga",2,"Avenida Central",9,18,9,515,257,258
11,26,2018,15,0,2,"Braga",3,"Rua de Caires",25,25,0,4,4,0
11,26,2018,15,0,2,"Braga",4,"N14 Bosch",27,47,20,83,47,36
11,26,2018,15,0,2,"Braga",5,"Avenida João Paulo II",39,39,0,8,8,0
11,26,2018,15,0,2,"Braga",6,"Avenida Padre Júlio Fragata",61,61,0,21,21,0
11,26,2018,15,0,2,"Braga",7,"Rua Nova Santa Cruz",23,29,6,132,104,28
11,26,2018,15,0,2,"Braga",8,"Rua Costa Gomes",41,41,0,42,42,0
11,26,2018,16,0,2,"Braga",1,"Avenida da Liberdade",17,24,7,39,27,12
11,26,2018,16,0,2,"Braga",2,"Avenida Central",14,18,4,331,257,74
11,26,2018,16,0,2,"Braga",3,"Rua de Caires",20,25,5,5,4,1
11,26,2018,16,0,2,"Braga",4,"N14 Bosch",46,46,0,48,48,0
11,26,2018,16,0,2,"Braga",5,"Avenida João Paulo II",39,39,0,8,8,0
11,26,2018,16,0,2,"Braga",6,"Avenida Padre Júlio Fragata",49,62,13,27,21,6
11,26,2018,16,0,2,"Braga",7,"Rua Nova Santa Cruz",16,29,13,190,104,86
11,26,2018,16,0,2,"Braga",8,"Rua Costa Gomes",30,40,10,57,43,14
11,26,2018,17,0,2,"Braga",1,"Avenida da Liberdade",19,25,6,34,26,8
11,26,2018,17,0,2,"Braga",2,"Avenida Central",11,18,7,421,257,164
11,26,2018,17,0,2,"Braga",3,"Rua de Caires",18,24,6,5,4,1
11,26,2018,17,0,2,"Braga",4,"N14 Bosch",19,46,27,118,48,70
11,26,2018,17,0,2,"Braga",5,"Avenida João Paulo II",25,39,14,13,8,5
11,26,2018,17,0,2,"Braga",6,"Avenida Padre Júlio Fragata",48,62,14,27,21,6
11,26,2018,17,0,2,"Braga",7,"Rua Nova Santa Cruz",21,29,8,144,104,40
11,26,2018,17,0,2,"Braga",8,"Rua Costa Gomes",24,40,16,72,43,29
11,26,2018,18,0,2,"Braga",1,"Avenida da Liberdade",20,25,5,33,26,7
11,26,2018,18,0,2,"Braga",2,"Avenida Central",10,17,7,463,272,191
11,26,2018,18,0,2,"Braga",3,"Rua de Caires",13,26,13,8,4,4
11,26,2018,18,0,2,"Braga",4,"N14 Bosch",17,47,30,132,47,85
11,26,2018,18,0,2,"Braga",5,"Avenida João Paulo II",38,38,0,9,9,0
11,26,2018,18,0,2,"Braga",6,"Avenida Padre Júlio Fragata",33,61,28,40,21,19
11,26,2018,18,0,2,"Braga",7,"Rua Nova Santa Cruz",21,29,8,144,104,40
11,26,2018,18,0,2,"Braga",8,"Rua Costa Gomes",10,39,29,172,44,128
11,26,2018,19,0,2,"Braga",1,"Avenida da Liberdade",17,24,7,39,27,12
11,26,2018,19,0,2,"Braga",2,"Avenida Central",6,17,11,772,272,500
11,26,2018,19,0,2,"Braga",3,"Rua de Caires",25,25,0,4,4,0
11,26,2018,19,0,2,"Braga",4,"N14 Bosch",19,48,29,118,46,72
11,26,2018,19,0,2,"Braga",5,"Avenida João Paulo II",30,38,8,11,9,2
11,26,2018,19,0,2,"Braga",6,"Avenida Padre Júlio Fragata",24,62,38,55,21,34
11,26,2018,19,0,2,"Braga",7,"Rua Nova Santa Cruz",19,29,10,160,104,56
11,26,2018,19,0,2,"Braga",8,"Rua Costa Gomes",14,42,28,123,41,82
11,26,2018,20,0,2,"Braga",1,"Avenida da Liberdade",25,25,0,26,26,0
11,26,2018,20,0,2,"Braga",2,"Avenida Central",18,18,0,257,257,0
11,26,2018,20,0,2,"Braga",3,"Rua de Caires",25,25,0,4,4,0
11,26,2018,20,0,2,"Braga",4,"N14 Bosch",47,47,0,47,47,0
11,26,2018,20,0,2,"Braga",5,"Avenida João Paulo II",38,38,0,9,9,0
11,26,2018,20,0,2,"Braga",6,"Avenida Padre Júlio Fragata",62,62,0,21,21,0
11,26,2018,20,0,2,"Braga",7,"Rua Nova Santa Cruz",22,29,7,138,104,34
11,26,2018,20,0,2,"Braga",8,"Rua Costa Gomes",19,40,21,90,43,47
11,26,2018,21,0,2,"Braga",1,"Avenida da Liberdade",25,25,0,26,26,0
11,26,2018,21,0,2,"Braga",2,"Avenida Central",17,17,0,272,272,0
11,26,2018,21,0,2,"Braga",3,"Rua de Caires",24,24,0,4,4,0
11,26,2018,21,0,2,"Braga",4,"N14 Bosch",46,46,0,48,48,0
11,26,2018,21,0,2,"Braga",5,"Avenida João Paulo II",38,38,0,9,9,0
11,26,2018,21,0,2,"Braga",6,"Avenida Padre Júlio Fragata",31,62,31,42,21,21
11,26,2018,21,0,2,"Braga",7,"Rua Nova Santa Cruz",29,29,0,104,104,0
11,26,2018,21,0,2,"Braga",8,"Rua Costa Gomes",40,40,0,43,43,0
11,26,2018,22,0,2,"Braga",1,"Avenida da Liberdade",25,25,0,26,26,0
11,26,2018,22,0,2,"Braga",2,"Avenida Central",17,17,0,272,272,0
11,26,2018,22,0,2,"Braga",3,"Rua de Caires",24,24,0,4,4,0
11,26,2018,22,0,2,"Braga",4,"N14 Bosch",46,46,0,48,48,0
11,26,2018,22,0,2,"Braga",5,"Avenida João Paulo II",38,38,0,9,9,0
11,26,2018,22,0,2,"Braga",6,"Avenida Padre Júlio Fragata",61,61,0,21,21,0
11,26,2018,22,0,2,"Braga",7,"Rua Nova Santa Cruz",29,29,0,104,104,0
11,26,2018,22,0,2,"Braga",8,"Rua Costa Gomes",40,40,0,43,43,0
11,26,2018,23,0,2,"Braga",1,"Avenida da Liberdade",25,25,0,26,26,0
11,26,2018,23,0,2,"Braga",2,"Avenida Central",17,17,0,272,272,0
11,26,2018,23,0,2,"Braga",3,"Rua de Caires",17,25,8,6,4,2
11,26,2018,23,0,2,"Braga",4,"N14 Bosch",46,46,0,48,48,0
11,26,2018,23,0,2,"Braga",5,"Avenida João Paulo II",38,38,0,9,9,0
11,26,2018,23,0,2,"Braga",6,"Avenida Padre Júlio Fragata",61,61,0,21,21,0
11,26,2018,23,0,2,"Braga",7,"Rua Nova Santa Cruz",29,29,0,104,104,0
11,26,2018,23,0,2,"Braga",8,"Rua Costa Gomes",40,40,0,43,43,0
11,27,2018,0,0,3,"Braga",1,"Avenida da Liberdade",25,25,0,26,26,0
11,27,2018,0,0,3,"Braga",2,"Avenida Central",17,17,0,272,272,0
11,27,2018,0,0,3,"Braga",3,"Rua de Caires",24,24,0,4,4,0
11,27,2018,0,0,3,"Braga",4,"N14 Bosch",46,46,0,48,48,0
11,27,2018,0,0,3,"Braga",5,"Avenida João Paulo II",38,38,0,9,9,0
11,27,2018,0,0,3,"Braga",6,"Avenida Padre Júlio Fragata",61,61,0,21,21,0
11,27,2018,0,0,3,"Braga",7,"Rua Nova Santa Cruz",29,29,0,104,104,0
11,27,2018,0,0,3,"Braga",8,"Rua Costa Gomes",40,40,0,43,43,0
11,27,2018,1,0,3,"Braga",1,"Avenida da Liberdade",25,25,0,26,26,0
11,27,2018,1,0,3,"Braga",2,"Avenida Central",17,17,0,272,272,0
11,27,2018,1,0,3,"Braga",3,"Rua de Caires",14,24,10,7,4,3
11,27,2018,1,0,3,"Braga",4,"N14 Bosch",46,46,0,48,48,0
11,27,2018,1,0,3,"Braga",5,"Avenida João Paulo II",38,38,0,9,9,0
11,27,2018,1,0,3,"Braga",6,"Avenida Padre Júlio Fragata",61,61,0,21,21,0
11,27,2018,1,0,3,"Braga",7,"Rua Nova Santa Cruz",29,29,0,104,104,0
11,27,2018,1,0,3,"Braga",8,"Rua Costa Gomes",40,40,0,43,43,0
11,27,2018,2,0,3,"Braga",1,"Avenida da Liberdade",25,25,0,26,26,0
11,27,2018,2,0,3,"Braga",2,"Avenida Central",17,17,0,272,272,0
11,27,2018,2,0,3,"Braga",3,"Rua de Caires",24,24,0,4,4,0
11,27,2018,2,0,3,"Braga",4,"N14 Bosch",46,46,0,48,48,0
11,27,2018,2,0,3,"Braga",5,"Avenida João Paulo II",38,38,0,9,9,0
11,27,2018,2,0,3,"Braga",6,"Avenida Padre Júlio Fragata",61,61,0,21,21,0
11,27,2018,2,0,3,"Braga",7,"Rua Nova Santa Cruz",29,29,0,104,104,0
11,27,2018,2,0,3,"Braga",8,"Rua Costa Gomes",40,40,0,43,43,0
11,27,2018,3,0,3,"Braga",1,"Avenida da Liberdade",25,25,0,26,26,0
11,27,2018,3,0,3,"Braga",2,"Avenida Central",17,17,0,272,272,0
11,27,2018,3,0,3,"Braga",3,"Rua de Caires",24,24,0,4,4,0
11,27,2018,3,0,3,"Braga",4,"N14 Bosch",46,46,0,48,48,0
11,27,2018,3,0,3,"Braga",5,"Avenida João Paulo II",38,38,0,9,9,0
11,27,2018,3,0,3,"Braga",6,"Avenida Padre Júlio Fragata",61,61,0,21,21,0
11,27,2018,3,0,3,"Braga",7,"Rua Nova Santa Cruz",29,29,0,104,104,0
11,27,2018,3,0,3,"Braga",8,"Rua Costa Gomes",40,40,0,43,43,0
11,27,2018,4,0,3,"Braga",1,"Avenida da Liberdade",25,25,0,26,26,0
11,27,2018,4,0,3,"Braga",2,"Avenida Central",17,17,0,272,272,0
11,27,2018,4,0,3,"Braga",3,"Rua de Caires",24,24,0,4,4,0
11,27,2018,4,0,3,"Braga",4,"N14 Bosch",46,46,0,48,48,0
11,27,2018,4,0,3,"Braga",5,"Avenida João Paulo II",38,38,0,9,9,0
11,27,2018,4,0,3,"Braga",6,"Avenida Padre Júlio Fragata",61,61,0,21,21,0
11,27,2018,4,0,3,"Braga",7,"Rua Nova Santa Cruz",29,29,0,104,104,0
11,27,2018,4,0,3,"Braga",8,"Rua Costa Gomes",40,40,0,43,43,0
11,27,2018,5,0,3,"Braga",1,"Avenida da Liberdade",25,25,0,26,26,0
11,27,2018,5,0,3,"Braga",2,"Avenida Central",17,17,0,272,272,0
11,27,2018,5,0,3,"Braga",3,"Rua de Caires",24,24,0,4,4,0
11,27,2018,5,0,3,"Braga",4,"N14 Bosch",46,46,0,48,48,0
11,27,2018,5,0,3,"Braga",5,"Avenida João Paulo II",38,38,0,9,9,0
11,27,2018,5,0,3,"Braga",6,"Avenida Padre Júlio Fragata",61,61,0,21,21,0
11,27,2018,5,0,3,"Braga",7,"Rua Nova Santa Cruz",29,29,0,104,104,0
11,27,2018,5,0,3,"Braga",8,"Rua Costa Gomes",40,40,0,43,43,0
11,27,2018,6,0,3,"Braga",1,"Avenida da Liberdade",25,25,0,26,26,0
11,27,2018,6,0,3,"Braga",2,"Avenida Central",17,17,0,272,272,0
11,27,2018,6,0,3,"Braga",3,"Rua de Caires",24,24,0,4,4,0
11,27,2018,6,0,3,"Braga",4,"N14 Bosch",46,46,0,48,48,0
11,27,2018,6,0,3,"Braga",5,"Avenida João Paulo II",38,38,0,9,9,0
11,27,2018,6,0,3,"Braga",6,"Avenida Padre Júlio Fragata",61,61,0,21,21,0
11,27,2018,6,0,3,"Braga",7,"Rua Nova Santa Cruz",29,29,0,104,104,0
11,27,2018,6,0,3,"Braga",8,"Rua Costa Gomes",40,40,0,43,43,0
11,27,2018,7,0,3,"Braga",1,"Avenida da Liberdade",25,25,0,26,26,0
11,27,2018,7,0,3,"Braga",2,"Avenida Central",17,17,0,272,272,0
11,27,2018,7,0,3,"Braga",3,"Rua de Caires",24,24,0,4,4,0
11,27,2018,7,0,3,"Braga",4,"N14 Bosch",46,46,0,48,48,0
11,27,2018,7,0,3,"Braga",5,"Avenida João Paulo II",38,38,0,9,9,0
11,27,2018,7,0,3,"Braga",6,"Avenida Padre Júlio Fragata",61,61,0,21,21,0
11,27,2018,7,0,3,"Braga",7,"Rua Nova Santa Cruz",29,29,0,104,104,0
11,27,2018,7,0,3,"Braga",8,"Rua Costa Gomes",40,40,0,43,43,0
11,27,2018,8,0,3,"Braga",1,"Avenida da Liberdade",25,25,0,26,26,0
11,27,2018,8,0,3,"Braga",2,"Avenida Central",14,18,4,331,257,74
11,27,2018,8,0,3,"Braga",3,"Rua de Caires",24,24,0,4,4,0
11,27,2018,8,0,3,"Braga",4,"N14 Bosch",11,46,35,204,48,156
11,27,2018,8,0,3,"Braga",5,"Avenida João Paulo II",38,38,0,9,9,0
11,27,2018,8,0,3,"Braga",6,"Avenida Padre Júlio Fragata",61,61,0,21,21,0
11,27,2018,8,0,3,"Braga",7,"Rua Nova Santa Cruz",29,29,0,104,104,0
11,27,2018,8,0,3,"Braga",8,"Rua Costa Gomes",40,40,0,43,43,0
11,27,2018,9,0,3,"Braga",1,"Avenida da Liberdade",18,25,7,36,26,10
11,27,2018,9,0,3,"Braga",2,"Avenida Central",14,18,4,331,257,74
11,27,2018,9,0,3,"Braga",3,"Rua de Caires",24,24,0,4,4,0
11,27,2018,9,0,3,"Braga",4,"N14 Bosch",23,47,24,97,47,50
11,27,2018,9,0,3,"Braga",5,"Avenida João Paulo II",39,39,0,8,8,0
11,27,2018,9,0,3,"Braga",6,"Avenida Padre Júlio Fragata",20,61,41,66,21,45
11,27,2018,9,0,3,"Braga",7,"Rua Nova Santa Cruz",21,29,8,144,104,40
11,27,2018,9,0,3,"Braga",8,"Rua Costa Gomes",23,41,18,75,42,33
11,27,2018,10,0,3,"Braga",1,"Avenida da Liberdade",24,24,0,27,27,0
11,27,2018,10,0,3,"Braga",2,"Avenida Central",18,18,0,257,257,0
11,27,2018,10,0,3,"Braga",3,"Rua de Caires",24,24,0,4,4,0
11,27,2018,10,0,3,"Braga",4,"N14 Bosch",47,47,0,47,47,0
11,27,2018,10,0,3,"Braga",5,"Avenida João Paulo II",39,39,0,8,8,0
11,27,2018,10,0,3,"Braga",6,"Avenida Padre Júlio Fragata",62,62,0,21,21,0
11,27,2018,10,0,3,"Braga",7,"Rua Nova Santa Cruz",28,28,0,108,108,0
11,27,2018,10,0,3,"Braga",8,"Rua Costa Gomes",41,41,0,42,42,0
11,27,2018,11,0,3,"Braga",1,"Avenida da Liberdade",25,25,0,26,26,0
11,27,2018,11,0,3,"Braga",2,"Avenida Central",14,17,3,331,272,59
11,27,2018,11,0,3,"Braga",3,"Rua de Caires",25,25,0,4,4,0
11,27,2018,11,0,3,"Braga",4,"N14 Bosch",36,47,11,62,47,15
11,27,2018,11,0,3,"Braga",5,"Avenida João Paulo II",39,39,0,8,8,0
11,27,2018,11,0,3,"Braga",6,"Avenida Padre Júlio Fragata",61,61,0,21,21,0
11,27,2018,11,0,3,"Braga",7,"Rua Nova Santa Cruz",23,29,6,132,104,28
11,27,2018,11,0,3,"Braga",8,"Rua Costa Gomes",27,41,14,64,42,22
11,27,2018,12,0,3,"Braga",1,"Avenida da Liberdade",25,25,0,26,26,0
11,27,2018,12,0,3,"Braga",2,"Avenida Central",11,17,6,421,272,149
11,27,2018,12,0,3,"Braga",3,"Rua de Caires",25,25,0,4,4,0
11,27,2018,12,0,3,"Braga",4,"N14 Bosch",37,47,10,60,47,13
11,27,2018,12,0,3,"Braga",5,"Avenida João Paulo II",39,39,0,8,8,0
11,27,2018,12,0,3,"Braga",6,"Avenida Padre Júlio Fragata",61,61,0,21,21,0
11,27,2018,12,0,3,"Braga",7,"Rua Nova Santa Cruz",18,29,11,169,104,65
11,27,2018,12,0,3,"Braga",8,"Rua Costa Gomes",33,41,8,52,42,10
11,27,2018,13,0,3,"Braga",1,"Avenida da Liberdade",25,25,0,26,26,0
11,27,2018,13,0,3,"Braga",2,"Avenida Central",18,18,0,257,257,0
11,27,2018,13,0,3,"Braga",3,"Rua de Caires",25,25,0,4,4,0
11,27,2018,13,0,3,"Braga",4,"N14 Bosch",23,46,23,97,48,49
11,27,2018,13,0,3,"Braga",5,"Avenida João Paulo II",39,39,0,8,8,0
11,27,2018,13,0,3,"Braga",6,"Avenida Padre Júlio Fragata",61,61,0,21,21,0
11,27,2018,13,0,3,"Braga",7,"Rua Nova Santa Cruz",23,29,6,132,104,28
11,27,2018,13,0,3,"Braga",8,"Rua Costa Gomes",31,41,10,55,42,13
11,27,2018,14,0,3,"Braga",1,"Avenida da Liberdade",25,25,0,26,26,0
11,27,2018,14,0,3,"Braga",2,"Avenida Central",14,17,3,331,272,59
11,27,2018,14,0,3,"Braga",3,"Rua de Caires",25,25,0,4,4,0
11,27,2018,14,0,3,"Braga",4,"N14 Bosch",24,47,23,93,47,46
11,27,2018,14,0,3,"Braga",5,"Avenida João Paulo II",39,39,0,8,8,0
11,27,2018,14,0,3,"Braga",6,"Avenida Padre Júlio Fragata",61,61,0,21,21,0
11,27,2018,14,0,3,"Braga",7,"Rua Nova Santa Cruz",28,28,0,108,108,0
11,27,2018,14,0,3,"Braga",8,"Rua Costa Gomes",30,40,10,57,43,14
11,27,2018,15,0,3,"Braga",1,"Avenida da Liberdade",25,25,0,26,26,0
11,27,2018,15,0,3,"Braga",2,"Avenida Central",12,18,6,386,257,129
11,27,2018,15,0,3,"Braga",3,"Rua de Caires",25,25,0,4,4,0
11,27,2018,15,0,3,"Braga",4,"N14 Bosch",23,47,24,97,47,50
11,27,2018,15,0,3,"Braga",5,"Avenida João Paulo II",39,39,0,8,8,0
11,27,2018,15,0,3,"Braga",6,"Avenida Padre Júlio Fragata",45,61,16,29,21,8
11,27,2018,15,0,3,"Braga",7,"Rua Nova Santa Cruz",29,29,0,104,104,0
11,27,2018,15,0,3,"Braga",8,"Rua Costa Gomes",41,41,0,42,42,0
11,27,2018,16,0,3,"Braga",1,"Avenida da Liberdade",25,25,0,26,26,0
11,27,2018,16,0,3,"Braga",2,"Avenida Central",17,17,0,272,272,0
11,27,2018,16,0,3,"Braga",3,"Rua de Caires",25,25,0,4,4,0
11,27,2018,16,0,3,"Braga",4,"N14 Bosch",34,47,13,66,47,19
11,27,2018,16,0,3,"Braga",5,"Avenida João Paulo II",38,38,0,9,9,0
11,27,2018,16,0,3,"Braga",6,"Avenida Padre Júlio Fragata",62,62,0,21,21,0
11,27,2018,16,0,3,"Braga",7,"Rua Nova Santa Cruz",29,29,0,104,104,0
11,27,2018,16,0,3,"Braga",8,"Rua Costa Gomes",28,40,12,61,43,18
11,27,2018,17,0,3,"Braga",1,"Avenida da Liberdade",25,25,0,26,26,0
11,27,2018,17,0,3,"Braga",2,"Avenida Central",11,18,7,421,257,164
11,27,2018,17,0,3,"Braga",3,"Rua de Caires",25,25,0,4,4,0
11,27,2018,17,0,3,"Braga",4,"N14 Bosch",21,46,25,107,48,59
11,27,2018,17,0,3,"Braga",5,"Avenida João Paulo II",31,38,7,11,9,2
11,27,2018,17,0,3,"Braga",6,"Avenida Padre Júlio Fragata",41,62,21,32,21,11
11,27,2018,17,0,3,"Braga",7,"Rua Nova Santa Cruz",17,29,12,179,104,75
11,27,2018,17,0,3,"Braga",8,"Rua Costa Gomes",28,40,12,61,43,18
11,27,2018,18,0,3,"Braga",1,"Avenida da Liberdade",17,24,7,39,27,12
11,27,2018,18,0,3,"Braga",2,"Avenida Central",5,20,15,927,231,696
11,27,2018,18,0,3,"Braga",3,"Rua de Caires",19,24,5,5,4,1
11,27,2018,18,0,3,"Braga",4,"N14 Bosch",14,48,34,160,46,114
11,27,2018,18,0,3,"Braga",5,"Avenida João Paulo II",30,39,9,11,8,3
11,27,2018,18,0,3,"Braga",6,"Avenida Padre Júlio Fragata",27,61,34,49,21,28
11,27,2018,18,0,3,"Braga",7,"Rua Nova Santa Cruz",16,28,12,190,108,82
11,27,2018,18,0,3,"Braga",8,"Rua Costa Gomes",41,41,0,42,42,0
11,27,2018,19,0,3,"Braga",1,"Avenida da Liberdade",17,25,8,39,26,13
11,27,2018,19,0,3,"Braga",2,"Avenida Central",6,18,12,772,257,515
11,27,2018,19,0,3,"Braga",3,"Rua de Caires",24,24,0,4,4,0
11,27,2018,19,0,3,"Braga",4,"N14 Bosch",30,47,17,74,47,27
11,27,2018,19,0,3,"Braga",5,"Avenida João Paulo II",16,38,22,21,9,12
11,27,2018,19,0,3,"Braga",6,"Avenida Padre Júlio Fragata",34,62,28,39,21,18
11,27,2018,19,0,3,"Braga",7,"Rua Nova Santa Cruz",13,28,15,234,108,126
11,27,2018,19,0,3,"Braga",8,"Rua Costa Gomes",41,41,0,42,42,0
11,27,2018,20,0,3,"Braga",1,"Avenida da Liberdade",25,25,0,26,26,0
11,27,2018,20,0,3,"Braga",2,"Avenida Central",11,17,6,421,272,149
11,27,2018,20,0,3,"Braga",3,"Rua de Caires",25,25,0,4,4,0
11,27,2018,20,0,3,"Braga",4,"N14 Bosch",46,46,0,48,48,0
11,27,2018,20,0,3,"Braga",5,"Avenida João Paulo II",39,39,0,8,8,0
11,27,2018,20,0,3,"Braga",6,"Avenida Padre Júlio Fragata",61,61,0,21,21,0
11,27,2018,20,0,3,"Braga",7,"Rua Nova Santa Cruz",22,28,6,138,108,30
11,27,2018,20,0,3,"Braga",8,"Rua Costa Gomes",41,41,0,42,42,0
11,27,2018,21,0,3,"Braga",1,"Avenida da Liberdade",25,25,0,26,26,0
11,27,2018,21,0,3,"Braga",2,"Avenida Central",17,17,0,272,272,0
11,27,2018,21,0,3,"Braga",3,"Rua de Caires",10,25,15,10,4,6
11,27,2018,21,0,3,"Braga",4,"N14 Bosch",46,46,0,48,48,0
11,27,2018,21,0,3,"Braga",5,"Avenida João Paulo II",39,39,0,8,8,0
11,27,2018,21,0,3,"Braga",6,"Avenida Padre Júlio Fragata",49,62,13,27,21,6
11,27,2018,21,0,3,"Braga",7,"Rua Nova Santa Cruz",17,29,12,179,104,75
11,27,2018,21,0,3,"Braga",8,"Rua Costa Gomes",22,41,19,78,42,36
11,27,2018,22,0,3,"Braga",1,"Avenida da Liberdade",25,25,0,26,26,0
11,27,2018,22,0,3,"Braga",2,"Avenida Central",17,17,0,272,272,0
11,27,2018,22,0,3,"Braga",3,"Rua de Caires",24,24,0,4,4,0
11,27,2018,22,0,3,"Braga",4,"N14 Bosch",46,46,0,48,48,0
11,27,2018,22,0,3,"Braga",5,"Avenida João Paulo II",39,39,0,8,8,0
11,27,2018,22,0,3,"Braga",6,"Avenida Padre Júlio Fragata",62,62,0,21,21,0
11,27,2018,22,0,3,"Braga",7,"Rua Nova Santa Cruz",29,29,0,104,104,0
11,27,2018,22,0,3,"Braga",8,"Rua Costa Gomes",40,40,0,43,43,0
11,27,2018,23,0,3,"Braga",1,"Avenida da Liberdade",25,25,0,26,26,0
11,27,2018,23,0,3,"Braga",2,"Avenida Central",17,17,0,272,272,0
11,27,2018,23,0,3,"Braga",3,"Rua de Caires",24,24,0,4,4,0
11,27,2018,23,0,3,"Braga",4,"N14 Bosch",46,46,0,48,48,0
11,27,2018,23,0,3,"Braga",5,"Avenida João Paulo II",39,39,0,8,8,0
11,27,2018,23,0,3,"Braga",6,"Avenida Padre Júlio Fragata",62,62,0,21,21,0
11,27,2018,23,0,3,"Braga",7,"Rua Nova Santa Cruz",29,29,0,104,104,0
11,27,2018,23,0,3,"Braga",8,"Rua Costa Gomes",40,40,0,43,43,0
11,28,2018,0,0,4,"Braga",1,"Avenida da Liberdade",25,25,0,26,26,0
11,28,2018,0,0,4,"Braga",2,"Avenida Central",17,17,0,272,272,0
11,28,2018,0,0,4,"Braga",3,"Rua de Caires",24,24,0,4,4,0
11,28,2018,0,0,4,"Braga",4,"N14 Bosch",46,46,0,48,48,0
11,28,2018,0,0,4,"Braga",5,"Avenida João Paulo II",31,38,7,11,9,2
11,28,2018,0,0,4,"Braga",6,"Avenida Padre Júlio Fragata",61,61,0,21,21,0
11,28,2018,0,0,4,"Braga",7,"Rua Nova Santa Cruz",29,29,0,104,104,0
11,28,2018,0,0,4,"Braga",8,"Rua Costa Gomes",40,40,0,43,43,0
11,28,2018,1,0,4,"Braga",1,"Avenida da Liberdade",25,25,0,26,26,0
11,28,2018,1,0,4,"Braga",2,"Avenida Central",17,17,0,272,272,0
11,28,2018,1,0,4,"Braga",3,"Rua de Caires",24,24,0,4,4,0
11,28,2018,1,0,4,"Braga",4,"N14 Bosch",46,46,0,48,48,0
11,28,2018,1,0,4,"Braga",5,"Avenida João Paulo II",38,38,0,9,9,0
11,28,2018,1,0,4,"Braga",6,"Avenida Padre Júlio Fragata",61,61,0,21,21,0
11,28,2018,1,0,4,"Braga",7,"Rua Nova Santa Cruz",29,29,0,104,104,0
11,28,2018,1,0,4,"Braga",8,"Rua Costa Gomes",40,40,0,43,43,0
11,28,2018,2,0,4,"Braga",1,"Avenida da Liberdade",25,25,0,26,26,0
11,28,2018,2,0,4,"Braga",2,"Avenida Central",17,17,0,272,272,0
11,28,2018,2,0,4,"Braga",3,"Rua de Caires",24,24,0,4,4,0
11,28,2018,2,0,4,"Braga",4,"N14 Bosch",46,46,0,48,48,0
11,28,2018,2,0,4,"Braga",5,"Avenida João Paulo II",38,38,0,9,9,0
11,28,2018,2,0,4,"Braga",6,"Avenida Padre Júlio Fragata",61,61,0,21,21,0
11,28,2018,2,0,4,"Braga",7,"Rua Nova Santa Cruz",29,29,0,104,104,0
11,28,2018,2,0,4,"Braga",8,"Rua Costa Gomes",40,40,0,43,43,0
11,28,2018,3,0,4,"Braga",1,"Avenida da Liberdade",25,25,0,26,26,0
11,28,2018,3,0,4,"Braga",2,"Avenida Central",17,17,0,272,272,0
11,28,2018,3,0,4,"Braga",3,"Rua de Caires",24,24,0,4,4,0
11,28,2018,3,0,4,"Braga",4,"N14 Bosch",46,46,0,48,48,0
11,28,2018,3,0,4,"Braga",5,"Avenida João Paulo II",38,38,0,9,9,0
11,28,2018,3,0,4,"Braga",6,"Avenida Padre Júlio Fragata",61,61,0,21,21,0
11,28,2018,3,0,4,"Braga",7,"Rua Nova Santa Cruz",29,29,0,104,104,0
11,28,2018,3,0,4,"Braga",8,"Rua Costa Gomes",40,40,0,43,43,0
11,28,2018,4,0,4,"Braga",1,"Avenida da Liberdade",25,25,0,26,26,0
11,28,2018,4,0,4,"Braga",2,"Avenida Central",17,17,0,272,272,0
11,28,2018,4,0,4,"Braga",3,"Rua de Caires",24,24,0,4,4,0
11,28,2018,4,0,4,"Braga",4,"N14 Bosch",46,46,0,48,48,0
11,28,2018,4,0,4,"Braga",5,"Avenida João Paulo II",38,38,0,9,9,0
11,28,2018,4,0,4,"Braga",6,"Avenida Padre Júlio Fragata",61,61,0,21,21,0
11,28,2018,4,0,4,"Braga",7,"Rua Nova Santa Cruz",29,29,0,104,104,0
11,28,2018,4,0,4,"Braga",8,"Rua Costa Gomes",40,40,0,43,43,0
11,28,2018,5,0,4,"Braga",1,"Avenida da Liberdade",25,25,0,26,26,0
11,28,2018,5,0,4,"Braga",2,"Avenida Central",17,17,0,272,272,0
11,28,2018,5,0,4,"Braga",3,"Rua de Caires",24,24,0,4,4,0
11,28,2018,5,0,4,"Braga",4,"N14 Bosch",46,46,0,48,48,0
11,28,2018,5,0,4,"Braga",5,"Avenida João Paulo II",38,38,0,9,9,0
11,28,2018,5,0,4,"Braga",6,"Avenida Padre Júlio Fragata",61,61,0,21,21,0
11,28,2018,5,0,4,"Braga",7,"Rua Nova Santa Cruz",29,29,0,104,104,0
11,28,2018,5,0,4,"Braga",8,"Rua Costa Gomes",40,40,0,43,43,0
11,28,2018,6,0,4,"Braga",1,"Avenida da Liberdade",25,25,0,26,26,0
11,28,2018,6,0,4,"Braga",2,"Avenida Central",17,17,0,272,272,0
11,28,2018,6,0,4,"Braga",3,"Rua de Caires",24,24,0,4,4,0
11,28,2018,6,0,4,"Braga",4,"N14 Bosch",46,46,0,48,48,0
11,28,2018,6,0,4,"Braga",5,"Avenida João Paulo II",38,38,0,9,9,0
11,28,2018,6,0,4,"Braga",6,"Avenida Padre Júlio Fragata",61,61,0,21,21,0
11,28,2018,6,0,4,"Braga",7,"Rua Nova Santa Cruz",29,29,0,104,104,0
11,28,2018,6,0,4,"Braga",8,"Rua Costa Gomes",40,40,0,43,43,0
11,28,2018,7,0,4,"Braga",1,"Avenida da Liberdade",25,25,0,26,26,0
11,28,2018,7,0,4,"Braga",2,"Avenida Central",17,17,0,272,272,0
11,28,2018,7,0,4,"Braga",3,"Rua de Caires",24,24,0,4,4,0
11,28,2018,7,0,4,"Braga",4,"N14 Bosch",46,46,0,48,48,0
11,28,2018,7,0,4,"Braga",5,"Avenida João Paulo II",38,38,0,9,9,0
11,28,2018,7,0,4,"Braga",6,"Avenida Padre Júlio Fragata",61,61,0,21,21,0
11,28,2018,7,0,4,"Braga",7,"Rua Nova Santa Cruz",29,29,0,104,104,0
11,28,2018,7,0,4,"Braga",8,"Rua Costa Gomes",40,40,0,43,43,0
11,28,2018,8,0,4,"Braga",1,"Avenida da Liberdade",25,25,0,26,26,0
11,28,2018,8,0,4,"Braga",2,"Avenida Central",17,17,0,272,272,0
11,28,2018,8,0,4,"Braga",3,"Rua de Caires",24,24,0,4,4,0
11,28,2018,8,0,4,"Braga",4,"N14 Bosch",33,47,14,68,47,21
11,28,2018,8,0,4,"Braga",5,"Avenida João Paulo II",38,38,0,9,9,0
11,28,2018,8,0,4,"Braga",6,"Avenida Padre Júlio Fragata",61,61,0,21,21,0
11,28,2018,8,0,4,"Braga",7,"Rua Nova Santa Cruz",29,29,0,104,104,0
11,28,2018,8,0,4,"Braga",8,"Rua Costa Gomes",40,40,0,43,43,0
11,28,2018,9,0,4,"Braga",1,"Avenida da Liberdade",18,25,7,36,26,10
11,28,2018,9,0,4,"Braga",2,"Avenida Central",10,18,8,463,257,206
11,28,2018,9,0,4,"Braga",3,"Rua de Caires",17,24,7,6,4,2
11,28,2018,9,0,4,"Braga",4,"N14 Bosch",46,46,0,48,48,0
11,28,2018,9,0,4,"Braga",5,"Avenida João Paulo II",38,38,0,9,9,0
11,28,2018,9,0,4,"Braga",6,"Avenida Padre Júlio Fragata",36,61,25,36,21,15
11,28,2018,9,0,4,"Braga",7,"Rua Nova Santa Cruz",29,29,0,104,104,0
11,28,2018,9,0,4,"Braga",8,"Rua Costa Gomes",31,40,9,55,43,12
11,28,2018,10,0,4,"Braga",1,"Avenida da Liberdade",20,25,5,33,26,7
11,28,2018,10,0,4,"Braga",2,"Avenida Central",17,17,0,272,272,0
11,28,2018,10,0,4,"Braga",3,"Rua de Caires",24,24,0,4,4,0
11,28,2018,10,0,4,"Braga",4,"N14 Bosch",31,46,15,72,48,24
11,28,2018,10,0,4,"Braga",5,"Avenida João Paulo II",39,39,0,8,8,0
11,28,2018,10,0,4,"Braga",6,"Avenida Padre Júlio Fragata",62,62,0,21,21,0
11,28,2018,10,0,4,"Braga",7,"Rua Nova Santa Cruz",23,29,6,132,104,28
11,28,2018,10,0,4,"Braga",8,"Rua Costa Gomes",32,40,8,54,43,11
11,28,2018,11,0,4,"Braga",1,"Avenida da Liberdade",20,25,5,33,26,7
11,28,2018,11,0,4,"Braga",2,"Avenida Central",12,18,6,386,257,129
11,28,2018,11,0,4,"Braga",3,"Rua de Caires",24,24,0,4,4,0
11,28,2018,11,0,4,"Braga",4,"N14 Bosch",8,46,38,281,48,233
11,28,2018,11,0,4,"Braga",5,"Avenida João Paulo II",38,38,0,9,9,0
11,28,2018,11,0,4,"Braga",6,"Avenida Padre Júlio Fragata",62,62,0,21,21,0
11,28,2018,11,0,4,"Braga",7,"Rua Nova Santa Cruz",29,29,0,104,104,0
11,28,2018,11,0,4,"Braga",8,"Rua Costa Gomes",32,41,9,54,42,12
11,28,2018,12,0,4,"Braga",1,"Avenida da Liberdade",25,25,0,26,26,0
11,28,2018,12,0,4,"Braga",2,"Avenida Central",18,18,0,257,257,0
11,28,2018,12,0,4,"Braga",3,"Rua de Caires",24,24,0,4,4,0
11,28,2018,12,0,4,"Braga",4,"N14 Bosch",47,47,0,47,47,0
11,28,2018,12,0,4,"Braga",5,"Avenida João Paulo II",38,38,0,9,9,0
11,28,2018,12,0,4,"Braga",6,"Avenida Padre Júlio Fragata",61,61,0,21,21,0
11,28,2018,12,0,4,"Braga",7,"Rua Nova Santa Cruz",29,29,0,104,104,0
11,28,2018,12,0,4,"Braga",8,"Rua Costa Gomes",41,41,0,42,42,0
11,28,2018,13,0,4,"Braga",1,"Avenida da Liberdade",25,25,0,26,26,0
11,28,2018,13,0,4,"Braga",2,"Avenida Central",10,17,7,463,272,191
11,28,2018,13,0,4,"Braga",3,"Rua de Caires",4,25,21,26,4,22
11,28,2018,13,0,4,"Braga",4,"N14 Bosch",24,46,22,93,48,45
11,28,2018,13,0,4,"Braga",5,"Avenida João Paulo II",38,38,0,9,9,0
11,28,2018,13,0,4,"Braga",6,"Avenida Padre Júlio Fragata",61,61,0,21,21,0
11,28,2018,13,0,4,"Braga",7,"Rua Nova Santa Cruz",20,29,9,152,104,48
11,28,2018,13,0,4,"Braga",8,"Rua Costa Gomes",41,41,0,42,42,0
11,28,2018,14,0,4,"Braga",1,"Avenida da Liberdade",25,25,0,26,26,0
11,28,2018,14,0,4,"Braga",2,"Avenida Central",12,17,5,386,272,114
11,28,2018,14,0,4,"Braga",3,"Rua de Caires",25,25,0,4,4,0
11,28,2018,14,0,4,"Braga",4,"N14 Bosch",24,46,22,93,48,45
11,28,2018,14,0,4,"Braga",5,"Avenida João Paulo II",39,39,0,8,8,0
11,28,2018,14,0,4,"Braga",6,"Avenida Padre Júlio Fragata",34,62,28,39,21,18
11,28,2018,14,0,4,"Braga",7,"Rua Nova Santa Cruz",21,29,8,144,104,40
11,28,2018,14,0,4,"Braga",8,"Rua Costa Gomes",29,40,11,59,43,16
11,28,2018,15,0,4,"Braga",1,"Avenida da Liberdade",25,25,0,26,26,0
11,28,2018,15,0,4,"Braga",2,"Avenida Central",14,17,3,331,272,59
11,28,2018,15,0,4,"Braga",3,"Rua de Caires",25,25,0,4,4,0
11,28,2018,15,0,4,"Braga",4,"N14 Bosch",27,46,19,83,48,35
11,28,2018,15,0,4,"Braga",5,"Avenida João Paulo II",39,39,0,8,8,0
11,28,2018,15,0,4,"Braga",6,"Avenida Padre Júlio Fragata",62,62,0,21,21,0
11,28,2018,15,0,4,"Braga",7,"Rua Nova Santa Cruz",21,29,8,144,104,40
11,28,2018,15,0,4,"Braga",8,"Rua Costa Gomes",41,41,0,42,42,0
11,28,2018,16,0,4,"Braga",1,"Avenida da Liberdade",25,25,0,26,26,0
11,28,2018,16,0,4,"Braga",2,"Avenida Central",18,18,0,257,257,0
11,28,2018,16,0,4,"Braga",3,"Rua de Caires",25,25,0,4,4,0
11,28,2018,16,0,4,"Braga",4,"N14 Bosch",21,47,26,107,47,60
11,28,2018,16,0,4,"Braga",5,"Avenida João Paulo II",38,38,0,9,9,0
11,28,2018,16,0,4,"Braga",6,"Avenida Padre Júlio Fragata",61,61,0,21,21,0
11,28,2018,16,0,4,"Braga",7,"Rua Nova Santa Cruz",18,29,11,169,104,65
11,28,2018,16,0,4,"Braga",8,"Rua Costa Gomes",29,40,11,59,43,16
11,28,2018,17,0,4,"Braga",1,"Avenida da Liberdade",20,25,5,33,26,7
11,28,2018,17,0,4,"Braga",2,"Avenida Central",10,17,7,463,272,191
11,28,2018,17,0,4,"Braga",3,"Rua de Caires",19,24,5,5,4,1
11,28,2018,17,0,4,"Braga",4,"N14 Bosch",23,46,23,97,48,49
11,28,2018,17,0,4,"Braga",5,"Avenida João Paulo II",25,39,14,13,8,5
11,28,2018,17,0,4,"Braga",6,"Avenida Padre Júlio Fragata",62,62,0,21,21,0
11,28,2018,17,0,4,"Braga",7,"Rua Nova Santa Cruz",22,29,7,138,104,34
11,28,2018,17,0,4,"Braga",8,"Rua Costa Gomes",40,40,0,43,43,0
11,28,2018,18,0,4,"Braga",1,"Avenida da Liberdade",18,25,7,36,26,10
11,28,2018,18,0,4,"Braga",2,"Avenida Central",7,17,10,662,272,390
11,28,2018,18,0,4,"Braga",3,"Rua de Caires",15,25,10,6,4,2
11,28,2018,18,0,4,"Braga",4,"N14 Bosch",17,47,30,132,47,85
11,28,2018,18,0,4,"Braga",5,"Avenida João Paulo II",29,39,10,12,8,4
11,28,2018,18,0,4,"Braga",6,"Avenida Padre Júlio Fragata",28,62,34,47,21,26
11,28,2018,18,0,4,"Braga",7,"Rua Nova Santa Cruz",21,28,7,144,108,36
11,28,2018,18,0,4,"Braga",8,"Rua Costa Gomes",16,41,25,108,42,66
11,28,2018,19,0,4,"Braga",1,"Avenida da Liberdade",24,24,0,27,27,0
11,28,2018,19,0,4,"Braga",2,"Avenida Central",11,18,7,421,257,164
11,28,2018,19,0,4,"Braga",3,"Rua de Caires",24,24,0,4,4,0
11,28,2018,19,0,4,"Braga",4,"N14 Bosch",20,48,28,112,46,66
11,28,2018,19,0,4,"Braga",5,"Avenida João Paulo II",39,39,0,8,8,0
11,28,2018,19,0,4,"Braga",6,"Avenida Padre Júlio Fragata",30,61,31,44,21,23
11,28,2018,19,0,4,"Braga",7,"Rua Nova Santa Cruz",16,28,12,190,108,82
11,28,2018,19,0,4,"Braga",8,"Rua Costa Gomes",9,41,32,192,42,150
11,28,2018,20,0,4,"Braga",1,"Avenida da Liberdade",25,25,0,26,26,0
11,28,2018,20,0,4,"Braga",2,"Avenida Central",18,18,0,257,257,0
11,28,2018,20,0,4,"Braga",3,"Rua de Caires",24,24,0,4,4,0
11,28,2018,20,0,4,"Braga",4,"N14 Bosch",46,46,0,48,48,0
11,28,2018,20,0,4,"Braga",5,"Avenida João Paulo II",39,39,0,8,8,0
11,28,2018,20,0,4,"Braga",6,"Avenida Padre Júlio Fragata",62,62,0,21,21,0
11,28,2018,20,0,4,"Braga",7,"Rua Nova Santa Cruz",22,29,7,138,104,34
11,28,2018,20,0,4,"Braga",8,"Rua Costa Gomes",32,41,9,54,42,12
11,28,2018,21,0,4,"Braga",1,"Avenida da Liberdade",25,25,0,26,26,0
11,28,2018,21,0,4,"Braga",2,"Avenida Central",17,17,0,272,272,0
11,28,2018,21,0,4,"Braga",3,"Rua de Caires",24,24,0,4,4,0
11,28,2018,21,0,4,"Braga",4,"N14 Bosch",46,46,0,48,48,0
11,28,2018,21,0,4,"Braga",5,"Avenida João Paulo II",39,39,0,8,8,0
11,28,2018,21,0,4,"Braga",6,"Avenida Padre Júlio Fragata",62,62,0,21,21,0
11,28,2018,21,0,4,"Braga",7,"Rua Nova Santa Cruz",29,29,0,104,104,0
11,28,2018,21,0,4,"Braga",8,"Rua Costa Gomes",41,41,0,42,42,0
11,28,2018,22,0,4,"Braga",1,"Avenida da Liberdade",25,25,0,26,26,0
11,28,2018,22,0,4,"Braga",2,"Avenida Central",17,17,0,272,272,0
11,28,2018,22,0,4,"Braga",3,"Rua de Caires",24,24,0,4,4,0
11,28,2018,22,0,4,"Braga",4,"N14 Bosch",46,46,0,48,48,0
11,28,2018,22,0,4,"Braga",5,"Avenida João Paulo II",39,39,0,8,8,0
11,28,2018,22,0,4,"Braga",6,"Avenida Padre Júlio Fragata",62,62,0,21,21,0
11,28,2018,22,0,4,"Braga",7,"Rua Nova Santa Cruz",29,29,0,104,104,0
11,28,2018,22,0,4,"Braga",8,"Rua Costa Gomes",41,41,0,42,42,0
11,28,2018,23,0,4,"Braga",1,"Avenida da Liberdade",25,25,0,26,26,0
11,28,2018,23,0,4,"Braga",2,"Avenida Central",17,17,0,272,272,0
11,28,2018,23,0,4,"Braga",3,"Rua de Caires",24,24,0,4,4,0
11,28,2018,23,0,4,"Braga",4,"N14 Bosch",46,46,0,48,48,0
11,28,2018,23,0,4,"Braga",5,"Avenida João Paulo II",39,39,0,8,8,0
11,28,2018,23,0,4,"Braga",6,"Avenida Padre Júlio Fragata",62,62,0,21,21,0
11,28,2018,23,0,4,"Braga",7,"Rua Nova Santa Cruz",29,29,0,104,104,0
11,28,2018,23,0,4,"Braga",8,"Rua Costa Gomes",41,41,0,42,42,0
11,29,2018,0,0,5,"Braga",1,"Avenida da Liberdade",25,25,0,26,26,0
11,29,2018,0,0,5,"Braga",2,"Avenida Central",17,17,0,272,272,0
11,29,2018,0,0,5,"Braga",3,"Rua de Caires",24,24,0,4,4,0
11,29,2018,0,0,5,"Braga",4,"N14 Bosch",46,46,0,48,48,0
11,29,2018,0,0,5,"Braga",5,"Avenida João Paulo II",39,39,0,8,8,0
11,29,2018,0,0,5,"Braga",6,"Avenida Padre Júlio Fragata",62,62,0,21,21,0
11,29,2018,0,0,5,"Braga",7,"Rua Nova Santa Cruz",29,29,0,104,104,0
11,29,2018,0,0,5,"Braga",8,"Rua Costa Gomes",41,41,0,42,42,0
11,29,2018,1,0,5,"Braga",1,"Avenida da Liberdade",25,25,0,26,26,0
11,29,2018,1,0,5,"Braga",2,"Avenida Central",17,17,0,272,272,0
11,29,2018,1,0,5,"Braga",3,"Rua de Caires",24,24,0,4,4,0
11,29,2018,1,0,5,"Braga",4,"N14 Bosch",47,47,0,47,47,0
11,29,2018,1,0,5,"Braga",5,"Avenida João Paulo II",39,39,0,8,8,0
11,29,2018,1,0,5,"Braga",6,"Avenida Padre Júlio Fragata",62,62,0,21,21,0
11,29,2018,1,0,5,"Braga",7,"Rua Nova Santa Cruz",29,29,0,104,104,0
11,29,2018,1,0,5,"Braga",8,"Rua Costa Gomes",41,41,0,42,42,0
11,29,2018,2,0,5,"Braga",1,"Avenida da Liberdade",25,25,0,26,26,0
11,29,2018,2,0,5,"Braga",2,"Avenida Central",17,17,0,272,272,0
11,29,2018,2,0,5,"Braga",3,"Rua de Caires",24,24,0,4,4,0
11,29,2018,2,0,5,"Braga",4,"N14 Bosch",47,47,0,47,47,0
11,29,2018,2,0,5,"Braga",5,"Avenida João Paulo II",39,39,0,8,8,0
11,29,2018,2,0,5,"Braga",6,"Avenida Padre Júlio Fragata",62,62,0,21,21,0
11,29,2018,2,0,5,"Braga",7,"Rua Nova Santa Cruz",29,29,0,104,104,0
11,29,2018,2,0,5,"Braga",8,"Rua Costa Gomes",41,41,0,42,42,0
11,29,2018,3,0,5,"Braga",1,"Avenida da Liberdade",25,25,0,26,26,0
11,29,2018,3,0,5,"Braga",2,"Avenida Central",17,17,0,272,272,0
11,29,2018,3,0,5,"Braga",3,"Rua de Caires",24,24,0,4,4,0
11,29,2018,3,0,5,"Braga",4,"N14 Bosch",47,47,0,47,47,0
11,29,2018,3,0,5,"Braga",5,"Avenida João Paulo II",39,39,0,8,8,0
11,29,2018,3,0,5,"Braga",6,"Avenida Padre Júlio Fragata",62,62,0,21,21,0
11,29,2018,3,0,5,"Braga",7,"Rua Nova Santa Cruz",29,29,0,104,104,0
11,29,2018,3,0,5,"Braga",8,"Rua Costa Gomes",41,41,0,42,42,0
11,29,2018,4,0,5,"Braga",1,"Avenida da Liberdade",25,25,0,26,26,0
11,29,2018,4,0,5,"Braga",2,"Avenida Central",17,17,0,272,272,0
11,29,2018,4,0,5,"Braga",3,"Rua de Caires",24,24,0,4,4,0
11,29,2018,4,0,5,"Braga",4,"N14 Bosch",47,47,0,47,47,0
11,29,2018,4,0,5,"Braga",5,"Avenida João Paulo II",39,39,0,8,8,0
11,29,2018,4,0,5,"Braga",6,"Avenida Padre Júlio Fragata",62,62,0,21,21,0
11,29,2018,4,0,5,"Braga",7,"Rua Nova Santa Cruz",29,29,0,104,104,0
11,29,2018,4,0,5,"Braga",8,"Rua Costa Gomes",41,41,0,42,42,0
11,29,2018,5,0,5,"Braga",1,"Avenida da Liberdade",25,25,0,26,26,0
11,29,2018,5,0,5,"Braga",2,"Avenida Central",17,17,0,272,272,0
11,29,2018,5,0,5,"Braga",3,"Rua de Caires",24,24,0,4,4,0
11,29,2018,5,0,5,"Braga",4,"N14 Bosch",47,47,0,47,47,0
11,29,2018,5,0,5,"Braga",5,"Avenida João Paulo II",39,39,0,8,8,0
11,29,2018,5,0,5,"Braga",6,"Avenida Padre Júlio Fragata",62,62,0,21,21,0
11,29,2018,5,0,5,"Braga",7,"Rua Nova Santa Cruz",29,29,0,104,104,0
11,29,2018,5,0,5,"Braga",8,"Rua Costa Gomes",41,41,0,42,42,0
11,29,2018,6,0,5,"Braga",1,"Avenida da Liberdade",25,25,0,26,26,0
11,29,2018,6,0,5,"Braga",2,"Avenida Central",17,17,0,272,272,0
11,29,2018,6,0,5,"Braga",3,"Rua de Caires",24,24,0,4,4,0
11,29,2018,6,0,5,"Braga",4,"N14 Bosch",47,47,0,47,47,0
11,29,2018,6,0,5,"Braga",5,"Avenida João Paulo II",39,39,0,8,8,0
11,29,2018,6,0,5,"Braga",6,"Avenida Padre Júlio Fragata",62,62,0,21,21,0
11,29,2018,6,0,5,"Braga",7,"Rua Nova Santa Cruz",29,29,0,104,104,0
11,29,2018,6,0,5,"Braga",8,"Rua Costa Gomes",41,41,0,42,42,0
11,29,2018,7,0,5,"Braga",1,"Avenida da Liberdade",25,25,0,26,26,0
11,29,2018,7,0,5,"Braga",2,"Avenida Central",17,17,0,272,272,0
11,29,2018,7,0,5,"Braga",3,"Rua de Caires",24,24,0,4,4,0
11,29,2018,7,0,5,"Braga",4,"N14 Bosch",47,47,0,47,47,0
11,29,2018,7,0,5,"Braga",5,"Avenida João Paulo II",39,39,0,8,8,0
11,29,2018,7,0,5,"Braga",6,"Avenida Padre Júlio Fragata",62,62,0,21,21,0
11,29,2018,7,0,5,"Braga",7,"Rua Nova Santa Cruz",29,29,0,104,104,0
11,29,2018,7,0,5,"Braga",8,"Rua Costa Gomes",41,41,0,42,42,0
11,29,2018,8,0,5,"Braga",1,"Avenida da Liberdade",20,25,5,33,26,7
11,29,2018,8,0,5,"Braga",2,"Avenida Central",17,17,0,272,272,0
11,29,2018,8,0,5,"Braga",3,"Rua de Caires",24,24,0,4,4,0
11,29,2018,8,0,5,"Braga",4,"N14 Bosch",34,47,13,66,47,19
11,29,2018,8,0,5,"Braga",5,"Avenida João Paulo II",39,39,0,8,8,0
11,29,2018,8,0,5,"Braga",6,"Avenida Padre Júlio Fragata",62,62,0,21,21,0
11,29,2018,8,0,5,"Braga",7,"Rua Nova Santa Cruz",29,29,0,104,104,0
11,29,2018,8,0,5,"Braga",8,"Rua Costa Gomes",32,41,9,54,42,12
11,29,2018,9,0,5,"Braga",1,"Avenida da Liberdade",18,24,6,36,27,9
11,29,2018,9,0,5,"Braga",2,"Avenida Central",11,18,7,421,257,164
11,29,2018,9,0,5,"Braga",3,"Rua de Caires",11,25,14,9,4,5
11,29,2018,9,0,5,"Braga",4,"N14 Bosch",23,47,24,97,47,50
11,29,2018,9,0,5,"Braga",5,"Avenida João Paulo II",13,39,26,26,8,18
11,29,2018,9,0,5,"Braga",6,"Avenida Padre Júlio Fragata",25,62,37,53,21,32
11,29,2018,9,0,5,"Braga",7,"Rua Nova Santa Cruz",29,29,0,104,104,0
11,29,2018,9,0,5,"Braga",8,"Rua Costa Gomes",22,41,19,78,42,36
11,29,2018,10,0,5,"Braga",1,"Avenida da Liberdade",20,25,5,33,26,7
11,29,2018,10,0,5,"Braga",2,"Avenida Central",10,17,7,463,272,191
11,29,2018,10,0,5,"Braga",3,"Rua de Caires",26,26,0,4,4,0
11,29,2018,10,0,5,"Braga",4,"N14 Bosch",29,46,17,77,48,29
11,29,2018,10,0,5,"Braga",5,"Avenida João Paulo II",27,39,12,12,8,4
11,29,2018,10,0,5,"Braga",6,"Avenida Padre Júlio Fragata",48,62,14,27,21,6
11,29,2018,10,0,5,"Braga",7,"Rua Nova Santa Cruz",18,29,11,169,104,65
11,29,2018,10,0,5,"Braga",8,"Rua Costa Gomes",30,41,11,57,42,15
11,29,2018,11,0,5,"Braga",1,"Avenida da Liberdade",19,24,5,34,27,7
11,29,2018,11,0,5,"Braga",2,"Avenida Central",9,18,9,515,257,258
11,29,2018,11,0,5,"Braga",3,"Rua de Caires",23,23,0,4,4,0
11,29,2018,11,0,5,"Braga",4,"N14 Bosch",46,46,0,48,48,0
11,29,2018,11,0,5,"Braga",5,"Avenida João Paulo II",28,39,11,12,8,4
11,29,2018,11,0,5,"Braga",6,"Avenida Padre Júlio Fragata",62,62,0,21,21,0
11,29,2018,11,0,5,"Braga",7,"Rua Nova Santa Cruz",29,29,0,104,104,0
11,29,2018,11,0,5,"Braga",8,"Rua Costa Gomes",30,40,10,57,43,14
11,29,2018,12,0,5,"Braga",1,"Avenida da Liberdade",19,25,6,34,26,8
11,29,2018,12,0,5,"Braga",2,"Avenida Central",12,17,5,386,272,114
11,29,2018,12,0,5,"Braga",3,"Rua de Caires",23,23,0,4,4,0
11,29,2018,12,0,5,"Braga",4,"N14 Bosch",34,46,12,66,48,18
11,29,2018,12,0,5,"Braga",5,"Avenida João Paulo II",39,39,0,8,8,0
11,29,2018,12,0,5,"Braga",6,"Avenida Padre Júlio Fragata",62,62,0,21,21,0
11,29,2018,12,0,5,"Braga",7,"Rua Nova Santa Cruz",29,29,0,104,104,0
11,29,2018,12,0,5,"Braga",8,"Rua Costa Gomes",41,41,0,42,42,0
11,29,2018,13,0,5,"Braga",1,"Avenida da Liberdade",24,24,0,27,27,0
11,29,2018,13,0,5,"Braga",2,"Avenida Central",12,17,5,386,272,114
11,29,2018,13,0,5,"Braga",3,"Rua de Caires",20,25,5,5,4,1
11,29,2018,13,0,5,"Braga",4,"N14 Bosch",22,47,25,102,47,55
11,29,2018,13,0,5,"Braga",5,"Avenida João Paulo II",39,39,0,8,8,0
11,29,2018,13,0,5,"Braga",6,"Avenida Padre Júlio Fragata",49,61,12,27,21,6
11,29,2018,13,0,5,"Braga",7,"Rua Nova Santa Cruz",29,29,0,104,104,0
11,29,2018,13,0,5,"Braga",8,"Rua Costa Gomes",41,41,0,42,42,0
11,29,2018,14,0,5,"Braga",1,"Avenida da Liberdade",9,24,15,73,27,46
11,29,2018,14,0,5,"Braga",2,"Avenida Central",12,18,6,386,257,129
11,29,2018,14,0,5,"Braga",3,"Rua de Caires",25,25,0,4,4,0
11,29,2018,14,0,5,"Braga",4,"N14 Bosch",33,46,13,68,48,20
11,29,2018,14,0,5,"Braga",5,"Avenida João Paulo II",38,38,0,9,9,0
11,29,2018,14,0,5,"Braga",6,"Avenida Padre Júlio Fragata",39,62,23,34,21,13
11,29,2018,14,0,5,"Braga",7,"Rua Nova Santa Cruz",28,28,0,108,108,0
11,29,2018,14,0,5,"Braga",8,"Rua Costa Gomes",32,41,9,54,42,12
11,29,2018,15,0,5,"Braga",1,"Avenida da Liberdade",25,25,0,26,26,0
11,29,2018,15,0,5,"Braga",2,"Avenida Central",11,18,7,421,257,164
11,29,2018,15,0,5,"Braga",3,"Rua de Caires",25,25,0,4,4,0
11,29,2018,15,0,5,"Braga",4,"N14 Bosch",47,47,0,47,47,0
11,29,2018,15,0,5,"Braga",5,"Avenida João Paulo II",38,38,0,9,9,0
11,29,2018,15,0,5,"Braga",6,"Avenida Padre Júlio Fragata",39,62,23,34,21,13
11,29,2018,15,0,5,"Braga",7,"Rua Nova Santa Cruz",23,29,6,132,104,28
11,29,2018,15,0,5,"Braga",8,"Rua Costa Gomes",31,41,10,55,42,13
11,29,2018,16,0,5,"Braga",1,"Avenida da Liberdade",19,24,5,34,27,7
11,29,2018,16,0,5,"Braga",2,"Avenida Central",9,17,8,515,272,243
11,29,2018,16,0,5,"Braga",3,"Rua de Caires",19,24,5,5,4,1
11,29,2018,16,0,5,"Braga",4,"N14 Bosch",28,47,19,80,47,33
11,29,2018,16,0,5,"Braga",5,"Avenida João Paulo II",30,39,9,11,8,3
11,29,2018,16,0,5,"Braga",6,"Avenida Padre Júlio Fragata",46,62,16,28,21,7
11,29,2018,16,0,5,"Braga",7,"Rua Nova Santa Cruz",17,28,11,179,108,71
11,29,2018,16,0,5,"Braga",8,"Rua Costa Gomes",29,41,12,59,42,17
11,29,2018,17,0,5,"Braga",1,"Avenida da Liberdade",25,25,0,26,26,0
11,29,2018,17,0,5,"Braga",2,"Avenida Central",11,18,7,421,257,164
11,29,2018,17,0,5,"Braga",3,"Rua de Caires",24,24,0,4,4,0
11,29,2018,17,0,5,"Braga",4,"N14 Bosch",33,46,13,68,48,20
11,29,2018,17,0,5,"Braga",5,"Avenida João Paulo II",24,39,15,14,8,6
11,29,2018,17,0,5,"Braga",6,"Avenida Padre Júlio Fragata",47,62,15,28,21,7
11,29,2018,17,0,5,"Braga",7,"Rua Nova Santa Cruz",19,29,10,160,104,56
11,29,2018,17,0,5,"Braga",8,"Rua Costa Gomes",21,41,20,82,42,40
11,29,2018,18,0,5,"Braga",1,"Avenida da Liberdade",12,25,13,55,26,29
11,29,2018,18,0,5,"Braga",2,"Avenida Central",7,19,12,662,244,418
11,29,2018,18,0,5,"Braga",3,"Rua de Caires",28,28,0,3,3,0
11,29,2018,18,0,5,"Braga",4,"N14 Bosch",13,46,33,172,48,124
11,29,2018,18,0,5,"Braga",5,"Avenida João Paulo II",10,40,30,34,8,26
11,29,2018,18,0,5,"Braga",6,"Avenida Padre Júlio Fragata",25,62,37,51,20,31
11,29,2018,18,0,5,"Braga",7,"Rua Nova Santa Cruz",7,29,22,434,104,330
11,29,2018,18,0,5,"Braga",8,"Rua Costa Gomes",7,42,35,246,41,205
11,29,2018,19,0,5,"Braga",1,"Avenida da Liberdade",16,25,9,41,26,15
11,29,2018,19,0,5,"Braga",2,"Avenida Central",5,20,15,927,231,696
11,29,2018,19,0,5,"Braga",3,"Rua de Caires",28,28,0,3,3,0
11,29,2018,19,0,5,"Braga",4,"N14 Bosch",32,47,15,70,47,23
11,29,2018,19,0,5,"Braga",5,"Avenida João Paulo II",28,38,10,12,9,3
11,29,2018,19,0,5,"Braga",6,"Avenida Padre Júlio Fragata",23,61,38,55,21,34
11,29,2018,19,0,5,"Braga",7,"Rua Nova Santa Cruz",12,28,16,253,108,145
11,29,2018,19,0,5,"Braga",8,"Rua Costa Gomes",15,41,26,115,42,73
11,29,2018,20,0,5,"Braga",1,"Avenida da Liberdade",24,24,0,27,27,0
11,29,2018,20,0,5,"Braga",2,"Avenida Central",12,17,5,386,272,114
11,29,2018,20,0,5,"Braga",3,"Rua de Caires",14,24,10,7,4,3
11,29,2018,20,0,5,"Braga",4,"N14 Bosch",47,47,0,47,47,0
11,29,2018,20,0,5,"Braga",5,"Avenida João Paulo II",39,39,0,8,8,0
11,29,2018,20,0,5,"Braga",6,"Avenida Padre Júlio Fragata",43,61,18,29,21,8
11,29,2018,20,0,5,"Braga",7,"Rua Nova Santa Cruz",12,28,16,253,108,145
11,29,2018,20,0,5,"Braga",8,"Rua Costa Gomes",26,41,15,66,42,24
11,29,2018,21,0,5,"Braga",1,"Avenida da Liberdade",24,24,0,27,27,0
11,29,2018,21,0,5,"Braga",2,"Avenida Central",17,17,0,272,272,0
11,29,2018,21,0,5,"Braga",3,"Rua de Caires",24,24,0,4,4,0
11,29,2018,21,0,5,"Braga",4,"N14 Bosch",46,46,0,48,48,0
11,29,2018,21,0,5,"Braga",5,"Avenida João Paulo II",38,38,0,9,9,0
11,29,2018,21,0,5,"Braga",6,"Avenida Padre Júlio Fragata",38,62,24,33,20,13
11,29,2018,21,0,5,"Braga",7,"Rua Nova Santa Cruz",28,28,0,108,108,0
11,29,2018,21,0,5,"Braga",8,"Rua Costa Gomes",41,41,0,42,42,0
11,29,2018,22,0,5,"Braga",1,"Avenida da Liberdade",24,24,0,27,27,0
11,29,2018,22,0,5,"Braga",2,"Avenida Central",17,17,0,272,272,0
11,29,2018,22,0,5,"Braga",3,"Rua de Caires",24,24,0,4,4,0
11,29,2018,22,0,5,"Braga",4,"N14 Bosch",46,46,0,48,48,0
11,29,2018,22,0,5,"Braga",5,"Avenida João Paulo II",38,38,0,9,9,0
11,29,2018,22,0,5,"Braga",6,"Avenida Padre Júlio Fragata",62,62,0,20,20,0
11,29,2018,22,0,5,"Braga",7,"Rua Nova Santa Cruz",28,28,0,108,108,0
11,29,2018,22,0,5,"Braga",8,"Rua Costa Gomes",41,41,0,42,42,0
11,29,2018,23,0,5,"Braga",1,"Avenida da Liberdade",24,24,0,27,27,0
11,29,2018,23,0,5,"Braga",2,"Avenida Central",17,17,0,272,272,0
11,29,2018,23,0,5,"Braga",3,"Rua de Caires",24,24,0,4,4,0
11,29,2018,23,0,5,"Braga",4,"N14 Bosch",46,46,0,48,48,0
11,29,2018,23,0,5,"Braga",5,"Avenida João Paulo II",38,38,0,9,9,0
11,29,2018,23,0,5,"Braga",6,"Avenida Padre Júlio Fragata",44,62,18,29,20,9
11,29,2018,23,0,5,"Braga",7,"Rua Nova Santa Cruz",28,28,0,108,108,0
11,29,2018,23,0,5,"Braga",8,"Rua Costa Gomes",41,41,0,42,42,0
11,30,2018,0,0,6,"Braga",1,"Avenida da Liberdade",24,24,0,27,27,0
11,30,2018,0,0,6,"Braga",2,"Avenida Central",17,17,0,272,272,0
11,30,2018,0,0,6,"Braga",3,"Rua de Caires",24,24,0,4,4,0
11,30,2018,0,0,6,"Braga",4,"N14 Bosch",46,46,0,48,48,0
11,30,2018,0,0,6,"Braga",5,"Avenida João Paulo II",38,38,0,9,9,0
11,30,2018,0,0,6,"Braga",6,"Avenida Padre Júlio Fragata",62,62,0,20,20,0
11,30,2018,0,0,6,"Braga",7,"Rua Nova Santa Cruz",28,28,0,108,108,0
11,30,2018,0,0,6,"Braga",8,"Rua Costa Gomes",41,41,0,42,42,0
11,30,2018,1,0,6,"Braga",1,"Avenida da Liberdade",24,24,0,27,27,0
11,30,2018,1,0,6,"Braga",2,"Avenida Central",17,17,0,272,272,0
11,30,2018,1,0,6,"Braga",3,"Rua de Caires",24,24,0,4,4,0
11,30,2018,1,0,6,"Braga",4,"N14 Bosch",46,46,0,48,48,0
11,30,2018,1,0,6,"Braga",5,"Avenida João Paulo II",38,38,0,9,9,0
11,30,2018,1,0,6,"Braga",6,"Avenida Padre Júlio Fragata",62,62,0,20,20,0
11,30,2018,1,0,6,"Braga",7,"Rua Nova Santa Cruz",28,28,0,108,108,0
11,30,2018,1,0,6,"Braga",8,"Rua Costa Gomes",41,41,0,42,42,0
11,30,2018,2,0,6,"Braga",1,"Avenida da Liberdade",24,24,0,27,27,0
11,30,2018,2,0,6,"Braga",2,"Avenida Central",17,17,0,272,272,0
11,30,2018,2,0,6,"Braga",3,"Rua de Caires",24,24,0,4,4,0
11,30,2018,2,0,6,"Braga",4,"N14 Bosch",46,46,0,48,48,0
11,30,2018,2,0,6,"Braga",5,"Avenida João Paulo II",38,38,0,9,9,0
11,30,2018,2,0,6,"Braga",6,"Avenida Padre Júlio Fragata",62,62,0,20,20,0
11,30,2018,2,0,6,"Braga",7,"Rua Nova Santa Cruz",28,28,0,108,108,0
11,30,2018,2,0,6,"Braga",8,"Rua Costa Gomes",41,41,0,42,42,0
11,30,2018,3,0,6,"Braga",1,"Avenida da Liberdade",24,24,0,27,27,0
11,30,2018,3,0,6,"Braga",2,"Avenida Central",17,17,0,272,272,0
11,30,2018,3,0,6,"Braga",3,"Rua de Caires",24,24,0,4,4,0
11,30,2018,3,0,6,"Braga",4,"N14 Bosch",46,46,0,48,48,0
11,30,2018,3,0,6,"Braga",5,"Avenida João Paulo II",38,38,0,9,9,0
11,30,2018,3,0,6,"Braga",6,"Avenida Padre Júlio Fragata",62,62,0,20,20,0
11,30,2018,3,0,6,"Braga",7,"Rua Nova Santa Cruz",28,28,0,108,108,0
11,30,2018,3,0,6,"Braga",8,"Rua Costa Gomes",41,41,0,42,42,0
11,30,2018,4,0,6,"Braga",1,"Avenida da Liberdade",24,24,0,27,27,0
11,30,2018,4,0,6,"Braga",2,"Avenida Central",17,17,0,272,272,0
11,30,2018,4,0,6,"Braga",3,"Rua de Caires",24,24,0,4,4,0
11,30,2018,4,0,6,"Braga",4,"N14 Bosch",46,46,0,48,48,0
11,30,2018,4,0,6,"Braga",5,"Avenida João Paulo II",38,38,0,9,9,0
11,30,2018,4,0,6,"Braga",6,"Avenida Padre Júlio Fragata",62,62,0,20,20,0
11,30,2018,4,0,6,"Braga",7,"Rua Nova Santa Cruz",28,28,0,108,108,0
11,30,2018,4,0,6,"Braga",8,"Rua Costa Gomes",41,41,0,42,42,0
11,30,2018,5,0,6,"Braga",1,"Avenida da Liberdade",24,24,0,27,27,0
11,30,2018,5,0,6,"Braga",2,"Avenida Central",17,17,0,272,272,0
11,30,2018,5,0,6,"Braga",3,"Rua de Caires",24,24,0,4,4,0
11,30,2018,5,0,6,"Braga",4,"N14 Bosch",46,46,0,48,48,0
11,30,2018,5,0,6,"Braga",5,"Avenida João Paulo II",38,38,0,9,9,0
11,30,2018,5,0,6,"Braga",6,"Avenida Padre Júlio Fragata",62,62,0,20,20,0
11,30,2018,5,0,6,"Braga",7,"Rua Nova Santa Cruz",28,28,0,108,108,0
11,30,2018,5,0,6,"Braga",8,"Rua Costa Gomes",41,41,0,42,42,0
11,30,2018,6,0,6,"Braga",1,"Avenida da Liberdade",24,24,0,27,27,0
11,30,2018,6,0,6,"Braga",2,"Avenida Central",17,17,0,272,272,0
11,30,2018,6,0,6,"Braga",3,"Rua de Caires",24,24,0,4,4,0
11,30,2018,6,0,6,"Braga",4,"N14 Bosch",46,46,0,48,48,0
11,30,2018,6,0,6,"Braga",5,"Avenida João Paulo II",38,38,0,9,9,0
11,30,2018,6,0,6,"Braga",6,"Avenida Padre Júlio Fragata",62,62,0,20,20,0
11,30,2018,6,0,6,"Braga",7,"Rua Nova Santa Cruz",28,28,0,108,108,0
11,30,2018,6,0,6,"Braga",8,"Rua Costa Gomes",41,41,0,42,42,0
11,30,2018,7,0,6,"Braga",1,"Avenida da Liberdade",24,24,0,27,27,0
11,30,2018,7,0,6,"Braga",2,"Avenida Central",17,17,0,272,272,0
11,30,2018,7,0,6,"Braga",3,"Rua de Caires",24,24,0,4,4,0
11,30,2018,7,0,6,"Braga",4,"N14 Bosch",46,46,0,48,48,0
11,30,2018,7,0,6,"Braga",5,"Avenida João Paulo II",38,38,0,9,9,0
11,30,2018,7,0,6,"Braga",6,"Avenida Padre Júlio Fragata",62,62,0,20,20,0
11,30,2018,7,0,6,"Braga",7,"Rua Nova Santa Cruz",28,28,0,108,108,0
11,30,2018,7,0,6,"Braga",8,"Rua Costa Gomes",41,41,0,42,42,0
11,30,2018,8,0,6,"Braga",1,"Avenida da Liberdade",24,24,0,27,27,0
11,30,2018,8,0,6,"Braga",2,"Avenida Central",13,17,4,356,272,84
11,30,2018,8,0,6,"Braga",3,"Rua de Caires",24,24,0,4,4,0
11,30,2018,8,0,6,"Braga",4,"N14 Bosch",47,47,0,47,47,0
11,30,2018,8,0,6,"Braga",5,"Avenida João Paulo II",31,39,8,11,8,3
11,30,2018,8,0,6,"Braga",6,"Avenida Padre Júlio Fragata",62,62,0,20,20,0
11,30,2018,8,0,6,"Braga",7,"Rua Nova Santa Cruz",28,28,0,108,108,0
11,30,2018,8,0,6,"Braga",8,"Rua Costa Gomes",27,41,14,63,42,21
11,30,2018,9,0,6,"Braga",1,"Avenida da Liberdade",20,25,5,33,26,7
11,30,2018,9,0,6,"Braga",2,"Avenida Central",9,18,9,515,257,258
11,30,2018,9,0,6,"Braga",3,"Rua de Caires",25,25,0,4,4,0
11,30,2018,9,0,6,"Braga",4,"N14 Bosch",23,47,24,97,47,50
11,30,2018,9,0,6,"Braga",5,"Avenida João Paulo II",39,39,0,8,8,0
11,30,2018,9,0,6,"Braga",6,"Avenida Padre Júlio Fragata",49,62,13,26,20,6
11,30,2018,9,0,6,"Braga",7,"Rua Nova Santa Cruz",28,28,0,108,108,0
11,30,2018,9,0,6,"Braga",8,"Rua Costa Gomes",27,40,13,63,43,20
11,30,2018,10,0,6,"Braga",1,"Avenida da Liberdade",19,24,5,34,27,7
11,30,2018,10,0,6,"Braga",2,"Avenida Central",14,18,4,331,257,74
11,30,2018,10,0,6,"Braga",3,"Rua de Caires",25,25,0,4,4,0
11,30,2018,10,0,6,"Braga",4,"N14 Bosch",34,46,12,66,48,18
11,30,2018,10,0,6,"Braga",5,"Avenida João Paulo II",39,39,0,8,8,0
11,30,2018,10,0,6,"Braga",6,"Avenida Padre Júlio Fragata",62,62,0,20,20,0
11,30,2018,10,0,6,"Braga",7,"Rua Nova Santa Cruz",28,28,0,108,108,0
11,30,2018,10,0,6,"Braga",8,"Rua Costa Gomes",40,40,0,43,43,0
11,30,2018,11,0,6,"Braga",1,"Avenida da Liberdade",20,25,5,33,26,7
11,30,2018,11,0,6,"Braga",2,"Avenida Central",14,17,3,331,272,59
11,30,2018,11,0,6,"Braga",3,"Rua de Caires",17,25,8,6,4,2
11,30,2018,11,0,6,"Braga",4,"N14 Bosch",35,46,11,64,48,16
11,30,2018,11,0,6,"Braga",5,"Avenida João Paulo II",30,39,9,11,8,3
11,30,2018,11,0,6,"Braga",6,"Avenida Padre Júlio Fragata",62,62,0,20,20,0
11,30,2018,11,0,6,"Braga",7,"Rua Nova Santa Cruz",23,29,6,132,104,28
11,30,2018,11,0,6,"Braga",8,"Rua Costa Gomes",40,40,0,43,43,0
11,30,2018,12,0,6,"Braga",1,"Avenida da Liberdade",25,25,0,26,26,0
11,30,2018,12,0,6,"Braga",2,"Avenida Central",12,18,6,386,257,129
11,30,2018,12,0,6,"Braga",3,"Rua de Caires",24,24,0,4,4,0
11,30,2018,12,0,6,"Braga",4,"N14 Bosch",29,47,18,77,47,30
11,30,2018,12,0,6,"Braga",5,"Avenida João Paulo II",38,38,0,9,9,0
11,30,2018,12,0,6,"Braga",6,"Avenida Padre Júlio Fragata",62,62,0,20,20,0
11,30,2018,12,0,6,"Braga",7,"Rua Nova Santa Cruz",28,28,0,108,108,0
11,30,2018,12,0,6,"Braga",8,"Rua Costa Gomes",40,40,0,43,43,0
11,30,2018,13,0,6,"Braga",1,"Avenida da Liberdade",25,25,0,26,26,0
11,30,2018,13,0,6,"Braga",2,"Avenida Central",17,17,0,272,272,0
11,30,2018,13,0,6,"Braga",3,"Rua de Caires",24,24,0,4,4,0
11,30,2018,13,0,6,"Braga",4,"N14 Bosch",25,46,21,89,48,41
11,30,2018,13,0,6,"Braga",5,"Avenida João Paulo II",39,39,0,8,8,0
11,30,2018,13,0,6,"Braga",6,"Avenida Padre Júlio Fragata",49,62,13,26,20,6
11,30,2018,13,0,6,"Braga",7,"Rua Nova Santa Cruz",11,29,18,276,104,172
11,30,2018,13,0,6,"Braga",8,"Rua Costa Gomes",40,40,0,43,43,0
11,30,2018,14,0,6,"Braga",1,"Avenida da Liberdade",20,25,5,33,26,7
11,30,2018,14,0,6,"Braga",2,"Avenida Central",12,17,5,386,272,114
11,30,2018,14,0,6,"Braga",3,"Rua de Caires",24,24,0,4,4,0
11,30,2018,14,0,6,"Braga",4,"N14 Bosch",15,46,31,149,48,101
11,30,2018,14,0,6,"Braga",5,"Avenida João Paulo II",38,38,0,9,9,0
11,30,2018,14,0,6,"Braga",6,"Avenida Padre Júlio Fragata",35,61,26,36,21,15
11,30,2018,14,0,6,"Braga",7,"Rua Nova Santa Cruz",17,29,12,179,104,75
11,30,2018,14,0,6,"Braga",8,"Rua Costa Gomes",30,41,11,57,42,15
11,30,2018,15,0,6,"Braga",1,"Avenida da Liberdade",25,25,0,26,26,0
11,30,2018,15,0,6,"Braga",2,"Avenida Central",13,17,4,356,272,84
11,30,2018,15,0,6,"Braga",3,"Rua de Caires",25,25,0,4,4,0
11,30,2018,15,0,6,"Braga",4,"N14 Bosch",15,46,31,149,48,101
11,30,2018,15,0,6,"Braga",5,"Avenida João Paulo II",39,39,0,8,8,0
11,30,2018,15,0,6,"Braga",6,"Avenida Padre Júlio Fragata",49,61,12,26,21,5
11,30,2018,15,0,6,"Braga",7,"Rua Nova Santa Cruz",12,29,17,253,104,149
11,30,2018,15,0,6,"Braga",8,"Rua Costa Gomes",29,41,12,59,42,17
11,30,2018,16,0,6,"Braga",1,"Avenida da Liberdade",12,25,13,55,26,29
11,30,2018,16,0,6,"Braga",2,"Avenida Central",17,17,0,272,272,0
11,30,2018,16,0,6,"Braga",3,"Rua de Caires",10,25,15,10,4,6
11,30,2018,16,0,6,"Braga",4,"N14 Bosch",24,46,22,93,48,45
11,30,2018,16,0,6,"Braga",5,"Avenida João Paulo II",24,38,14,14,9,5
11,30,2018,16,0,6,"Braga",6,"Avenida Padre Júlio Fragata",45,62,17,28,20,8
11,30,2018,16,0,6,"Braga",7,"Rua Nova Santa Cruz",28,28,0,108,108,0
11,30,2018,16,0,6,"Braga",8,"Rua Costa Gomes",25,40,15,69,43,26
11,30,2018,17,0,6,"Braga",1,"Avenida da Liberdade",20,25,5,33,26,7
11,30,2018,17,0,6,"Braga",2,"Avenida Central",6,18,12,772,257,515
11,30,2018,17,0,6,"Braga",3,"Rua de Caires",24,24,0,4,4,0
11,30,2018,17,0,6,"Braga",4,"N14 Bosch",27,46,19,83,48,35
11,30,2018,17,0,6,"Braga",5,"Avenida João Paulo II",28,39,11,12,8,4
11,30,2018,17,0,6,"Braga",6,"Avenida Padre Júlio Fragata",36,61,25,35,21,14
11,30,2018,17,0,6,"Braga",7,"Rua Nova Santa Cruz",21,28,7,144,108,36
11,30,2018,17,0,6,"Braga",8,"Rua Costa Gomes",22,41,19,78,42,36
11,30,2018,18,0,6,"Braga",1,"Avenida da Liberdade",17,25,8,39,26,13
11,30,2018,18,0,6,"Braga",2,"Avenida Central",6,16,10,772,289,483
11,30,2018,18,0,6,"Braga",3,"Rua de Caires",14,25,11,7,4,3
11,30,2018,18,0,6,"Braga",4,"N14 Bosch",12,45,33,187,49,138
11,30,2018,18,0,6,"Braga",5,"Avenida João Paulo II",7,37,30,49,9,40
11,30,2018,18,0,6,"Braga",6,"Avenida Padre Júlio Fragata",17,63,46,75,20,55
11,30,2018,18,0,6,"Braga",7,"Rua Nova Santa Cruz",10,29,19,304,104,200
11,30,2018,18,0,6,"Braga",8,"Rua Costa Gomes",10,40,30,172,43,129
11,30,2018,19,0,6,"Braga",1,"Avenida da Liberdade",18,25,7,36,26,10
11,30,2018,19,0,6,"Braga",2,"Avenida Central",7,17,10,662,272,390
11,30,2018,19,0,6,"Braga",3,"Rua de Caires",4,25,21,26,4,22
11,30,2018,19,0,6,"Braga",4,"N14 Bosch",22,47,25,102,47,55
11,30,2018,19,0,6,"Braga",5,"Avenida João Paulo II",9,38,29,38,9,29
11,30,2018,19,0,6,"Braga",6,"Avenida Padre Júlio Fragata",22,62,40,58,20,38
11,30,2018,19,0,6,"Braga",7,"Rua Nova Santa Cruz",10,28,18,304,108,196
11,30,2018,19,0,6,"Braga",8,"Rua Costa Gomes",7,42,35,246,41,205
11,30,2018,20,0,6,"Braga",1,"Avenida da Liberdade",25,25,0,26,26,0
11,30,2018,20,0,6,"Braga",2,"Avenida Central",17,17,0,272,272,0
11,30,2018,20,0,6,"Braga",3,"Rua de Caires",17,25,8,6,4,2
11,30,2018,20,0,6,"Braga",4,"N14 Bosch",28,46,18,80,48,32
11,30,2018,20,0,6,"Braga",5,"Avenida João Paulo II",23,39,16,15,8,7
11,30,2018,20,0,6,"Braga",6,"Avenida Padre Júlio Fragata",20,61,41,64,21,43
11,30,2018,20,0,6,"Braga",7,"Rua Nova Santa Cruz",14,28,14,217,108,109
11,30,2018,20,0,6,"Braga",8,"Rua Costa Gomes",30,41,11,57,42,15
11,30,2018,21,0,6,"Braga",1,"Avenida da Liberdade",25,25,0,26,26,0
11,30,2018,21,0,6,"Braga",2,"Avenida Central",17,17,0,272,272,0
11,30,2018,21,0,6,"Braga",3,"Rua de Caires",25,25,0,4,4,0
11,30,2018,21,0,6,"Braga",4,"N14 Bosch",30,46,16,74,48,26
11,30,2018,21,0,6,"Braga",5,"Avenida João Paulo II",26,39,13,13,8,5
11,30,2018,21,0,6,"Braga",6,"Avenida Padre Júlio Fragata",48,62,14,26,20,6
11,30,2018,21,0,6,"Braga",7,"Rua Nova Santa Cruz",29,29,0,104,104,0
11,30,2018,21,0,6,"Braga",8,"Rua Costa Gomes",18,42,24,95,41,54
11,30,2018,22,0,6,"Braga",1,"Avenida da Liberdade",25,25,0,26,26,0
11,30,2018,22,0,6,"Braga",2,"Avenida Central",12,17,5,386,272,114
11,30,2018,22,0,6,"Braga",3,"Rua de Caires",25,25,0,4,4,0
11,30,2018,22,0,6,"Braga",4,"N14 Bosch",37,46,9,60,48,12
11,30,2018,22,0,6,"Braga",5,"Avenida João Paulo II",39,39,0,8,8,0
11,30,2018,22,0,6,"Braga",6,"Avenida Padre Júlio Fragata",44,61,17,29,21,8
11,30,2018,22,0,6,"Braga",7,"Rua Nova Santa Cruz",29,29,0,104,104,0
11,30,2018,22,0,6,"Braga",8,"Rua Costa Gomes",40,40,0,43,43,0
11,30,2018,23,0,6,"Braga",1,"Avenida da Liberdade",25,25,0,26,26,0
11,30,2018,23,0,6,"Braga",2,"Avenida Central",17,17,0,272,272,0
11,30,2018,23,0,6,"Braga",3,"Rua de Caires",25,25,0,4,4,0
11,30,2018,23,0,6,"Braga",4,"N14 Bosch",47,47,0,47,47,0
11,30,2018,23,0,6,"Braga",5,"Avenida João Paulo II",39,39,0,8,8,0
11,30,2018,23,0,6,"Braga",6,"Avenida Padre Júlio Fragata",28,62,34,45,20,25
11,30,2018,23,0,6,"Braga",7,"Rua Nova Santa Cruz",22,28,6,138,108,30
11,30,2018,23,0,6,"Braga",8,"Rua Costa Gomes",40,40,0,43,43,0
12,1,2018,0,0,7,"Braga",1,"Avenida da Liberdade",25,25,0,26,26,0
12,1,2018,0,0,7,"Braga",2,"Avenida Central",14,17,3,331,272,59
12,1,2018,0,0,7,"Braga",3,"Rua de Caires",25,25,0,4,4,0
12,1,2018,0,0,7,"Braga",4,"N14 Bosch",46,46,0,48,48,0
12,1,2018,0,0,7,"Braga",5,"Avenida João Paulo II",39,39,0,8,8,0
12,1,2018,0,0,7,"Braga",6,"Avenida Padre Júlio Fragata",41,62,21,31,20,11
12,1,2018,0,0,7,"Braga",7,"Rua Nova Santa Cruz",28,28,0,108,108,0
12,1,2018,0,0,7,"Braga",8,"Rua Costa Gomes",40,40,0,43,43,0
12,1,2018,1,0,7,"Braga",1,"Avenida da Liberdade",25,25,0,26,26,0
12,1,2018,1,0,7,"Braga",2,"Avenida Central",17,17,0,272,272,0
12,1,2018,1,0,7,"Braga",3,"Rua de Caires",22,22,0,4,4,0
12,1,2018,1,0,7,"Braga",4,"N14 Bosch",46,46,0,48,48,0
12,1,2018,1,0,7,"Braga",5,"Avenida João Paulo II",39,39,0,8,8,0
12,1,2018,1,0,7,"Braga",6,"Avenida Padre Júlio Fragata",61,61,0,21,21,0
12,1,2018,1,0,7,"Braga",7,"Rua Nova Santa Cruz",28,28,0,108,108,0
12,1,2018,1,0,7,"Braga",8,"Rua Costa Gomes",40,40,0,43,43,0
12,1,2018,2,0,7,"Braga",1,"Avenida da Liberdade",25,25,0,26,26,0
12,1,2018,2,0,7,"Braga",2,"Avenida Central",17,17,0,272,272,0
12,1,2018,2,0,7,"Braga",3,"Rua de Caires",22,22,0,4,4,0
12,1,2018,2,0,7,"Braga",4,"N14 Bosch",46,46,0,48,48,0
12,1,2018,2,0,7,"Braga",5,"Avenida João Paulo II",39,39,0,8,8,0
12,1,2018,2,0,7,"Braga",6,"Avenida Padre Júlio Fragata",61,61,0,21,21,0
12,1,2018,2,0,7,"Braga",7,"Rua Nova Santa Cruz",29,29,0,104,104,0
12,1,2018,2,0,7,"Braga",8,"Rua Costa Gomes",22,40,18,78,43,35
12,1,2018,3,0,7,"Braga",1,"Avenida da Liberdade",25,25,0,26,26,0
12,1,2018,3,0,7,"Braga",2,"Avenida Central",17,17,0,272,272,0
12,1,2018,3,0,7,"Braga",3,"Rua de Caires",22,22,0,4,4,0
12,1,2018,3,0,7,"Braga",4,"N14 Bosch",46,46,0,48,48,0
12,1,2018,3,0,7,"Braga",5,"Avenida João Paulo II",39,39,0,8,8,0
12,1,2018,3,0,7,"Braga",6,"Avenida Padre Júlio Fragata",61,61,0,21,21,0
12,1,2018,3,0,7,"Braga",7,"Rua Nova Santa Cruz",29,29,0,104,104,0
12,1,2018,3,0,7,"Braga",8,"Rua Costa Gomes",40,40,0,43,43,0
12,1,2018,4,0,7,"Braga",1,"Avenida da Liberdade",25,25,0,26,26,0
12,1,2018,4,0,7,"Braga",2,"Avenida Central",17,17,0,272,272,0
12,1,2018,4,0,7,"Braga",3,"Rua de Caires",22,22,0,4,4,0
12,1,2018,4,0,7,"Braga",4,"N14 Bosch",46,46,0,48,48,0
12,1,2018,4,0,7,"Braga",5,"Avenida João Paulo II",39,39,0,8,8,0
12,1,2018,4,0,7,"Braga",6,"Avenida Padre Júlio Fragata",61,61,0,21,21,0
12,1,2018,4,0,7,"Braga",7,"Rua Nova Santa Cruz",29,29,0,104,104,0
12,1,2018,4,0,7,"Braga",8,"Rua Costa Gomes",40,40,0,43,43,0
12,1,2018,5,0,7,"Braga",1,"Avenida da Liberdade",25,25,0,26,26,0
12,1,2018,5,0,7,"Braga",2,"Avenida Central",17,17,0,272,272,0
12,1,2018,5,0,7,"Braga",3,"Rua de Caires",22,22,0,4,4,0
12,1,2018,5,0,7,"Braga",4,"N14 Bosch",46,46,0,48,48,0
12,1,2018,5,0,7,"Braga",5,"Avenida João Paulo II",39,39,0,8,8,0
12,1,2018,5,0,7,"Braga",6,"Avenida Padre Júlio Fragata",61,61,0,21,21,0
12,1,2018,5,0,7,"Braga",7,"Rua Nova Santa Cruz",29,29,0,104,104,0
12,1,2018,5,0,7,"Braga",8,"Rua Costa Gomes",40,40,0,43,43,0
12,1,2018,6,0,7,"Braga",1,"Avenida da Liberdade",25,25,0,26,26,0
12,1,2018,6,0,7,"Braga",2,"Avenida Central",17,17,0,272,272,0
12,1,2018,6,0,7,"Braga",3,"Rua de Caires",22,22,0,4,4,0
12,1,2018,6,0,7,"Braga",4,"N14 Bosch",46,46,0,48,48,0
12,1,2018,6,0,7,"Braga",5,"Avenida João Paulo II",39,39,0,8,8,0
12,1,2018,6,0,7,"Braga",6,"Avenida Padre Júlio Fragata",61,61,0,21,21,0
12,1,2018,6,0,7,"Braga",7,"Rua Nova Santa Cruz",29,29,0,104,104,0
12,1,2018,6,0,7,"Braga",8,"Rua Costa Gomes",40,40,0,43,43,0
12,1,2018,7,0,7,"Braga",1,"Avenida da Liberdade",25,25,0,26,26,0
12,1,2018,7,0,7,"Braga",2,"Avenida Central",17,17,0,272,272,0
12,1,2018,7,0,7,"Braga",3,"Rua de Caires",22,22,0,4,4,0
12,1,2018,7,0,7,"Braga",4,"N14 Bosch",46,46,0,48,48,0
12,1,2018,7,0,7,"Braga",5,"Avenida João Paulo II",39,39,0,8,8,0
12,1,2018,7,0,7,"Braga",6,"Avenida Padre Júlio Fragata",61,61,0,21,21,0
12,1,2018,7,0,7,"Braga",7,"Rua Nova Santa Cruz",29,29,0,104,104,0
12,1,2018,7,0,7,"Braga",8,"Rua Costa Gomes",40,40,0,43,43,0
12,1,2018,8,0,7,"Braga",1,"Avenida da Liberdade",25,25,0,26,26,0
12,1,2018,8,0,7,"Braga",2,"Avenida Central",17,17,0,272,272,0
12,1,2018,8,0,7,"Braga",3,"Rua de Caires",22,22,0,4,4,0
12,1,2018,8,0,7,"Braga",4,"N14 Bosch",46,46,0,48,48,0
12,1,2018,8,0,7,"Braga",5,"Avenida João Paulo II",39,39,0,8,8,0
12,1,2018,8,0,7,"Braga",6,"Avenida Padre Júlio Fragata",61,61,0,21,21,0
12,1,2018,8,0,7,"Braga",7,"Rua Nova Santa Cruz",29,29,0,104,104,0
12,1,2018,8,0,7,"Braga",8,"Rua Costa Gomes",40,40,0,43,43,0
12,1,2018,9,0,7,"Braga",1,"Avenida da Liberdade",25,25,0,26,26,0
12,1,2018,9,0,7,"Braga",2,"Avenida Central",17,17,0,272,272,0
12,1,2018,9,0,7,"Braga",3,"Rua de Caires",22,22,0,4,4,0
12,1,2018,9,0,7,"Braga",4,"N14 Bosch",46,46,0,48,48,0
12,1,2018,9,0,7,"Braga",5,"Avenida João Paulo II",39,39,0,8,8,0
12,1,2018,9,0,7,"Braga",6,"Avenida Padre Júlio Fragata",61,61,0,21,21,0
12,1,2018,9,0,7,"Braga",7,"Rua Nova Santa Cruz",29,29,0,104,104,0
12,1,2018,9,0,7,"Braga",8,"Rua Costa Gomes",40,40,0,43,43,0
12,1,2018,10,0,7,"Braga",1,"Avenida da Liberdade",25,25,0,26,26,0
12,1,2018,10,0,7,"Braga",2,"Avenida Central",17,17,0,272,272,0
12,1,2018,10,0,7,"Braga",3,"Rua de Caires",18,24,6,5,4,1
12,1,2018,10,0,7,"Braga",4,"N14 Bosch",31,47,16,72,47,25
12,1,2018,10,0,7,"Braga",5,"Avenida João Paulo II",39,39,0,8,8,0
12,1,2018,10,0,7,"Braga",6,"Avenida Padre Júlio Fragata",42,62,20,30,20,10
12,1,2018,10,0,7,"Braga",7,"Rua Nova Santa Cruz",29,29,0,104,104,0
12,1,2018,10,0,7,"Braga",8,"Rua Costa Gomes",40,40,0,43,43,0
12,1,2018,11,0,7,"Braga",1,"Avenida da Liberdade",25,25,0,26,26,0
12,1,2018,11,0,7,"Braga",2,"Avenida Central",12,18,6,386,257,129
12,1,2018,11,0,7,"Braga",3,"Rua de Caires",25,25,0,4,4,0
12,1,2018,11,0,7,"Braga",4,"N14 Bosch",47,47,0,47,47,0
12,1,2018,11,0,7,"Braga",5,"Avenida João Paulo II",39,39,0,8,8,0
12,1,2018,11,0,7,"Braga",6,"Avenida Padre Júlio Fragata",49,62,13,26,20,6
12,1,2018,11,0,7,"Braga",7,"Rua Nova Santa Cruz",29,29,0,104,104,0
12,1,2018,11,0,7,"Braga",8,"Rua Costa Gomes",40,40,0,43,43,0
12,1,2018,12,0,7,"Braga",1,"Avenida da Liberdade",25,25,0,26,26,0
12,1,2018,12,0,7,"Braga",2,"Avenida Central",6,19,13,772,244,528
12,1,2018,12,0,7,"Braga",3,"Rua de Caires",25,25,0,4,4,0
12,1,2018,12,0,7,"Braga",4,"N14 Bosch",46,46,0,48,48,0
12,1,2018,12,0,7,"Braga",5,"Avenida João Paulo II",38,38,0,9,9,0
12,1,2018,12,0,7,"Braga",6,"Avenida Padre Júlio Fragata",61,61,0,21,21,0
12,1,2018,12,0,7,"Braga",7,"Rua Nova Santa Cruz",19,29,10,160,104,56
12,1,2018,12,0,7,"Braga",8,"Rua Costa Gomes",40,40,0,43,43,0
12,1,2018,13,0,7,"Braga",1,"Avenida da Liberdade",25,25,0,26,26,0
12,1,2018,13,0,7,"Braga",2,"Avenida Central",14,18,4,331,257,74
12,1,2018,13,0,7,"Braga",3,"Rua de Caires",25,25,0,4,4,0
12,1,2018,13,0,7,"Braga",4,"N14 Bosch",46,46,0,48,48,0
12,1,2018,13,0,7,"Braga",5,"Avenida João Paulo II",39,39,0,8,8,0
12,1,2018,13,0,7,"Braga",6,"Avenida Padre Júlio Fragata",30,62,32,42,20,22
12,1,2018,13,0,7,"Braga",7,"Rua Nova Santa Cruz",28,28,0,108,108,0
12,1,2018,13,0,7,"Braga",8,"Rua Costa Gomes",40,40,0,43,43,0
12,1,2018,14,0,7,"Braga",1,"Avenida da Liberdade",25,25,0,26,26,0
12,1,2018,14,0,7,"Braga",2,"Avenida Central",18,18,0,257,257,0
12,1,2018,14,0,7,"Braga",3,"Rua de Caires",25,25,0,4,4,0
12,1,2018,14,0,7,"Braga",4,"N14 Bosch",46,46,0,48,48,0
12,1,2018,14,0,7,"Braga",5,"Avenida João Paulo II",39,39,0,8,8,0
12,1,2018,14,0,7,"Braga",6,"Avenida Padre Júlio Fragata",61,61,0,21,21,0
12,1,2018,14,0,7,"Braga",7,"Rua Nova Santa Cruz",28,28,0,108,108,0
12,1,2018,14,0,7,"Braga",8,"Rua Costa Gomes",40,40,0,43,43,0
12,1,2018,15,0,7,"Braga",1,"Avenida da Liberdade",25,25,0,26,26,0
12,1,2018,15,0,7,"Braga",2,"Avenida Central",13,17,4,356,272,84
12,1,2018,15,0,7,"Braga",3,"Rua de Caires",25,25,0,4,4,0
12,1,2018,15,0,7,"Braga",4,"N14 Bosch",47,47,0,47,47,0
12,1,2018,15,0,7,"Braga",5,"Avenida João Paulo II",15,39,24,23,8,15
12,1,2018,15,0,7,"Braga",6,"Avenida Padre Júlio Fragata",33,61,28,38,21,17
12,1,2018,15,0,7,"Braga",7,"Rua Nova Santa Cruz",28,28,0,108,108,0
12,1,2018,15,0,7,"Braga",8,"Rua Costa Gomes",31,41,10,55,42,13
12,1,2018,16,0,7,"Braga",1,"Avenida da Liberdade",25,25,0,26,26,0
12,1,2018,16,0,7,"Braga",2,"Avenida Central",10,17,7,463,272,191
12,1,2018,16,0,7,"Braga",3,"Rua de Caires",25,25,0,4,4,0
12,1,2018,16,0,7,"Braga",4,"N14 Bosch",14,48,34,160,46,114
12,1,2018,16,0,7,"Braga",5,"Avenida João Paulo II",5,36,31,69,9,60
12,1,2018,16,0,7,"Braga",6,"Avenida Padre Júlio Fragata",38,61,23,33,21,12
12,1,2018,16,0,7,"Braga",7,"Rua Nova Santa Cruz",28,28,0,108,108,0
12,1,2018,16,0,7,"Braga",8,"Rua Costa Gomes",41,41,0,42,42,0
12,1,2018,17,0,7,"Braga",1,"Avenida da Liberdade",25,25,0,26,26,0
12,1,2018,17,0,7,"Braga",2,"Avenida Central",6,16,10,772,289,483
12,1,2018,17,0,7,"Braga",3,"Rua de Caires",25,25,0,4,4,0
12,1,2018,17,0,7,"Braga",4,"N14 Bosch",38,47,9,59,47,12
12,1,2018,17,0,7,"Braga",5,"Avenida João Paulo II",22,38,16,15,9,6
12,1,2018,17,0,7,"Braga",6,"Avenida Padre Júlio Fragata",31,61,30,41,21,20
12,1,2018,17,0,7,"Braga",7,"Rua Nova Santa Cruz",28,28,0,108,108,0
12,1,2018,17,0,7,"Braga",8,"Rua Costa Gomes",41,41,0,42,42,0
12,1,2018,18,0,7,"Braga",1,"Avenida da Liberdade",25,25,0,26,26,0
12,1,2018,18,0,7,"Braga",2,"Avenida Central",7,18,11,662,257,405
12,1,2018,18,0,7,"Braga",3,"Rua de Caires",25,25,0,4,4,0
12,1,2018,18,0,7,"Braga",4,"N14 Bosch",30,47,17,74,47,27
12,1,2018,18,0,7,"Braga",5,"Avenida João Paulo II",39,39,0,8,8,0
12,1,2018,18,0,7,"Braga",6,"Avenida Padre Júlio Fragata",43,61,18,29,21,8
12,1,2018,18,0,7,"Braga",7,"Rua Nova Santa Cruz",28,28,0,108,108,0
12,1,2018,18,0,7,"Braga",8,"Rua Costa Gomes",28,40,12,61,43,18
12,1,2018,19,0,7,"Braga",1,"Avenida da Liberdade",25,25,0,26,26,0
12,1,2018,19,0,7,"Braga",2,"Avenida Central",10,17,7,463,272,191
12,1,2018,19,0,7,"Braga",3,"Rua de Caires",14,24,10,7,4,3
12,1,2018,19,0,7,"Braga",4,"N14 Bosch",37,47,10,60,47,13
12,1,2018,19,0,7,"Braga",5,"Avenida João Paulo II",38,38,0,9,9,0
12,1,2018,19,0,7,"Braga",6,"Avenida Padre Júlio Fragata",27,61,34,47,21,26
12,1,2018,19,0,7,"Braga",7,"Rua Nova Santa Cruz",28,28,0,108,108,0
12,1,2018,19,0,7,"Braga",8,"Rua Costa Gomes",40,40,0,43,43,0
12,1,2018,20,0,7,"Braga",1,"Avenida da Liberdade",25,25,0,26,26,0
12,1,2018,20,0,7,"Braga",2,"Avenida Central",10,18,8,463,257,206
12,1,2018,20,0,7,"Braga",3,"Rua de Caires",24,24,0,4,4,0
12,1,2018,20,0,7,"Braga",4,"N14 Bosch",47,47,0,47,47,0
12,1,2018,20,0,7,"Braga",5,"Avenida João Paulo II",39,39,0,8,8,0
12,1,2018,20,0,7,"Braga",6,"Avenida Padre Júlio Fragata",41,62,21,31,20,11
12,1,2018,20,0,7,"Braga",7,"Rua Nova Santa Cruz",29,29,0,104,104,0
12,1,2018,20,0,7,"Braga",8,"Rua Costa Gomes",28,41,13,61,42,19
12,1,2018,21,0,7,"Braga",1,"Avenida da Liberdade",25,25,0,26,26,0
12,1,2018,21,0,7,"Braga",2,"Avenida Central",17,17,0,272,272,0
12,1,2018,21,0,7,"Braga",3,"Rua de Caires",25,25,0,4,4,0
12,1,2018,21,0,7,"Braga",4,"N14 Bosch",47,47,0,47,47,0
12,1,2018,21,0,7,"Braga",5,"Avenida João Paulo II",39,39,0,8,8,0
12,1,2018,21,0,7,"Braga",6,"Avenida Padre Júlio Fragata",62,62,0,20,20,0
12,1,2018,21,0,7,"Braga",7,"Rua Nova Santa Cruz",29,29,0,104,104,0
12,1,2018,21,0,7,"Braga",8,"Rua Costa Gomes",27,41,14,63,42,21
12,1,2018,22,0,7,"Braga",1,"Avenida da Liberdade",25,25,0,26,26,0
12,1,2018,22,0,7,"Braga",2,"Avenida Central",9,18,9,515,257,258
12,1,2018,22,0,7,"Braga",3,"Rua de Caires",25,25,0,4,4,0
12,1,2018,22,0,7,"Braga",4,"N14 Bosch",47,47,0,47,47,0
12,1,2018,22,0,7,"Braga",5,"Avenida João Paulo II",39,39,0,8,8,0
12,1,2018,22,0,7,"Braga",6,"Avenida Padre Júlio Fragata",61,61,0,21,21,0
12,1,2018,22,0,7,"Braga",7,"Rua Nova Santa Cruz",29,29,0,104,104,0
12,1,2018,22,0,7,"Braga",8,"Rua Costa Gomes",40,40,0,43,43,0
12,1,2018,23,0,7,"Braga",1,"Avenida da Liberdade",25,25,0,26,26,0
12,1,2018,23,0,7,"Braga",2,"Avenida Central",9,19,10,515,244,271
12,1,2018,23,0,7,"Braga",3,"Rua de Caires",25,25,0,4,4,0
12,1,2018,23,0,7,"Braga",4,"N14 Bosch",47,47,0,47,47,0
12,1,2018,23,0,7,"Braga",5,"Avenida João Paulo II",39,39,0,8,8,0
12,1,2018,23,0,7,"Braga",6,"Avenida Padre Júlio Fragata",61,61,0,21,21,0
12,1,2018,23,0,7,"Braga",7,"Rua Nova Santa Cruz",29,29,0,104,104,0
12,1,2018,23,0,7,"Braga",8,"Rua Costa Gomes",40,40,0,43,43,0
12,2,2018,0,0,8,"Braga",1,"Avenida da Liberdade",25,25,0,26,26,0
12,2,2018,0,0,8,"Braga",2,"Avenida Central",10,17,7,463,272,191
12,2,2018,0,0,8,"Braga",3,"Rua de Caires",25,25,0,4,4,0
12,2,2018,0,0,8,"Braga",4,"N14 Bosch",47,47,0,47,47,0
12,2,2018,0,0,8,"Braga",5,"Avenida João Paulo II",39,39,0,8,8,0
12,2,2018,0,0,8,"Braga",6,"Avenida Padre Júlio Fragata",48,62,14,26,20,6
12,2,2018,0,0,8,"Braga",7,"Rua Nova Santa Cruz",29,29,0,104,104,0
12,2,2018,0,0,8,"Braga",8,"Rua Costa Gomes",40,40,0,43,43,0
12,2,2018,1,0,8,"Braga",1,"Avenida da Liberdade",25,25,0,26,26,0
12,2,2018,1,0,8,"Braga",2,"Avenida Central",18,18,0,257,257,0
12,2,2018,1,0,8,"Braga",3,"Rua de Caires",25,25,0,4,4,0
12,2,2018,1,0,8,"Braga",4,"N14 Bosch",47,47,0,47,47,0
12,2,2018,1,0,8,"Braga",5,"Avenida João Paulo II",39,39,0,8,8,0
12,2,2018,1,0,8,"Braga",6,"Avenida Padre Júlio Fragata",61,61,0,21,21,0
12,2,2018,1,0,8,"Braga",7,"Rua Nova Santa Cruz",29,29,0,104,104,0
12,2,2018,1,0,8,"Braga",8,"Rua Costa Gomes",40,40,0,43,43,0
12,2,2018,2,0,8,"Braga",2,"Avenida Central",18,18,0,257,257,0
12,2,2018,2,0,8,"Braga",3,"Rua de Caires",25,25,0,4,4,0
12,2,2018,2,0,8,"Braga",4,"N14 Bosch",47,47,0,47,47,0
12,2,2018,2,0,8,"Braga",5,"Avenida João Paulo II",39,39,0,8,8,0
12,2,2018,2,0,8,"Braga",6,"Avenida Padre Júlio Fragata",61,61,0,21,21,0
12,2,2018,2,0,8,"Braga",7,"Rua Nova Santa Cruz",29,29,0,104,104,0
12,2,2018,2,0,8,"Braga",8,"Rua Costa Gomes",41,41,0,42,42,0
12,2,2018,2,0,8,"Braga",1,"Avenida da Liberdade",25,25,0,26,26,0
12,2,2018,2,0,8,"Braga",2,"Avenida Central",18,18,0,257,257,0
12,2,2018,3,0,8,"Braga",1,"Avenida da Liberdade",25,25,0,26,26,0
12,2,2018,3,0,8,"Braga",2,"Avenida Central",18,18,0,257,257,0
12,2,2018,3,0,8,"Braga",3,"Rua de Caires",25,25,0,4,4,0
12,2,2018,3,0,8,"Braga",4,"N14 Bosch",47,47,0,47,47,0
12,2,2018,3,0,8,"Braga",5,"Avenida João Paulo II",39,39,0,8,8,0
12,2,2018,3,0,8,"Braga",6,"Avenida Padre Júlio Fragata",61,61,0,21,21,0
12,2,2018,3,0,8,"Braga",7,"Rua Nova Santa Cruz",29,29,0,104,104,0
12,2,2018,3,0,8,"Braga",8,"Rua Costa Gomes",41,41,0,42,42,0
12,2,2018,4,0,8,"Braga",1,"Avenida da Liberdade",25,25,0,26,26,0
12,2,2018,4,0,8,"Braga",2,"Avenida Central",18,18,0,257,257,0
12,2,2018,4,0,8,"Braga",3,"Rua de Caires",25,25,0,4,4,0
12,2,2018,4,0,8,"Braga",4,"N14 Bosch",47,47,0,47,47,0
12,2,2018,4,0,8,"Braga",5,"Avenida João Paulo II",39,39,0,8,8,0
12,2,2018,4,0,8,"Braga",6,"Avenida Padre Júlio Fragata",61,61,0,21,21,0
12,2,2018,4,0,8,"Braga",7,"Rua Nova Santa Cruz",29,29,0,104,104,0
12,2,2018,4,0,8,"Braga",8,"Rua Costa Gomes",41,41,0,42,42,0
12,2,2018,5,0,8,"Braga",1,"Avenida da Liberdade",25,25,0,26,26,0
12,2,2018,5,0,8,"Braga",2,"Avenida Central",18,18,0,257,257,0
12,2,2018,5,0,8,"Braga",3,"Rua de Caires",25,25,0,4,4,0
12,2,2018,5,0,8,"Braga",4,"N14 Bosch",47,47,0,47,47,0
12,2,2018,5,0,8,"Braga",5,"Avenida João Paulo II",39,39,0,8,8,0
12,2,2018,5,0,8,"Braga",6,"Avenida Padre Júlio Fragata",61,61,0,21,21,0
12,2,2018,5,0,8,"Braga",7,"Rua Nova Santa Cruz",29,29,0,104,104,0
12,2,2018,5,0,8,"Braga",8,"Rua Costa Gomes",41,41,0,42,42,0
12,2,2018,6,0,8,"Braga",1,"Avenida da Liberdade",25,25,0,26,26,0
12,2,2018,6,0,8,"Braga",2,"Avenida Central",18,18,0,257,257,0
12,2,2018,6,0,8,"Braga",3,"Rua de Caires",25,25,0,4,4,0
12,2,2018,6,0,8,"Braga",4,"N14 Bosch",47,47,0,47,47,0
12,2,2018,6,0,8,"Braga",5,"Avenida João Paulo II",39,39,0,8,8,0
12,2,2018,6,0,8,"Braga",6,"Avenida Padre Júlio Fragata",61,61,0,21,21,0
12,2,2018,6,0,8,"Braga",7,"Rua Nova Santa Cruz",29,29,0,104,104,0
12,2,2018,6,0,8,"Braga",8,"Rua Costa Gomes",41,41,0,42,42,0
12,2,2018,7,0,8,"Braga",1,"Avenida da Liberdade",25,25,0,26,26,0
12,2,2018,7,0,8,"Braga",2,"Avenida Central",18,18,0,257,257,0
12,2,2018,7,0,8,"Braga",3,"Rua de Caires",25,25,0,4,4,0
12,2,2018,7,0,8,"Braga",4,"N14 Bosch",47,47,0,47,47,0
12,2,2018,7,0,8,"Braga",5,"Avenida João Paulo II",29,38,9,12,9,3
12,2,2018,7,0,8,"Braga",6,"Avenida Padre Júlio Fragata",61,61,0,21,21,0
12,2,2018,7,0,8,"Braga",7,"Rua Nova Santa Cruz",29,29,0,104,104,0
12,2,2018,7,0,8,"Braga",8,"Rua Costa Gomes",41,41,0,42,42,0
12,2,2018,8,0,8,"Braga",1,"Avenida da Liberdade",25,25,0,26,26,0
12,2,2018,8,0,8,"Braga",2,"Avenida Central",18,18,0,257,257,0
12,2,2018,8,0,8,"Braga",3,"Rua de Caires",25,25,0,4,4,0
12,2,2018,8,0,8,"Braga",4,"N14 Bosch",47,47,0,47,47,0
12,2,2018,8,0,8,"Braga",5,"Avenida João Paulo II",38,38,0,9,9,0
12,2,2018,8,0,8,"Braga",6,"Avenida Padre Júlio Fragata",61,61,0,21,21,0
12,2,2018,8,0,8,"Braga",7,"Rua Nova Santa Cruz",29,29,0,104,104,0
12,2,2018,8,0,8,"Braga",8,"Rua Costa Gomes",41,41,0,42,42,0
12,2,2018,9,0,8,"Braga",1,"Avenida da Liberdade",25,25,0,26,26,0
12,2,2018,9,0,8,"Braga",2,"Avenida Central",18,18,0,257,257,0
12,2,2018,9,0,8,"Braga",3,"Rua de Caires",25,25,0,4,4,0
12,2,2018,9,0,8,"Braga",4,"N14 Bosch",47,47,0,47,47,0
12,2,2018,9,0,8,"Braga",5,"Avenida João Paulo II",38,38,0,9,9,0
12,2,2018,9,0,8,"Braga",6,"Avenida Padre Júlio Fragata",61,61,0,21,21,0
12,2,2018,9,0,8,"Braga",7,"Rua Nova Santa Cruz",29,29,0,104,104,0
12,2,2018,9,0,8,"Braga",8,"Rua Costa Gomes",41,41,0,42,42,0
12,2,2018,10,0,8,"Braga",1,"Avenida da Liberdade",25,25,0,26,26,0
12,2,2018,10,0,8,"Braga",2,"Avenida Central",18,18,0,257,257,0
12,2,2018,10,0,8,"Braga",3,"Rua de Caires",25,25,0,4,4,0
12,2,2018,10,0,8,"Braga",4,"N14 Bosch",47,47,0,47,47,0
12,2,2018,10,0,8,"Braga",5,"Avenida João Paulo II",38,38,0,9,9,0
12,2,2018,10,0,8,"Braga",6,"Avenida Padre Júlio Fragata",61,61,0,21,21,0
12,2,2018,10,0,8,"Braga",7,"Rua Nova Santa Cruz",29,29,0,104,104,0
12,2,2018,10,0,8,"Braga",8,"Rua Costa Gomes",41,41,0,42,42,0
12,2,2018,11,0,8,"Braga",1,"Avenida da Liberdade",25,25,0,26,26,0
12,2,2018,11,0,8,"Braga",2,"Avenida Central",17,17,0,272,272,0
12,2,2018,11,0,8,"Braga",3,"Rua de Caires",25,25,0,4,4,0
12,2,2018,11,0,8,"Braga",4,"N14 Bosch",47,47,0,47,47,0
12,2,2018,11,0,8,"Braga",5,"Avenida João Paulo II",38,38,0,9,9,0
12,2,2018,11,0,8,"Braga",6,"Avenida Padre Júlio Fragata",61,61,0,21,21,0
12,2,2018,11,0,8,"Braga",7,"Rua Nova Santa Cruz",29,29,0,104,104,0
12,2,2018,11,0,8,"Braga",8,"Rua Costa Gomes",41,41,0,42,42,0
12,2,2018,12,0,8,"Braga",1,"Avenida da Liberdade",25,25,0,26,26,0
12,2,2018,12,0,8,"Braga",2,"Avenida Central",17,17,0,272,272,0
12,2,2018,12,0,8,"Braga",3,"Rua de Caires",25,25,0,4,4,0
12,2,2018,12,0,8,"Braga",4,"N14 Bosch",47,47,0,47,47,0
12,2,2018,12,0,8,"Braga",5,"Avenida João Paulo II",38,38,0,9,9,0
12,2,2018,12,0,8,"Braga",6,"Avenida Padre Júlio Fragata",34,62,28,37,20,17
12,2,2018,12,0,8,"Braga",7,"Rua Nova Santa Cruz",29,29,0,104,104,0
12,2,2018,12,0,8,"Braga",8,"Rua Costa Gomes",22,40,18,78,43,35
12,2,2018,13,0,8,"Braga",1,"Avenida da Liberdade",25,25,0,26,26,0
12,2,2018,13,0,8,"Braga",2,"Avenida Central",17,17,0,272,272,0
12,2,2018,13,0,8,"Braga",3,"Rua de Caires",25,25,0,4,4,0
12,2,2018,13,0,8,"Braga",4,"N14 Bosch",47,47,0,47,47,0
12,2,2018,13,0,8,"Braga",5,"Avenida João Paulo II",38,38,0,9,9,0
12,2,2018,13,0,8,"Braga",6,"Avenida Padre Júlio Fragata",62,62,0,20,20,0
12,2,2018,13,0,8,"Braga",7,"Rua Nova Santa Cruz",29,29,0,104,104,0
12,2,2018,13,0,8,"Braga",8,"Rua Costa Gomes",41,41,0,42,42,0
12,2,2018,14,0,8,"Braga",4,"N14 Bosch",47,47,0,47,47,0
12,2,2018,14,0,8,"Braga",5,"Avenida João Paulo II",38,38,0,9,9,0
12,2,2018,14,0,8,"Braga",6,"Avenida Padre Júlio Fragata",62,62,0,20,20,0
12,2,2018,14,0,8,"Braga",7,"Rua Nova Santa Cruz",29,29,0,104,104,0
12,2,2018,14,0,8,"Braga",8,"Rua Costa Gomes",31,41,10,55,42,13
12,2,2018,14,0,8,"Braga",1,"Avenida da Liberdade",25,25,0,26,26,0
12,2,2018,14,0,8,"Braga",2,"Avenida Central",18,18,0,257,257,0
12,2,2018,14,0,8,"Braga",3,"Rua de Caires",25,25,0,4,4,0
12,2,2018,14,0,8,"Braga",4,"N14 Bosch",47,47,0,47,47,0
12,2,2018,15,0,8,"Braga",1,"Avenida da Liberdade",25,25,0,26,26,0
12,2,2018,15,0,8,"Braga",2,"Avenida Central",17,17,0,272,272,0
12,2,2018,15,0,8,"Braga",3,"Rua de Caires",25,25,0,4,4,0
12,2,2018,15,0,8,"Braga",4,"N14 Bosch",36,46,10,62,48,14
12,2,2018,15,0,8,"Braga",5,"Avenida João Paulo II",24,38,14,14,9,5
12,2,2018,15,0,8,"Braga",6,"Avenida Padre Júlio Fragata",30,62,32,42,20,22
12,2,2018,15,0,8,"Braga",7,"Rua Nova Santa Cruz",29,29,0,104,104,0
12,2,2018,15,0,8,"Braga",8,"Rua Costa Gomes",31,40,9,55,43,12
12,2,2018,16,0,8,"Braga",1,"Avenida da Liberdade",25,25,0,26,26,0
12,2,2018,16,0,8,"Braga",2,"Avenida Central",11,17,6,421,272,149
12,2,2018,16,0,8,"Braga",3,"Rua de Caires",19,25,6,5,4,1
12,2,2018,16,0,8,"Braga",4,"N14 Bosch",31,46,15,72,48,24
12,2,2018,16,0,8,"Braga",5,"Avenida João Paulo II",5,36,31,69,9,60
12,2,2018,16,0,8,"Braga",6,"Avenida Padre Júlio Fragata",28,62,34,45,20,25
12,2,2018,16,0,8,"Braga",7,"Rua Nova Santa Cruz",29,29,0,104,104,0
12,2,2018,16,0,8,"Braga",8,"Rua Costa Gomes",31,41,10,55,42,13
12,2,2018,17,0,8,"Braga",1,"Avenida da Liberdade",25,25,0,26,26,0
12,2,2018,17,0,8,"Braga",2,"Avenida Central",6,16,10,772,289,483
12,2,2018,17,0,8,"Braga",3,"Rua de Caires",25,25,0,4,4,0
12,2,2018,17,0,8,"Braga",4,"N14 Bosch",47,47,0,47,47,0
12,2,2018,17,0,8,"Braga",5,"Avenida João Paulo II",21,38,17,16,9,7
12,2,2018,17,0,8,"Braga",6,"Avenida Padre Júlio Fragata",34,61,27,37,21,16
12,2,2018,17,0,8,"Braga",7,"Rua Nova Santa Cruz",29,29,0,104,104,0
12,2,2018,17,0,8,"Braga",8,"Rua Costa Gomes",31,40,9,55,43,12
12,2,2018,18,0,8,"Braga",1,"Avenida da Liberdade",25,25,0,26,26,0
12,2,2018,18,0,8,"Braga",2,"Avenida Central",6,18,12,772,257,515
12,2,2018,18,0,8,"Braga",3,"Rua de Caires",25,25,0,4,4,0
12,2,2018,18,0,8,"Braga",4,"N14 Bosch",33,46,13,68,48,20
12,2,2018,18,0,8,"Braga",5,"Avenida João Paulo II",29,38,9,12,9,3
12,2,2018,18,0,8,"Braga",6,"Avenida Padre Júlio Fragata",43,62,19,29,20,9
12,2,2018,18,0,8,"Braga",7,"Rua Nova Santa Cruz",29,29,0,104,104,0
12,2,2018,18,0,8,"Braga",8,"Rua Costa Gomes",30,40,10,57,43,14
12,2,2018,19,0,8,"Braga",1,"Avenida da Liberdade",25,25,0,26,26,0
12,2,2018,19,0,8,"Braga",2,"Avenida Central",6,19,13,772,244,528
12,2,2018,19,0,8,"Braga",3,"Rua de Caires",25,25,0,4,4,0
12,2,2018,19,0,8,"Braga",4,"N14 Bosch",46,46,0,48,48,0
12,2,2018,19,0,8,"Braga",5,"Avenida João Paulo II",39,39,0,8,8,0
12,2,2018,19,0,8,"Braga",6,"Avenida Padre Júlio Fragata",62,62,0,20,20,0
12,2,2018,19,0,8,"Braga",7,"Rua Nova Santa Cruz",29,29,0,104,104,0
12,2,2018,19,0,8,"Braga",8,"Rua Costa Gomes",32,41,9,53,42,11
12,2,2018,20,0,8,"Braga",1,"Avenida da Liberdade",25,25,0,26,26,0
12,2,2018,20,0,8,"Braga",2,"Avenida Central",9,18,9,515,257,258
12,2,2018,20,0,8,"Braga",3,"Rua de Caires",25,25,0,4,4,0
12,2,2018,20,0,8,"Braga",4,"N14 Bosch",47,47,0,47,47,0
12,2,2018,20,0,8,"Braga",5,"Avenida João Paulo II",39,39,0,8,8,0
12,2,2018,20,0,8,"Braga",6,"Avenida Padre Júlio Fragata",61,61,0,21,21,0
12,2,2018,20,0,8,"Braga",7,"Rua Nova Santa Cruz",29,29,0,104,104,0
12,2,2018,20,0,8,"Braga",8,"Rua Costa Gomes",41,41,0,42,42,0
12,2,2018,21,0,8,"Braga",1,"Avenida da Liberdade",25,25,0,26,26,0
12,2,2018,21,0,8,"Braga",2,"Avenida Central",18,18,0,257,257,0
12,2,2018,21,0,8,"Braga",3,"Rua de Caires",17,24,7,6,4,2
12,2,2018,21,0,8,"Braga",4,"N14 Bosch",47,47,0,47,47,0
12,2,2018,21,0,8,"Braga",5,"Avenida João Paulo II",39,39,0,8,8,0
12,2,2018,21,0,8,"Braga",6,"Avenida Padre Júlio Fragata",62,62,0,20,20,0
12,2,2018,21,0,8,"Braga",7,"Rua Nova Santa Cruz",20,28,8,152,108,44
12,2,2018,21,0,8,"Braga",8,"Rua Costa Gomes",41,41,0,42,42,0
12,2,2018,22,0,8,"Braga",1,"Avenida da Liberdade",25,25,0,26,26,0
12,2,2018,22,0,8,"Braga",2,"Avenida Central",18,18,0,257,257,0
12,2,2018,22,0,8,"Braga",3,"Rua de Caires",25,25,0,4,4,0
12,2,2018,22,0,8,"Braga",4,"N14 Bosch",47,47,0,47,47,0
12,2,2018,22,0,8,"Braga",5,"Avenida João Paulo II",39,39,0,8,8,0
12,2,2018,22,0,8,"Braga",6,"Avenida Padre Júlio Fragata",62,62,0,20,20,0
12,2,2018,22,0,8,"Braga",7,"Rua Nova Santa Cruz",28,28,0,108,108,0
12,2,2018,22,0,8,"Braga",8,"Rua Costa Gomes",41,41,0,42,42,0
12,2,2018,23,0,8,"Braga",1,"Avenida da Liberdade",25,25,0,26,26,0
12,2,2018,23,0,8,"Braga",2,"Avenida Central",18,18,0,257,257,0
12,2,2018,23,0,8,"Braga",3,"Rua de Caires",25,25,0,4,4,0
12,2,2018,23,0,8,"Braga",4,"N14 Bosch",47,47,0,47,47,0
12,2,2018,23,0,8,"Braga",5,"Avenida João Paulo II",39,39,0,8,8,0
12,2,2018,23,0,8,"Braga",6,"Avenida Padre Júlio Fragata",62,62,0,20,20,0
12,2,2018,23,0,8,"Braga",7,"Rua Nova Santa Cruz",28,28,0,108,108,0
12,2,2018,23,0,8,"Braga",8,"Rua Costa Gomes",41,41,0,42,42,0
12,3,2018,0,0,2,"Braga",1,"Avenida da Liberdade",25,25,0,26,26,0
12,3,2018,0,0,2,"Braga",2,"Avenida Central",18,18,0,257,257,0
12,3,2018,0,0,2,"Braga",3,"Rua de Caires",25,25,0,4,4,0
12,3,2018,0,0,2,"Braga",4,"N14 Bosch",47,47,0,47,47,0
12,3,2018,0,0,2,"Braga",5,"Avenida João Paulo II",39,39,0,8,8,0
12,3,2018,0,0,2,"Braga",6,"Avenida Padre Júlio Fragata",62,62,0,20,20,0
12,3,2018,0,0,2,"Braga",7,"Rua Nova Santa Cruz",28,28,0,108,108,0
12,3,2018,0,0,2,"Braga",8,"Rua Costa Gomes",41,41,0,42,42,0
12,3,2018,1,0,2,"Braga",1,"Avenida da Liberdade",25,25,0,26,26,0
12,3,2018,1,0,2,"Braga",2,"Avenida Central",18,18,0,257,257,0
12,3,2018,1,0,2,"Braga",3,"Rua de Caires",25,25,0,4,4,0
12,3,2018,1,0,2,"Braga",4,"N14 Bosch",47,47,0,47,47,0
12,3,2018,1,0,2,"Braga",5,"Avenida João Paulo II",39,39,0,8,8,0
12,3,2018,1,0,2,"Braga",6,"Avenida Padre Júlio Fragata",62,62,0,20,20,0
12,3,2018,1,0,2,"Braga",7,"Rua Nova Santa Cruz",28,28,0,108,108,0
12,3,2018,1,0,2,"Braga",8,"Rua Costa Gomes",41,41,0,42,42,0
12,3,2018,2,0,2,"Braga",1,"Avenida da Liberdade",25,25,0,26,26,0
12,3,2018,2,0,2,"Braga",2,"Avenida Central",18,18,0,257,257,0
12,3,2018,2,0,2,"Braga",3,"Rua de Caires",25,25,0,4,4,0
12,3,2018,2,0,2,"Braga",4,"N14 Bosch",47,47,0,47,47,0
12,3,2018,2,0,2,"Braga",5,"Avenida João Paulo II",39,39,0,8,8,0
12,3,2018,2,0,2,"Braga",6,"Avenida Padre Júlio Fragata",62,62,0,20,20,0
12,3,2018,2,0,2,"Braga",7,"Rua Nova Santa Cruz",28,28,0,108,108,0
12,3,2018,2,0,2,"Braga",8,"Rua Costa Gomes",41,41,0,42,42,0
12,3,2018,3,0,2,"Braga",1,"Avenida da Liberdade",25,25,0,26,26,0
12,3,2018,3,0,2,"Braga",2,"Avenida Central",18,18,0,257,257,0
12,3,2018,3,0,2,"Braga",3,"Rua de Caires",25,25,0,4,4,0
12,3,2018,3,0,2,"Braga",4,"N14 Bosch",47,47,0,47,47,0
12,3,2018,3,0,2,"Braga",5,"Avenida João Paulo II",39,39,0,8,8,0
12,3,2018,3,0,2,"Braga",6,"Avenida Padre Júlio Fragata",62,62,0,20,20,0
12,3,2018,3,0,2,"Braga",7,"Rua Nova Santa Cruz",28,28,0,108,108,0
12,3,2018,3,0,2,"Braga",8,"Rua Costa Gomes",41,41,0,42,42,0
12,3,2018,4,0,2,"Braga",1,"Avenida da Liberdade",25,25,0,26,26,0
12,3,2018,4,0,2,"Braga",2,"Avenida Central",18,18,0,257,257,0
12,3,2018,4,0,2,"Braga",3,"Rua de Caires",25,25,0,4,4,0
12,3,2018,4,0,2,"Braga",4,"N14 Bosch",47,47,0,47,47,0
12,3,2018,4,0,2,"Braga",5,"Avenida João Paulo II",39,39,0,8,8,0
12,3,2018,4,0,2,"Braga",6,"Avenida Padre Júlio Fragata",62,62,0,20,20,0
12,3,2018,4,0,2,"Braga",7,"Rua Nova Santa Cruz",28,28,0,108,108,0
12,3,2018,4,0,2,"Braga",8,"Rua Costa Gomes",41,41,0,42,42,0
12,3,2018,5,0,2,"Braga",1,"Avenida da Liberdade",25,25,0,26,26,0
12,3,2018,5,0,2,"Braga",2,"Avenida Central",18,18,0,257,257,0
12,3,2018,5,0,2,"Braga",3,"Rua de Caires",25,25,0,4,4,0
12,3,2018,5,0,2,"Braga",4,"N14 Bosch",47,47,0,47,47,0
12,3,2018,5,0,2,"Braga",5,"Avenida João Paulo II",39,39,0,8,8,0
12,3,2018,5,0,2,"Braga",6,"Avenida Padre Júlio Fragata",62,62,0,20,20,0
12,3,2018,5,0,2,"Braga",7,"Rua Nova Santa Cruz",28,28,0,108,108,0
12,3,2018,5,0,2,"Braga",8,"Rua Costa Gomes",41,41,0,42,42,0
12,3,2018,6,0,2,"Braga",1,"Avenida da Liberdade",25,25,0,26,26,0
12,3,2018,6,0,2,"Braga",2,"Avenida Central",18,18,0,257,257,0
12,3,2018,6,0,2,"Braga",3,"Rua de Caires",25,25,0,4,4,0
12,3,2018,6,0,2,"Braga",4,"N14 Bosch",47,47,0,47,47,0
12,3,2018,6,0,2,"Braga",5,"Avenida João Paulo II",39,39,0,8,8,0
12,3,2018,6,0,2,"Braga",6,"Avenida Padre Júlio Fragata",62,62,0,20,20,0
12,3,2018,6,0,2,"Braga",7,"Rua Nova Santa Cruz",28,28,0,108,108,0
12,3,2018,6,0,2,"Braga",8,"Rua Costa Gomes",41,41,0,42,42,0
12,3,2018,7,0,2,"Braga",1,"Avenida da Liberdade",25,25,0,26,26,0
12,3,2018,7,0,2,"Braga",2,"Avenida Central",18,18,0,257,257,0
12,3,2018,7,0,2,"Braga",3,"Rua de Caires",25,25,0,4,4,0
12,3,2018,7,0,2,"Braga",4,"N14 Bosch",47,47,0,47,47,0
12,3,2018,7,0,2,"Braga",5,"Avenida João Paulo II",39,39,0,8,8,0
12,3,2018,7,0,2,"Braga",6,"Avenida Padre Júlio Fragata",62,62,0,20,20,0
12,3,2018,7,0,2,"Braga",7,"Rua Nova Santa Cruz",28,28,0,108,108,0
12,3,2018,7,0,2,"Braga",8,"Rua Costa Gomes",41,41,0,42,42,0
12,3,2018,8,0,2,"Braga",1,"Avenida da Liberdade",25,25,0,26,26,0
12,3,2018,8,0,2,"Braga",2,"Avenida Central",18,18,0,257,257,0
12,3,2018,8,0,2,"Braga",3,"Rua de Caires",25,25,0,4,4,0
12,3,2018,8,0,2,"Braga",4,"N14 Bosch",46,46,0,48,48,0
12,3,2018,8,0,2,"Braga",5,"Avenida João Paulo II",39,39,0,8,8,0
12,3,2018,8,0,2,"Braga",6,"Avenida Padre Júlio Fragata",62,62,0,20,20,0
12,3,2018,8,0,2,"Braga",7,"Rua Nova Santa Cruz",28,28,0,108,108,0
12,3,2018,8,0,2,"Braga",8,"Rua Costa Gomes",41,41,0,42,42,0
12,3,2018,9,0,2,"Braga",1,"Avenida da Liberdade",25,25,0,26,26,0
12,3,2018,9,0,2,"Braga",2,"Avenida Central",11,18,7,421,257,164
12,3,2018,9,0,2,"Braga",3,"Rua de Caires",14,25,11,7,4,3
12,3,2018,9,0,2,"Braga",4,"N14 Bosch",30,46,16,74,48,26
12,3,2018,9,0,2,"Braga",5,"Avenida João Paulo II",6,41,35,58,8,50
12,3,2018,9,0,2,"Braga",6,"Avenida Padre Júlio Fragata",18,62,44,71,20,51
12,3,2018,9,0,2,"Braga",7,"Rua Nova Santa Cruz",28,28,0,108,108,0
12,3,2018,9,0,2,"Braga",8,"Rua Costa Gomes",24,40,16,71,43,28
12,3,2018,10,0,2,"Braga",1,"Avenida da Liberdade",17,24,7,39,27,12
12,3,2018,10,0,2,"Braga",2,"Avenida Central",10,17,7,463,272,191
12,3,2018,10,0,2,"Braga",3,"Rua de Caires",25,25,0,4,4,0
12,3,2018,10,0,2,"Braga",4,"N14 Bosch",27,46,19,83,48,35
12,3,2018,10,0,2,"Braga",5,"Avenida João Paulo II",39,39,0,8,8,0
12,3,2018,10,0,2,"Braga",6,"Avenida Padre Júlio Fragata",62,62,0,20,20,0
12,3,2018,10,0,2,"Braga",7,"Rua Nova Santa Cruz",23,29,6,132,104,28
12,3,2018,10,0,2,"Braga",8,"Rua Costa Gomes",41,41,0,42,42,0
12,3,2018,11,0,2,"Braga",1,"Avenida da Liberdade",18,24,6,36,27,9
12,3,2018,11,0,2,"Braga",2,"Avenida Central",17,17,0,272,272,0
12,3,2018,11,0,2,"Braga",3,"Rua de Caires",25,25,0,4,4,0
12,3,2018,11,0,2,"Braga",4,"N14 Bosch",36,46,10,62,48,14
12,3,2018,11,0,2,"Braga",5,"Avenida João Paulo II",39,39,0,8,8,0
12,3,2018,11,0,2,"Braga",6,"Avenida Padre Júlio Fragata",61,61,0,21,21,0
12,3,2018,11,0,2,"Braga",7,"Rua Nova Santa Cruz",29,29,0,104,104,0
12,3,2018,11,0,2,"Braga",8,"Rua Costa Gomes",33,41,8,52,42,10
12,3,2018,12,0,2,"Braga",1,"Avenida da Liberdade",18,24,6,36,27,9
12,3,2018,12,0,2,"Braga",2,"Avenida Central",18,18,0,257,257,0
12,3,2018,12,0,2,"Braga",3,"Rua de Caires",25,25,0,4,4,0
12,3,2018,12,0,2,"Braga",4,"N14 Bosch",24,46,22,93,48,45
12,3,2018,12,0,2,"Braga",5,"Avenida João Paulo II",39,39,0,8,8,0
12,3,2018,12,0,2,"Braga",6,"Avenida Padre Júlio Fragata",61,61,0,21,21,0
12,3,2018,12,0,2,"Braga",7,"Rua Nova Santa Cruz",21,28,7,144,108,36
12,3,2018,12,0,2,"Braga",8,"Rua Costa Gomes",41,41,0,42,42,0
12,3,2018,13,0,2,"Braga",1,"Avenida da Liberdade",24,24,0,27,27,0
12,3,2018,13,0,2,"Braga",2,"Avenida Central",17,17,0,272,272,0
12,3,2018,13,0,2,"Braga",3,"Rua de Caires",25,25,0,4,4,0
12,3,2018,13,0,2,"Braga",4,"N14 Bosch",27,47,20,83,47,36
12,3,2018,13,0,2,"Braga",5,"Avenida João Paulo II",28,38,10,12,9,3
12,3,2018,13,0,2,"Braga",6,"Avenida Padre Júlio Fragata",42,61,19,30,21,9
12,3,2018,13,0,2,"Braga",7,"Rua Nova Santa Cruz",20,28,8,152,108,44
12,3,2018,13,0,2,"Braga",8,"Rua Costa Gomes",41,41,0,42,42,0
12,3,2018,14,0,2,"Braga",1,"Avenida da Liberdade",19,24,5,34,27,7
12,3,2018,14,0,2,"Braga",2,"Avenida Central",17,17,0,272,272,0
12,3,2018,14,0,2,"Braga",3,"Rua de Caires",25,25,0,4,4,0
12,3,2018,14,0,2,"Braga",4,"N14 Bosch",12,45,33,187,49,138
12,3,2018,14,0,2,"Braga",5,"Avenida João Paulo II",19,38,19,18,9,9
12,3,2018,14,0,2,"Braga",6,"Avenida Padre Júlio Fragata",42,61,19,30,21,9
12,3,2018,14,0,2,"Braga",7,"Rua Nova Santa Cruz",19,29,10,160,104,56
12,3,2018,14,0,2,"Braga",8,"Rua Costa Gomes",32,41,9,53,42,11
12,3,2018,15,0,2,"Braga",1,"Avenida da Liberdade",24,24,0,27,27,0
12,3,2018,15,0,2,"Braga",2,"Avenida Central",11,18,7,421,257,164
12,3,2018,15,0,2,"Braga",3,"Rua de Caires",25,25,0,4,4,0
12,3,2018,15,0,2,"Braga",4,"N14 Bosch",35,46,11,64,48,16
12,3,2018,15,0,2,"Braga",5,"Avenida João Paulo II",21,39,18,16,8,8
12,3,2018,15,0,2,"Braga",6,"Avenida Padre Júlio Fragata",43,62,19,29,20,9
12,3,2018,15,0,2,"Braga",7,"Rua Nova Santa Cruz",9,28,19,338,108,230
12,3,2018,15,0,2,"Braga",8,"Rua Costa Gomes",24,40,16,71,43,28
12,3,2018,16,0,2,"Braga",1,"Avenida da Liberdade",18,24,6,36,27,9
12,3,2018,16,0,2,"Braga",2,"Avenida Central",14,17,3,331,272,59
12,3,2018,16,0,2,"Braga",3,"Rua de Caires",24,24,0,4,4,0
12,3,2018,16,0,2,"Braga",4,"N14 Bosch",30,47,17,74,47,27
12,3,2018,16,0,2,"Braga",5,"Avenida João Paulo II",21,39,18,16,8,8
12,3,2018,16,0,2,"Braga",6,"Avenida Padre Júlio Fragata",44,62,18,29,20,9
12,3,2018,16,0,2,"Braga",7,"Rua Nova Santa Cruz",29,29,0,104,104,0
12,3,2018,16,0,2,"Braga",8,"Rua Costa Gomes",29,41,12,59,42,17
12,3,2018,17,0,2,"Braga",1,"Avenida da Liberdade",20,25,5,33,26,7
12,3,2018,17,0,2,"Braga",2,"Avenida Central",14,18,4,331,257,74
12,3,2018,17,0,2,"Braga",3,"Rua de Caires",16,25,9,6,4,2
12,3,2018,17,0,2,"Braga",4,"N14 Bosch",15,46,31,149,48,101
12,3,2018,17,0,2,"Braga",5,"Avenida João Paulo II",38,38,0,9,9,0
12,3,2018,17,0,2,"Braga",6,"Avenida Padre Júlio Fragata",32,61,29,40,21,19
12,3,2018,17,0,2,"Braga",7,"Rua Nova Santa Cruz",22,28,6,138,108,30
12,3,2018,17,0,2,"Braga",8,"Rua Costa Gomes",32,41,9,53,42,11
12,3,2018,18,0,2,"Braga",1,"Avenida da Liberdade",15,24,9,44,27,17
12,3,2018,18,0,2,"Braga",2,"Avenida Central",9,18,9,515,257,258
12,3,2018,18,0,2,"Braga",3,"Rua de Caires",15,25,10,6,4,2
12,3,2018,18,0,2,"Braga",4,"N14 Bosch",11,48,37,204,46,158
12,3,2018,18,0,2,"Braga",5,"Avenida João Paulo II",4,41,37,87,8,79
12,3,2018,18,0,2,"Braga",6,"Avenida Padre Júlio Fragata",6,61,55,214,21,193
12,3,2018,18,0,2,"Braga",7,"Rua Nova Santa Cruz",9,28,19,338,108,230
12,3,2018,18,0,2,"Braga",8,"Rua Costa Gomes",17,41,24,101,42,59
12,3,2018,19,0,2,"Braga",1,"Avenida da Liberdade",16,25,9,41,26,15
12,3,2018,19,0,2,"Braga",2,"Avenida Central",5,17,12,927,272,655
12,3,2018,19,0,2,"Braga",3,"Rua de Caires",11,25,14,9,4,5
12,3,2018,19,0,2,"Braga",4,"N14 Bosch",35,46,11,64,48,16
12,3,2018,19,0,2,"Braga",5,"Avenida João Paulo II",16,40,24,21,8,13
12,3,2018,19,0,2,"Braga",6,"Avenida Padre Júlio Fragata",23,63,40,55,20,35
12,3,2018,19,0,2,"Braga",7,"Rua Nova Santa Cruz",21,29,8,144,104,40
12,3,2018,19,0,2,"Braga",8,"Rua Costa Gomes",15,41,26,115,42,73
12,3,2018,20,0,2,"Braga",1,"Avenida da Liberdade",24,24,0,27,27,0
12,3,2018,20,0,2,"Braga",2,"Avenida Central",8,17,9,579,272,307
12,3,2018,20,0,2,"Braga",3,"Rua de Caires",25,25,0,4,4,0
12,3,2018,20,0,2,"Braga",4,"N14 Bosch",33,47,14,68,47,21
12,3,2018,20,0,2,"Braga",5,"Avenida João Paulo II",38,38,0,9,9,0
12,3,2018,20,0,2,"Braga",6,"Avenida Padre Júlio Fragata",61,61,0,21,21,0
12,3,2018,20,0,2,"Braga",7,"Rua Nova Santa Cruz",22,28,6,138,108,30
12,3,2018,20,0,2,"Braga",8,"Rua Costa Gomes",41,41,0,42,42,0
12,3,2018,21,0,2,"Braga",1,"Avenida da Liberdade",24,24,0,27,27,0
12,3,2018,21,0,2,"Braga",2,"Avenida Central",18,18,0,257,257,0
12,3,2018,21,0,2,"Braga",3,"Rua de Caires",25,25,0,4,4,0
12,3,2018,21,0,2,"Braga",4,"N14 Bosch",47,47,0,47,47,0
12,3,2018,21,0,2,"Braga",5,"Avenida João Paulo II",38,38,0,9,9,0
12,3,2018,21,0,2,"Braga",6,"Avenida Padre Júlio Fragata",62,62,0,20,20,0
12,3,2018,21,0,2,"Braga",7,"Rua Nova Santa Cruz",29,29,0,104,104,0
12,3,2018,21,0,2,"Braga",8,"Rua Costa Gomes",30,40,10,57,43,14
12,3,2018,22,0,2,"Braga",1,"Avenida da Liberdade",24,24,0,27,27,0
12,3,2018,22,0,2,"Braga",2,"Avenida Central",18,18,0,257,257,0
12,3,2018,22,0,2,"Braga",3,"Rua de Caires",25,25,0,4,4,0
12,3,2018,22,0,2,"Braga",4,"N14 Bosch",47,47,0,47,47,0
12,3,2018,22,0,2,"Braga",5,"Avenida João Paulo II",38,38,0,9,9,0
12,3,2018,22,0,2,"Braga",6,"Avenida Padre Júlio Fragata",62,62,0,20,20,0
12,3,2018,22,0,2,"Braga",7,"Rua Nova Santa Cruz",29,29,0,104,104,0
12,3,2018,22,0,2,"Braga",8,"Rua Costa Gomes",41,41,0,42,42,0
12,3,2018,23,0,2,"Braga",1,"Avenida da Liberdade",24,24,0,27,27,0
12,3,2018,23,0,2,"Braga",2,"Avenida Central",18,18,0,257,257,0
12,3,2018,23,0,2,"Braga",3,"Rua de Caires",25,25,0,4,4,0
12,3,2018,23,0,2,"Braga",4,"N14 Bosch",47,47,0,47,47,0
12,3,2018,23,0,2,"Braga",5,"Avenida João Paulo II",38,38,0,9,9,0
12,3,2018,23,0,2,"Braga",6,"Avenida Padre Júlio Fragata",62,62,0,20,20,0
12,3,2018,23,0,2,"Braga",7,"Rua Nova Santa Cruz",29,29,0,104,104,0
12,3,2018,23,0,2,"Braga",8,"Rua Costa Gomes",41,41,0,42,42,0
12,4,2018,0,0,3,"Braga",1,"Avenida da Liberdade",24,24,0,27,27,0
12,4,2018,0,0,3,"Braga",2,"Avenida Central",18,18,0,257,257,0
12,4,2018,0,0,3,"Braga",3,"Rua de Caires",25,25,0,4,4,0
12,4,2018,0,0,3,"Braga",4,"N14 Bosch",47,47,0,47,47,0
12,4,2018,0,0,3,"Braga",5,"Avenida João Paulo II",38,38,0,9,9,0
12,4,2018,0,0,3,"Braga",6,"Avenida Padre Júlio Fragata",62,62,0,20,20,0
12,4,2018,0,0,3,"Braga",7,"Rua Nova Santa Cruz",29,29,0,104,104,0
12,4,2018,0,0,3,"Braga",8,"Rua Costa Gomes",41,41,0,42,42,0
12,4,2018,1,0,3,"Braga",1,"Avenida da Liberdade",24,24,0,27,27,0
12,4,2018,1,0,3,"Braga",2,"Avenida Central",18,18,0,257,257,0
12,4,2018,1,0,3,"Braga",3,"Rua de Caires",25,25,0,4,4,0
12,4,2018,1,0,3,"Braga",4,"N14 Bosch",46,46,0,48,48,0
12,4,2018,1,0,3,"Braga",5,"Avenida João Paulo II",38,38,0,9,9,0
12,4,2018,1,0,3,"Braga",6,"Avenida Padre Júlio Fragata",62,62,0,20,20,0
12,4,2018,1,0,3,"Braga",7,"Rua Nova Santa Cruz",29,29,0,104,104,0
12,4,2018,1,0,3,"Braga",8,"Rua Costa Gomes",41,41,0,42,42,0
12,4,2018,2,0,3,"Braga",1,"Avenida da Liberdade",24,24,0,27,27,0
12,4,2018,2,0,3,"Braga",2,"Avenida Central",18,18,0,257,257,0
12,4,2018,2,0,3,"Braga",3,"Rua de Caires",25,25,0,4,4,0
12,4,2018,2,0,3,"Braga",4,"N14 Bosch",46,46,0,48,48,0
12,4,2018,2,0,3,"Braga",5,"Avenida João Paulo II",38,38,0,9,9,0
12,4,2018,2,0,3,"Braga",6,"Avenida Padre Júlio Fragata",62,62,0,20,20,0
12,4,2018,2,0,3,"Braga",7,"Rua Nova Santa Cruz",29,29,0,104,104,0
12,4,2018,2,0,3,"Braga",8,"Rua Costa Gomes",41,41,0,42,42,0
12,4,2018,3,0,3,"Braga",4,"N14 Bosch",46,46,0,48,48,0
12,4,2018,3,0,3,"Braga",5,"Avenida João Paulo II",38,38,0,9,9,0
12,4,2018,3,0,3,"Braga",6,"Avenida Padre Júlio Fragata",62,62,0,20,20,0
12,4,2018,3,0,3,"Braga",7,"Rua Nova Santa Cruz",29,29,0,104,104,0
12,4,2018,3,0,3,"Braga",8,"Rua Costa Gomes",41,41,0,42,42,0
12,4,2018,3,0,3,"Braga",1,"Avenida da Liberdade",24,24,0,27,27,0
12,4,2018,3,0,3,"Braga",2,"Avenida Central",18,18,0,257,257,0
12,4,2018,3,0,3,"Braga",3,"Rua de Caires",25,25,0,4,4,0
12,4,2018,3,0,3,"Braga",4,"N14 Bosch",46,46,0,48,48,0
12,4,2018,4,0,3,"Braga",1,"Avenida da Liberdade",24,24,0,27,27,0
12,4,2018,4,0,3,"Braga",2,"Avenida Central",18,18,0,257,257,0
12,4,2018,4,0,3,"Braga",3,"Rua de Caires",25,25,0,4,4,0
12,4,2018,4,0,3,"Braga",4,"N14 Bosch",46,46,0,48,48,0
12,4,2018,4,0,3,"Braga",5,"Avenida João Paulo II",38,38,0,9,9,0
12,4,2018,4,0,3,"Braga",6,"Avenida Padre Júlio Fragata",62,62,0,20,20,0
12,4,2018,4,0,3,"Braga",7,"Rua Nova Santa Cruz",29,29,0,104,104,0
12,4,2018,4,0,3,"Braga",8,"Rua Costa Gomes",41,41,0,42,42,0
12,4,2018,5,0,3,"Braga",1,"Avenida da Liberdade",24,24,0,27,27,0
12,4,2018,5,0,3,"Braga",2,"Avenida Central",18,18,0,257,257,0
12,4,2018,5,0,3,"Braga",3,"Rua de Caires",25,25,0,4,4,0
12,4,2018,5,0,3,"Braga",4,"N14 Bosch",46,46,0,48,48,0
12,4,2018,5,0,3,"Braga",5,"Avenida João Paulo II",38,38,0,9,9,0
12,4,2018,5,0,3,"Braga",6,"Avenida Padre Júlio Fragata",62,62,0,20,20,0
12,4,2018,5,0,3,"Braga",7,"Rua Nova Santa Cruz",29,29,0,104,104,0
12,4,2018,5,0,3,"Braga",8,"Rua Costa Gomes",41,41,0,42,42,0
12,4,2018,6,0,3,"Braga",1,"Avenida da Liberdade",24,24,0,27,27,0
12,4,2018,6,0,3,"Braga",2,"Avenida Central",18,18,0,257,257,0
12,4,2018,6,0,3,"Braga",3,"Rua de Caires",25,25,0,4,4,0
12,4,2018,6,0,3,"Braga",4,"N14 Bosch",46,46,0,48,48,0
12,4,2018,6,0,3,"Braga",5,"Avenida João Paulo II",38,38,0,9,9,0
12,4,2018,6,0,3,"Braga",6,"Avenida Padre Júlio Fragata",62,62,0,20,20,0
12,4,2018,6,0,3,"Braga",7,"Rua Nova Santa Cruz",29,29,0,104,104,0
12,4,2018,6,0,3,"Braga",8,"Rua Costa Gomes",41,41,0,42,42,0
12,4,2018,7,0,3,"Braga",1,"Avenida da Liberdade",24,24,0,27,27,0
12,4,2018,7,0,3,"Braga",2,"Avenida Central",18,18,0,257,257,0
12,4,2018,7,0,3,"Braga",3,"Rua de Caires",15,24,9,6,4,2
12,4,2018,7,0,3,"Braga",4,"N14 Bosch",46,46,0,48,48,0
12,4,2018,7,0,3,"Braga",5,"Avenida João Paulo II",38,38,0,9,9,0
12,4,2018,7,0,3,"Braga",6,"Avenida Padre Júlio Fragata",62,62,0,20,20,0
12,4,2018,7,0,3,"Braga",7,"Rua Nova Santa Cruz",29,29,0,104,104,0
12,4,2018,7,0,3,"Braga",8,"Rua Costa Gomes",41,41,0,42,42,0
12,4,2018,8,0,3,"Braga",1,"Avenida da Liberdade",24,24,0,27,27,0
12,4,2018,8,0,3,"Braga",2,"Avenida Central",18,18,0,257,257,0
12,4,2018,8,0,3,"Braga",3,"Rua de Caires",24,24,0,4,4,0
12,4,2018,8,0,3,"Braga",4,"N14 Bosch",30,47,17,74,47,27
12,4,2018,8,0,3,"Braga",5,"Avenida João Paulo II",38,38,0,9,9,0
12,4,2018,8,0,3,"Braga",6,"Avenida Padre Júlio Fragata",62,62,0,20,20,0
12,4,2018,8,0,3,"Braga",7,"Rua Nova Santa Cruz",29,29,0,104,104,0
12,4,2018,8,0,3,"Braga",8,"Rua Costa Gomes",41,41,0,42,42,0
12,4,2018,9,0,3,"Braga",1,"Avenida da Liberdade",24,24,0,27,27,0
12,4,2018,9,0,3,"Braga",2,"Avenida Central",8,17,9,579,272,307
12,4,2018,9,0,3,"Braga",3,"Rua de Caires",9,24,15,11,4,7
12,4,2018,9,0,3,"Braga",4,"N14 Bosch",15,47,32,149,47,102
12,4,2018,9,0,3,"Braga",5,"Avenida João Paulo II",28,39,11,12,8,4
12,4,2018,9,0,3,"Braga",6,"Avenida Padre Júlio Fragata",32,61,29,40,21,19
12,4,2018,9,0,3,"Braga",7,"Rua Nova Santa Cruz",29,29,0,104,104,0
12,4,2018,9,0,3,"Braga",8,"Rua Costa Gomes",29,41,12,59,42,17
12,4,2018,10,0,3,"Braga",1,"Avenida da Liberdade",20,25,5,33,26,7
12,4,2018,10,0,3,"Braga",2,"Avenida Central",18,18,0,257,257,0
12,4,2018,10,0,3,"Braga",3,"Rua de Caires",25,25,0,4,4,0
12,4,2018,10,0,3,"Braga",4,"N14 Bosch",35,46,11,64,48,16
12,4,2018,10,0,3,"Braga",5,"Avenida João Paulo II",39,39,0,8,8,0
12,4,2018,10,0,3,"Braga",6,"Avenida Padre Júlio Fragata",62,62,0,20,20,0
12,4,2018,10,0,3,"Braga",7,"Rua Nova Santa Cruz",29,29,0,104,104,0
12,4,2018,10,0,3,"Braga",8,"Rua Costa Gomes",32,41,9,53,42,11
12,4,2018,11,0,3,"Braga",1,"Avenida da Liberdade",25,25,0,26,26,0
12,4,2018,11,0,3,"Braga",2,"Avenida Central",17,17,0,272,272,0
12,4,2018,11,0,3,"Braga",3,"Rua de Caires",25,25,0,4,4,0
12,4,2018,11,0,3,"Braga",4,"N14 Bosch",22,46,24,102,48,54
12,4,2018,11,0,3,"Braga",5,"Avenida João Paulo II",27,39,12,12,8,4
12,4,2018,11,0,3,"Braga",6,"Avenida Padre Júlio Fragata",62,62,0,20,20,0
12,4,2018,11,0,3,"Braga",7,"Rua Nova Santa Cruz",29,29,0,104,104,0
12,4,2018,11,0,3,"Braga",8,"Rua Costa Gomes",32,40,8,53,43,10
12,4,2018,12,0,3,"Braga",1,"Avenida da Liberdade",25,25,0,26,26,0
12,4,2018,12,0,3,"Braga",2,"Avenida Central",10,17,7,463,272,191
12,4,2018,12,0,3,"Braga",3,"Rua de Caires",25,25,0,4,4,0
12,4,2018,12,0,3,"Braga",4,"N14 Bosch",33,47,14,68,47,21
12,4,2018,12,0,3,"Braga",5,"Avenida João Paulo II",38,38,0,9,9,0
12,4,2018,12,0,3,"Braga",6,"Avenida Padre Júlio Fragata",61,61,0,21,21,0
12,4,2018,12,0,3,"Braga",7,"Rua Nova Santa Cruz",28,28,0,108,108,0
12,4,2018,12,0,3,"Braga",8,"Rua Costa Gomes",41,41,0,42,42,0
12,4,2018,13,0,3,"Braga",1,"Avenida da Liberdade",17,25,8,39,26,13
12,4,2018,13,0,3,"Braga",2,"Avenida Central",18,18,0,257,257,0
12,4,2018,13,0,3,"Braga",3,"Rua de Caires",25,25,0,4,4,0
12,4,2018,13,0,3,"Braga",4,"N14 Bosch",47,47,0,47,47,0
12,4,2018,13,0,3,"Braga",5,"Avenida João Paulo II",38,38,0,9,9,0
12,4,2018,13,0,3,"Braga",6,"Avenida Padre Júlio Fragata",62,62,0,20,20,0
12,4,2018,13,0,3,"Braga",7,"Rua Nova Santa Cruz",28,28,0,108,108,0
12,4,2018,13,0,3,"Braga",8,"Rua Costa Gomes",31,40,9,55,43,12
12,4,2018,14,0,3,"Braga",1,"Avenida da Liberdade",25,25,0,26,26,0
12,4,2018,14,0,3,"Braga",2,"Avenida Central",12,17,5,386,272,114
12,4,2018,14,0,3,"Braga",3,"Rua de Caires",24,24,0,4,4,0
12,4,2018,14,0,3,"Braga",4,"N14 Bosch",11,46,35,204,48,156
12,4,2018,14,0,3,"Braga",5,"Avenida João Paulo II",39,39,0,8,8,0
12,4,2018,14,0,3,"Braga",6,"Avenida Padre Júlio Fragata",62,62,0,20,20,0
12,4,2018,14,0,3,"Braga",7,"Rua Nova Santa Cruz",28,28,0,108,108,0
12,4,2018,14,0,3,"Braga",8,"Rua Costa Gomes",40,40,0,43,43,0
12,4,2018,15,0,3,"Braga",1,"Avenida da Liberdade",25,25,0,26,26,0
12,4,2018,15,0,3,"Braga",2,"Avenida Central",8,17,9,579,272,307
12,4,2018,15,0,3,"Braga",3,"Rua de Caires",24,24,0,4,4,0
12,4,2018,15,0,3,"Braga",4,"N14 Bosch",34,46,12,66,48,18
12,4,2018,15,0,3,"Braga",5,"Avenida João Paulo II",25,39,14,13,8,5
12,4,2018,15,0,3,"Braga",6,"Avenida Padre Júlio Fragata",62,62,0,20,20,0
12,4,2018,15,0,3,"Braga",7,"Rua Nova Santa Cruz",28,28,0,108,108,0
12,4,2018,15,0,3,"Braga",8,"Rua Costa Gomes",25,40,15,69,43,26
12,4,2018,16,0,3,"Braga",1,"Avenida da Liberdade",25,25,0,26,26,0
12,4,2018,16,0,3,"Braga",2,"Avenida Central",10,17,7,463,272,191
12,4,2018,16,0,3,"Braga",3,"Rua de Caires",23,23,0,4,4,0
12,4,2018,16,0,3,"Braga",4,"N14 Bosch",23,47,24,97,47,50
12,4,2018,16,0,3,"Braga",5,"Avenida João Paulo II",39,39,0,8,8,0
12,4,2018,16,0,3,"Braga",6,"Avenida Padre Júlio Fragata",46,61,15,27,21,6
12,4,2018,16,0,3,"Braga",7,"Rua Nova Santa Cruz",19,29,10,160,104,56
12,4,2018,16,0,3,"Braga",8,"Rua Costa Gomes",29,41,12,59,42,17
12,4,2018,17,0,3,"Braga",1,"Avenida da Liberdade",25,25,0,26,26,0
12,4,2018,17,0,3,"Braga",2,"Avenida Central",12,18,6,386,257,129
12,4,2018,17,0,3,"Braga",3,"Rua de Caires",23,23,0,4,4,0
12,4,2018,17,0,3,"Braga",4,"N14 Bosch",18,46,28,124,48,76
12,4,2018,17,0,3,"Braga",5,"Avenida João Paulo II",30,38,8,11,9,2
12,4,2018,17,0,3,"Braga",6,"Avenida Padre Júlio Fragata",61,61,0,21,21,0
12,4,2018,17,0,3,"Braga",7,"Rua Nova Santa Cruz",21,29,8,144,104,40
12,4,2018,17,0,3,"Braga",8,"Rua Costa Gomes",22,41,19,78,42,36
12,4,2018,18,0,3,"Braga",1,"Avenida da Liberdade",17,25,8,39,26,13
12,4,2018,18,0,3,"Braga",2,"Avenida Central",7,17,10,662,272,390
12,4,2018,18,0,3,"Braga",3,"Rua de Caires",24,24,0,4,4,0
12,4,2018,18,0,3,"Braga",4,"N14 Bosch",11,45,34,204,49,155
12,4,2018,18,0,3,"Braga",5,"Avenida João Paulo II",26,39,13,13,8,5
12,4,2018,18,0,3,"Braga",6,"Avenida Padre Júlio Fragata",29,62,33,44,20,24
12,4,2018,18,0,3,"Braga",7,"Rua Nova Santa Cruz",9,28,19,338,108,230
12,4,2018,18,0,3,"Braga",8,"Rua Costa Gomes",10,40,30,172,43,129
12,4,2018,19,0,3,"Braga",1,"Avenida da Liberdade",24,24,0,27,27,0
12,4,2018,19,0,3,"Braga",2,"Avenida Central",7,17,10,662,272,390
12,4,2018,19,0,3,"Braga",3,"Rua de Caires",25,25,0,4,4,0
12,4,2018,19,0,3,"Braga",4,"N14 Bosch",29,47,18,77,47,30
12,4,2018,19,0,3,"Braga",5,"Avenida João Paulo II",39,39,0,8,8,0
12,4,2018,19,0,3,"Braga",6,"Avenida Padre Júlio Fragata",42,61,19,30,21,9
12,4,2018,19,0,3,"Braga",7,"Rua Nova Santa Cruz",15,29,14,202,104,98
12,4,2018,19,0,3,"Braga",8,"Rua Costa Gomes",5,39,34,345,44,301
12,4,2018,20,0,3,"Braga",1,"Avenida da Liberdade",20,25,5,33,26,7
12,4,2018,20,0,3,"Braga",2,"Avenida Central",17,17,0,272,272,0
12,4,2018,20,0,3,"Braga",3,"Rua de Caires",25,25,0,4,4,0
12,4,2018,20,0,3,"Braga",4,"N14 Bosch",47,47,0,47,47,0
12,4,2018,20,0,3,"Braga",5,"Avenida João Paulo II",7,39,32,49,8,41
12,4,2018,20,0,3,"Braga",6,"Avenida Padre Júlio Fragata",10,64,54,128,20,108
12,4,2018,20,0,3,"Braga",7,"Rua Nova Santa Cruz",18,28,10,169,108,61
12,4,2018,20,0,3,"Braga",8,"Rua Costa Gomes",25,41,16,69,42,27
12,4,2018,21,0,3,"Braga",1,"Avenida da Liberdade",24,24,0,27,27,0
12,4,2018,21,0,3,"Braga",2,"Avenida Central",18,18,0,257,257,0
12,4,2018,21,0,3,"Braga",3,"Rua de Caires",4,23,19,26,4,22
12,4,2018,21,0,3,"Braga",4,"N14 Bosch",37,46,9,60,48,12
12,4,2018,21,0,3,"Braga",5,"Avenida João Paulo II",37,37,0,9,9,0
12,4,2018,21,0,3,"Braga",6,"Avenida Padre Júlio Fragata",62,62,0,20,20,0
12,4,2018,21,0,3,"Braga",7,"Rua Nova Santa Cruz",29,29,0,104,104,0
12,4,2018,21,0,3,"Braga",8,"Rua Costa Gomes",40,40,0,43,43,0
12,4,2018,22,0,3,"Braga",1,"Avenida da Liberdade",24,24,0,27,27,0
12,4,2018,22,0,3,"Braga",2,"Avenida Central",18,18,0,257,257,0
12,4,2018,22,0,3,"Braga",3,"Rua de Caires",26,26,0,4,4,0
12,4,2018,22,0,3,"Braga",4,"N14 Bosch",46,46,0,48,48,0
12,4,2018,22,0,3,"Braga",5,"Avenida João Paulo II",37,37,0,9,9,0
12,4,2018,22,0,3,"Braga",6,"Avenida Padre Júlio Fragata",62,62,0,20,20,0
12,4,2018,22,0,3,"Braga",7,"Rua Nova Santa Cruz",29,29,0,104,104,0
12,4,2018,22,0,3,"Braga",8,"Rua Costa Gomes",40,40,0,43,43,0
12,4,2018,23,0,3,"Braga",1,"Avenida da Liberdade",24,24,0,27,27,0
12,4,2018,23,0,3,"Braga",2,"Avenida Central",18,18,0,257,257,0
12,4,2018,23,0,3,"Braga",3,"Rua de Caires",26,26,0,4,4,0
12,4,2018,23,0,3,"Braga",4,"N14 Bosch",46,46,0,48,48,0
12,4,2018,23,0,3,"Braga",5,"Avenida João Paulo II",37,37,0,9,9,0
12,4,2018,23,0,3,"Braga",6,"Avenida Padre Júlio Fragata",62,62,0,20,20,0
12,4,2018,23,0,3,"Braga",7,"Rua Nova Santa Cruz",29,29,0,104,104,0
12,4,2018,23,0,3,"Braga",8,"Rua Costa Gomes",40,40,0,43,43,0
12,5,2018,0,0,4,"Braga",1,"Avenida da Liberdade",24,24,0,27,27,0
12,5,2018,0,0,4,"Braga",2,"Avenida Central",18,18,0,257,257,0
12,5,2018,0,0,4,"Braga",3,"Rua de Caires",26,26,0,4,4,0
12,5,2018,0,0,4,"Braga",4,"N14 Bosch",46,46,0,48,48,0
12,5,2018,0,0,4,"Braga",5,"Avenida João Paulo II",37,37,0,9,9,0
12,5,2018,0,0,4,"Braga",6,"Avenida Padre Júlio Fragata",62,62,0,20,20,0
12,5,2018,0,0,4,"Braga",7,"Rua Nova Santa Cruz",29,29,0,104,104,0
12,5,2018,0,0,4,"Braga",8,"Rua Costa Gomes",40,40,0,43,43,0
12,5,2018,1,0,4,"Braga",1,"Avenida da Liberdade",24,24,0,27,27,0
12,5,2018,1,0,4,"Braga",2,"Avenida Central",18,18,0,257,257,0
12,5,2018,1,0,4,"Braga",3,"Rua de Caires",26,26,0,4,4,0
12,5,2018,1,0,4,"Braga",4,"N14 Bosch",46,46,0,48,48,0
12,5,2018,1,0,4,"Braga",5,"Avenida João Paulo II",37,37,0,9,9,0
12,5,2018,1,0,4,"Braga",6,"Avenida Padre Júlio Fragata",62,62,0,20,20,0
12,5,2018,1,0,4,"Braga",7,"Rua Nova Santa Cruz",29,29,0,104,104,0
12,5,2018,1,0,4,"Braga",8,"Rua Costa Gomes",40,40,0,43,43,0
12,5,2018,2,0,4,"Braga",1,"Avenida da Liberdade",24,24,0,27,27,0
12,5,2018,2,0,4,"Braga",2,"Avenida Central",18,18,0,257,257,0
12,5,2018,2,0,4,"Braga",3,"Rua de Caires",26,26,0,4,4,0
12,5,2018,2,0,4,"Braga",4,"N14 Bosch",46,46,0,48,48,0
12,5,2018,2,0,4,"Braga",5,"Avenida João Paulo II",37,37,0,9,9,0
12,5,2018,2,0,4,"Braga",6,"Avenida Padre Júlio Fragata",62,62,0,20,20,0
12,5,2018,2,0,4,"Braga",7,"Rua Nova Santa Cruz",29,29,0,104,104,0
12,5,2018,2,0,4,"Braga",8,"Rua Costa Gomes",40,40,0,43,43,0
12,5,2018,3,0,4,"Braga",1,"Avenida da Liberdade",24,24,0,27,27,0
12,5,2018,3,0,4,"Braga",2,"Avenida Central",18,18,0,257,257,0
12,5,2018,3,0,4,"Braga",3,"Rua de Caires",26,26,0,4,4,0
12,5,2018,3,0,4,"Braga",4,"N14 Bosch",46,46,0,48,48,0
12,5,2018,3,0,4,"Braga",5,"Avenida João Paulo II",37,37,0,9,9,0
12,5,2018,3,0,4,"Braga",6,"Avenida Padre Júlio Fragata",62,62,0,20,20,0
12,5,2018,3,0,4,"Braga",7,"Rua Nova Santa Cruz",29,29,0,104,104,0
12,5,2018,3,0,4,"Braga",8,"Rua Costa Gomes",40,40,0,43,43,0
12,5,2018,4,0,4,"Braga",1,"Avenida da Liberdade",24,24,0,27,27,0
12,5,2018,4,0,4,"Braga",2,"Avenida Central",18,18,0,257,257,0
12,5,2018,4,0,4,"Braga",3,"Rua de Caires",26,26,0,4,4,0
12,5,2018,4,0,4,"Braga",4,"N14 Bosch",46,46,0,48,48,0
12,5,2018,4,0,4,"Braga",5,"Avenida João Paulo II",28,38,10,12,9,3
12,5,2018,4,0,4,"Braga",6,"Avenida Padre Júlio Fragata",62,62,0,20,20,0
12,5,2018,4,0,4,"Braga",7,"Rua Nova Santa Cruz",29,29,0,104,104,0
12,5,2018,4,0,4,"Braga",8,"Rua Costa Gomes",40,40,0,43,43,0
12,5,2018,5,0,4,"Braga",1,"Avenida da Liberdade",24,24,0,27,27,0
12,5,2018,5,0,4,"Braga",2,"Avenida Central",18,18,0,257,257,0
12,5,2018,5,0,4,"Braga",3,"Rua de Caires",26,26,0,4,4,0
12,5,2018,5,0,4,"Braga",4,"N14 Bosch",46,46,0,48,48,0
12,5,2018,5,0,4,"Braga",5,"Avenida João Paulo II",38,38,0,9,9,0
12,5,2018,5,0,4,"Braga",6,"Avenida Padre Júlio Fragata",62,62,0,20,20,0
12,5,2018,5,0,4,"Braga",7,"Rua Nova Santa Cruz",29,29,0,104,104,0
12,5,2018,5,0,4,"Braga",8,"Rua Costa Gomes",40,40,0,43,43,0
12,5,2018,6,0,4,"Braga",1,"Avenida da Liberdade",24,24,0,27,27,0
12,5,2018,6,0,4,"Braga",2,"Avenida Central",18,18,0,257,257,0
12,5,2018,6,0,4,"Braga",3,"Rua de Caires",26,26,0,4,4,0
12,5,2018,6,0,4,"Braga",4,"N14 Bosch",46,46,0,48,48,0
12,5,2018,6,0,4,"Braga",5,"Avenida João Paulo II",38,38,0,9,9,0
12,5,2018,6,0,4,"Braga",6,"Avenida Padre Júlio Fragata",62,62,0,20,20,0
12,5,2018,6,0,4,"Braga",7,"Rua Nova Santa Cruz",29,29,0,104,104,0
12,5,2018,6,0,4,"Braga",8,"Rua Costa Gomes",40,40,0,43,43,0
12,5,2018,7,0,4,"Braga",1,"Avenida da Liberdade",24,24,0,27,27,0
12,5,2018,7,0,4,"Braga",2,"Avenida Central",18,18,0,257,257,0
12,5,2018,7,0,4,"Braga",3,"Rua de Caires",26,26,0,4,4,0
12,5,2018,7,0,4,"Braga",4,"N14 Bosch",46,46,0,48,48,0
12,5,2018,7,0,4,"Braga",5,"Avenida João Paulo II",38,38,0,9,9,0
12,5,2018,7,0,4,"Braga",6,"Avenida Padre Júlio Fragata",62,62,0,20,20,0
12,5,2018,7,0,4,"Braga",7,"Rua Nova Santa Cruz",29,29,0,104,104,0
12,5,2018,7,0,4,"Braga",8,"Rua Costa Gomes",40,40,0,43,43,0
12,5,2018,8,0,4,"Braga",1,"Avenida da Liberdade",24,24,0,27,27,0
12,5,2018,8,0,4,"Braga",2,"Avenida Central",18,18,0,257,257,0
12,5,2018,8,0,4,"Braga",3,"Rua de Caires",26,26,0,4,4,0
12,5,2018,8,0,4,"Braga",4,"N14 Bosch",36,46,10,62,48,14
12,5,2018,8,0,4,"Braga",5,"Avenida João Paulo II",38,38,0,9,9,0
12,5,2018,8,0,4,"Braga",6,"Avenida Padre Júlio Fragata",62,62,0,20,20,0
12,5,2018,8,0,4,"Braga",7,"Rua Nova Santa Cruz",29,29,0,104,104,0
12,5,2018,8,0,4,"Braga",8,"Rua Costa Gomes",40,40,0,43,43,0
12,5,2018,9,0,4,"Braga",1,"Avenida da Liberdade",17,24,7,39,27,12
12,5,2018,9,0,4,"Braga",2,"Avenida Central",17,17,0,272,272,0
12,5,2018,9,0,4,"Braga",3,"Rua de Caires",25,25,0,4,4,0
12,5,2018,9,0,4,"Braga",4,"N14 Bosch",32,47,15,70,47,23
12,5,2018,9,0,4,"Braga",5,"Avenida João Paulo II",39,39,0,8,8,0
12,5,2018,9,0,4,"Braga",6,"Avenida Padre Júlio Fragata",38,61,23,33,21,12
12,5,2018,9,0,4,"Braga",7,"Rua Nova Santa Cruz",28,28,0,108,108,0
12,5,2018,9,0,4,"Braga",8,"Rua Costa Gomes",18,41,23,95,42,53
12,5,2018,10,0,4,"Braga",1,"Avenida da Liberdade",24,24,0,27,27,0
12,5,2018,10,0,4,"Braga",2,"Avenida Central",10,18,8,463,257,206
12,5,2018,10,0,4,"Braga",3,"Rua de Caires",25,25,0,4,4,0
12,5,2018,10,0,4,"Braga",4,"N14 Bosch",35,46,11,64,48,16
12,5,2018,10,0,4,"Braga",5,"Avenida João Paulo II",39,39,0,8,8,0
12,5,2018,10,0,4,"Braga",6,"Avenida Padre Júlio Fragata",62,62,0,20,20,0
12,5,2018,10,0,4,"Braga",7,"Rua Nova Santa Cruz",28,28,0,108,108,0
12,5,2018,10,0,4,"Braga",8,"Rua Costa Gomes",32,40,8,53,43,10
12,5,2018,11,0,4,"Braga",1,"Avenida da Liberdade",19,25,6,34,26,8
12,5,2018,11,0,4,"Braga",2,"Avenida Central",12,18,6,386,257,129
12,5,2018,11,0,4,"Braga",3,"Rua de Caires",25,25,0,4,4,0
12,5,2018,11,0,4,"Braga",4,"N14 Bosch",46,46,0,48,48,0
12,5,2018,11,0,4,"Braga",5,"Avenida João Paulo II",39,39,0,8,8,0
12,5,2018,11,0,4,"Braga",6,"Avenida Padre Júlio Fragata",62,62,0,20,20,0
12,5,2018,11,0,4,"Braga",7,"Rua Nova Santa Cruz",28,28,0,108,108,0
12,5,2018,11,0,4,"Braga",8,"Rua Costa Gomes",32,40,8,53,43,10
12,5,2018,12,0,4,"Braga",1,"Avenida da Liberdade",24,24,0,27,27,0
12,5,2018,12,0,4,"Braga",2,"Avenida Central",13,18,5,356,257,99
12,5,2018,12,0,4,"Braga",3,"Rua de Caires",25,25,0,4,4,0
12,5,2018,12,0,4,"Braga",4,"N14 Bosch",36,46,10,62,48,14
12,5,2018,12,0,4,"Braga",5,"Avenida João Paulo II",39,39,0,8,8,0
12,5,2018,12,0,4,"Braga",6,"Avenida Padre Júlio Fragata",61,61,0,21,21,0
12,5,2018,12,0,4,"Braga",7,"Rua Nova Santa Cruz",28,28,0,108,108,0
12,5,2018,12,0,4,"Braga",8,"Rua Costa Gomes",30,40,10,57,43,14
12,5,2018,13,0,4,"Braga",1,"Avenida da Liberdade",24,24,0,27,27,0
12,5,2018,13,0,4,"Braga",2,"Avenida Central",17,17,0,272,272,0
12,5,2018,13,0,4,"Braga",3,"Rua de Caires",25,25,0,4,4,0
12,5,2018,13,0,4,"Braga",4,"N14 Bosch",12,46,34,187,48,139
12,5,2018,13,0,4,"Braga",5,"Avenida João Paulo II",30,39,9,11,8,3
12,5,2018,13,0,4,"Braga",6,"Avenida Padre Júlio Fragata",50,62,12,25,20,5
12,5,2018,13,0,4,"Braga",7,"Rua Nova Santa Cruz",17,29,12,179,104,75
12,5,2018,13,0,4,"Braga",8,"Rua Costa Gomes",41,41,0,42,42,0
12,5,2018,14,0,4,"Braga",1,"Avenida da Liberdade",24,24,0,27,27,0
12,5,2018,14,0,4,"Braga",2,"Avenida Central",12,17,5,386,272,114
12,5,2018,14,0,4,"Braga",3,"Rua de Caires",25,25,0,4,4,0
12,5,2018,14,0,4,"Braga",4,"N14 Bosch",32,46,14,70,48,22
12,5,2018,14,0,4,"Braga",5,"Avenida João Paulo II",25,38,13,13,9,4
12,5,2018,14,0,4,"Braga",6,"Avenida Padre Júlio Fragata",61,61,0,21,21,0
12,5,2018,14,0,4,"Braga",7,"Rua Nova Santa Cruz",20,28,8,152,108,44
12,5,2018,14,0,4,"Braga",8,"Rua Costa Gomes",24,41,17,71,42,29
12,5,2018,15,0,4,"Braga",1,"Avenida da Liberdade",24,24,0,27,27,0
12,5,2018,15,0,4,"Braga",2,"Avenida Central",12,17,5,386,272,114
12,5,2018,15,0,4,"Braga",3,"Rua de Caires",25,25,0,4,4,0
12,5,2018,15,0,4,"Braga",4,"N14 Bosch",18,47,29,124,47,77
12,5,2018,15,0,4,"Braga",5,"Avenida João Paulo II",18,40,22,19,8,11
12,5,2018,15,0,4,"Braga",6,"Avenida Padre Júlio Fragata",62,62,0,20,20,0
12,5,2018,15,0,4,"Braga",7,"Rua Nova Santa Cruz",28,28,0,108,108,0
12,5,2018,15,0,4,"Braga",8,"Rua Costa Gomes",31,41,10,55,42,13
12,5,2018,16,0,4,"Braga",1,"Avenida da Liberdade",24,24,0,27,27,0
12,5,2018,16,0,4,"Braga",2,"Avenida Central",13,18,5,356,257,99
12,5,2018,16,0,4,"Braga",3,"Rua de Caires",25,25,0,4,4,0
12,5,2018,16,0,4,"Braga",4,"N14 Bosch",17,48,31,132,46,86
12,5,2018,16,0,4,"Braga",5,"Avenida João Paulo II",39,39,0,8,8,0
12,5,2018,16,0,4,"Braga",6,"Avenida Padre Júlio Fragata",62,62,0,20,20,0
12,5,2018,16,0,4,"Braga",7,"Rua Nova Santa Cruz",29,29,0,104,104,0
12,5,2018,16,0,4,"Braga",8,"Rua Costa Gomes",29,40,11,59,43,16
12,5,2018,17,0,4,"Braga",1,"Avenida da Liberdade",20,25,5,33,26,7
12,5,2018,17,0,4,"Braga",2,"Avenida Central",10,17,7,463,272,191
12,5,2018,17,0,4,"Braga",3,"Rua de Caires",25,25,0,4,4,0
12,5,2018,17,0,4,"Braga",4,"N14 Bosch",16,48,32,140,46,94
12,5,2018,17,0,4,"Braga",5,"Avenida João Paulo II",29,38,9,12,9,3
12,5,2018,17,0,4,"Braga",6,"Avenida Padre Júlio Fragata",46,61,15,27,21,6
12,5,2018,17,0,4,"Braga",7,"Rua Nova Santa Cruz",29,29,0,104,104,0
12,5,2018,17,0,4,"Braga",8,"Rua Costa Gomes",18,41,23,95,42,53
12,5,2018,18,0,4,"Braga",1,"Avenida da Liberdade",25,25,0,26,26,0
12,5,2018,18,0,4,"Braga",2,"Avenida Central",7,18,11,662,257,405
12,5,2018,18,0,4,"Braga",3,"Rua de Caires",14,24,10,7,4,3
12,5,2018,18,0,4,"Braga",4,"N14 Bosch",20,48,28,112,46,66
12,5,2018,18,0,4,"Braga",5,"Avenida João Paulo II",28,38,10,12,9,3
12,5,2018,18,0,4,"Braga",6,"Avenida Padre Júlio Fragata",26,62,36,49,20,29
12,5,2018,18,0,4,"Braga",7,"Rua Nova Santa Cruz",14,28,14,217,108,109
12,5,2018,18,0,4,"Braga",8,"Rua Costa Gomes",11,42,31,156,41,115
12,5,2018,19,0,4,"Braga",1,"Avenida da Liberdade",25,25,0,26,26,0
12,5,2018,19,0,4,"Braga",2,"Avenida Central",5,17,12,927,272,655
12,5,2018,19,0,4,"Braga",3,"Rua de Caires",11,24,13,9,4,5
12,5,2018,19,0,4,"Braga",4,"N14 Bosch",30,46,16,74,48,26
12,5,2018,19,0,4,"Braga",5,"Avenida João Paulo II",38,38,0,9,9,0
12,5,2018,19,0,4,"Braga",6,"Avenida Padre Júlio Fragata",32,62,30,40,20,20
12,5,2018,19,0,4,"Braga",7,"Rua Nova Santa Cruz",29,29,0,104,104,0
12,5,2018,19,0,4,"Braga",8,"Rua Costa Gomes",10,42,32,172,41,131
12,5,2018,20,0,4,"Braga",1,"Avenida da Liberdade",25,25,0,26,26,0
12,5,2018,20,0,4,"Braga",2,"Avenida Central",17,17,0,272,272,0
12,5,2018,20,0,4,"Braga",3,"Rua de Caires",24,24,0,4,4,0
12,5,2018,20,0,4,"Braga",4,"N14 Bosch",46,46,0,48,48,0
12,5,2018,20,0,4,"Braga",5,"Avenida João Paulo II",28,38,10,12,9,3
12,5,2018,20,0,4,"Braga",6,"Avenida Padre Júlio Fragata",39,62,23,32,20,12
12,5,2018,20,0,4,"Braga",7,"Rua Nova Santa Cruz",9,29,20,338,104,234
12,5,2018,20,0,4,"Braga",8,"Rua Costa Gomes",32,41,9,53,42,11
12,5,2018,21,0,4,"Braga",1,"Avenida da Liberdade",25,25,0,26,26,0
12,5,2018,21,0,4,"Braga",2,"Avenida Central",17,17,0,272,272,0
12,5,2018,21,0,4,"Braga",3,"Rua de Caires",20,25,5,5,4,1
12,5,2018,21,0,4,"Braga",4,"N14 Bosch",46,46,0,48,48,0
12,5,2018,21,0,4,"Braga",5,"Avenida João Paulo II",39,39,0,8,8,0
12,5,2018,21,0,4,"Braga",6,"Avenida Padre Júlio Fragata",62,62,0,20,20,0
12,5,2018,21,0,4,"Braga",7,"Rua Nova Santa Cruz",20,29,9,152,104,48
12,5,2018,21,0,4,"Braga",8,"Rua Costa Gomes",22,40,18,78,43,35
12,5,2018,22,0,4,"Braga",1,"Avenida da Liberdade",25,25,0,26,26,0
12,5,2018,22,0,4,"Braga",2,"Avenida Central",17,17,0,272,272,0
12,5,2018,22,0,4,"Braga",3,"Rua de Caires",25,25,0,4,4,0
12,5,2018,22,0,4,"Braga",4,"N14 Bosch",46,46,0,48,48,0
12,5,2018,22,0,4,"Braga",5,"Avenida João Paulo II",39,39,0,8,8,0
12,5,2018,22,0,4,"Braga",6,"Avenida Padre Júlio Fragata",62,62,0,20,20,0
12,5,2018,22,0,4,"Braga",7,"Rua Nova Santa Cruz",28,28,0,108,108,0
12,5,2018,22,0,4,"Braga",8,"Rua Costa Gomes",41,41,0,42,42,0
12,5,2018,23,0,4,"Braga",1,"Avenida da Liberdade",25,25,0,26,26,0
12,5,2018,23,0,4,"Braga",2,"Avenida Central",17,17,0,272,272,0
12,5,2018,23,0,4,"Braga",3,"Rua de Caires",25,25,0,4,4,0
12,5,2018,23,0,4,"Braga",4,"N14 Bosch",46,46,0,48,48,0
12,5,2018,23,0,4,"Braga",5,"Avenida João Paulo II",39,39,0,8,8,0
12,5,2018,23,0,4,"Braga",6,"Avenida Padre Júlio Fragata",62,62,0,20,20,0
12,5,2018,23,0,4,"Braga",7,"Rua Nova Santa Cruz",28,28,0,108,108,0
12,5,2018,23,0,4,"Braga",8,"Rua Costa Gomes",41,41,0,42,42,0
12,6,2018,0,0,5,"Braga",1,"Avenida da Liberdade",25,25,0,26,26,0
12,6,2018,0,0,5,"Braga",2,"Avenida Central",17,17,0,272,272,0
12,6,2018,0,0,5,"Braga",3,"Rua de Caires",5,25,20,20,4,16
12,6,2018,0,0,5,"Braga",4,"N14 Bosch",47,47,0,47,47,0
12,6,2018,0,0,5,"Braga",5,"Avenida João Paulo II",39,39,0,8,8,0
12,6,2018,0,0,5,"Braga",6,"Avenida Padre Júlio Fragata",62,62,0,20,20,0
12,6,2018,0,0,5,"Braga",7,"Rua Nova Santa Cruz",28,28,0,108,108,0
12,6,2018,0,0,5,"Braga",8,"Rua Costa Gomes",41,41,0,42,42,0
12,6,2018,1,0,5,"Braga",1,"Avenida da Liberdade",25,25,0,26,26,0
12,6,2018,1,0,5,"Braga",2,"Avenida Central",17,17,0,272,272,0
12,6,2018,1,0,5,"Braga",3,"Rua de Caires",26,26,0,4,4,0
12,6,2018,1,0,5,"Braga",4,"N14 Bosch",47,47,0,47,47,0
12,6,2018,1,0,5,"Braga",5,"Avenida João Paulo II",39,39,0,8,8,0
12,6,2018,1,0,5,"Braga",6,"Avenida Padre Júlio Fragata",62,62,0,20,20,0
12,6,2018,1,0,5,"Braga",7,"Rua Nova Santa Cruz",28,28,0,108,108,0
12,6,2018,1,0,5,"Braga",8,"Rua Costa Gomes",41,41,0,42,42,0
12,6,2018,2,0,5,"Braga",1,"Avenida da Liberdade",25,25,0,26,26,0
12,6,2018,2,0,5,"Braga",2,"Avenida Central",17,17,0,272,272,0
12,6,2018,2,0,5,"Braga",3,"Rua de Caires",26,26,0,4,4,0
12,6,2018,2,0,5,"Braga",4,"N14 Bosch",47,47,0,47,47,0
12,6,2018,2,0,5,"Braga",5,"Avenida João Paulo II",39,39,0,8,8,0
12,6,2018,2,0,5,"Braga",6,"Avenida Padre Júlio Fragata",62,62,0,20,20,0
12,6,2018,2,0,5,"Braga",7,"Rua Nova Santa Cruz",28,28,0,108,108,0
12,6,2018,2,0,5,"Braga",8,"Rua Costa Gomes",41,41,0,42,42,0
12,6,2018,3,0,5,"Braga",1,"Avenida da Liberdade",25,25,0,26,26,0
12,6,2018,3,0,5,"Braga",2,"Avenida Central",17,17,0,272,272,0
12,6,2018,3,0,5,"Braga",3,"Rua de Caires",26,26,0,4,4,0
12,6,2018,3,0,5,"Braga",4,"N14 Bosch",47,47,0,47,47,0
12,6,2018,3,0,5,"Braga",5,"Avenida João Paulo II",39,39,0,8,8,0
12,6,2018,3,0,5,"Braga",6,"Avenida Padre Júlio Fragata",48,62,14,26,20,6
12,6,2018,3,0,5,"Braga",7,"Rua Nova Santa Cruz",28,28,0,108,108,0
12,6,2018,3,0,5,"Braga",8,"Rua Costa Gomes",41,41,0,42,42,0
12,6,2018,4,0,5,"Braga",1,"Avenida da Liberdade",25,25,0,26,26,0
12,6,2018,4,0,5,"Braga",2,"Avenida Central",17,17,0,272,272,0
12,6,2018,4,0,5,"Braga",3,"Rua de Caires",26,26,0,4,4,0
12,6,2018,4,0,5,"Braga",4,"N14 Bosch",47,47,0,47,47,0
12,6,2018,4,0,5,"Braga",5,"Avenida João Paulo II",39,39,0,8,8,0
12,6,2018,4,0,5,"Braga",6,"Avenida Padre Júlio Fragata",62,62,0,20,20,0
12,6,2018,4,0,5,"Braga",7,"Rua Nova Santa Cruz",28,28,0,108,108,0
12,6,2018,4,0,5,"Braga",8,"Rua Costa Gomes",41,41,0,42,42,0
12,6,2018,5,0,5,"Braga",1,"Avenida da Liberdade",25,25,0,26,26,0
12,6,2018,5,0,5,"Braga",2,"Avenida Central",17,17,0,272,272,0
12,6,2018,5,0,5,"Braga",3,"Rua de Caires",26,26,0,4,4,0
12,6,2018,5,0,5,"Braga",4,"N14 Bosch",47,47,0,47,47,0
12,6,2018,5,0,5,"Braga",5,"Avenida João Paulo II",39,39,0,8,8,0
12,6,2018,5,0,5,"Braga",6,"Avenida Padre Júlio Fragata",62,62,0,20,20,0
12,6,2018,5,0,5,"Braga",7,"Rua Nova Santa Cruz",28,28,0,108,108,0
12,6,2018,5,0,5,"Braga",8,"Rua Costa Gomes",41,41,0,42,42,0
12,6,2018,6,0,5,"Braga",1,"Avenida da Liberdade",25,25,0,26,26,0
12,6,2018,6,0,5,"Braga",2,"Avenida Central",17,17,0,272,272,0
12,6,2018,6,0,5,"Braga",3,"Rua de Caires",26,26,0,4,4,0
12,6,2018,6,0,5,"Braga",4,"N14 Bosch",47,47,0,47,47,0
12,6,2018,6,0,5,"Braga",5,"Avenida João Paulo II",39,39,0,8,8,0
12,6,2018,6,0,5,"Braga",6,"Avenida Padre Júlio Fragata",62,62,0,20,20,0
12,6,2018,6,0,5,"Braga",7,"Rua Nova Santa Cruz",28,28,0,108,108,0
12,6,2018,6,0,5,"Braga",8,"Rua Costa Gomes",41,41,0,42,42,0
12,6,2018,7,0,5,"Braga",1,"Avenida da Liberdade",25,25,0,26,26,0
12,6,2018,7,0,5,"Braga",2,"Avenida Central",17,17,0,272,272,0
12,6,2018,7,0,5,"Braga",3,"Rua de Caires",26,26,0,4,4,0
12,6,2018,7,0,5,"Braga",4,"N14 Bosch",47,47,0,47,47,0
12,6,2018,7,0,5,"Braga",5,"Avenida João Paulo II",39,39,0,8,8,0
12,6,2018,7,0,5,"Braga",6,"Avenida Padre Júlio Fragata",62,62,0,20,20,0
12,6,2018,7,0,5,"Braga",7,"Rua Nova Santa Cruz",28,28,0,108,108,0
12,6,2018,7,0,5,"Braga",8,"Rua Costa Gomes",41,41,0,42,42,0
12,6,2018,8,0,5,"Braga",1,"Avenida da Liberdade",25,25,0,26,26,0
12,6,2018,8,0,5,"Braga",2,"Avenida Central",17,17,0,272,272,0
12,6,2018,8,0,5,"Braga",3,"Rua de Caires",26,26,0,4,4,0
12,6,2018,8,0,5,"Braga",4,"N14 Bosch",22,46,24,102,48,54
12,6,2018,8,0,5,"Braga",5,"Avenida João Paulo II",39,39,0,8,8,0
12,6,2018,8,0,5,"Braga",6,"Avenida Padre Júlio Fragata",61,61,0,21,21,0
12,6,2018,8,0,5,"Braga",7,"Rua Nova Santa Cruz",28,28,0,108,108,0
12,6,2018,8,0,5,"Braga",8,"Rua Costa Gomes",31,40,9,55,43,12
12,6,2018,9,0,5,"Braga",1,"Avenida da Liberdade",15,24,9,44,27,17
12,6,2018,9,0,5,"Braga",2,"Avenida Central",5,17,12,927,272,655
12,6,2018,9,0,5,"Braga",3,"Rua de Caires",26,26,0,4,4,0
12,6,2018,9,0,5,"Braga",4,"N14 Bosch",22,47,25,102,47,55
12,6,2018,9,0,5,"Braga",5,"Avenida João Paulo II",24,39,15,14,8,6
12,6,2018,9,0,5,"Braga",6,"Avenida Padre Júlio Fragata",25,61,36,51,21,30
12,6,2018,9,0,5,"Braga",7,"Rua Nova Santa Cruz",28,28,0,108,108,0
12,6,2018,9,0,5,"Braga",8,"Rua Costa Gomes",40,40,0,43,43,0
12,6,2018,10,0,5,"Braga",1,"Avenida da Liberdade",18,24,6,36,27,9
12,6,2018,10,0,5,"Braga",2,"Avenida Central",7,17,10,662,272,390
12,6,2018,10,0,5,"Braga",3,"Rua de Caires",25,25,0,4,4,0
12,6,2018,10,0,5,"Braga",4,"N14 Bosch",35,46,11,64,48,16
12,6,2018,10,0,5,"Braga",5,"Avenida João Paulo II",38,38,0,9,9,0
12,6,2018,10,0,5,"Braga",6,"Avenida Padre Júlio Fragata",62,62,0,20,20,0
12,6,2018,10,0,5,"Braga",7,"Rua Nova Santa Cruz",21,29,8,144,104,40
12,6,2018,10,0,5,"Braga",8,"Rua Costa Gomes",40,40,0,43,43,0
12,6,2018,11,0,5,"Braga",1,"Avenida da Liberdade",19,24,5,34,27,7
12,6,2018,11,0,5,"Braga",2,"Avenida Central",8,17,9,579,272,307
12,6,2018,11,0,5,"Braga",3,"Rua de Caires",25,25,0,4,4,0
12,6,2018,11,0,5,"Braga",4,"N14 Bosch",31,47,16,72,47,25
12,6,2018,11,0,5,"Braga",5,"Avenida João Paulo II",38,38,0,9,9,0
12,6,2018,11,0,5,"Braga",6,"Avenida Padre Júlio Fragata",62,62,0,20,20,0
12,6,2018,11,0,5,"Braga",7,"Rua Nova Santa Cruz",29,29,0,104,104,0
12,6,2018,11,0,5,"Braga",8,"Rua Costa Gomes",40,40,0,43,43,0
12,6,2018,12,0,5,"Braga",1,"Avenida da Liberdade",19,24,5,34,27,7
12,6,2018,12,0,5,"Braga",2,"Avenida Central",12,18,6,386,257,129
12,6,2018,12,0,5,"Braga",3,"Rua de Caires",25,25,0,4,4,0
12,6,2018,12,0,5,"Braga",4,"N14 Bosch",32,47,15,70,47,23
12,6,2018,12,0,5,"Braga",5,"Avenida João Paulo II",38,38,0,9,9,0
12,6,2018,12,0,5,"Braga",6,"Avenida Padre Júlio Fragata",62,62,0,20,20,0
12,6,2018,12,0,5,"Braga",7,"Rua Nova Santa Cruz",29,29,0,104,104,0
12,6,2018,12,0,5,"Braga",8,"Rua Costa Gomes",40,40,0,43,43,0
12,6,2018,13,0,5,"Braga",1,"Avenida da Liberdade",26,26,0,25,25,0
12,6,2018,13,0,5,"Braga",2,"Avenida Central",12,18,6,386,257,129
12,6,2018,13,0,5,"Braga",3,"Rua de Caires",25,25,0,4,4,0
12,6,2018,13,0,5,"Braga",4,"N14 Bosch",25,47,22,89,47,42
12,6,2018,13,0,5,"Braga",5,"Avenida João Paulo II",38,38,0,9,9,0
12,6,2018,13,0,5,"Braga",6,"Avenida Padre Júlio Fragata",47,61,14,27,21,6
12,6,2018,13,0,5,"Braga",7,"Rua Nova Santa Cruz",23,29,6,132,104,28
12,6,2018,13,0,5,"Braga",8,"Rua Costa Gomes",40,40,0,43,43,0
12,6,2018,14,0,5,"Braga",1,"Avenida da Liberdade",26,26,0,25,25,0
12,6,2018,14,0,5,"Braga",2,"Avenida Central",13,17,4,356,272,84
12,6,2018,14,0,5,"Braga",3,"Rua de Caires",20,25,5,5,4,1
12,6,2018,14,0,5,"Braga",4,"N14 Bosch",19,47,28,118,47,71
12,6,2018,14,0,5,"Braga",5,"Avenida João Paulo II",30,39,9,11,8,3
12,6,2018,14,0,5,"Braga",6,"Avenida Padre Júlio Fragata",40,62,22,32,20,12
12,6,2018,14,0,5,"Braga",7,"Rua Nova Santa Cruz",28,28,0,108,108,0
12,6,2018,14,0,5,"Braga",8,"Rua Costa Gomes",31,41,10,55,42,13
12,6,2018,15,0,5,"Braga",1,"Avenida da Liberdade",12,25,13,55,26,29
12,6,2018,15,0,5,"Braga",2,"Avenida Central",17,17,0,272,272,0
12,6,2018,15,0,5,"Braga",3,"Rua de Caires",25,25,0,4,4,0
12,6,2018,15,0,5,"Braga",4,"N14 Bosch",32,46,14,70,48,22
12,6,2018,15,0,5,"Braga",5,"Avenida João Paulo II",39,39,0,8,8,0
12,6,2018,15,0,5,"Braga",6,"Avenida Padre Júlio Fragata",61,61,0,21,21,0
12,6,2018,15,0,5,"Braga",7,"Rua Nova Santa Cruz",18,29,11,169,104,65
12,6,2018,15,0,5,"Braga",8,"Rua Costa Gomes",30,41,11,57,42,15
12,6,2018,16,0,5,"Braga",1,"Avenida da Liberdade",19,25,6,34,26,8
12,6,2018,16,0,5,"Braga",2,"Avenida Central",13,18,5,356,257,99
12,6,2018,16,0,5,"Braga",3,"Rua de Caires",25,25,0,4,4,0
12,6,2018,16,0,5,"Braga",4,"N14 Bosch",15,47,32,149,47,102
12,6,2018,16,0,5,"Braga",5,"Avenida João Paulo II",39,39,0,8,8,0
12,6,2018,16,0,5,"Braga",6,"Avenida Padre Júlio Fragata",62,62,0,20,20,0
12,6,2018,16,0,5,"Braga",7,"Rua Nova Santa Cruz",22,29,7,138,104,34
12,6,2018,16,0,5,"Braga",8,"Rua Costa Gomes",28,41,13,61,42,19
12,6,2018,17,0,5,"Braga",1,"Avenida da Liberdade",19,25,6,34,26,8
12,6,2018,17,0,5,"Braga",2,"Avenida Central",7,18,11,662,257,405
12,6,2018,17,0,5,"Braga",3,"Rua de Caires",25,25,0,4,4,0
12,6,2018,17,0,5,"Braga",4,"N14 Bosch",14,47,33,160,47,113
12,6,2018,17,0,5,"Braga",5,"Avenida João Paulo II",25,39,14,13,8,5
12,6,2018,17,0,5,"Braga",6,"Avenida Padre Júlio Fragata",34,61,27,37,21,16
12,6,2018,17,0,5,"Braga",7,"Rua Nova Santa Cruz",17,28,11,179,108,71
12,6,2018,17,0,5,"Braga",8,"Rua Costa Gomes",22,41,19,78,42,36
12,6,2018,18,0,5,"Braga",1,"Avenida da Liberdade",18,25,7,36,26,10
12,6,2018,18,0,5,"Braga",2,"Avenida Central",6,19,13,772,244,528
12,6,2018,18,0,5,"Braga",3,"Rua de Caires",17,24,7,6,4,2
12,6,2018,18,0,5,"Braga",4,"N14 Bosch",14,47,33,160,47,113
12,6,2018,18,0,5,"Braga",5,"Avenida João Paulo II",14,40,26,24,8,16
12,6,2018,18,0,5,"Braga",6,"Avenida Padre Júlio Fragata",14,61,47,91,21,70
12,6,2018,18,0,5,"Braga",7,"Rua Nova Santa Cruz",13,29,16,234,104,130
12,6,2018,18,0,5,"Braga",8,"Rua Costa Gomes",12,41,29,143,42,101
12,6,2018,19,0,5,"Braga",1,"Avenida da Liberdade",19,24,5,34,27,7
12,6,2018,19,0,5,"Braga",2,"Avenida Central",5,19,14,927,244,683
12,6,2018,19,0,5,"Braga",3,"Rua de Caires",13,26,13,8,4,4
12,6,2018,19,0,5,"Braga",4,"N14 Bosch",16,47,31,140,47,93
12,6,2018,19,0,5,"Braga",5,"Avenida João Paulo II",16,39,23,21,8,13
12,6,2018,19,0,5,"Braga",6,"Avenida Padre Júlio Fragata",28,63,35,45,20,25
12,6,2018,19,0,5,"Braga",7,"Rua Nova Santa Cruz",6,30,24,507,101,406
12,6,2018,19,0,5,"Braga",8,"Rua Costa Gomes",12,41,29,143,42,101
12,6,2018,20,0,5,"Braga",1,"Avenida da Liberdade",24,24,0,27,27,0
12,6,2018,20,0,5,"Braga",2,"Avenida Central",11,17,6,421,272,149
12,6,2018,20,0,5,"Braga",3,"Rua de Caires",25,25,0,4,4,0
12,6,2018,20,0,5,"Braga",4,"N14 Bosch",33,47,14,68,47,21
12,6,2018,20,0,5,"Braga",5,"Avenida João Paulo II",38,38,0,9,9,0
12,6,2018,20,0,5,"Braga",6,"Avenida Padre Júlio Fragata",42,62,20,30,20,10
12,6,2018,20,0,5,"Braga",7,"Rua Nova Santa Cruz",18,28,10,169,108,61
12,6,2018,20,0,5,"Braga",8,"Rua Costa Gomes",28,40,12,61,43,18
12,6,2018,21,0,5,"Braga",1,"Avenida da Liberdade",24,24,0,27,27,0
12,6,2018,21,0,5,"Braga",2,"Avenida Central",17,17,0,272,272,0
12,6,2018,21,0,5,"Braga",3,"Rua de Caires",5,26,21,20,4,16
12,6,2018,21,0,5,"Braga",4,"N14 Bosch",46,46,0,48,48,0
12,6,2018,21,0,5,"Braga",5,"Avenida João Paulo II",38,38,0,9,9,0
12,6,2018,21,0,5,"Braga",6,"Avenida Padre Júlio Fragata",46,61,15,27,21,6
12,6,2018,21,0,5,"Braga",7,"Rua Nova Santa Cruz",28,28,0,108,108,0
12,6,2018,21,0,5,"Braga",8,"Rua Costa Gomes",41,41,0,42,42,0
12,6,2018,22,0,5,"Braga",1,"Avenida da Liberdade",24,24,0,27,27,0
12,6,2018,22,0,5,"Braga",2,"Avenida Central",18,18,0,257,257,0
12,6,2018,22,0,5,"Braga",3,"Rua de Caires",26,26,0,4,4,0
12,6,2018,22,0,5,"Braga",4,"N14 Bosch",46,46,0,48,48,0
12,6,2018,22,0,5,"Braga",5,"Avenida João Paulo II",38,38,0,9,9,0
12,6,2018,22,0,5,"Braga",6,"Avenida Padre Júlio Fragata",39,62,23,32,20,12
12,6,2018,22,0,5,"Braga",7,"Rua Nova Santa Cruz",28,28,0,108,108,0
12,6,2018,22,0,5,"Braga",8,"Rua Costa Gomes",41,41,0,42,42,0
12,6,2018,23,0,5,"Braga",1,"Avenida da Liberdade",24,24,0,27,27,0
12,6,2018,23,0,5,"Braga",2,"Avenida Central",18,18,0,257,257,0
12,6,2018,23,0,5,"Braga",3,"Rua de Caires",26,26,0,4,4,0
12,6,2018,23,0,5,"Braga",4,"N14 Bosch",46,46,0,48,48,0
12,6,2018,23,0,5,"Braga",5,"Avenida João Paulo II",38,38,0,9,9,0
12,6,2018,23,0,5,"Braga",6,"Avenida Padre Júlio Fragata",62,62,0,20,20,0
12,6,2018,23,0,5,"Braga",7,"Rua Nova Santa Cruz",28,28,0,108,108,0
12,6,2018,23,0,5,"Braga",8,"Rua Costa Gomes",41,41,0,42,42,0
12,7,2018,0,0,6,"Braga",1,"Avenida da Liberdade",24,24,0,27,27,0
12,7,2018,0,0,6,"Braga",2,"Avenida Central",18,18,0,257,257,0
12,7,2018,0,0,6,"Braga",3,"Rua de Caires",26,26,0,4,4,0
12,7,2018,0,0,6,"Braga",4,"N14 Bosch",46,46,0,48,48,0
12,7,2018,0,0,6,"Braga",5,"Avenida João Paulo II",38,38,0,9,9,0
12,7,2018,0,0,6,"Braga",6,"Avenida Padre Júlio Fragata",62,62,0,20,20,0
12,7,2018,0,0,6,"Braga",7,"Rua Nova Santa Cruz",28,28,0,108,108,0
12,7,2018,0,0,6,"Braga",8,"Rua Costa Gomes",41,41,0,42,42,0
12,7,2018,1,0,6,"Braga",1,"Avenida da Liberdade",24,24,0,27,27,0
12,7,2018,1,0,6,"Braga",2,"Avenida Central",18,18,0,257,257,0
12,7,2018,1,0,6,"Braga",3,"Rua de Caires",19,24,5,5,4,1
12,7,2018,1,0,6,"Braga",4,"N14 Bosch",46,46,0,48,48,0
12,7,2018,1,0,6,"Braga",5,"Avenida João Paulo II",38,38,0,9,9,0
12,7,2018,1,0,6,"Braga",6,"Avenida Padre Júlio Fragata",62,62,0,20,20,0
12,7,2018,1,0,6,"Braga",7,"Rua Nova Santa Cruz",28,28,0,108,108,0
12,7,2018,1,0,6,"Braga",8,"Rua Costa Gomes",41,41,0,42,42,0
12,7,2018,2,0,6,"Braga",1,"Avenida da Liberdade",24,24,0,27,27,0
12,7,2018,2,0,6,"Braga",2,"Avenida Central",18,18,0,257,257,0
12,7,2018,2,0,6,"Braga",3,"Rua de Caires",25,25,0,4,4,0
12,7,2018,2,0,6,"Braga",4,"N14 Bosch",46,46,0,48,48,0
12,7,2018,2,0,6,"Braga",5,"Avenida João Paulo II",38,38,0,9,9,0
12,7,2018,2,0,6,"Braga",6,"Avenida Padre Júlio Fragata",62,62,0,20,20,0
12,7,2018,2,0,6,"Braga",7,"Rua Nova Santa Cruz",28,28,0,108,108,0
12,7,2018,2,0,6,"Braga",8,"Rua Costa Gomes",41,41,0,42,42,0
12,7,2018,3,0,6,"Braga",1,"Avenida da Liberdade",24,24,0,27,27,0
12,7,2018,3,0,6,"Braga",2,"Avenida Central",18,18,0,257,257,0
12,7,2018,3,0,6,"Braga",3,"Rua de Caires",25,25,0,4,4,0
12,7,2018,3,0,6,"Braga",4,"N14 Bosch",46,46,0,48,48,0
12,7,2018,3,0,6,"Braga",5,"Avenida João Paulo II",38,38,0,9,9,0
12,7,2018,3,0,6,"Braga",6,"Avenida Padre Júlio Fragata",62,62,0,20,20,0
12,7,2018,3,0,6,"Braga",7,"Rua Nova Santa Cruz",28,28,0,108,108,0
12,7,2018,3,0,6,"Braga",8,"Rua Costa Gomes",41,41,0,42,42,0
12,7,2018,4,0,6,"Braga",1,"Avenida da Liberdade",24,24,0,27,27,0
12,7,2018,4,0,6,"Braga",2,"Avenida Central",18,18,0,257,257,0
12,7,2018,4,0,6,"Braga",3,"Rua de Caires",25,25,0,4,4,0
12,7,2018,4,0,6,"Braga",4,"N14 Bosch",46,46,0,48,48,0
12,7,2018,4,0,6,"Braga",5,"Avenida João Paulo II",38,38,0,9,9,0
12,7,2018,4,0,6,"Braga",6,"Avenida Padre Júlio Fragata",62,62,0,20,20,0
12,7,2018,4,0,6,"Braga",7,"Rua Nova Santa Cruz",28,28,0,108,108,0
12,7,2018,4,0,6,"Braga",8,"Rua Costa Gomes",41,41,0,42,42,0
12,7,2018,5,0,6,"Braga",1,"Avenida da Liberdade",24,24,0,27,27,0
12,7,2018,5,0,6,"Braga",2,"Avenida Central",18,18,0,257,257,0
12,7,2018,5,0,6,"Braga",3,"Rua de Caires",25,25,0,4,4,0
12,7,2018,5,0,6,"Braga",4,"N14 Bosch",46,46,0,48,48,0
12,7,2018,5,0,6,"Braga",5,"Avenida João Paulo II",38,38,0,9,9,0
12,7,2018,5,0,6,"Braga",6,"Avenida Padre Júlio Fragata",62,62,0,20,20,0
12,7,2018,5,0,6,"Braga",7,"Rua Nova Santa Cruz",28,28,0,108,108,0
12,7,2018,5,0,6,"Braga",8,"Rua Costa Gomes",41,41,0,42,42,0
12,7,2018,6,0,6,"Braga",1,"Avenida da Liberdade",24,24,0,27,27,0
12,7,2018,6,0,6,"Braga",2,"Avenida Central",18,18,0,257,257,0
12,7,2018,6,0,6,"Braga",3,"Rua de Caires",25,25,0,4,4,0
12,7,2018,6,0,6,"Braga",4,"N14 Bosch",46,46,0,48,48,0
12,7,2018,6,0,6,"Braga",5,"Avenida João Paulo II",38,38,0,9,9,0
12,7,2018,6,0,6,"Braga",6,"Avenida Padre Júlio Fragata",62,62,0,20,20,0
12,7,2018,6,0,6,"Braga",7,"Rua Nova Santa Cruz",28,28,0,108,108,0
12,7,2018,6,0,6,"Braga",8,"Rua Costa Gomes",41,41,0,42,42,0
12,7,2018,7,0,6,"Braga",1,"Avenida da Liberdade",24,24,0,27,27,0
12,7,2018,7,0,6,"Braga",2,"Avenida Central",18,18,0,257,257,0
12,7,2018,7,0,6,"Braga",3,"Rua de Caires",25,25,0,4,4,0
12,7,2018,7,0,6,"Braga",4,"N14 Bosch",46,46,0,48,48,0
12,7,2018,7,0,6,"Braga",5,"Avenida João Paulo II",38,38,0,9,9,0
12,7,2018,7,0,6,"Braga",6,"Avenida Padre Júlio Fragata",62,62,0,20,20,0
12,7,2018,7,0,6,"Braga",7,"Rua Nova Santa Cruz",28,28,0,108,108,0
12,7,2018,7,0,6,"Braga",8,"Rua Costa Gomes",41,41,0,42,42,0
12,7,2018,8,0,6,"Braga",1,"Avenida da Liberdade",24,24,0,27,27,0
12,7,2018,8,0,6,"Braga",2,"Avenida Central",18,18,0,257,257,0
12,7,2018,8,0,6,"Braga",3,"Rua de Caires",25,25,0,4,4,0
12,7,2018,8,0,6,"Braga",4,"N14 Bosch",46,46,0,48,48,0
12,7,2018,8,0,6,"Braga",5,"Avenida João Paulo II",38,38,0,9,9,0
12,7,2018,8,0,6,"Braga",6,"Avenida Padre Júlio Fragata",61,61,0,21,21,0
12,7,2018,8,0,6,"Braga",7,"Rua Nova Santa Cruz",28,28,0,108,108,0
12,7,2018,8,0,6,"Braga",8,"Rua Costa Gomes",41,41,0,42,42,0
12,7,2018,9,0,6,"Braga",1,"Avenida da Liberdade",17,25,8,39,26,13
12,7,2018,9,0,6,"Braga",2,"Avenida Central",9,18,9,515,257,258
12,7,2018,9,0,6,"Braga",3,"Rua de Caires",19,25,6,5,4,1
12,7,2018,9,0,6,"Braga",4,"N14 Bosch",20,47,27,112,47,65
12,7,2018,9,0,6,"Braga",5,"Avenida João Paulo II",11,39,28,31,8,23
12,7,2018,9,0,6,"Braga",6,"Avenida Padre Júlio Fragata",24,62,38,53,20,33
12,7,2018,9,0,6,"Braga",7,"Rua Nova Santa Cruz",28,28,0,108,108,0
12,7,2018,9,0,6,"Braga",8,"Rua Costa Gomes",33,41,8,52,42,10
12,7,2018,10,0,6,"Braga",1,"Avenida da Liberdade",19,24,5,34,27,7
12,7,2018,10,0,6,"Braga",2,"Avenida Central",13,17,4,356,272,84
12,7,2018,10,0,6,"Braga",3,"Rua de Caires",25,25,0,4,4,0
12,7,2018,10,0,6,"Braga",4,"N14 Bosch",22,46,24,102,48,54
12,7,2018,10,0,6,"Braga",5,"Avenida João Paulo II",38,38,0,9,9,0
12,7,2018,10,0,6,"Braga",6,"Avenida Padre Júlio Fragata",62,62,0,20,20,0
12,7,2018,10,0,6,"Braga",7,"Rua Nova Santa Cruz",28,28,0,108,108,0
12,7,2018,10,0,6,"Braga",8,"Rua Costa Gomes",32,41,9,53,42,11
12,7,2018,11,0,6,"Braga",1,"Avenida da Liberdade",24,24,0,27,27,0
12,7,2018,11,0,6,"Braga",2,"Avenida Central",13,17,4,356,272,84
12,7,2018,11,0,6,"Braga",3,"Rua de Caires",25,25,0,4,4,0
12,7,2018,11,0,6,"Braga",4,"N14 Bosch",18,46,28,124,48,76
12,7,2018,11,0,6,"Braga",5,"Avenida João Paulo II",38,38,0,9,9,0
12,7,2018,11,0,6,"Braga",6,"Avenida Padre Júlio Fragata",49,62,13,26,20,6
12,7,2018,11,0,6,"Braga",7,"Rua Nova Santa Cruz",29,29,0,104,104,0
12,7,2018,11,0,6,"Braga",8,"Rua Costa Gomes",30,40,10,57,43,14
12,7,2018,12,0,6,"Braga",1,"Avenida da Liberdade",24,24,0,27,27,0
12,7,2018,12,0,6,"Braga",2,"Avenida Central",11,18,7,421,257,164
12,7,2018,12,0,6,"Braga",3,"Rua de Caires",24,24,0,4,4,0
12,7,2018,12,0,6,"Braga",4,"N14 Bosch",36,47,11,62,47,15
12,7,2018,12,0,6,"Braga",5,"Avenida João Paulo II",30,39,9,11,8,3
12,7,2018,12,0,6,"Braga",6,"Avenida Padre Júlio Fragata",62,62,0,20,20,0
12,7,2018,12,0,6,"Braga",7,"Rua Nova Santa Cruz",20,28,8,152,108,44
12,7,2018,12,0,6,"Braga",8,"Rua Costa Gomes",23,40,17,75,43,32
12,7,2018,13,0,6,"Braga",1,"Avenida da Liberdade",24,24,0,27,27,0
12,7,2018,13,0,6,"Braga",2,"Avenida Central",12,17,5,386,272,114
12,7,2018,13,0,6,"Braga",3,"Rua de Caires",24,24,0,4,4,0
12,7,2018,13,0,6,"Braga",4,"N14 Bosch",36,46,10,62,48,14
12,7,2018,13,0,6,"Braga",5,"Avenida João Paulo II",38,38,0,9,9,0
12,7,2018,13,0,6,"Braga",6,"Avenida Padre Júlio Fragata",62,62,0,20,20,0
12,7,2018,13,0,6,"Braga",7,"Rua Nova Santa Cruz",14,28,14,217,108,109
12,7,2018,13,0,6,"Braga",8,"Rua Costa Gomes",41,41,0,42,42,0
12,7,2018,14,0,6,"Braga",1,"Avenida da Liberdade",18,25,7,36,26,10
12,7,2018,14,0,6,"Braga",2,"Avenida Central",7,17,10,662,272,390
12,7,2018,14,0,6,"Braga",3,"Rua de Caires",24,24,0,4,4,0
12,7,2018,14,0,6,"Braga",4,"N14 Bosch",22,46,24,102,48,54
12,7,2018,14,0,6,"Braga",5,"Avenida João Paulo II",23,39,16,15,8,7
12,7,2018,14,0,6,"Braga",6,"Avenida Padre Júlio Fragata",48,61,13,26,21,5
12,7,2018,14,0,6,"Braga",7,"Rua Nova Santa Cruz",21,29,8,144,104,40
12,7,2018,14,0,6,"Braga",8,"Rua Costa Gomes",29,40,11,59,43,16
12,7,2018,15,0,6,"Braga",1,"Avenida da Liberdade",18,24,6,36,27,9
12,7,2018,15,0,6,"Braga",2,"Avenida Central",11,18,7,421,257,164
12,7,2018,15,0,6,"Braga",3,"Rua de Caires",24,24,0,4,4,0
12,7,2018,15,0,6,"Braga",4,"N14 Bosch",11,47,36,204,47,157
12,7,2018,15,0,6,"Braga",5,"Avenida João Paulo II",30,39,9,11,8,3
12,7,2018,15,0,6,"Braga",6,"Avenida Padre Júlio Fragata",45,62,17,28,20,8
12,7,2018,15,0,6,"Braga",7,"Rua Nova Santa Cruz",17,28,11,179,108,71
12,7,2018,15,0,6,"Braga",8,"Rua Costa Gomes",21,40,19,82,43,39
12,7,2018,16,0,6,"Braga",1,"Avenida da Liberdade",24,24,0,27,27,0
12,7,2018,16,0,6,"Braga",2,"Avenida Central",9,18,9,515,257,258
12,7,2018,16,0,6,"Braga",3,"Rua de Caires",16,24,8,6,4,2
12,7,2018,16,0,6,"Braga",4,"N14 Bosch",31,47,16,72,47,25
12,7,2018,16,0,6,"Braga",5,"Avenida João Paulo II",38,38,0,9,9,0
12,7,2018,16,0,6,"Braga",6,"Avenida Padre Júlio Fragata",34,61,27,37,21,16
12,7,2018,16,0,6,"Braga",7,"Rua Nova Santa Cruz",15,29,14,202,104,98
12,7,2018,16,0,6,"Braga",8,"Rua Costa Gomes",41,41,0,42,42,0
12,7,2018,17,0,6,"Braga",1,"Avenida da Liberdade",20,25,5,33,26,7
12,7,2018,17,0,6,"Braga",2,"Avenida Central",9,19,10,515,244,271
12,7,2018,17,0,6,"Braga",3,"Rua de Caires",19,24,5,5,4,1
12,7,2018,17,0,6,"Braga",4,"N14 Bosch",18,48,30,124,46,78
12,7,2018,17,0,6,"Braga",5,"Avenida João Paulo II",25,39,14,13,8,5
12,7,2018,17,0,6,"Braga",6,"Avenida Padre Júlio Fragata",19,62,43,67,20,47
12,7,2018,17,0,6,"Braga",7,"Rua Nova Santa Cruz",13,29,16,234,104,130
12,7,2018,17,0,6,"Braga",8,"Rua Costa Gomes",21,40,19,82,43,39
12,7,2018,18,0,6,"Braga",1,"Avenida da Liberdade",25,25,0,26,26,0
12,7,2018,18,0,6,"Braga",2,"Avenida Central",6,18,12,772,257,515
12,7,2018,18,0,6,"Braga",3,"Rua de Caires",3,24,21,34,4,30
12,7,2018,18,0,6,"Braga",4,"N14 Bosch",6,48,42,374,46,328
12,7,2018,18,0,6,"Braga",5,"Avenida João Paulo II",6,38,32,58,9,49
12,7,2018,18,0,6,"Braga",6,"Avenida Padre Júlio Fragata",8,64,56,160,20,140
12,7,2018,18,0,6,"Braga",7,"Rua Nova Santa Cruz",11,29,18,276,104,172
12,7,2018,18,0,6,"Braga",8,"Rua Costa Gomes",9,40,31,191,43,148
12,7,2018,19,0,6,"Braga",1,"Avenida da Liberdade",25,25,0,26,26,0
12,7,2018,19,0,6,"Braga",2,"Avenida Central",6,19,13,772,244,528
12,7,2018,19,0,6,"Braga",3,"Rua de Caires",14,25,11,7,4,3
12,7,2018,19,0,6,"Braga",4,"N14 Bosch",17,45,28,132,49,83
12,7,2018,19,0,6,"Braga",5,"Avenida João Paulo II",2,33,31,174,10,164
12,7,2018,19,0,6,"Braga",6,"Avenida Padre Júlio Fragata",5,59,54,257,21,236
12,7,2018,19,0,6,"Braga",7,"Rua Nova Santa Cruz",5,30,25,608,101,507
12,7,2018,19,0,6,"Braga",8,"Rua Costa Gomes",5,40,35,345,43,302
12,7,2018,20,0,6,"Braga",1,"Avenida da Liberdade",14,25,11,47,26,21
12,7,2018,20,0,6,"Braga",2,"Avenida Central",7,19,12,662,244,418
12,7,2018,20,0,6,"Braga",3,"Rua de Caires",20,25,5,5,4,1
12,7,2018,20,0,6,"Braga",4,"N14 Bosch",26,46,20,86,48,38
12,7,2018,20,0,6,"Braga",5,"Avenida João Paulo II",11,38,27,31,9,22
12,7,2018,20,0,6,"Braga",6,"Avenida Padre Júlio Fragata",48,62,14,26,20,6
12,7,2018,20,0,6,"Braga",7,"Rua Nova Santa Cruz",9,30,21,338,101,237
12,7,2018,20,0,6,"Braga",8,"Rua Costa Gomes",10,41,31,172,42,130
12,7,2018,21,0,6,"Braga",1,"Avenida da Liberdade",25,25,0,26,26,0
12,7,2018,21,0,6,"Braga",2,"Avenida Central",12,18,6,386,257,129
12,7,2018,21,0,6,"Braga",3,"Rua de Caires",25,25,0,4,4,0
12,7,2018,21,0,6,"Braga",4,"N14 Bosch",32,47,15,70,47,23
12,7,2018,21,0,6,"Braga",5,"Avenida João Paulo II",23,39,16,15,8,7
12,7,2018,21,0,6,"Braga",6,"Avenida Padre Júlio Fragata",47,62,15,27,20,7
12,7,2018,21,0,6,"Braga",7,"Rua Nova Santa Cruz",22,29,7,138,104,34
12,7,2018,21,0,6,"Braga",8,"Rua Costa Gomes",31,41,10,55,42,13
12,7,2018,22,0,6,"Braga",1,"Avenida da Liberdade",25,25,0,26,26,0
12,7,2018,22,0,6,"Braga",2,"Avenida Central",17,17,0,272,272,0
12,7,2018,22,0,6,"Braga",3,"Rua de Caires",25,25,0,4,4,0
12,7,2018,22,0,6,"Braga",4,"N14 Bosch",47,47,0,47,47,0
12,7,2018,22,0,6,"Braga",5,"Avenida João Paulo II",39,39,0,8,8,0
12,7,2018,22,0,6,"Braga",6,"Avenida Padre Júlio Fragata",42,61,19,30,21,9
12,7,2018,22,0,6,"Braga",7,"Rua Nova Santa Cruz",28,28,0,108,108,0
12,7,2018,22,0,6,"Braga",8,"Rua Costa Gomes",40,40,0,43,43,0
12,7,2018,23,0,6,"Braga",1,"Avenida da Liberdade",25,25,0,26,26,0
12,7,2018,23,0,6,"Braga",2,"Avenida Central",17,17,0,272,272,0
12,7,2018,23,0,6,"Braga",3,"Rua de Caires",25,25,0,4,4,0
12,7,2018,23,0,6,"Braga",4,"N14 Bosch",36,47,11,62,47,15
12,7,2018,23,0,6,"Braga",5,"Avenida João Paulo II",39,39,0,8,8,0
12,7,2018,23,0,6,"Braga",6,"Avenida Padre Júlio Fragata",61,61,0,21,21,0
12,7,2018,23,0,6,"Braga",7,"Rua Nova Santa Cruz",28,28,0,108,108,0
12,7,2018,23,0,6,"Braga",8,"Rua Costa Gomes",40,40,0,43,43,0
12,8,2018,0,0,7,"Braga",1,"Avenida da Liberdade",25,25,0,26,26,0
12,8,2018,0,0,7,"Braga",2,"Avenida Central",17,17,0,272,272,0
12,8,2018,0,0,7,"Braga",3,"Rua de Caires",25,25,0,4,4,0
12,8,2018,0,0,7,"Braga",4,"N14 Bosch",47,47,0,47,47,0
12,8,2018,0,0,7,"Braga",5,"Avenida João Paulo II",39,39,0,8,8,0
12,8,2018,0,0,7,"Braga",6,"Avenida Padre Júlio Fragata",61,61,0,21,21,0
12,8,2018,0,0,7,"Braga",7,"Rua Nova Santa Cruz",28,28,0,108,108,0
12,8,2018,0,0,7,"Braga",8,"Rua Costa Gomes",40,40,0,43,43,0
12,8,2018,1,0,7,"Braga",1,"Avenida da Liberdade",25,25,0,26,26,0
12,8,2018,1,0,7,"Braga",2,"Avenida Central",17,17,0,272,272,0
12,8,2018,1,0,7,"Braga",3,"Rua de Caires",25,25,0,4,4,0
12,8,2018,1,0,7,"Braga",4,"N14 Bosch",46,46,0,48,48,0
12,8,2018,1,0,7,"Braga",5,"Avenida João Paulo II",38,38,0,9,9,0
12,8,2018,1,0,7,"Braga",6,"Avenida Padre Júlio Fragata",62,62,0,20,20,0
12,8,2018,1,0,7,"Braga",7,"Rua Nova Santa Cruz",29,29,0,104,104,0
12,8,2018,1,0,7,"Braga",8,"Rua Costa Gomes",40,40,0,43,43,0
12,8,2018,2,0,7,"Braga",1,"Avenida da Liberdade",25,25,0,26,26,0
12,8,2018,2,0,7,"Braga",2,"Avenida Central",17,17,0,272,272,0
12,8,2018,2,0,7,"Braga",3,"Rua de Caires",25,25,0,4,4,0
12,8,2018,2,0,7,"Braga",4,"N14 Bosch",46,46,0,48,48,0
12,8,2018,2,0,7,"Braga",5,"Avenida João Paulo II",38,38,0,9,9,0
12,8,2018,2,0,7,"Braga",6,"Avenida Padre Júlio Fragata",62,62,0,20,20,0
12,8,2018,2,0,7,"Braga",7,"Rua Nova Santa Cruz",29,29,0,104,104,0
12,8,2018,2,0,7,"Braga",8,"Rua Costa Gomes",40,40,0,43,43,0
12,8,2018,3,0,7,"Braga",1,"Avenida da Liberdade",25,25,0,26,26,0
12,8,2018,3,0,7,"Braga",2,"Avenida Central",17,17,0,272,272,0
12,8,2018,3,0,7,"Braga",3,"Rua de Caires",25,25,0,4,4,0
12,8,2018,3,0,7,"Braga",4,"N14 Bosch",46,46,0,48,48,0
12,8,2018,3,0,7,"Braga",5,"Avenida João Paulo II",38,38,0,9,9,0
12,8,2018,3,0,7,"Braga",6,"Avenida Padre Júlio Fragata",62,62,0,20,20,0
12,8,2018,3,0,7,"Braga",7,"Rua Nova Santa Cruz",29,29,0,104,104,0
12,8,2018,3,0,7,"Braga",8,"Rua Costa Gomes",40,40,0,43,43,0
12,8,2018,4,0,7,"Braga",1,"Avenida da Liberdade",25,25,0,26,26,0
12,8,2018,4,0,7,"Braga",2,"Avenida Central",17,17,0,272,272,0
12,8,2018,4,0,7,"Braga",3,"Rua de Caires",25,25,0,4,4,0
12,8,2018,4,0,7,"Braga",4,"N14 Bosch",46,46,0,48,48,0
12,8,2018,4,0,7,"Braga",5,"Avenida João Paulo II",38,38,0,9,9,0
12,8,2018,4,0,7,"Braga",6,"Avenida Padre Júlio Fragata",62,62,0,20,20,0
12,8,2018,4,0,7,"Braga",7,"Rua Nova Santa Cruz",29,29,0,104,104,0
12,8,2018,4,0,7,"Braga",8,"Rua Costa Gomes",40,40,0,43,43,0
12,8,2018,5,0,7,"Braga",1,"Avenida da Liberdade",25,25,0,26,26,0
12,8,2018,5,0,7,"Braga",2,"Avenida Central",17,17,0,272,272,0
12,8,2018,5,0,7,"Braga",3,"Rua de Caires",25,25,0,4,4,0
12,8,2018,5,0,7,"Braga",4,"N14 Bosch",46,46,0,48,48,0
12,8,2018,5,0,7,"Braga",5,"Avenida João Paulo II",38,38,0,9,9,0
12,8,2018,5,0,7,"Braga",6,"Avenida Padre Júlio Fragata",62,62,0,20,20,0
12,8,2018,5,0,7,"Braga",7,"Rua Nova Santa Cruz",29,29,0,104,104,0
12,8,2018,5,0,7,"Braga",8,"Rua Costa Gomes",40,40,0,43,43,0
12,8,2018,6,0,7,"Braga",1,"Avenida da Liberdade",25,25,0,26,26,0
12,8,2018,6,0,7,"Braga",2,"Avenida Central",17,17,0,272,272,0
12,8,2018,6,0,7,"Braga",3,"Rua de Caires",25,25,0,4,4,0
12,8,2018,6,0,7,"Braga",4,"N14 Bosch",46,46,0,48,48,0
12,8,2018,6,0,7,"Braga",5,"Avenida João Paulo II",38,38,0,9,9,0
12,8,2018,6,0,7,"Braga",6,"Avenida Padre Júlio Fragata",62,62,0,20,20,0
12,8,2018,6,0,7,"Braga",7,"Rua Nova Santa Cruz",29,29,0,104,104,0
12,8,2018,6,0,7,"Braga",8,"Rua Costa Gomes",40,40,0,43,43,0
12,8,2018,7,0,7,"Braga",1,"Avenida da Liberdade",25,25,0,26,26,0
12,8,2018,7,0,7,"Braga",2,"Avenida Central",17,17,0,272,272,0
12,8,2018,7,0,7,"Braga",3,"Rua de Caires",25,25,0,4,4,0
12,8,2018,7,0,7,"Braga",4,"N14 Bosch",46,46,0,48,48,0
12,8,2018,7,0,7,"Braga",5,"Avenida João Paulo II",38,38,0,9,9,0
12,8,2018,7,0,7,"Braga",6,"Avenida Padre Júlio Fragata",62,62,0,20,20,0
12,8,2018,7,0,7,"Braga",7,"Rua Nova Santa Cruz",29,29,0,104,104,0
12,8,2018,7,0,7,"Braga",8,"Rua Costa Gomes",40,40,0,43,43,0
12,8,2018,8,0,7,"Braga",1,"Avenida da Liberdade",25,25,0,26,26,0
12,8,2018,8,0,7,"Braga",2,"Avenida Central",17,17,0,272,272,0
12,8,2018,8,0,7,"Braga",3,"Rua de Caires",17,25,8,6,4,2
12,8,2018,8,0,7,"Braga",4,"N14 Bosch",46,46,0,48,48,0
12,8,2018,8,0,7,"Braga",5,"Avenida João Paulo II",38,38,0,9,9,0
12,8,2018,8,0,7,"Braga",6,"Avenida Padre Júlio Fragata",62,62,0,20,20,0
12,8,2018,8,0,7,"Braga",7,"Rua Nova Santa Cruz",29,29,0,104,104,0
12,8,2018,8,0,7,"Braga",8,"Rua Costa Gomes",40,40,0,43,43,0
12,8,2018,9,0,7,"Braga",1,"Avenida da Liberdade",25,25,0,26,26,0
12,8,2018,9,0,7,"Braga",2,"Avenida Central",17,17,0,272,272,0
12,8,2018,9,0,7,"Braga",3,"Rua de Caires",24,24,0,4,4,0
12,8,2018,9,0,7,"Braga",4,"N14 Bosch",46,46,0,48,48,0
12,8,2018,9,0,7,"Braga",5,"Avenida João Paulo II",38,38,0,9,9,0
12,8,2018,9,0,7,"Braga",6,"Avenida Padre Júlio Fragata",62,62,0,20,20,0
12,8,2018,9,0,7,"Braga",7,"Rua Nova Santa Cruz",29,29,0,104,104,0
12,8,2018,9,0,7,"Braga",8,"Rua Costa Gomes",40,40,0,43,43,0
12,8,2018,10,0,7,"Braga",1,"Avenida da Liberdade",25,25,0,26,26,0
12,8,2018,10,0,7,"Braga",2,"Avenida Central",17,17,0,272,272,0
12,8,2018,10,0,7,"Braga",3,"Rua de Caires",25,25,0,4,4,0
12,8,2018,10,0,7,"Braga",4,"N14 Bosch",47,47,0,47,47,0
12,8,2018,10,0,7,"Braga",5,"Avenida João Paulo II",38,38,0,9,9,0
12,8,2018,10,0,7,"Braga",6,"Avenida Padre Júlio Fragata",62,62,0,20,20,0
12,8,2018,10,0,7,"Braga",7,"Rua Nova Santa Cruz",29,29,0,104,104,0
12,8,2018,10,0,7,"Braga",8,"Rua Costa Gomes",40,40,0,43,43,0
12,8,2018,11,0,7,"Braga",1,"Avenida da Liberdade",25,25,0,26,26,0
12,8,2018,11,0,7,"Braga",2,"Avenida Central",11,18,7,421,257,164
12,8,2018,11,0,7,"Braga",3,"Rua de Caires",25,25,0,4,4,0
12,8,2018,11,0,7,"Braga",4,"N14 Bosch",31,47,16,72,47,25
12,8,2018,11,0,7,"Braga",5,"Avenida João Paulo II",13,37,24,26,9,17
12,8,2018,11,0,7,"Braga",6,"Avenida Padre Júlio Fragata",35,61,26,36,21,15
12,8,2018,11,0,7,"Braga",7,"Rua Nova Santa Cruz",29,29,0,104,104,0
12,8,2018,11,0,7,"Braga",8,"Rua Costa Gomes",40,40,0,43,43,0
12,8,2018,12,0,7,"Braga",1,"Avenida da Liberdade",25,25,0,26,26,0
12,8,2018,12,0,7,"Braga",2,"Avenida Central",7,19,12,662,244,418
12,8,2018,12,0,7,"Braga",3,"Rua de Caires",18,25,7,5,4,1
12,8,2018,12,0,7,"Braga",4,"N14 Bosch",38,47,9,59,47,12
12,8,2018,12,0,7,"Braga",5,"Avenida João Paulo II",19,39,20,18,8,10
12,8,2018,12,0,7,"Braga",6,"Avenida Padre Júlio Fragata",34,62,28,37,20,17
12,8,2018,12,0,7,"Braga",7,"Rua Nova Santa Cruz",29,29,0,104,104,0
12,8,2018,12,0,7,"Braga",8,"Rua Costa Gomes",40,40,0,43,43,0
12,8,2018,13,0,7,"Braga",1,"Avenida da Liberdade",25,25,0,26,26,0
12,8,2018,13,0,7,"Braga",2,"Avenida Central",14,18,4,331,257,74
12,8,2018,13,0,7,"Braga",3,"Rua de Caires",24,24,0,4,4,0
12,8,2018,13,0,7,"Braga",4,"N14 Bosch",34,46,12,66,48,18
12,8,2018,13,0,7,"Braga",5,"Avenida João Paulo II",31,39,8,11,8,3
12,8,2018,13,0,7,"Braga",6,"Avenida Padre Júlio Fragata",62,62,0,20,20,0
12,8,2018,13,0,7,"Braga",7,"Rua Nova Santa Cruz",29,29,0,104,104,0
12,8,2018,13,0,7,"Braga",8,"Rua Costa Gomes",30,41,11,57,42,15
12,8,2018,14,0,7,"Braga",1,"Avenida da Liberdade",25,25,0,26,26,0
12,8,2018,14,0,7,"Braga",2,"Avenida Central",13,17,4,356,272,84
12,8,2018,14,0,7,"Braga",3,"Rua de Caires",24,24,0,4,4,0
12,8,2018,14,0,7,"Braga",4,"N14 Bosch",47,47,0,47,47,0
12,8,2018,14,0,7,"Braga",5,"Avenida João Paulo II",39,39,0,8,8,0
12,8,2018,14,0,7,"Braga",6,"Avenida Padre Júlio Fragata",41,61,20,31,21,10
12,8,2018,14,0,7,"Braga",7,"Rua Nova Santa Cruz",29,29,0,104,104,0
12,8,2018,14,0,7,"Braga",8,"Rua Costa Gomes",41,41,0,42,42,0
12,8,2018,15,0,7,"Braga",1,"Avenida da Liberdade",25,25,0,26,26,0
12,8,2018,15,0,7,"Braga",2,"Avenida Central",14,18,4,331,257,74
12,8,2018,15,0,7,"Braga",3,"Rua de Caires",24,24,0,4,4,0
12,8,2018,15,0,7,"Braga",4,"N14 Bosch",47,47,0,47,47,0
12,8,2018,15,0,7,"Braga",5,"Avenida João Paulo II",9,39,30,38,8,30
12,8,2018,15,0,7,"Braga",6,"Avenida Padre Júlio Fragata",21,63,42,61,20,41
12,8,2018,15,0,7,"Braga",7,"Rua Nova Santa Cruz",29,29,0,104,104,0
12,8,2018,15,0,7,"Braga",8,"Rua Costa Gomes",31,40,9,55,43,12
12,8,2018,16,0,7,"Braga",1,"Avenida da Liberdade",25,25,0,26,26,0
12,8,2018,16,0,7,"Braga",2,"Avenida Central",6,17,11,772,272,500
12,8,2018,16,0,7,"Braga",3,"Rua de Caires",9,24,15,11,4,7
12,8,2018,16,0,7,"Braga",4,"N14 Bosch",30,47,17,74,47,27
12,8,2018,16,0,7,"Braga",5,"Avenida João Paulo II",4,41,37,87,8,79
12,8,2018,16,0,7,"Braga",6,"Avenida Padre Júlio Fragata",29,62,33,44,20,24
12,8,2018,16,0,7,"Braga",7,"Rua Nova Santa Cruz",23,28,5,132,108,24
12,8,2018,16,0,7,"Braga",8,"Rua Costa Gomes",33,41,8,52,42,10
12,8,2018,17,0,7,"Braga",1,"Avenida da Liberdade",25,25,0,26,26,0
12,8,2018,17,0,7,"Braga",2,"Avenida Central",9,17,8,515,272,243
12,8,2018,17,0,7,"Braga",3,"Rua de Caires",17,24,7,6,4,2
12,8,2018,17,0,7,"Braga",4,"N14 Bosch",24,47,23,93,47,46
12,8,2018,17,0,7,"Braga",5,"Avenida João Paulo II",16,40,24,21,8,13
12,8,2018,17,0,7,"Braga",6,"Avenida Padre Júlio Fragata",38,61,23,33,21,12
12,8,2018,17,0,7,"Braga",7,"Rua Nova Santa Cruz",28,28,0,108,108,0
12,8,2018,17,0,7,"Braga",8,"Rua Costa Gomes",26,41,15,66,42,24
12,8,2018,18,0,7,"Braga",1,"Avenida da Liberdade",25,25,0,26,26,0
12,8,2018,18,0,7,"Braga",2,"Avenida Central",7,18,11,662,257,405
12,8,2018,18,0,7,"Braga",3,"Rua de Caires",20,25,5,5,4,1
12,8,2018,18,0,7,"Braga",4,"N14 Bosch",29,46,17,77,48,29
12,8,2018,18,0,7,"Braga",5,"Avenida João Paulo II",10,37,27,34,9,25
12,8,2018,18,0,7,"Braga",6,"Avenida Padre Júlio Fragata",25,61,36,51,21,30
12,8,2018,18,0,7,"Braga",7,"Rua Nova Santa Cruz",28,28,0,108,108,0
12,8,2018,18,0,7,"Braga",8,"Rua Costa Gomes",29,41,12,59,42,17
12,8,2018,19,0,7,"Braga",1,"Avenida da Liberdade",25,25,0,26,26,0
12,8,2018,19,0,7,"Braga",2,"Avenida Central",9,17,8,515,272,243
12,8,2018,19,0,7,"Braga",3,"Rua de Caires",24,24,0,4,4,0
12,8,2018,19,0,7,"Braga",4,"N14 Bosch",47,47,0,47,47,0
12,8,2018,19,0,7,"Braga",5,"Avenida João Paulo II",28,38,10,12,9,3
12,8,2018,19,0,7,"Braga",6,"Avenida Padre Júlio Fragata",40,61,21,32,21,11
12,8,2018,19,0,7,"Braga",7,"Rua Nova Santa Cruz",28,28,0,108,108,0
12,8,2018,19,0,7,"Braga",8,"Rua Costa Gomes",30,40,10,57,43,14
12,8,2018,20,0,7,"Braga",1,"Avenida da Liberdade",25,25,0,26,26,0
12,8,2018,20,0,7,"Braga",2,"Avenida Central",13,18,5,356,257,99
12,8,2018,20,0,7,"Braga",3,"Rua de Caires",24,24,0,4,4,0
12,8,2018,20,0,7,"Braga",4,"N14 Bosch",34,46,12,66,48,18
12,8,2018,20,0,7,"Braga",5,"Avenida João Paulo II",38,38,0,9,9,0
12,8,2018,20,0,7,"Braga",6,"Avenida Padre Júlio Fragata",34,62,28,37,20,17
12,8,2018,20,0,7,"Braga",7,"Rua Nova Santa Cruz",29,29,0,104,104,0
12,8,2018,20,0,7,"Braga",8,"Rua Costa Gomes",21,40,19,82,43,39
12,8,2018,21,0,7,"Braga",1,"Avenida da Liberdade",25,25,0,26,26,0
12,8,2018,21,0,7,"Braga",2,"Avenida Central",18,18,0,257,257,0
12,8,2018,21,0,7,"Braga",3,"Rua de Caires",24,24,0,4,4,0
12,8,2018,21,0,7,"Braga",4,"N14 Bosch",47,47,0,47,47,0
12,8,2018,21,0,7,"Braga",5,"Avenida João Paulo II",29,39,10,12,8,4
12,8,2018,21,0,7,"Braga",6,"Avenida Padre Júlio Fragata",61,61,0,21,21,0
12,8,2018,21,0,7,"Braga",7,"Rua Nova Santa Cruz",21,28,7,144,108,36
12,8,2018,21,0,7,"Braga",8,"Rua Costa Gomes",31,41,10,55,42,13
12,8,2018,22,0,7,"Braga",1,"Avenida da Liberdade",25,25,0,26,26,0
12,8,2018,22,0,7,"Braga",2,"Avenida Central",17,17,0,272,272,0
12,8,2018,22,0,7,"Braga",3,"Rua de Caires",24,24,0,4,4,0
12,8,2018,22,0,7,"Braga",4,"N14 Bosch",47,47,0,47,47,0
12,8,2018,22,0,7,"Braga",5,"Avenida João Paulo II",39,39,0,8,8,0
12,8,2018,22,0,7,"Braga",6,"Avenida Padre Júlio Fragata",61,61,0,21,21,0
12,8,2018,22,0,7,"Braga",7,"Rua Nova Santa Cruz",29,29,0,104,104,0
12,8,2018,22,0,7,"Braga",8,"Rua Costa Gomes",41,41,0,42,42,0
12,8,2018,23,0,7,"Braga",1,"Avenida da Liberdade",25,25,0,26,26,0
12,8,2018,23,0,7,"Braga",2,"Avenida Central",11,18,7,421,257,164
12,8,2018,23,0,7,"Braga",3,"Rua de Caires",24,24,0,4,4,0
12,8,2018,23,0,7,"Braga",4,"N14 Bosch",46,46,0,48,48,0
12,8,2018,23,0,7,"Braga",5,"Avenida João Paulo II",39,39,0,8,8,0
12,8,2018,23,0,7,"Braga",6,"Avenida Padre Júlio Fragata",62,62,0,20,20,0
12,8,2018,23,0,7,"Braga",7,"Rua Nova Santa Cruz",29,29,0,104,104,0
12,8,2018,23,0,7,"Braga",8,"Rua Costa Gomes",41,41,0,42,42,0
12,9,2018,0,0,8,"Braga",1,"Avenida da Liberdade",25,25,0,26,26,0
12,9,2018,0,0,8,"Braga",2,"Avenida Central",18,18,0,257,257,0
12,9,2018,0,0,8,"Braga",3,"Rua de Caires",24,24,0,4,4,0
12,9,2018,0,0,8,"Braga",4,"N14 Bosch",46,46,0,48,48,0
12,9,2018,0,0,8,"Braga",5,"Avenida João Paulo II",39,39,0,8,8,0
12,9,2018,0,0,8,"Braga",6,"Avenida Padre Júlio Fragata",62,62,0,20,20,0
12,9,2018,0,0,8,"Braga",7,"Rua Nova Santa Cruz",29,29,0,104,104,0
12,9,2018,0,0,8,"Braga",8,"Rua Costa Gomes",41,41,0,42,42,0
12,9,2018,1,0,8,"Braga",1,"Avenida da Liberdade",25,25,0,26,26,0
12,9,2018,1,0,8,"Braga",2,"Avenida Central",17,17,0,272,272,0
12,9,2018,1,0,8,"Braga",3,"Rua de Caires",24,24,0,4,4,0
12,9,2018,1,0,8,"Braga",4,"N14 Bosch",46,46,0,48,48,0
12,9,2018,1,0,8,"Braga",5,"Avenida João Paulo II",39,39,0,8,8,0
12,9,2018,1,0,8,"Braga",6,"Avenida Padre Júlio Fragata",62,62,0,20,20,0
12,9,2018,1,0,8,"Braga",7,"Rua Nova Santa Cruz",29,29,0,104,104,0
12,9,2018,1,0,8,"Braga",8,"Rua Costa Gomes",41,41,0,42,42,0
12,9,2018,2,0,8,"Braga",1,"Avenida da Liberdade",25,25,0,26,26,0
12,9,2018,2,0,8,"Braga",2,"Avenida Central",17,17,0,272,272,0
12,9,2018,2,0,8,"Braga",3,"Rua de Caires",24,24,0,4,4,0
12,9,2018,2,0,8,"Braga",4,"N14 Bosch",46,46,0,48,48,0
12,9,2018,2,0,8,"Braga",5,"Avenida João Paulo II",39,39,0,8,8,0
12,9,2018,2,0,8,"Braga",6,"Avenida Padre Júlio Fragata",62,62,0,20,20,0
12,9,2018,2,0,8,"Braga",7,"Rua Nova Santa Cruz",29,29,0,104,104,0
12,9,2018,2,0,8,"Braga",8,"Rua Costa Gomes",41,41,0,42,42,0
12,9,2018,3,0,8,"Braga",1,"Avenida da Liberdade",25,25,0,26,26,0
12,9,2018,3,0,8,"Braga",2,"Avenida Central",17,17,0,272,272,0
12,9,2018,3,0,8,"Braga",3,"Rua de Caires",24,24,0,4,4,0
12,9,2018,3,0,8,"Braga",4,"N14 Bosch",46,46,0,48,48,0
12,9,2018,3,0,8,"Braga",5,"Avenida João Paulo II",39,39,0,8,8,0
12,9,2018,3,0,8,"Braga",6,"Avenida Padre Júlio Fragata",62,62,0,20,20,0
12,9,2018,3,0,8,"Braga",7,"Rua Nova Santa Cruz",29,29,0,104,104,0
12,9,2018,3,0,8,"Braga",8,"Rua Costa Gomes",41,41,0,42,42,0
12,9,2018,4,0,8,"Braga",1,"Avenida da Liberdade",25,25,0,26,26,0
12,9,2018,4,0,8,"Braga",2,"Avenida Central",17,17,0,272,272,0
12,9,2018,4,0,8,"Braga",3,"Rua de Caires",24,24,0,4,4,0
12,9,2018,4,0,8,"Braga",4,"N14 Bosch",46,46,0,48,48,0
12,9,2018,4,0,8,"Braga",5,"Avenida João Paulo II",39,39,0,8,8,0
12,9,2018,4,0,8,"Braga",6,"Avenida Padre Júlio Fragata",62,62,0,20,20,0
12,9,2018,4,0,8,"Braga",7,"Rua Nova Santa Cruz",29,29,0,104,104,0
12,9,2018,4,0,8,"Braga",8,"Rua Costa Gomes",41,41,0,42,42,0
12,9,2018,5,0,8,"Braga",1,"Avenida da Liberdade",25,25,0,26,26,0
12,9,2018,5,0,8,"Braga",2,"Avenida Central",17,17,0,272,272,0
12,9,2018,5,0,8,"Braga",3,"Rua de Caires",24,24,0,4,4,0
12,9,2018,5,0,8,"Braga",4,"N14 Bosch",46,46,0,48,48,0
12,9,2018,5,0,8,"Braga",5,"Avenida João Paulo II",39,39,0,8,8,0
12,9,2018,5,0,8,"Braga",6,"Avenida Padre Júlio Fragata",62,62,0,20,20,0
12,9,2018,5,0,8,"Braga",7,"Rua Nova Santa Cruz",29,29,0,104,104,0
12,9,2018,5,0,8,"Braga",8,"Rua Costa Gomes",41,41,0,42,42,0
12,9,2018,6,0,8,"Braga",1,"Avenida da Liberdade",25,25,0,26,26,0
12,9,2018,6,0,8,"Braga",2,"Avenida Central",17,17,0,272,272,0
12,9,2018,6,0,8,"Braga",3,"Rua de Caires",24,24,0,4,4,0
12,9,2018,6,0,8,"Braga",4,"N14 Bosch",46,46,0,48,48,0
12,9,2018,6,0,8,"Braga",5,"Avenida João Paulo II",39,39,0,8,8,0
12,9,2018,6,0,8,"Braga",6,"Avenida Padre Júlio Fragata",62,62,0,20,20,0
12,9,2018,6,0,8,"Braga",7,"Rua Nova Santa Cruz",29,29,0,104,104,0
12,9,2018,6,0,8,"Braga",8,"Rua Costa Gomes",41,41,0,42,42,0
12,9,2018,7,0,8,"Braga",1,"Avenida da Liberdade",25,25,0,26,26,0
12,9,2018,7,0,8,"Braga",2,"Avenida Central",17,17,0,272,272,0
12,9,2018,7,0,8,"Braga",3,"Rua de Caires",24,24,0,4,4,0
12,9,2018,7,0,8,"Braga",4,"N14 Bosch",46,46,0,48,48,0
12,9,2018,7,0,8,"Braga",5,"Avenida João Paulo II",39,39,0,8,8,0
12,9,2018,7,0,8,"Braga",6,"Avenida Padre Júlio Fragata",62,62,0,20,20,0
12,9,2018,7,0,8,"Braga",7,"Rua Nova Santa Cruz",29,29,0,104,104,0
12,9,2018,7,0,8,"Braga",8,"Rua Costa Gomes",41,41,0,42,42,0
12,9,2018,8,0,8,"Braga",1,"Avenida da Liberdade",25,25,0,26,26,0
12,9,2018,8,0,8,"Braga",2,"Avenida Central",17,17,0,272,272,0
12,9,2018,8,0,8,"Braga",3,"Rua de Caires",24,24,0,4,4,0
12,9,2018,8,0,8,"Braga",4,"N14 Bosch",46,46,0,48,48,0
12,9,2018,8,0,8,"Braga",5,"Avenida João Paulo II",39,39,0,8,8,0
12,9,2018,8,0,8,"Braga",6,"Avenida Padre Júlio Fragata",62,62,0,20,20,0
12,9,2018,8,0,8,"Braga",7,"Rua Nova Santa Cruz",29,29,0,104,104,0
12,9,2018,8,0,8,"Braga",8,"Rua Costa Gomes",41,41,0,42,42,0
12,9,2018,9,0,8,"Braga",1,"Avenida da Liberdade",25,25,0,26,26,0
12,9,2018,9,0,8,"Braga",2,"Avenida Central",17,17,0,272,272,0
12,9,2018,9,0,8,"Braga",3,"Rua de Caires",24,24,0,4,4,0
12,9,2018,9,0,8,"Braga",4,"N14 Bosch",46,46,0,48,48,0
12,9,2018,9,0,8,"Braga",5,"Avenida João Paulo II",39,39,0,8,8,0
12,9,2018,9,0,8,"Braga",6,"Avenida Padre Júlio Fragata",62,62,0,20,20,0
12,9,2018,9,0,8,"Braga",7,"Rua Nova Santa Cruz",29,29,0,104,104,0
12,9,2018,9,0,8,"Braga",8,"Rua Costa Gomes",41,41,0,42,42,0
12,9,2018,10,0,8,"Braga",1,"Avenida da Liberdade",25,25,0,26,26,0
12,9,2018,10,0,8,"Braga",2,"Avenida Central",14,18,4,331,257,74
12,9,2018,10,0,8,"Braga",3,"Rua de Caires",20,25,5,5,4,1
12,9,2018,10,0,8,"Braga",4,"N14 Bosch",46,46,0,48,48,0
12,9,2018,10,0,8,"Braga",5,"Avenida João Paulo II",39,39,0,8,8,0
12,9,2018,10,0,8,"Braga",6,"Avenida Padre Júlio Fragata",61,61,0,21,21,0
12,9,2018,10,0,8,"Braga",7,"Rua Nova Santa Cruz",29,29,0,104,104,0
12,9,2018,10,0,8,"Braga",8,"Rua Costa Gomes",41,41,0,42,42,0
12,9,2018,11,0,8,"Braga",1,"Avenida da Liberdade",25,25,0,26,26,0
12,9,2018,11,0,8,"Braga",2,"Avenida Central",17,17,0,272,272,0
12,9,2018,11,0,8,"Braga",3,"Rua de Caires",19,25,6,5,4,1
12,9,2018,11,0,8,"Braga",4,"N14 Bosch",46,46,0,48,48,0
12,9,2018,11,0,8,"Braga",5,"Avenida João Paulo II",39,39,0,8,8,0
12,9,2018,11,0,8,"Braga",6,"Avenida Padre Júlio Fragata",48,62,14,26,20,6
12,9,2018,11,0,8,"Braga",7,"Rua Nova Santa Cruz",29,29,0,104,104,0
12,9,2018,11,0,8,"Braga",8,"Rua Costa Gomes",41,41,0,42,42,0
12,9,2018,12,0,8,"Braga",1,"Avenida da Liberdade",25,25,0,26,26,0
12,9,2018,12,0,8,"Braga",2,"Avenida Central",10,17,7,463,272,191
12,9,2018,12,0,8,"Braga",3,"Rua de Caires",24,24,0,4,4,0
12,9,2018,12,0,8,"Braga",4,"N14 Bosch",47,47,0,47,47,0
12,9,2018,12,0,8,"Braga",5,"Avenida João Paulo II",39,39,0,8,8,0
12,9,2018,12,0,8,"Braga",6,"Avenida Padre Júlio Fragata",50,62,12,25,20,5
12,9,2018,12,0,8,"Braga",7,"Rua Nova Santa Cruz",29,29,0,104,104,0
12,9,2018,12,0,8,"Braga",8,"Rua Costa Gomes",41,41,0,42,42,0
12,9,2018,13,0,8,"Braga",1,"Avenida da Liberdade",25,25,0,26,26,0
12,9,2018,13,0,8,"Braga",2,"Avenida Central",18,18,0,257,257,0
12,9,2018,13,0,8,"Braga",3,"Rua de Caires",24,24,0,4,4,0
12,9,2018,13,0,8,"Braga",4,"N14 Bosch",47,47,0,47,47,0
12,9,2018,13,0,8,"Braga",5,"Avenida João Paulo II",38,38,0,9,9,0
12,9,2018,13,0,8,"Braga",6,"Avenida Padre Júlio Fragata",62,62,0,20,20,0
12,9,2018,13,0,8,"Braga",7,"Rua Nova Santa Cruz",29,29,0,104,104,0
12,9,2018,13,0,8,"Braga",8,"Rua Costa Gomes",41,41,0,42,42,0
12,9,2018,14,0,8,"Braga",1,"Avenida da Liberdade",25,25,0,26,26,0
12,9,2018,14,0,8,"Braga",2,"Avenida Central",18,18,0,257,257,0
12,9,2018,14,0,8,"Braga",3,"Rua de Caires",25,25,0,4,4,0
12,9,2018,14,0,8,"Braga",4,"N14 Bosch",46,46,0,48,48,0
12,9,2018,14,0,8,"Braga",5,"Avenida João Paulo II",38,38,0,9,9,0
12,9,2018,14,0,8,"Braga",6,"Avenida Padre Júlio Fragata",43,62,19,29,20,9
12,9,2018,14,0,8,"Braga",7,"Rua Nova Santa Cruz",29,29,0,104,104,0
12,9,2018,14,0,8,"Braga",8,"Rua Costa Gomes",31,40,9,55,43,12
12,9,2018,16,0,8,"Braga",1,"Avenida da Liberdade",18,24,6,36,27,9
12,9,2018,16,0,8,"Braga",2,"Avenida Central",6,16,10,772,289,483
12,9,2018,16,0,8,"Braga",3,"Rua de Caires",9,24,15,11,4,7
12,9,2018,16,0,8,"Braga",4,"N14 Bosch",36,46,10,62,48,14
12,9,2018,16,0,8,"Braga",5,"Avenida João Paulo II",23,38,15,15,9,6
12,9,2018,16,0,8,"Braga",6,"Avenida Padre Júlio Fragata",38,62,24,33,20,13
12,9,2018,16,0,8,"Braga",7,"Rua Nova Santa Cruz",29,29,0,104,104,0
12,9,2018,16,0,8,"Braga",8,"Rua Costa Gomes",24,41,17,71,42,29
12,9,2018,18,0,8,"Braga",1,"Avenida da Liberdade",25,25,0,26,26,0
12,9,2018,18,0,8,"Braga",2,"Avenida Central",6,17,11,772,272,500
12,9,2018,18,0,8,"Braga",3,"Rua de Caires",14,25,11,7,4,3
12,9,2018,18,0,8,"Braga",4,"N14 Bosch",22,46,24,102,48,54
12,9,2018,18,0,8,"Braga",5,"Avenida João Paulo II",29,38,9,12,9,3
12,9,2018,18,0,8,"Braga",6,"Avenida Padre Júlio Fragata",35,62,27,36,20,16
12,9,2018,18,0,8,"Braga",7,"Rua Nova Santa Cruz",19,28,9,160,108,52
12,9,2018,18,0,8,"Braga",8,"Rua Costa Gomes",27,40,13,63,43,20
12,9,2018,19,0,8,"Braga",1,"Avenida da Liberdade",25,25,0,26,26,0
12,9,2018,19,0,8,"Braga",2,"Avenida Central",10,17,7,463,272,191
12,9,2018,19,0,8,"Braga",3,"Rua de Caires",25,25,0,4,4,0
12,9,2018,19,0,8,"Braga",4,"N14 Bosch",47,47,0,47,47,0
12,9,2018,19,0,8,"Braga",5,"Avenida João Paulo II",28,38,10,12,9,3
12,9,2018,19,0,8,"Braga",6,"Avenida Padre Júlio Fragata",44,61,17,29,21,8
12,9,2018,19,0,8,"Braga",7,"Rua Nova Santa Cruz",28,28,0,108,108,0
12,9,2018,19,0,8,"Braga",8,"Rua Costa Gomes",16,40,24,107,43,64
12,9,2018,20,0,8,"Braga",1,"Avenida da Liberdade",25,25,0,26,26,0
12,9,2018,20,0,8,"Braga",2,"Avenida Central",13,18,5,356,257,99
12,9,2018,20,0,8,"Braga",3,"Rua de Caires",9,24,15,11,4,7
12,9,2018,20,0,8,"Braga",4,"N14 Bosch",47,47,0,47,47,0
12,9,2018,20,0,8,"Braga",5,"Avenida João Paulo II",39,39,0,8,8,0
12,9,2018,20,0,8,"Braga",6,"Avenida Padre Júlio Fragata",39,61,22,32,21,11
12,9,2018,20,0,8,"Braga",7,"Rua Nova Santa Cruz",22,28,6,138,108,30
12,9,2018,20,0,8,"Braga",8,"Rua Costa Gomes",40,40,0,43,43,0
12,9,2018,21,0,8,"Braga",1,"Avenida da Liberdade",25,25,0,26,26,0
12,9,2018,21,0,8,"Braga",2,"Avenida Central",13,17,4,356,272,84
12,9,2018,21,0,8,"Braga",3,"Rua de Caires",24,24,0,4,4,0
12,9,2018,21,0,8,"Braga",4,"N14 Bosch",47,47,0,47,47,0
12,9,2018,21,0,8,"Braga",5,"Avenida João Paulo II",39,39,0,8,8,0
12,9,2018,21,0,8,"Braga",6,"Avenida Padre Júlio Fragata",48,62,14,26,20,6
12,9,2018,21,0,8,"Braga",7,"Rua Nova Santa Cruz",15,28,13,202,108,94
12,9,2018,21,0,8,"Braga",8,"Rua Costa Gomes",40,40,0,43,43,0
12,9,2018,22,0,8,"Braga",1,"Avenida da Liberdade",25,25,0,26,26,0
12,9,2018,22,0,8,"Braga",2,"Avenida Central",17,17,0,272,272,0
12,9,2018,22,0,8,"Braga",3,"Rua de Caires",2,31,29,52,3,49
12,9,2018,22,0,8,"Braga",4,"N14 Bosch",47,47,0,47,47,0
12,9,2018,22,0,8,"Braga",5,"Avenida João Paulo II",39,39,0,8,8,0
12,9,2018,22,0,8,"Braga",6,"Avenida Padre Júlio Fragata",62,62,0,20,20,0
12,9,2018,22,0,8,"Braga",7,"Rua Nova Santa Cruz",28,28,0,108,108,0
12,9,2018,22,0,8,"Braga",8,"Rua Costa Gomes",40,40,0,43,43,0
12,9,2018,23,0,8,"Braga",1,"Avenida da Liberdade",25,25,0,26,26,0
12,9,2018,23,0,8,"Braga",2,"Avenida Central",17,17,0,272,272,0
12,9,2018,23,0,8,"Braga",3,"Rua de Caires",25,25,0,4,4,0
12,9,2018,23,0,8,"Braga",4,"N14 Bosch",47,47,0,47,47,0
12,9,2018,23,0,8,"Braga",5,"Avenida João Paulo II",39,39,0,8,8,0
12,9,2018,23,0,8,"Braga",6,"Avenida Padre Júlio Fragata",62,62,0,20,20,0
12,9,2018,23,0,8,"Braga",7,"Rua Nova Santa Cruz",29,29,0,104,104,0
12,9,2018,23,0,8,"Braga",8,"Rua Costa Gomes",40,40,0,43,43,0
12,10,2018,0,0,2,"Braga",1,"Avenida da Liberdade",25,25,0,26,26,0
12,10,2018,0,0,2,"Braga",2,"Avenida Central",17,17,0,272,272,0
12,10,2018,0,0,2,"Braga",3,"Rua de Caires",25,25,0,4,4,0
12,10,2018,0,0,2,"Braga",4,"N14 Bosch",47,47,0,47,47,0
12,10,2018,0,0,2,"Braga",5,"Avenida João Paulo II",39,39,0,8,8,0
12,10,2018,0,0,2,"Braga",6,"Avenida Padre Júlio Fragata",61,61,0,21,21,0
12,10,2018,0,0,2,"Braga",7,"Rua Nova Santa Cruz",29,29,0,104,104,0
12,10,2018,0,0,2,"Braga",8,"Rua Costa Gomes",40,40,0,43,43,0
12,10,2018,1,0,2,"Braga",1,"Avenida da Liberdade",25,25,0,26,26,0
12,10,2018,1,0,2,"Braga",2,"Avenida Central",17,17,0,272,272,0
12,10,2018,1,0,2,"Braga",3,"Rua de Caires",25,25,0,4,4,0
12,10,2018,1,0,2,"Braga",4,"N14 Bosch",47,47,0,47,47,0
12,10,2018,1,0,2,"Braga",5,"Avenida João Paulo II",39,39,0,8,8,0
12,10,2018,1,0,2,"Braga",6,"Avenida Padre Júlio Fragata",61,61,0,21,21,0
12,10,2018,1,0,2,"Braga",7,"Rua Nova Santa Cruz",29,29,0,104,104,0
12,10,2018,1,0,2,"Braga",8,"Rua Costa Gomes",40,40,0,43,43,0
12,10,2018,2,0,2,"Braga",1,"Avenida da Liberdade",25,25,0,26,26,0
12,10,2018,2,0,2,"Braga",2,"Avenida Central",17,17,0,272,272,0
12,10,2018,2,0,2,"Braga",3,"Rua de Caires",25,25,0,4,4,0
12,10,2018,2,0,2,"Braga",4,"N14 Bosch",47,47,0,47,47,0
12,10,2018,2,0,2,"Braga",5,"Avenida João Paulo II",39,39,0,8,8,0
12,10,2018,2,0,2,"Braga",6,"Avenida Padre Júlio Fragata",61,61,0,21,21,0
12,10,2018,2,0,2,"Braga",7,"Rua Nova Santa Cruz",29,29,0,104,104,0
12,10,2018,2,0,2,"Braga",8,"Rua Costa Gomes",40,40,0,43,43,0
12,10,2018,3,0,2,"Braga",1,"Avenida da Liberdade",25,25,0,26,26,0
12,10,2018,3,0,2,"Braga",2,"Avenida Central",17,17,0,272,272,0
12,10,2018,3,0,2,"Braga",3,"Rua de Caires",25,25,0,4,4,0
12,10,2018,3,0,2,"Braga",4,"N14 Bosch",47,47,0,47,47,0
12,10,2018,3,0,2,"Braga",5,"Avenida João Paulo II",39,39,0,8,8,0
12,10,2018,3,0,2,"Braga",6,"Avenida Padre Júlio Fragata",61,61,0,21,21,0
12,10,2018,3,0,2,"Braga",7,"Rua Nova Santa Cruz",29,29,0,104,104,0
12,10,2018,3,0,2,"Braga",8,"Rua Costa Gomes",40,40,0,43,43,0
12,10,2018,4,0,2,"Braga",1,"Avenida da Liberdade",25,25,0,26,26,0
12,10,2018,4,0,2,"Braga",2,"Avenida Central",17,17,0,272,272,0
12,10,2018,4,0,2,"Braga",3,"Rua de Caires",25,25,0,4,4,0
12,10,2018,4,0,2,"Braga",4,"N14 Bosch",47,47,0,47,47,0
12,10,2018,4,0,2,"Braga",5,"Avenida João Paulo II",39,39,0,8,8,0
12,10,2018,4,0,2,"Braga",6,"Avenida Padre Júlio Fragata",61,61,0,21,21,0
12,10,2018,4,0,2,"Braga",7,"Rua Nova Santa Cruz",29,29,0,104,104,0
12,10,2018,4,0,2,"Braga",8,"Rua Costa Gomes",40,40,0,43,43,0
12,10,2018,5,0,2,"Braga",1,"Avenida da Liberdade",25,25,0,26,26,0
12,10,2018,5,0,2,"Braga",2,"Avenida Central",17,17,0,272,272,0
12,10,2018,5,0,2,"Braga",3,"Rua de Caires",25,25,0,4,4,0
12,10,2018,5,0,2,"Braga",4,"N14 Bosch",47,47,0,47,47,0
12,10,2018,5,0,2,"Braga",5,"Avenida João Paulo II",39,39,0,8,8,0
12,10,2018,5,0,2,"Braga",6,"Avenida Padre Júlio Fragata",61,61,0,21,21,0
12,10,2018,5,0,2,"Braga",7,"Rua Nova Santa Cruz",29,29,0,104,104,0
12,10,2018,5,0,2,"Braga",8,"Rua Costa Gomes",40,40,0,43,43,0
12,10,2018,6,0,2,"Braga",1,"Avenida da Liberdade",25,25,0,26,26,0
12,10,2018,6,0,2,"Braga",2,"Avenida Central",17,17,0,272,272,0
12,10,2018,6,0,2,"Braga",3,"Rua de Caires",25,25,0,4,4,0
12,10,2018,6,0,2,"Braga",4,"N14 Bosch",47,47,0,47,47,0
12,10,2018,6,0,2,"Braga",5,"Avenida João Paulo II",39,39,0,8,8,0
12,10,2018,6,0,2,"Braga",6,"Avenida Padre Júlio Fragata",61,61,0,21,21,0
12,10,2018,6,0,2,"Braga",7,"Rua Nova Santa Cruz",29,29,0,104,104,0
12,10,2018,6,0,2,"Braga",8,"Rua Costa Gomes",40,40,0,43,43,0
12,10,2018,7,0,2,"Braga",1,"Avenida da Liberdade",25,25,0,26,26,0
12,10,2018,7,0,2,"Braga",2,"Avenida Central",17,17,0,272,272,0
12,10,2018,7,0,2,"Braga",3,"Rua de Caires",26,26,0,4,4,0
12,10,2018,7,0,2,"Braga",4,"N14 Bosch",47,47,0,47,47,0
12,10,2018,7,0,2,"Braga",5,"Avenida João Paulo II",39,39,0,8,8,0
12,10,2018,7,0,2,"Braga",6,"Avenida Padre Júlio Fragata",61,61,0,21,21,0
12,10,2018,7,0,2,"Braga",7,"Rua Nova Santa Cruz",29,29,0,104,104,0
12,10,2018,7,0,2,"Braga",8,"Rua Costa Gomes",40,40,0,43,43,0
12,10,2018,8,0,2,"Braga",1,"Avenida da Liberdade",25,25,0,26,26,0
12,10,2018,8,0,2,"Braga",2,"Avenida Central",17,17,0,272,272,0
12,10,2018,8,0,2,"Braga",3,"Rua de Caires",24,24,0,4,4,0
12,10,2018,8,0,2,"Braga",4,"N14 Bosch",47,47,0,47,47,0
12,10,2018,8,0,2,"Braga",5,"Avenida João Paulo II",39,39,0,8,8,0
12,10,2018,8,0,2,"Braga",6,"Avenida Padre Júlio Fragata",48,62,14,26,20,6
12,10,2018,8,0,2,"Braga",7,"Rua Nova Santa Cruz",29,29,0,104,104,0
12,10,2018,8,0,2,"Braga",8,"Rua Costa Gomes",28,41,13,61,42,19
12,10,2018,9,0,2,"Braga",1,"Avenida da Liberdade",12,24,12,55,27,28
12,10,2018,9,0,2,"Braga",2,"Avenida Central",8,17,9,579,272,307
12,10,2018,9,0,2,"Braga",3,"Rua de Caires",25,25,0,4,4,0
12,10,2018,9,0,2,"Braga",4,"N14 Bosch",20,46,26,112,48,64
12,10,2018,9,0,2,"Braga",5,"Avenida João Paulo II",27,39,12,12,8,4
12,10,2018,9,0,2,"Braga",6,"Avenida Padre Júlio Fragata",33,61,28,38,21,17
12,10,2018,9,0,2,"Braga",7,"Rua Nova Santa Cruz",28,28,0,108,108,0
12,10,2018,9,0,2,"Braga",8,"Rua Costa Gomes",28,41,13,61,42,19
12,10,2018,10,0,2,"Braga",1,"Avenida da Liberdade",12,24,12,55,27,28
12,10,2018,10,0,2,"Braga",2,"Avenida Central",18,18,0,257,257,0
12,10,2018,10,0,2,"Braga",3,"Rua de Caires",25,25,0,4,4,0
12,10,2018,10,0,2,"Braga",4,"N14 Bosch",37,47,10,60,47,13
12,10,2018,10,0,2,"Braga",5,"Avenida João Paulo II",39,39,0,8,8,0
12,10,2018,10,0,2,"Braga",6,"Avenida Padre Júlio Fragata",61,61,0,21,21,0
12,10,2018,10,0,2,"Braga",7,"Rua Nova Santa Cruz",28,28,0,108,108,0
12,10,2018,10,0,2,"Braga",8,"Rua Costa Gomes",40,40,0,43,43,0
12,10,2018,11,0,2,"Braga",1,"Avenida da Liberdade",25,25,0,26,26,0
12,10,2018,11,0,2,"Braga",2,"Avenida Central",12,17,5,386,272,114
12,10,2018,11,0,2,"Braga",3,"Rua de Caires",25,25,0,4,4,0
12,10,2018,11,0,2,"Braga",4,"N14 Bosch",46,46,0,48,48,0
12,10,2018,11,0,2,"Braga",5,"Avenida João Paulo II",39,39,0,8,8,0
12,10,2018,11,0,2,"Braga",6,"Avenida Padre Júlio Fragata",61,61,0,21,21,0
12,10,2018,11,0,2,"Braga",7,"Rua Nova Santa Cruz",28,28,0,108,108,0
12,10,2018,11,0,2,"Braga",8,"Rua Costa Gomes",40,40,0,43,43,0
12,10,2018,12,0,2,"Braga",1,"Avenida da Liberdade",24,24,0,27,27,0
12,10,2018,12,0,2,"Braga",2,"Avenida Central",18,18,0,257,257,0
12,10,2018,12,0,2,"Braga",3,"Rua de Caires",25,25,0,4,4,0
12,10,2018,12,0,2,"Braga",4,"N14 Bosch",46,46,0,48,48,0
12,10,2018,12,0,2,"Braga",5,"Avenida João Paulo II",29,38,9,12,9,3
12,10,2018,12,0,2,"Braga",6,"Avenida Padre Júlio Fragata",43,61,18,29,21,8
12,10,2018,12,0,2,"Braga",7,"Rua Nova Santa Cruz",28,28,0,108,108,0
12,10,2018,12,0,2,"Braga",8,"Rua Costa Gomes",40,40,0,43,43,0
12,10,2018,13,0,2,"Braga",1,"Avenida da Liberdade",24,24,0,27,27,0
12,10,2018,13,0,2,"Braga",2,"Avenida Central",13,18,5,356,257,99
12,10,2018,13,0,2,"Braga",3,"Rua de Caires",25,25,0,4,4,0
12,10,2018,13,0,2,"Braga",4,"N14 Bosch",32,47,15,70,47,23
12,10,2018,13,0,2,"Braga",5,"Avenida João Paulo II",38,38,0,9,9,0
12,10,2018,13,0,2,"Braga",6,"Avenida Padre Júlio Fragata",62,62,0,20,20,0
12,10,2018,13,0,2,"Braga",7,"Rua Nova Santa Cruz",17,29,12,179,104,75
12,10,2018,13,0,2,"Braga",8,"Rua Costa Gomes",26,40,14,66,43,23
12,10,2018,14,0,2,"Braga",1,"Avenida da Liberdade",24,24,0,27,27,0
12,10,2018,14,0,2,"Braga",2,"Avenida Central",17,17,0,272,272,0
12,10,2018,14,0,2,"Braga",3,"Rua de Caires",25,25,0,4,4,0
12,10,2018,14,0,2,"Braga",4,"N14 Bosch",21,48,27,107,46,61
12,10,2018,14,0,2,"Braga",5,"Avenida João Paulo II",38,38,0,9,9,0
12,10,2018,14,0,2,"Braga",6,"Avenida Padre Júlio Fragata",28,61,33,45,21,24
12,10,2018,14,0,2,"Braga",7,"Rua Nova Santa Cruz",16,28,12,190,108,82
12,10,2018,14,0,2,"Braga",8,"Rua Costa Gomes",33,41,8,52,42,10
12,10,2018,15,0,2,"Braga",1,"Avenida da Liberdade",25,25,0,26,26,0
12,10,2018,15,0,2,"Braga",2,"Avenida Central",12,17,5,386,272,114
12,10,2018,15,0,2,"Braga",3,"Rua de Caires",25,25,0,4,4,0
12,10,2018,15,0,2,"Braga",4,"N14 Bosch",35,46,11,64,48,16
12,10,2018,15,0,2,"Braga",5,"Avenida João Paulo II",39,39,0,8,8,0
12,10,2018,15,0,2,"Braga",6,"Avenida Padre Júlio Fragata",61,61,0,21,21,0
12,10,2018,15,0,2,"Braga",7,"Rua Nova Santa Cruz",20,28,8,152,108,44
12,10,2018,15,0,2,"Braga",8,"Rua Costa Gomes",31,41,10,55,42,13
12,10,2018,16,0,2,"Braga",1,"Avenida da Liberdade",19,25,6,34,26,8
12,10,2018,16,0,2,"Braga",2,"Avenida Central",12,18,6,386,257,129
12,10,2018,16,0,2,"Braga",3,"Rua de Caires",25,25,0,4,4,0
12,10,2018,16,0,2,"Braga",4,"N14 Bosch",28,46,18,80,48,32
12,10,2018,16,0,2,"Braga",5,"Avenida João Paulo II",30,39,9,11,8,3
12,10,2018,16,0,2,"Braga",6,"Avenida Padre Júlio Fragata",39,61,22,32,21,11
12,10,2018,16,0,2,"Braga",7,"Rua Nova Santa Cruz",18,29,11,169,104,65
12,10,2018,16,0,2,"Braga",8,"Rua Costa Gomes",21,41,20,82,42,40
12,10,2018,17,0,2,"Braga",1,"Avenida da Liberdade",20,25,5,33,26,7
12,10,2018,17,0,2,"Braga",2,"Avenida Central",9,19,10,515,244,271
12,10,2018,17,0,2,"Braga",3,"Rua de Caires",17,25,8,6,4,2
12,10,2018,17,0,2,"Braga",4,"N14 Bosch",19,47,28,118,47,71
12,10,2018,17,0,2,"Braga",5,"Avenida João Paulo II",27,38,11,12,9,3
12,10,2018,17,0,2,"Braga",6,"Avenida Padre Júlio Fragata",37,62,25,34,20,14
12,10,2018,17,0,2,"Braga",7,"Rua Nova Santa Cruz",18,29,11,169,104,65
12,10,2018,17,0,2,"Braga",8,"Rua Costa Gomes",40,40,0,43,43,0
12,10,2018,18,0,2,"Braga",1,"Avenida da Liberdade",25,25,0,26,26,0
12,10,2018,18,0,2,"Braga",2,"Avenida Central",9,19,10,515,244,271
12,10,2018,18,0,2,"Braga",3,"Rua de Caires",19,25,6,5,4,1
12,10,2018,18,0,2,"Braga",4,"N14 Bosch",16,47,31,140,47,93
12,10,2018,18,0,2,"Braga",5,"Avenida João Paulo II",11,38,27,31,9,22
12,10,2018,18,0,2,"Braga",6,"Avenida Padre Júlio Fragata",19,63,44,67,20,47
12,10,2018,18,0,2,"Braga",7,"Rua Nova Santa Cruz",19,29,10,160,104,56
12,10,2018,18,0,2,"Braga",8,"Rua Costa Gomes",11,41,30,156,42,114
12,10,2018,19,0,2,"Braga",1,"Avenida da Liberdade",24,24,0,27,27,0
12,10,2018,19,0,2,"Braga",2,"Avenida Central",7,19,12,662,244,418
12,10,2018,19,0,2,"Braga",3,"Rua de Caires",12,25,13,8,4,4
12,10,2018,19,0,2,"Braga",4,"N14 Bosch",24,46,22,93,48,45
12,10,2018,19,0,2,"Braga",5,"Avenida João Paulo II",12,40,28,29,8,21
12,10,2018,19,0,2,"Braga",6,"Avenida Padre Júlio Fragata",26,62,36,49,20,29
12,10,2018,19,0,2,"Braga",7,"Rua Nova Santa Cruz",28,28,0,108,108,0
12,10,2018,19,0,2,"Braga",8,"Rua Costa Gomes",10,40,30,172,43,129
12,10,2018,20,0,2,"Braga",1,"Avenida da Liberdade",25,25,0,26,26,0
12,10,2018,20,0,2,"Braga",2,"Avenida Central",18,18,0,257,257,0
12,10,2018,20,0,2,"Braga",3,"Rua de Caires",18,24,6,5,4,1
12,10,2018,20,0,2,"Braga",4,"N14 Bosch",47,47,0,47,47,0
12,10,2018,20,0,2,"Braga",5,"Avenida João Paulo II",38,38,0,9,9,0
12,10,2018,20,0,2,"Braga",6,"Avenida Padre Júlio Fragata",49,62,13,26,20,6
12,10,2018,20,0,2,"Braga",7,"Rua Nova Santa Cruz",23,29,6,132,104,28
12,10,2018,20,0,2,"Braga",8,"Rua Costa Gomes",40,40,0,43,43,0
12,10,2018,21,0,2,"Braga",1,"Avenida da Liberdade",25,25,0,26,26,0
12,10,2018,21,0,2,"Braga",2,"Avenida Central",17,17,0,272,272,0
12,10,2018,21,0,2,"Braga",3,"Rua de Caires",24,24,0,4,4,0
12,10,2018,21,0,2,"Braga",4,"N14 Bosch",47,47,0,47,47,0
12,10,2018,21,0,2,"Braga",5,"Avenida João Paulo II",38,38,0,9,9,0
12,10,2018,21,0,2,"Braga",6,"Avenida Padre Júlio Fragata",62,62,0,20,20,0
12,10,2018,21,0,2,"Braga",7,"Rua Nova Santa Cruz",28,28,0,108,108,0
12,10,2018,21,0,2,"Braga",8,"Rua Costa Gomes",40,40,0,43,43,0
12,10,2018,22,0,2,"Braga",1,"Avenida da Liberdade",25,25,0,26,26,0
12,10,2018,22,0,2,"Braga",2,"Avenida Central",17,17,0,272,272,0
12,10,2018,22,0,2,"Braga",3,"Rua de Caires",24,24,0,4,4,0
12,10,2018,22,0,2,"Braga",4,"N14 Bosch",47,47,0,47,47,0
12,10,2018,22,0,2,"Braga",5,"Avenida João Paulo II",38,38,0,9,9,0
12,10,2018,22,0,2,"Braga",6,"Avenida Padre Júlio Fragata",48,62,14,26,20,6
12,10,2018,22,0,2,"Braga",7,"Rua Nova Santa Cruz",28,28,0,108,108,0
12,10,2018,22,0,2,"Braga",8,"Rua Costa Gomes",40,40,0,43,43,0
12,10,2018,23,0,2,"Braga",1,"Avenida da Liberdade",25,25,0,26,26,0
12,10,2018,23,0,2,"Braga",2,"Avenida Central",17,17,0,272,272,0
12,10,2018,23,0,2,"Braga",3,"Rua de Caires",24,24,0,4,4,0
12,10,2018,23,0,2,"Braga",4,"N14 Bosch",47,47,0,47,47,0
12,10,2018,23,0,2,"Braga",5,"Avenida João Paulo II",39,39,0,8,8,0
12,10,2018,23,0,2,"Braga",6,"Avenida Padre Júlio Fragata",62,62,0,20,20,0
12,10,2018,23,0,2,"Braga",7,"Rua Nova Santa Cruz",28,28,0,108,108,0
12,10,2018,23,0,2,"Braga",8,"Rua Costa Gomes",40,40,0,43,43,0
12,11,2018,0,0,3,"Braga",1,"Avenida da Liberdade",25,25,0,26,26,0
12,11,2018,0,0,3,"Braga",2,"Avenida Central",17,17,0,272,272,0
12,11,2018,0,0,3,"Braga",3,"Rua de Caires",24,24,0,4,4,0
12,11,2018,0,0,3,"Braga",4,"N14 Bosch",47,47,0,47,47,0
12,11,2018,0,0,3,"Braga",5,"Avenida João Paulo II",38,38,0,9,9,0
12,11,2018,0,0,3,"Braga",6,"Avenida Padre Júlio Fragata",62,62,0,20,20,0
12,11,2018,0,0,3,"Braga",7,"Rua Nova Santa Cruz",28,28,0,108,108,0
12,11,2018,0,0,3,"Braga",8,"Rua Costa Gomes",40,40,0,43,43,0
12,11,2018,1,0,3,"Braga",1,"Avenida da Liberdade",25,25,0,26,26,0
12,11,2018,1,0,3,"Braga",2,"Avenida Central",17,17,0,272,272,0
12,11,2018,1,0,3,"Braga",3,"Rua de Caires",24,24,0,4,4,0
12,11,2018,1,0,3,"Braga",4,"N14 Bosch",47,47,0,47,47,0
12,11,2018,1,0,3,"Braga",5,"Avenida João Paulo II",38,38,0,9,9,0
12,11,2018,1,0,3,"Braga",6,"Avenida Padre Júlio Fragata",62,62,0,20,20,0
12,11,2018,1,0,3,"Braga",7,"Rua Nova Santa Cruz",28,28,0,108,108,0
12,11,2018,1,0,3,"Braga",8,"Rua Costa Gomes",40,40,0,43,43,0
12,11,2018,2,0,3,"Braga",1,"Avenida da Liberdade",25,25,0,26,26,0
12,11,2018,2,0,3,"Braga",2,"Avenida Central",17,17,0,272,272,0
12,11,2018,2,0,3,"Braga",3,"Rua de Caires",24,24,0,4,4,0
12,11,2018,2,0,3,"Braga",4,"N14 Bosch",47,47,0,47,47,0
12,11,2018,2,0,3,"Braga",5,"Avenida João Paulo II",38,38,0,9,9,0
12,11,2018,2,0,3,"Braga",6,"Avenida Padre Júlio Fragata",62,62,0,20,20,0
12,11,2018,2,0,3,"Braga",7,"Rua Nova Santa Cruz",28,28,0,108,108,0
12,11,2018,2,0,3,"Braga",8,"Rua Costa Gomes",40,40,0,43,43,0
12,11,2018,3,0,3,"Braga",1,"Avenida da Liberdade",25,25,0,26,26,0
12,11,2018,3,0,3,"Braga",2,"Avenida Central",17,17,0,272,272,0
12,11,2018,3,0,3,"Braga",3,"Rua de Caires",24,24,0,4,4,0
12,11,2018,3,0,3,"Braga",4,"N14 Bosch",47,47,0,47,47,0
12,11,2018,3,0,3,"Braga",5,"Avenida João Paulo II",38,38,0,9,9,0
12,11,2018,3,0,3,"Braga",6,"Avenida Padre Júlio Fragata",62,62,0,20,20,0
12,11,2018,3,0,3,"Braga",7,"Rua Nova Santa Cruz",28,28,0,108,108,0
12,11,2018,3,0,3,"Braga",8,"Rua Costa Gomes",40,40,0,43,43,0
12,11,2018,4,0,3,"Braga",1,"Avenida da Liberdade",25,25,0,26,26,0
12,11,2018,4,0,3,"Braga",2,"Avenida Central",17,17,0,272,272,0
12,11,2018,4,0,3,"Braga",3,"Rua de Caires",24,24,0,4,4,0
12,11,2018,4,0,3,"Braga",4,"N14 Bosch",47,47,0,47,47,0
12,11,2018,4,0,3,"Braga",5,"Avenida João Paulo II",38,38,0,9,9,0
12,11,2018,4,0,3,"Braga",6,"Avenida Padre Júlio Fragata",62,62,0,20,20,0
12,11,2018,4,0,3,"Braga",7,"Rua Nova Santa Cruz",28,28,0,108,108,0
12,11,2018,4,0,3,"Braga",8,"Rua Costa Gomes",40,40,0,43,43,0
12,11,2018,5,0,3,"Braga",1,"Avenida da Liberdade",25,25,0,26,26,0
12,11,2018,5,0,3,"Braga",2,"Avenida Central",17,17,0,272,272,0
12,11,2018,5,0,3,"Braga",3,"Rua de Caires",24,24,0,4,4,0
12,11,2018,5,0,3,"Braga",4,"N14 Bosch",47,47,0,47,47,0
12,11,2018,5,0,3,"Braga",5,"Avenida João Paulo II",38,38,0,9,9,0
12,11,2018,5,0,3,"Braga",6,"Avenida Padre Júlio Fragata",62,62,0,20,20,0
12,11,2018,5,0,3,"Braga",7,"Rua Nova Santa Cruz",28,28,0,108,108,0
12,11,2018,5,0,3,"Braga",8,"Rua Costa Gomes",40,40,0,43,43,0
12,11,2018,6,0,3,"Braga",1,"Avenida da Liberdade",25,25,0,26,26,0
12,11,2018,6,0,3,"Braga",2,"Avenida Central",17,17,0,272,272,0
12,11,2018,6,0,3,"Braga",3,"Rua de Caires",24,24,0,4,4,0
12,11,2018,6,0,3,"Braga",4,"N14 Bosch",47,47,0,47,47,0
12,11,2018,6,0,3,"Braga",5,"Avenida João Paulo II",38,38,0,9,9,0
12,11,2018,6,0,3,"Braga",6,"Avenida Padre Júlio Fragata",62,62,0,20,20,0
12,11,2018,6,0,3,"Braga",7,"Rua Nova Santa Cruz",28,28,0,108,108,0
12,11,2018,6,0,3,"Braga",8,"Rua Costa Gomes",40,40,0,43,43,0
12,11,2018,7,0,3,"Braga",1,"Avenida da Liberdade",25,25,0,26,26,0
12,11,2018,7,0,3,"Braga",2,"Avenida Central",17,17,0,272,272,0
12,11,2018,7,0,3,"Braga",3,"Rua de Caires",24,24,0,4,4,0
12,11,2018,7,0,3,"Braga",4,"N14 Bosch",47,47,0,47,47,0
12,11,2018,7,0,3,"Braga",5,"Avenida João Paulo II",38,38,0,9,9,0
12,11,2018,7,0,3,"Braga",6,"Avenida Padre Júlio Fragata",62,62,0,20,20,0
12,11,2018,7,0,3,"Braga",7,"Rua Nova Santa Cruz",28,28,0,108,108,0
12,11,2018,7,0,3,"Braga",8,"Rua Costa Gomes",40,40,0,43,43,0
12,11,2018,8,0,3,"Braga",1,"Avenida da Liberdade",25,25,0,26,26,0
12,11,2018,8,0,3,"Braga",2,"Avenida Central",14,17,3,331,272,59
12,11,2018,8,0,3,"Braga",3,"Rua de Caires",24,24,0,4,4,0
12,11,2018,8,0,3,"Braga",4,"N14 Bosch",31,47,16,72,47,25
12,11,2018,8,0,3,"Braga",5,"Avenida João Paulo II",38,38,0,9,9,0
12,11,2018,8,0,3,"Braga",6,"Avenida Padre Júlio Fragata",62,62,0,20,20,0
12,11,2018,8,0,3,"Braga",7,"Rua Nova Santa Cruz",28,28,0,108,108,0
12,11,2018,8,0,3,"Braga",8,"Rua Costa Gomes",40,40,0,43,43,0
12,11,2018,9,0,3,"Braga",1,"Avenida da Liberdade",18,24,6,36,27,9
12,11,2018,9,0,3,"Braga",2,"Avenida Central",10,17,7,463,272,191
12,11,2018,9,0,3,"Braga",3,"Rua de Caires",19,24,5,5,4,1
12,11,2018,9,0,3,"Braga",4,"N14 Bosch",20,47,27,112,47,65
12,11,2018,9,0,3,"Braga",5,"Avenida João Paulo II",10,38,28,34,9,25
12,11,2018,9,0,3,"Braga",6,"Avenida Padre Júlio Fragata",41,61,20,31,21,10
12,11,2018,9,0,3,"Braga",7,"Rua Nova Santa Cruz",29,29,0,104,104,0
12,11,2018,9,0,3,"Braga",8,"Rua Costa Gomes",41,41,0,42,42,0
12,11,2018,10,0,3,"Braga",1,"Avenida da Liberdade",20,25,5,33,26,7
12,11,2018,10,0,3,"Braga",2,"Avenida Central",8,18,10,579,257,322
12,11,2018,10,0,3,"Braga",3,"Rua de Caires",7,24,17,14,4,10
12,11,2018,10,0,3,"Braga",4,"N14 Bosch",35,46,11,64,48,16
12,11,2018,10,0,3,"Braga",5,"Avenida João Paulo II",26,39,13,13,8,5
12,11,2018,10,0,3,"Braga",6,"Avenida Padre Júlio Fragata",49,61,12,26,21,5
12,11,2018,10,0,3,"Braga",7,"Rua Nova Santa Cruz",29,29,0,104,104,0
12,11,2018,10,0,3,"Braga",8,"Rua Costa Gomes",24,41,17,71,42,29
12,11,2018,11,0,3,"Braga",1,"Avenida da Liberdade",25,25,0,26,26,0
12,11,2018,11,0,3,"Braga",2,"Avenida Central",11,17,6,421,272,149
12,11,2018,11,0,3,"Braga",3,"Rua de Caires",25,25,0,4,4,0
12,11,2018,11,0,3,"Braga",4,"N14 Bosch",47,47,0,47,47,0
12,11,2018,11,0,3,"Braga",5,"Avenida João Paulo II",39,39,0,8,8,0
12,11,2018,11,0,3,"Braga",6,"Avenida Padre Júlio Fragata",61,61,0,21,21,0
12,11,2018,11,0,3,"Braga",7,"Rua Nova Santa Cruz",29,29,0,104,104,0
12,11,2018,11,0,3,"Braga",8,"Rua Costa Gomes",31,40,9,55,43,12
12,11,2018,12,0,3,"Braga",1,"Avenida da Liberdade",24,24,0,27,27,0
12,11,2018,12,0,3,"Braga",2,"Avenida Central",13,17,4,356,272,84
12,11,2018,12,0,3,"Braga",3,"Rua de Caires",25,25,0,4,4,0
12,11,2018,12,0,3,"Braga",4,"N14 Bosch",35,46,11,64,48,16
12,11,2018,12,0,3,"Braga",5,"Avenida João Paulo II",38,38,0,9,9,0
12,11,2018,12,0,3,"Braga",6,"Avenida Padre Júlio Fragata",61,61,0,21,21,0
12,11,2018,12,0,3,"Braga",7,"Rua Nova Santa Cruz",13,28,15,234,108,126
12,11,2018,12,0,3,"Braga",8,"Rua Costa Gomes",29,40,11,59,43,16
12,11,2018,13,0,3,"Braga",1,"Avenida da Liberdade",25,25,0,26,26,0
12,11,2018,13,0,3,"Braga",2,"Avenida Central",18,18,0,257,257,0
12,11,2018,13,0,3,"Braga",3,"Rua de Caires",25,25,0,4,4,0
12,11,2018,13,0,3,"Braga",4,"N14 Bosch",28,46,18,80,48,32
12,11,2018,13,0,3,"Braga",5,"Avenida João Paulo II",39,39,0,8,8,0
12,11,2018,13,0,3,"Braga",6,"Avenida Padre Júlio Fragata",62,62,0,20,20,0
12,11,2018,13,0,3,"Braga",7,"Rua Nova Santa Cruz",29,29,0,104,104,0
12,11,2018,13,0,3,"Braga",8,"Rua Costa Gomes",29,41,12,59,42,17
12,11,2018,14,0,3,"Braga",1,"Avenida da Liberdade",25,25,0,26,26,0
12,11,2018,14,0,3,"Braga",2,"Avenida Central",13,18,5,356,257,99
12,11,2018,14,0,3,"Braga",3,"Rua de Caires",18,25,7,5,4,1
12,11,2018,14,0,3,"Braga",4,"N14 Bosch",32,46,14,70,48,22
12,11,2018,14,0,3,"Braga",5,"Avenida João Paulo II",39,39,0,8,8,0
12,11,2018,14,0,3,"Braga",6,"Avenida Padre Júlio Fragata",45,61,16,28,21,7
12,11,2018,14,0,3,"Braga",7,"Rua Nova Santa Cruz",19,29,10,160,104,56
12,11,2018,14,0,3,"Braga",8,"Rua Costa Gomes",30,40,10,57,43,14
12,11,2018,15,0,3,"Braga",1,"Avenida da Liberdade",25,25,0,26,26,0
12,11,2018,15,0,3,"Braga",2,"Avenida Central",11,18,7,421,257,164
12,11,2018,15,0,3,"Braga",3,"Rua de Caires",25,25,0,4,4,0
12,11,2018,15,0,3,"Braga",4,"N14 Bosch",15,47,32,149,47,102
12,11,2018,15,0,3,"Braga",5,"Avenida João Paulo II",25,39,14,13,8,5
12,11,2018,15,0,3,"Braga",6,"Avenida Padre Júlio Fragata",45,62,17,28,20,8
12,11,2018,15,0,3,"Braga",7,"Rua Nova Santa Cruz",21,29,8,144,104,40
12,11,2018,15,0,3,"Braga",8,"Rua Costa Gomes",16,40,24,107,43,64
12,11,2018,16,0,3,"Braga",1,"Avenida da Liberdade",25,25,0,26,26,0
12,11,2018,16,0,3,"Braga",2,"Avenida Central",11,17,6,421,272,149
12,11,2018,16,0,3,"Braga",3,"Rua de Caires",25,25,0,4,4,0
12,11,2018,16,0,3,"Braga",4,"N14 Bosch",32,46,14,70,48,22
12,11,2018,16,0,3,"Braga",5,"Avenida João Paulo II",22,39,17,15,8,7
12,11,2018,16,0,3,"Braga",6,"Avenida Padre Júlio Fragata",40,61,21,32,21,11
12,11,2018,16,0,3,"Braga",7,"Rua Nova Santa Cruz",14,28,14,217,108,109
12,11,2018,16,0,3,"Braga",8,"Rua Costa Gomes",40,40,0,43,43,0
12,11,2018,17,0,3,"Braga",1,"Avenida da Liberdade",25,25,0,26,26,0
12,11,2018,17,0,3,"Braga",2,"Avenida Central",13,18,5,356,257,99
12,11,2018,17,0,3,"Braga",3,"Rua de Caires",25,25,0,4,4,0
12,11,2018,17,0,3,"Braga",4,"N14 Bosch",37,47,10,60,47,13
12,11,2018,17,0,3,"Braga",5,"Avenida João Paulo II",39,39,0,8,8,0
12,11,2018,17,0,3,"Braga",6,"Avenida Padre Júlio Fragata",34,61,27,37,21,16
12,11,2018,17,0,3,"Braga",7,"Rua Nova Santa Cruz",19,29,10,160,104,56
12,11,2018,17,0,3,"Braga",8,"Rua Costa Gomes",23,40,17,75,43,32
12,11,2018,18,0,3,"Braga",1,"Avenida da Liberdade",17,24,7,39,27,12
12,11,2018,18,0,3,"Braga",2,"Avenida Central",8,18,10,579,257,322
12,11,2018,18,0,3,"Braga",3,"Rua de Caires",25,25,0,4,4,0
12,11,2018,18,0,3,"Braga",4,"N14 Bosch",20,47,27,112,47,65
12,11,2018,18,0,3,"Braga",5,"Avenida João Paulo II",12,40,28,29,8,21
12,11,2018,18,0,3,"Braga",6,"Avenida Padre Júlio Fragata",21,60,39,61,21,40
12,11,2018,18,0,3,"Braga",7,"Rua Nova Santa Cruz",8,30,22,380,101,279
12,11,2018,18,0,3,"Braga",8,"Rua Costa Gomes",13,41,28,132,42,90
12,11,2018,19,0,3,"Braga",1,"Avenida da Liberdade",17,25,8,39,26,13
12,11,2018,19,0,3,"Braga",2,"Avenida Central",4,18,14,1159,257,902
12,11,2018,19,0,3,"Braga",3,"Rua de Caires",19,25,6,5,4,1
12,11,2018,19,0,3,"Braga",4,"N14 Bosch",34,47,13,66,47,19
12,11,2018,19,0,3,"Braga",5,"Avenida João Paulo II",9,37,28,38,9,29
12,11,2018,19,0,3,"Braga",6,"Avenida Padre Júlio Fragata",18,63,45,71,20,51
12,11,2018,19,0,3,"Braga",7,"Rua Nova Santa Cruz",12,30,18,253,101,152
12,11,2018,19,0,3,"Braga",8,"Rua Costa Gomes",18,42,24,95,41,54
12,11,2018,20,0,3,"Braga",1,"Avenida da Liberdade",24,24,0,27,27,0
12,11,2018,20,0,3,"Braga",2,"Avenida Central",17,17,0,272,272,0
12,11,2018,20,0,3,"Braga",3,"Rua de Caires",6,26,20,17,4,13
12,11,2018,20,0,3,"Braga",4,"N14 Bosch",36,46,10,62,48,14
12,11,2018,20,0,3,"Braga",5,"Avenida João Paulo II",22,39,17,15,8,7
12,11,2018,20,0,3,"Braga",6,"Avenida Padre Júlio Fragata",44,61,17,29,21,8
12,11,2018,20,0,3,"Braga",7,"Rua Nova Santa Cruz",21,29,8,144,104,40
12,11,2018,20,0,3,"Braga",8,"Rua Costa Gomes",40,40,0,43,43,0
12,11,2018,21,0,3,"Braga",1,"Avenida da Liberdade",24,24,0,27,27,0
12,11,2018,21,0,3,"Braga",2,"Avenida Central",17,17,0,272,272,0
12,11,2018,21,0,3,"Braga",3,"Rua de Caires",29,29,0,3,3,0
12,11,2018,21,0,3,"Braga",4,"N14 Bosch",46,46,0,48,48,0
12,11,2018,21,0,3,"Braga",5,"Avenida João Paulo II",38,38,0,9,9,0
12,11,2018,21,0,3,"Braga",6,"Avenida Padre Júlio Fragata",61,61,0,21,21,0
12,11,2018,21,0,3,"Braga",7,"Rua Nova Santa Cruz",28,28,0,108,108,0
12,11,2018,21,0,3,"Braga",8,"Rua Costa Gomes",41,41,0,42,42,0
12,11,2018,22,0,3,"Braga",1,"Avenida da Liberdade",24,24,0,27,27,0
12,11,2018,22,0,3,"Braga",2,"Avenida Central",13,17,4,356,272,84
12,11,2018,22,0,3,"Braga",3,"Rua de Caires",29,29,0,3,3,0
12,11,2018,22,0,3,"Braga",4,"N14 Bosch",46,46,0,48,48,0
12,11,2018,22,0,3,"Braga",5,"Avenida João Paulo II",38,38,0,9,9,0
12,11,2018,22,0,3,"Braga",6,"Avenida Padre Júlio Fragata",61,61,0,21,21,0
12,11,2018,22,0,3,"Braga",7,"Rua Nova Santa Cruz",28,28,0,108,108,0
12,11,2018,22,0,3,"Braga",8,"Rua Costa Gomes",41,41,0,42,42,0
12,11,2018,23,0,3,"Braga",1,"Avenida da Liberdade",24,24,0,27,27,0
12,11,2018,23,0,3,"Braga",2,"Avenida Central",17,17,0,272,272,0
12,11,2018,23,0,3,"Braga",3,"Rua de Caires",20,25,5,5,4,1
12,11,2018,23,0,3,"Braga",4,"N14 Bosch",46,46,0,48,48,0
12,11,2018,23,0,3,"Braga",5,"Avenida João Paulo II",38,38,0,9,9,0
12,11,2018,23,0,3,"Braga",6,"Avenida Padre Júlio Fragata",61,61,0,21,21,0
12,11,2018,23,0,3,"Braga",7,"Rua Nova Santa Cruz",28,28,0,108,108,0
12,11,2018,23,0,3,"Braga",8,"Rua Costa Gomes",41,41,0,42,42,0
12,12,2018,0,0,4,"Braga",1,"Avenida da Liberdade",24,24,0,27,27,0
12,12,2018,0,0,4,"Braga",2,"Avenida Central",17,17,0,272,272,0
12,12,2018,0,0,4,"Braga",3,"Rua de Caires",25,25,0,4,4,0
12,12,2018,0,0,4,"Braga",4,"N14 Bosch",46,46,0,48,48,0
12,12,2018,0,0,4,"Braga",5,"Avenida João Paulo II",38,38,0,9,9,0
12,12,2018,0,0,4,"Braga",6,"Avenida Padre Júlio Fragata",61,61,0,21,21,0
12,12,2018,0,0,4,"Braga",7,"Rua Nova Santa Cruz",28,28,0,108,108,0
12,12,2018,0,0,4,"Braga",8,"Rua Costa Gomes",41,41,0,42,42,0
12,12,2018,1,0,4,"Braga",1,"Avenida da Liberdade",24,24,0,27,27,0
12,12,2018,1,0,4,"Braga",2,"Avenida Central",17,17,0,272,272,0
12,12,2018,1,0,4,"Braga",3,"Rua de Caires",25,25,0,4,4,0
12,12,2018,1,0,4,"Braga",4,"N14 Bosch",46,46,0,48,48,0
12,12,2018,1,0,4,"Braga",5,"Avenida João Paulo II",38,38,0,9,9,0
12,12,2018,1,0,4,"Braga",6,"Avenida Padre Júlio Fragata",61,61,0,21,21,0
12,12,2018,1,0,4,"Braga",7,"Rua Nova Santa Cruz",28,28,0,108,108,0
12,12,2018,1,0,4,"Braga",8,"Rua Costa Gomes",41,41,0,42,42,0
12,12,2018,2,0,4,"Braga",1,"Avenida da Liberdade",24,24,0,27,27,0
12,12,2018,2,0,4,"Braga",2,"Avenida Central",17,17,0,272,272,0
12,12,2018,2,0,4,"Braga",3,"Rua de Caires",25,25,0,4,4,0
12,12,2018,2,0,4,"Braga",4,"N14 Bosch",46,46,0,48,48,0
12,12,2018,2,0,4,"Braga",5,"Avenida João Paulo II",38,38,0,9,9,0
12,12,2018,2,0,4,"Braga",6,"Avenida Padre Júlio Fragata",61,61,0,21,21,0
12,12,2018,2,0,4,"Braga",7,"Rua Nova Santa Cruz",28,28,0,108,108,0
12,12,2018,2,0,4,"Braga",8,"Rua Costa Gomes",41,41,0,42,42,0
12,12,2018,3,0,4,"Braga",1,"Avenida da Liberdade",25,25,0,26,26,0
12,12,2018,3,0,4,"Braga",2,"Avenida Central",18,18,0,257,257,0
12,12,2018,3,0,4,"Braga",3,"Rua de Caires",25,25,0,4,4,0
12,12,2018,3,0,4,"Braga",4,"N14 Bosch",47,47,0,47,47,0
12,12,2018,3,0,4,"Braga",5,"Avenida João Paulo II",39,39,0,8,8,0
12,12,2018,3,0,4,"Braga",6,"Avenida Padre Júlio Fragata",62,62,0,20,20,0
12,12,2018,3,0,4,"Braga",7,"Rua Nova Santa Cruz",29,29,0,104,104,0
12,12,2018,3,0,4,"Braga",8,"Rua Costa Gomes",41,41,0,42,42,0
12,12,2018,4,0,4,"Braga",1,"Avenida da Liberdade",25,25,0,26,26,0
12,12,2018,4,0,4,"Braga",2,"Avenida Central",18,18,0,257,257,0
12,12,2018,4,0,4,"Braga",3,"Rua de Caires",25,25,0,4,4,0
12,12,2018,4,0,4,"Braga",4,"N14 Bosch",47,47,0,47,47,0
12,12,2018,4,0,4,"Braga",5,"Avenida João Paulo II",39,39,0,8,8,0
12,12,2018,4,0,4,"Braga",6,"Avenida Padre Júlio Fragata",62,62,0,20,20,0
12,12,2018,4,0,4,"Braga",7,"Rua Nova Santa Cruz",29,29,0,104,104,0
12,12,2018,4,0,4,"Braga",8,"Rua Costa Gomes",41,41,0,42,42,0
12,12,2018,5,0,4,"Braga",1,"Avenida da Liberdade",25,25,0,26,26,0
12,12,2018,5,0,4,"Braga",2,"Avenida Central",18,18,0,257,257,0
12,12,2018,5,0,4,"Braga",3,"Rua de Caires",25,25,0,4,4,0
12,12,2018,5,0,4,"Braga",4,"N14 Bosch",47,47,0,47,47,0
12,12,2018,5,0,4,"Braga",5,"Avenida João Paulo II",39,39,0,8,8,0
12,12,2018,5,0,4,"Braga",6,"Avenida Padre Júlio Fragata",62,62,0,20,20,0
12,12,2018,5,0,4,"Braga",7,"Rua Nova Santa Cruz",29,29,0,104,104,0
12,12,2018,5,0,4,"Braga",8,"Rua Costa Gomes",41,41,0,42,42,0
12,12,2018,6,0,4,"Braga",1,"Avenida da Liberdade",25,25,0,26,26,0
12,12,2018,6,0,4,"Braga",2,"Avenida Central",18,18,0,257,257,0
12,12,2018,6,0,4,"Braga",3,"Rua de Caires",3,22,19,34,4,30
12,12,2018,6,0,4,"Braga",4,"N14 Bosch",47,47,0,47,47,0
12,12,2018,6,0,4,"Braga",5,"Avenida João Paulo II",39,39,0,8,8,0
12,12,2018,6,0,4,"Braga",6,"Avenida Padre Júlio Fragata",62,62,0,20,20,0
12,12,2018,6,0,4,"Braga",7,"Rua Nova Santa Cruz",29,29,0,104,104,0
12,12,2018,6,0,4,"Braga",8,"Rua Costa Gomes",41,41,0,42,42,0
12,12,2018,7,0,4,"Braga",1,"Avenida da Liberdade",25,25,0,26,26,0
12,12,2018,7,0,4,"Braga",2,"Avenida Central",18,18,0,257,257,0
12,12,2018,7,0,4,"Braga",3,"Rua de Caires",23,23,0,4,4,0
12,12,2018,7,0,4,"Braga",4,"N14 Bosch",47,47,0,47,47,0
12,12,2018,7,0,4,"Braga",5,"Avenida João Paulo II",39,39,0,8,8,0
12,12,2018,7,0,4,"Braga",6,"Avenida Padre Júlio Fragata",62,62,0,20,20,0
12,12,2018,7,0,4,"Braga",7,"Rua Nova Santa Cruz",29,29,0,104,104,0
12,12,2018,7,0,4,"Braga",8,"Rua Costa Gomes",41,41,0,42,42,0
12,12,2018,8,0,4,"Braga",1,"Avenida da Liberdade",25,25,0,26,26,0
12,12,2018,8,0,4,"Braga",2,"Avenida Central",18,18,0,257,257,0
12,12,2018,8,0,4,"Braga",3,"Rua de Caires",18,24,6,5,4,1
12,12,2018,8,0,4,"Braga",4,"N14 Bosch",47,47,0,47,47,0
12,12,2018,8,0,4,"Braga",5,"Avenida João Paulo II",39,39,0,8,8,0
12,12,2018,8,0,4,"Braga",6,"Avenida Padre Júlio Fragata",62,62,0,20,20,0
12,12,2018,8,0,4,"Braga",7,"Rua Nova Santa Cruz",29,29,0,104,104,0
12,12,2018,8,0,4,"Braga",8,"Rua Costa Gomes",41,41,0,42,42,0
12,12,2018,9,0,4,"Braga",1,"Avenida da Liberdade",20,25,5,33,26,7
12,12,2018,9,0,4,"Braga",2,"Avenida Central",10,17,7,463,272,191
12,12,2018,9,0,4,"Braga",3,"Rua de Caires",25,25,0,4,4,0
12,12,2018,9,0,4,"Braga",4,"N14 Bosch",24,46,22,93,48,45
12,12,2018,9,0,4,"Braga",5,"Avenida João Paulo II",38,38,0,9,9,0
12,12,2018,9,0,4,"Braga",6,"Avenida Padre Júlio Fragata",30,62,32,42,20,22
12,12,2018,9,0,4,"Braga",7,"Rua Nova Santa Cruz",28,28,0,108,108,0
12,12,2018,9,0,4,"Braga",8,"Rua Costa Gomes",13,41,28,132,42,90
12,12,2018,10,0,4,"Braga",1,"Avenida da Liberdade",20,25,5,33,26,7
12,12,2018,10,0,4,"Braga",2,"Avenida Central",18,18,0,257,257,0
12,12,2018,10,0,4,"Braga",3,"Rua de Caires",14,25,11,7,4,3
12,12,2018,10,0,4,"Braga",4,"N14 Bosch",47,47,0,47,47,0
12,12,2018,10,0,4,"Braga",5,"Avenida João Paulo II",39,39,0,8,8,0
12,12,2018,10,0,4,"Braga",6,"Avenida Padre Júlio Fragata",62,62,0,20,20,0
12,12,2018,10,0,4,"Braga",7,"Rua Nova Santa Cruz",29,29,0,104,104,0
12,12,2018,10,0,4,"Braga",8,"Rua Costa Gomes",18,40,22,95,43,52
12,12,2018,11,0,4,"Braga",1,"Avenida da Liberdade",19,25,6,34,26,8
12,12,2018,11,0,4,"Braga",2,"Avenida Central",18,18,0,257,257,0
12,12,2018,11,0,4,"Braga",3,"Rua de Caires",18,24,6,5,4,1
12,12,2018,11,0,4,"Braga",4,"N14 Bosch",35,47,12,64,47,17
12,12,2018,11,0,4,"Braga",5,"Avenida João Paulo II",39,39,0,8,8,0
12,12,2018,11,0,4,"Braga",6,"Avenida Padre Júlio Fragata",46,61,15,27,21,6
12,12,2018,11,0,4,"Braga",7,"Rua Nova Santa Cruz",29,29,0,104,104,0
12,12,2018,11,0,4,"Braga",8,"Rua Costa Gomes",41,41,0,42,42,0
12,12,2018,12,0,4,"Braga",1,"Avenida da Liberdade",25,25,0,26,26,0
12,12,2018,12,0,4,"Braga",2,"Avenida Central",10,17,7,463,272,191
12,12,2018,12,0,4,"Braga",3,"Rua de Caires",24,24,0,4,4,0
12,12,2018,12,0,4,"Braga",4,"N14 Bosch",47,47,0,47,47,0
12,12,2018,12,0,4,"Braga",5,"Avenida João Paulo II",39,39,0,8,8,0
12,12,2018,12,0,4,"Braga",6,"Avenida Padre Júlio Fragata",62,62,0,20,20,0
12,12,2018,12,0,4,"Braga",7,"Rua Nova Santa Cruz",21,29,8,144,104,40
12,12,2018,12,0,4,"Braga",8,"Rua Costa Gomes",30,40,10,57,43,14
1,15,2019,19,0,3,"Braga",1,"Avenida da Liberdade",20,20,0,14,14,0
1,15,2019,19,0,3,"Braga",2,"Avenida Central",4,12,8,458,152,306
1,15,2019,19,0,3,"Braga",3,"Rua de Caires",26,36,10,51,37,14
1,15,2019,19,0,3,"Braga",4,"N14 Bosch",19,46,27,118,48,70
1,15,2019,19,0,3,"Braga",5,"Avenida João Paulo II",22,39,17,15,8,7
1,15,2019,19,0,3,"Braga",6,"Avenida Padre Júlio Fragata",25,60,35,51,21,30
1,15,2019,19,0,3,"Braga",7,"Rua Nova Santa Cruz",17,28,11,179,108,71
1,15,2019,19,0,3,"Braga",8,"Rua Costa Gomes",6,42,36,287,41,246
1,15,2019,20,0,3,"Braga",1,"Avenida da Liberdade",20,20,0,14,14,0
1,15,2019,20,0,3,"Braga",2,"Avenida Central",8,12,4,229,152,77
1,15,2019,20,0,3,"Braga",3,"Rua de Caires",35,35,0,38,38,0
1,15,2019,20,0,3,"Braga",4,"N14 Bosch",36,47,11,62,47,15
1,15,2019,20,0,3,"Braga",5,"Avenida João Paulo II",39,39,0,8,8,0
1,15,2019,20,0,3,"Braga",6,"Avenida Padre Júlio Fragata",62,62,0,20,20,0
1,15,2019,20,0,3,"Braga",7,"Rua Nova Santa Cruz",22,29,7,138,104,34
1,15,2019,20,0,3,"Braga",8,"Rua Costa Gomes",28,41,13,61,42,19
1,15,2019,21,0,3,"Braga",1,"Avenida da Liberdade",20,20,0,14,14,0
1,15,2019,21,0,3,"Braga",2,"Avenida Central",13,13,0,140,140,0
1,15,2019,21,0,3,"Braga",3,"Rua de Caires",35,35,0,38,38,0
1,15,2019,21,0,3,"Braga",4,"N14 Bosch",47,47,0,47,47,0
1,15,2019,21,0,3,"Braga",5,"Avenida João Paulo II",38,38,0,9,9,0
1,15,2019,21,0,3,"Braga",6,"Avenida Padre Júlio Fragata",61,61,0,21,21,0
1,15,2019,21,0,3,"Braga",7,"Rua Nova Santa Cruz",28,28,0,108,108,0
1,15,2019,21,0,3,"Braga",8,"Rua Costa Gomes",40,40,0,43,43,0
1,15,2019,22,0,3,"Braga",1,"Avenida da Liberdade",20,20,0,14,14,0
1,15,2019,22,0,3,"Braga",2,"Avenida Central",12,12,0,152,152,0
1,15,2019,22,0,3,"Braga",3,"Rua de Caires",35,35,0,38,38,0
1,15,2019,22,0,3,"Braga",4,"N14 Bosch",47,47,0,47,47,0
1,15,2019,22,0,3,"Braga",5,"Avenida João Paulo II",38,38,0,9,9,0
1,15,2019,22,0,3,"Braga",6,"Avenida Padre Júlio Fragata",61,61,0,21,21,0
1,15,2019,22,0,3,"Braga",7,"Rua Nova Santa Cruz",28,28,0,108,108,0
1,15,2019,22,0,3,"Braga",8,"Rua Costa Gomes",40,40,0,43,43,0
1,15,2019,23,0,3,"Braga",1,"Avenida da Liberdade",20,20,0,14,14,0
1,15,2019,23,0,3,"Braga",2,"Avenida Central",12,12,0,152,152,0
1,15,2019,23,0,3,"Braga",3,"Rua de Caires",35,35,0,38,38,0
1,15,2019,23,0,3,"Braga",4,"N14 Bosch",47,47,0,47,47,0
1,15,2019,23,0,3,"Braga",5,"Avenida João Paulo II",38,38,0,9,9,0
1,15,2019,23,0,3,"Braga",6,"Avenida Padre Júlio Fragata",61,61,0,21,21,0
1,15,2019,23,0,3,"Braga",7,"Rua Nova Santa Cruz",28,28,0,108,108,0
1,15,2019,23,0,3,"Braga",8,"Rua Costa Gomes",40,40,0,43,43,0
1,16,2019,0,0,4,"Braga",1,"Avenida da Liberdade",20,20,0,14,14,0
1,16,2019,0,0,4,"Braga",2,"Avenida Central",12,12,0,152,152,0
1,16,2019,0,0,4,"Braga",3,"Rua de Caires",36,36,0,37,37,0
1,16,2019,0,0,4,"Braga",4,"N14 Bosch",47,47,0,47,47,0
1,16,2019,0,0,4,"Braga",5,"Avenida João Paulo II",38,38,0,9,9,0
1,16,2019,0,0,4,"Braga",6,"Avenida Padre Júlio Fragata",62,62,0,20,20,0
1,16,2019,0,0,4,"Braga",7,"Rua Nova Santa Cruz",28,28,0,108,108,0
1,16,2019,0,0,4,"Braga",8,"Rua Costa Gomes",40,40,0,43,43,0
1,16,2019,1,0,4,"Braga",1,"Avenida da Liberdade",20,20,0,14,14,0
1,16,2019,1,0,4,"Braga",2,"Avenida Central",12,12,0,152,152,0
1,16,2019,1,0,4,"Braga",3,"Rua de Caires",36,36,0,37,37,0
1,16,2019,1,0,4,"Braga",4,"N14 Bosch",47,47,0,47,47,0
1,16,2019,1,0,4,"Braga",5,"Avenida João Paulo II",38,38,0,9,9,0
1,16,2019,1,0,4,"Braga",6,"Avenida Padre Júlio Fragata",62,62,0,20,20,0
1,16,2019,1,0,4,"Braga",7,"Rua Nova Santa Cruz",28,28,0,108,108,0
1,16,2019,1,0,4,"Braga",8,"Rua Costa Gomes",40,40,0,43,43,0
1,16,2019,2,0,4,"Braga",1,"Avenida da Liberdade",20,20,0,14,14,0
1,16,2019,2,0,4,"Braga",2,"Avenida Central",12,12,0,152,152,0
1,16,2019,2,0,4,"Braga",3,"Rua de Caires",36,36,0,37,37,0
1,16,2019,2,0,4,"Braga",4,"N14 Bosch",47,47,0,47,47,0
1,16,2019,2,0,4,"Braga",5,"Avenida João Paulo II",38,38,0,9,9,0
1,16,2019,2,0,4,"Braga",6,"Avenida Padre Júlio Fragata",62,62,0,20,20,0
1,16,2019,2,0,4,"Braga",7,"Rua Nova Santa Cruz",28,28,0,108,108,0
1,16,2019,2,0,4,"Braga",8,"Rua Costa Gomes",40,40,0,43,43,0
1,16,2019,3,0,4,"Braga",1,"Avenida da Liberdade",20,20,0,14,14,0
1,16,2019,3,0,4,"Braga",2,"Avenida Central",12,12,0,152,152,0
1,16,2019,3,0,4,"Braga",3,"Rua de Caires",36,36,0,37,37,0
1,16,2019,3,0,4,"Braga",4,"N14 Bosch",47,47,0,47,47,0
1,16,2019,3,0,4,"Braga",5,"Avenida João Paulo II",38,38,0,9,9,0
1,16,2019,3,0,4,"Braga",6,"Avenida Padre Júlio Fragata",62,62,0,20,20,0
1,16,2019,3,0,4,"Braga",7,"Rua Nova Santa Cruz",28,28,0,108,108,0
1,16,2019,3,0,4,"Braga",8,"Rua Costa Gomes",20,42,22,86,41,45
1,16,2019,4,0,4,"Braga",1,"Avenida da Liberdade",20,20,0,14,14,0
1,16,2019,4,0,4,"Braga",2,"Avenida Central",12,12,0,152,152,0
1,16,2019,4,0,4,"Braga",3,"Rua de Caires",36,36,0,37,37,0
1,16,2019,4,0,4,"Braga",4,"N14 Bosch",47,47,0,47,47,0
1,16,2019,4,0,4,"Braga",5,"Avenida João Paulo II",38,38,0,9,9,0
1,16,2019,4,0,4,"Braga",6,"Avenida Padre Júlio Fragata",62,62,0,20,20,0
1,16,2019,4,0,4,"Braga",7,"Rua Nova Santa Cruz",28,28,0,108,108,0
1,16,2019,4,0,4,"Braga",8,"Rua Costa Gomes",40,40,0,43,43,0
1,16,2019,5,0,4,"Braga",1,"Avenida da Liberdade",20,20,0,14,14,0
1,16,2019,5,0,4,"Braga",2,"Avenida Central",12,12,0,152,152,0
1,16,2019,5,0,4,"Braga",3,"Rua de Caires",36,36,0,37,37,0
1,16,2019,5,0,4,"Braga",4,"N14 Bosch",47,47,0,47,47,0
1,16,2019,5,0,4,"Braga",5,"Avenida João Paulo II",38,38,0,9,9,0
1,16,2019,5,0,4,"Braga",6,"Avenida Padre Júlio Fragata",62,62,0,20,20,0
1,16,2019,5,0,4,"Braga",7,"Rua Nova Santa Cruz",28,28,0,108,108,0
1,16,2019,5,0,4,"Braga",8,"Rua Costa Gomes",40,40,0,43,43,0
1,16,2019,6,0,4,"Braga",1,"Avenida da Liberdade",20,20,0,14,14,0
1,16,2019,6,0,4,"Braga",2,"Avenida Central",12,12,0,152,152,0
1,16,2019,6,0,4,"Braga",3,"Rua de Caires",36,36,0,37,37,0
1,16,2019,6,0,4,"Braga",4,"N14 Bosch",47,47,0,47,47,0
1,16,2019,6,0,4,"Braga",5,"Avenida João Paulo II",38,38,0,9,9,0
1,16,2019,6,0,4,"Braga",6,"Avenida Padre Júlio Fragata",62,62,0,20,20,0
1,16,2019,6,0,4,"Braga",7,"Rua Nova Santa Cruz",28,28,0,108,108,0
1,16,2019,6,0,4,"Braga",8,"Rua Costa Gomes",40,40,0,43,43,0
1,16,2019,8,0,4,"Braga",1,"Avenida da Liberdade",20,20,0,14,14,0
1,16,2019,8,0,4,"Braga",2,"Avenida Central",12,12,0,152,152,0
1,16,2019,8,0,4,"Braga",3,"Rua de Caires",27,36,9,49,37,12
1,16,2019,8,0,4,"Braga",4,"N14 Bosch",35,47,12,64,47,17
1,16,2019,8,0,4,"Braga",5,"Avenida João Paulo II",38,38,0,9,9,0
1,16,2019,8,0,4,"Braga",6,"Avenida Padre Júlio Fragata",62,62,0,20,20,0
1,16,2019,8,0,4,"Braga",7,"Rua Nova Santa Cruz",28,28,0,108,108,0
1,16,2019,8,0,4,"Braga",8,"Rua Costa Gomes",31,40,9,55,43,12
1,16,2019,9,0,4,"Braga",1,"Avenida da Liberdade",20,20,0,14,14,0
1,16,2019,9,0,4,"Braga",2,"Avenida Central",9,13,4,203,140,63
1,16,2019,9,0,4,"Braga",3,"Rua de Caires",25,35,10,53,38,15
1,16,2019,9,0,4,"Braga",4,"N14 Bosch",26,46,20,86,48,38
1,16,2019,9,0,4,"Braga",5,"Avenida João Paulo II",38,38,0,9,9,0
1,16,2019,9,0,4,"Braga",6,"Avenida Padre Júlio Fragata",62,62,0,20,20,0
1,16,2019,9,0,4,"Braga",7,"Rua Nova Santa Cruz",28,28,0,108,108,0
1,16,2019,9,0,4,"Braga",8,"Rua Costa Gomes",24,41,17,71,42,29
1,16,2019,10,0,4,"Braga",1,"Avenida da Liberdade",19,19,0,14,14,0
1,16,2019,10,0,4,"Braga",2,"Avenida Central",12,12,0,152,152,0
1,16,2019,10,0,4,"Braga",3,"Rua de Caires",25,36,11,53,37,16
1,16,2019,10,0,4,"Braga",4,"N14 Bosch",28,46,18,80,48,32
1,16,2019,10,0,4,"Braga",5,"Avenida João Paulo II",39,39,0,8,8,0
1,16,2019,10,0,4,"Braga",6,"Avenida Padre Júlio Fragata",62,62,0,20,20,0
1,16,2019,10,0,4,"Braga",7,"Rua Nova Santa Cruz",28,28,0,108,108,0
1,16,2019,10,0,4,"Braga",8,"Rua Costa Gomes",32,40,8,53,43,10
1,16,2019,11,0,4,"Braga",1,"Avenida da Liberdade",19,19,0,14,14,0
1,16,2019,11,0,4,"Braga",2,"Avenida Central",7,12,5,261,152,109
1,16,2019,11,0,4,"Braga",3,"Rua de Caires",23,36,13,58,37,21
1,16,2019,11,0,4,"Braga",4,"N14 Bosch",31,47,16,72,47,25
1,16,2019,11,0,4,"Braga",5,"Avenida João Paulo II",39,39,0,8,8,0
1,16,2019,11,0,4,"Braga",6,"Avenida Padre Júlio Fragata",62,62,0,20,20,0
1,16,2019,11,0,4,"Braga",7,"Rua Nova Santa Cruz",28,28,0,108,108,0
1,16,2019,11,0,4,"Braga",8,"Rua Costa Gomes",28,41,13,61,42,19
1,16,2019,12,0,4,"Braga",1,"Avenida da Liberdade",19,19,0,14,14,0
1,16,2019,12,0,4,"Braga",2,"Avenida Central",7,12,5,261,152,109
1,16,2019,12,0,4,"Braga",3,"Rua de Caires",24,36,12,56,37,19
1,16,2019,12,0,4,"Braga",4,"N14 Bosch",29,47,18,77,47,30
1,16,2019,12,0,4,"Braga",5,"Avenida João Paulo II",38,38,0,9,9,0
1,16,2019,12,0,4,"Braga",6,"Avenida Padre Júlio Fragata",62,62,0,20,20,0
1,16,2019,12,0,4,"Braga",7,"Rua Nova Santa Cruz",28,28,0,108,108,0
1,16,2019,12,0,4,"Braga",8,"Rua Costa Gomes",31,41,10,55,42,13
1,16,2019,13,0,4,"Braga",1,"Avenida da Liberdade",19,19,0,14,14,0
1,16,2019,13,0,4,"Braga",2,"Avenida Central",9,13,4,203,140,63
1,16,2019,13,0,4,"Braga",3,"Rua de Caires",22,36,14,61,37,24
1,16,2019,13,0,4,"Braga",4,"N14 Bosch",31,47,16,72,47,25
1,16,2019,13,0,4,"Braga",5,"Avenida João Paulo II",29,38,9,12,9,3
1,16,2019,13,0,4,"Braga",6,"Avenida Padre Júlio Fragata",62,62,0,20,20,0
1,16,2019,13,0,4,"Braga",7,"Rua Nova Santa Cruz",28,28,0,108,108,0
1,16,2019,13,0,4,"Braga",8,"Rua Costa Gomes",31,41,10,55,42,13
1,16,2019,14,0,4,"Braga",1,"Avenida da Liberdade",19,19,0,14,14,0
1,16,2019,14,0,4,"Braga",2,"Avenida Central",7,12,5,261,152,109
1,16,2019,14,0,4,"Braga",3,"Rua de Caires",27,35,8,49,38,11
1,16,2019,14,0,4,"Braga",4,"N14 Bosch",24,46,22,93,48,45
1,16,2019,14,0,4,"Braga",5,"Avenida João Paulo II",24,38,14,14,9,5
1,16,2019,14,0,4,"Braga",6,"Avenida Padre Júlio Fragata",49,61,12,26,21,5
1,16,2019,14,0,4,"Braga",7,"Rua Nova Santa Cruz",22,28,6,138,108,30
1,16,2019,14,0,4,"Braga",8,"Rua Costa Gomes",18,42,24,95,41,54
1,16,2019,15,0,4,"Braga",1,"Avenida da Liberdade",19,19,0,14,14,0
1,16,2019,15,0,4,"Braga",2,"Avenida Central",8,12,4,229,152,77
1,16,2019,15,0,4,"Braga",3,"Rua de Caires",25,35,10,53,38,15
1,16,2019,15,0,4,"Braga",4,"N14 Bosch",29,47,18,77,47,30
1,16,2019,15,0,4,"Braga",5,"Avenida João Paulo II",30,39,9,11,8,3
1,16,2019,15,0,4,"Braga",6,"Avenida Padre Júlio Fragata",61,61,0,21,21,0
1,16,2019,15,0,4,"Braga",7,"Rua Nova Santa Cruz",13,28,15,234,108,126
1,16,2019,15,0,4,"Braga",8,"Rua Costa Gomes",32,40,8,53,43,10
1,16,2019,16,0,4,"Braga",1,"Avenida da Liberdade",19,19,0,14,14,0
1,16,2019,16,0,4,"Braga",2,"Avenida Central",8,12,4,229,152,77
1,16,2019,16,0,4,"Braga",3,"Rua de Caires",28,36,8,48,37,11
1,16,2019,16,0,4,"Braga",4,"N14 Bosch",29,46,17,77,48,29
1,16,2019,16,0,4,"Braga",5,"Avenida João Paulo II",30,39,9,11,8,3
1,16,2019,16,0,4,"Braga",6,"Avenida Padre Júlio Fragata",45,62,17,28,20,8
1,16,2019,16,0,4,"Braga",7,"Rua Nova Santa Cruz",28,28,0,108,108,0
1,16,2019,16,0,4,"Braga",8,"Rua Costa Gomes",41,41,0,42,42,0
1,16,2019,17,0,4,"Braga",1,"Avenida da Liberdade",19,19,0,14,14,0
1,16,2019,17,0,4,"Braga",2,"Avenida Central",10,12,2,183,152,31
1,16,2019,17,0,4,"Braga",3,"Rua de Caires",21,35,14,64,38,26
1,16,2019,17,0,4,"Braga",4,"N14 Bosch",27,46,19,83,48,35
1,16,2019,17,0,4,"Braga",5,"Avenida João Paulo II",23,39,16,15,8,7
1,16,2019,17,0,4,"Braga",6,"Avenida Padre Júlio Fragata",62,62,0,20,20,0
1,16,2019,17,0,4,"Braga",7,"Rua Nova Santa Cruz",18,28,10,169,108,61
1,16,2019,17,0,4,"Braga",8,"Rua Costa Gomes",28,41,13,61,42,19
1,16,2019,18,0,4,"Braga",1,"Avenida da Liberdade",15,19,4,18,14,4
1,16,2019,18,0,4,"Braga",2,"Avenida Central",5,13,8,366,140,226
1,16,2019,18,0,4,"Braga",3,"Rua de Caires",23,35,12,58,38,20
1,16,2019,18,0,4,"Braga",4,"N14 Bosch",14,48,34,160,46,114
1,16,2019,18,0,4,"Braga",5,"Avenida João Paulo II",39,39,0,8,8,0
1,16,2019,18,0,4,"Braga",6,"Avenida Padre Júlio Fragata",29,61,32,44,21,23
1,16,2019,18,0,4,"Braga",7,"Rua Nova Santa Cruz",15,28,13,202,108,94
1,16,2019,18,0,4,"Braga",8,"Rua Costa Gomes",10,40,30,172,43,129
1,16,2019,19,0,4,"Braga",1,"Avenida da Liberdade",20,20,0,14,14,0
1,16,2019,19,0,4,"Braga",2,"Avenida Central",6,12,6,305,152,153
1,16,2019,19,0,4,"Braga",3,"Rua de Caires",25,36,11,53,37,16
1,16,2019,19,0,4,"Braga",4,"N14 Bosch",23,46,23,97,48,49
1,16,2019,19,0,4,"Braga",5,"Avenida João Paulo II",21,38,17,16,9,7
1,16,2019,19,0,4,"Braga",6,"Avenida Padre Júlio Fragata",38,62,24,33,20,13
1,16,2019,19,0,4,"Braga",7,"Rua Nova Santa Cruz",13,28,15,234,108,126
1,16,2019,19,0,4,"Braga",8,"Rua Costa Gomes",15,41,26,115,42,73
1,16,2019,20,0,4,"Braga",1,"Avenida da Liberdade",25,25,0,26,26,0
1,16,2019,20,0,4,"Braga",2,"Avenida Central",17,17,0,272,272,0
1,16,2019,20,0,4,"Braga",3,"Rua de Caires",14,24,10,7,4,3
1,16,2019,20,0,4,"Braga",4,"N14 Bosch",37,47,10,60,47,13
1,16,2019,20,0,4,"Braga",5,"Avenida João Paulo II",39,39,0,8,8,0
1,16,2019,20,0,4,"Braga",6,"Avenida Padre Júlio Fragata",48,61,13,26,21,5
1,16,2019,20,0,4,"Braga",7,"Rua Nova Santa Cruz",12,30,18,253,101,152
1,16,2019,20,0,4,"Braga",8,"Rua Costa Gomes",41,41,0,42,42,0
1,16,2019,21,0,4,"Braga",1,"Avenida da Liberdade",25,25,0,26,26,0
1,16,2019,21,0,4,"Braga",2,"Avenida Central",13,18,5,356,257,99
1,16,2019,21,0,4,"Braga",3,"Rua de Caires",25,25,0,4,4,0
1,16,2019,21,0,4,"Braga",4,"N14 Bosch",47,47,0,47,47,0
1,16,2019,21,0,4,"Braga",5,"Avenida João Paulo II",39,39,0,8,8,0
1,16,2019,21,0,4,"Braga",6,"Avenida Padre Júlio Fragata",62,62,0,20,20,0
1,16,2019,21,0,4,"Braga",7,"Rua Nova Santa Cruz",28,28,0,108,108,0
1,16,2019,21,0,4,"Braga",8,"Rua Costa Gomes",41,41,0,42,42,0
1,16,2019,22,0,4,"Braga",1,"Avenida da Liberdade",25,25,0,26,26,0
1,16,2019,22,0,4,"Braga",2,"Avenida Central",17,17,0,272,272,0
1,16,2019,22,0,4,"Braga",3,"Rua de Caires",6,27,21,17,3,14
1,16,2019,22,0,4,"Braga",4,"N14 Bosch",47,47,0,47,47,0
1,16,2019,22,0,4,"Braga",5,"Avenida João Paulo II",39,39,0,8,8,0
1,16,2019,22,0,4,"Braga",6,"Avenida Padre Júlio Fragata",61,61,0,21,21,0
1,16,2019,22,0,4,"Braga",7,"Rua Nova Santa Cruz",28,28,0,108,108,0
1,16,2019,22,0,4,"Braga",8,"Rua Costa Gomes",41,41,0,42,42,0
1,16,2019,23,0,4,"Braga",1,"Avenida da Liberdade",25,25,0,26,26,0
1,16,2019,23,0,4,"Braga",2,"Avenida Central",17,17,0,272,272,0
1,16,2019,23,0,4,"Braga",3,"Rua de Caires",27,27,0,3,3,0
1,16,2019,23,0,4,"Braga",4,"N14 Bosch",47,47,0,47,47,0
1,16,2019,23,0,4,"Braga",5,"Avenida João Paulo II",38,38,0,9,9,0
1,16,2019,23,0,4,"Braga",6,"Avenida Padre Júlio Fragata",61,61,0,21,21,0
1,16,2019,23,0,4,"Braga",7,"Rua Nova Santa Cruz",28,28,0,108,108,0
1,16,2019,23,0,4,"Braga",8,"Rua Costa Gomes",41,41,0,42,42,0
1,17,2019,0,0,5,"Braga",1,"Avenida da Liberdade",25,25,0,26,26,0
1,17,2019,0,0,5,"Braga",2,"Avenida Central",17,17,0,272,272,0
1,17,2019,0,0,5,"Braga",3,"Rua de Caires",27,27,0,3,3,0
1,17,2019,0,0,5,"Braga",4,"N14 Bosch",47,47,0,47,47,0
1,17,2019,0,0,5,"Braga",5,"Avenida João Paulo II",38,38,0,9,9,0
1,17,2019,0,0,5,"Braga",6,"Avenida Padre Júlio Fragata",61,61,0,21,21,0
1,17,2019,0,0,5,"Braga",7,"Rua Nova Santa Cruz",29,29,0,104,104,0
1,17,2019,0,0,5,"Braga",8,"Rua Costa Gomes",41,41,0,42,42,0
1,17,2019,1,0,5,"Braga",1,"Avenida da Liberdade",25,25,0,26,26,0
1,17,2019,1,0,5,"Braga",2,"Avenida Central",17,17,0,272,272,0
1,17,2019,1,0,5,"Braga",3,"Rua de Caires",27,27,0,3,3,0
1,17,2019,1,0,5,"Braga",4,"N14 Bosch",47,47,0,47,47,0
1,17,2019,1,0,5,"Braga",5,"Avenida João Paulo II",39,39,0,8,8,0
1,17,2019,1,0,5,"Braga",6,"Avenida Padre Júlio Fragata",61,61,0,21,21,0
1,17,2019,1,0,5,"Braga",7,"Rua Nova Santa Cruz",29,29,0,104,104,0
1,17,2019,1,0,5,"Braga",8,"Rua Costa Gomes",41,41,0,42,42,0
1,17,2019,2,0,5,"Braga",1,"Avenida da Liberdade",25,25,0,26,26,0
1,17,2019,2,0,5,"Braga",2,"Avenida Central",17,17,0,272,272,0
1,17,2019,2,0,5,"Braga",3,"Rua de Caires",27,27,0,3,3,0
1,17,2019,2,0,5,"Braga",4,"N14 Bosch",47,47,0,47,47,0
1,17,2019,2,0,5,"Braga",5,"Avenida João Paulo II",39,39,0,8,8,0
1,17,2019,2,0,5,"Braga",6,"Avenida Padre Júlio Fragata",61,61,0,21,21,0
1,17,2019,2,0,5,"Braga",7,"Rua Nova Santa Cruz",29,29,0,104,104,0
1,17,2019,2,0,5,"Braga",8,"Rua Costa Gomes",41,41,0,42,42,0
1,17,2019,3,0,5,"Braga",1,"Avenida da Liberdade",25,25,0,26,26,0
1,17,2019,3,0,5,"Braga",2,"Avenida Central",17,17,0,272,272,0
1,17,2019,3,0,5,"Braga",3,"Rua de Caires",27,27,0,3,3,0
1,17,2019,3,0,5,"Braga",4,"N14 Bosch",47,47,0,47,47,0
1,17,2019,3,0,5,"Braga",5,"Avenida João Paulo II",39,39,0,8,8,0
1,17,2019,3,0,5,"Braga",6,"Avenida Padre Júlio Fragata",61,61,0,21,21,0
1,17,2019,3,0,5,"Braga",7,"Rua Nova Santa Cruz",29,29,0,104,104,0
1,17,2019,3,0,5,"Braga",8,"Rua Costa Gomes",41,41,0,42,42,0
1,17,2019,4,0,5,"Braga",1,"Avenida da Liberdade",25,25,0,26,26,0
1,17,2019,4,0,5,"Braga",2,"Avenida Central",17,17,0,272,272,0
1,17,2019,4,0,5,"Braga",3,"Rua de Caires",27,27,0,3,3,0
1,17,2019,4,0,5,"Braga",4,"N14 Bosch",47,47,0,47,47,0
1,17,2019,4,0,5,"Braga",5,"Avenida João Paulo II",39,39,0,8,8,0
1,17,2019,4,0,5,"Braga",6,"Avenida Padre Júlio Fragata",61,61,0,21,21,0
1,17,2019,4,0,5,"Braga",7,"Rua Nova Santa Cruz",29,29,0,104,104,0
1,17,2019,4,0,5,"Braga",8,"Rua Costa Gomes",41,41,0,42,42,0
1,17,2019,5,0,5,"Braga",1,"Avenida da Liberdade",25,25,0,26,26,0
1,17,2019,5,0,5,"Braga",2,"Avenida Central",17,17,0,272,272,0
1,17,2019,5,0,5,"Braga",3,"Rua de Caires",27,27,0,3,3,0
1,17,2019,5,0,5,"Braga",4,"N14 Bosch",47,47,0,47,47,0
1,17,2019,5,0,5,"Braga",5,"Avenida João Paulo II",39,39,0,8,8,0
1,17,2019,5,0,5,"Braga",6,"Avenida Padre Júlio Fragata",61,61,0,21,21,0
1,17,2019,5,0,5,"Braga",7,"Rua Nova Santa Cruz",29,29,0,104,104,0
1,17,2019,5,0,5,"Braga",8,"Rua Costa Gomes",41,41,0,42,42,0
1,17,2019,6,0,5,"Braga",1,"Avenida da Liberdade",25,25,0,26,26,0
1,17,2019,6,0,5,"Braga",2,"Avenida Central",17,17,0,272,272,0
1,17,2019,6,0,5,"Braga",3,"Rua de Caires",27,27,0,3,3,0
1,17,2019,6,0,5,"Braga",4,"N14 Bosch",47,47,0,47,47,0
1,17,2019,6,0,5,"Braga",5,"Avenida João Paulo II",39,39,0,8,8,0
1,17,2019,6,0,5,"Braga",6,"Avenida Padre Júlio Fragata",61,61,0,21,21,0
1,17,2019,6,0,5,"Braga",7,"Rua Nova Santa Cruz",29,29,0,104,104,0
1,17,2019,6,0,5,"Braga",8,"Rua Costa Gomes",41,41,0,42,42,0
1,17,2019,7,0,5,"Braga",1,"Avenida da Liberdade",25,25,0,26,26,0
1,17,2019,7,0,5,"Braga",2,"Avenida Central",17,17,0,272,272,0
1,17,2019,7,0,5,"Braga",3,"Rua de Caires",27,27,0,3,3,0
1,17,2019,7,0,5,"Braga",4,"N14 Bosch",47,47,0,47,47,0
1,17,2019,7,0,5,"Braga",5,"Avenida João Paulo II",39,39,0,8,8,0
1,17,2019,7,0,5,"Braga",6,"Avenida Padre Júlio Fragata",61,61,0,21,21,0
1,17,2019,7,0,5,"Braga",7,"Rua Nova Santa Cruz",29,29,0,104,104,0
1,17,2019,7,0,5,"Braga",8,"Rua Costa Gomes",41,41,0,42,42,0
1,17,2019,8,0,5,"Braga",1,"Avenida da Liberdade",25,25,0,26,26,0
1,17,2019,8,0,5,"Braga",2,"Avenida Central",17,17,0,272,272,0
1,17,2019,8,0,5,"Braga",3,"Rua de Caires",27,27,0,3,3,0
1,17,2019,8,0,5,"Braga",4,"N14 Bosch",47,47,0,47,47,0
1,17,2019,8,0,5,"Braga",5,"Avenida João Paulo II",39,39,0,8,8,0
1,17,2019,8,0,5,"Braga",6,"Avenida Padre Júlio Fragata",61,61,0,21,21,0
1,17,2019,8,0,5,"Braga",7,"Rua Nova Santa Cruz",29,29,0,104,104,0
1,17,2019,8,0,5,"Braga",8,"Rua Costa Gomes",41,41,0,42,42,0
1,17,2019,9,0,5,"Braga",1,"Avenida da Liberdade",17,24,7,39,27,12
1,17,2019,9,0,5,"Braga",2,"Avenida Central",11,18,7,421,257,164
1,17,2019,9,0,5,"Braga",3,"Rua de Caires",19,24,5,5,4,1
1,17,2019,9,0,5,"Braga",4,"N14 Bosch",20,47,27,112,47,65
1,17,2019,9,0,5,"Braga",5,"Avenida João Paulo II",38,38,0,9,9,0
1,17,2019,9,0,5,"Braga",6,"Avenida Padre Júlio Fragata",61,61,0,21,21,0
1,17,2019,9,0,5,"Braga",7,"Rua Nova Santa Cruz",29,29,0,104,104,0
1,17,2019,9,0,5,"Braga",8,"Rua Costa Gomes",40,40,0,43,43,0
1,17,2019,10,0,5,"Braga",1,"Avenida da Liberdade",17,24,7,39,27,12
1,17,2019,10,0,5,"Braga",2,"Avenida Central",14,18,4,331,257,74
1,17,2019,10,0,5,"Braga",3,"Rua de Caires",25,25,0,4,4,0
1,17,2019,10,0,5,"Braga",4,"N14 Bosch",46,46,0,48,48,0
1,17,2019,10,0,5,"Braga",5,"Avenida João Paulo II",38,38,0,9,9,0
1,17,2019,10,0,5,"Braga",6,"Avenida Padre Júlio Fragata",62,62,0,20,20,0
1,17,2019,10,0,5,"Braga",7,"Rua Nova Santa Cruz",29,29,0,104,104,0
1,17,2019,10,0,5,"Braga",8,"Rua Costa Gomes",41,41,0,42,42,0
1,17,2019,11,0,5,"Braga",1,"Avenida da Liberdade",25,25,0,26,26,0
1,17,2019,11,0,5,"Braga",2,"Avenida Central",13,18,5,356,257,99
1,17,2019,11,0,5,"Braga",3,"Rua de Caires",25,25,0,4,4,0
1,17,2019,11,0,5,"Braga",4,"N14 Bosch",34,46,12,66,48,18
1,17,2019,11,0,5,"Braga",5,"Avenida João Paulo II",38,38,0,9,9,0
1,17,2019,11,0,5,"Braga",6,"Avenida Padre Júlio Fragata",62,62,0,20,20,0
1,17,2019,11,0,5,"Braga",7,"Rua Nova Santa Cruz",28,28,0,108,108,0
1,17,2019,11,0,5,"Braga",8,"Rua Costa Gomes",27,40,13,63,43,20
1,17,2019,12,0,5,"Braga",1,"Avenida da Liberdade",25,25,0,26,26,0
1,17,2019,12,0,5,"Braga",2,"Avenida Central",13,18,5,356,257,99
1,17,2019,12,0,5,"Braga",3,"Rua de Caires",25,25,0,4,4,0
1,17,2019,12,0,5,"Braga",4,"N14 Bosch",36,46,10,62,48,14
1,17,2019,12,0,5,"Braga",5,"Avenida João Paulo II",30,39,9,11,8,3
1,17,2019,12,0,5,"Braga",6,"Avenida Padre Júlio Fragata",62,62,0,20,20,0
1,17,2019,12,0,5,"Braga",7,"Rua Nova Santa Cruz",28,28,0,108,108,0
1,17,2019,12,0,5,"Braga",8,"Rua Costa Gomes",31,40,9,55,43,12
1,17,2019,13,0,5,"Braga",1,"Avenida da Liberdade",24,24,0,27,27,0
1,17,2019,13,0,5,"Braga",2,"Avenida Central",18,18,0,257,257,0
1,17,2019,13,0,5,"Braga",3,"Rua de Caires",25,25,0,4,4,0
1,17,2019,13,0,5,"Braga",4,"N14 Bosch",24,46,22,93,48,45
1,17,2019,13,0,5,"Braga",5,"Avenida João Paulo II",38,38,0,9,9,0
1,17,2019,13,0,5,"Braga",6,"Avenida Padre Júlio Fragata",62,62,0,20,20,0
1,17,2019,13,0,5,"Braga",7,"Rua Nova Santa Cruz",28,28,0,108,108,0
1,17,2019,13,0,5,"Braga",8,"Rua Costa Gomes",40,40,0,43,43,0
1,17,2019,14,0,5,"Braga",1,"Avenida da Liberdade",24,24,0,27,27,0
1,17,2019,14,0,5,"Braga",2,"Avenida Central",18,18,0,257,257,0
1,17,2019,14,0,5,"Braga",3,"Rua de Caires",25,25,0,4,4,0
1,17,2019,14,0,5,"Braga",4,"N14 Bosch",26,46,20,86,48,38
1,17,2019,14,0,5,"Braga",5,"Avenida João Paulo II",38,38,0,9,9,0
1,17,2019,14,0,5,"Braga",6,"Avenida Padre Júlio Fragata",62,62,0,20,20,0
1,17,2019,14,0,5,"Braga",7,"Rua Nova Santa Cruz",17,28,11,179,108,71
1,17,2019,14,0,5,"Braga",8,"Rua Costa Gomes",40,40,0,43,43,0
1,17,2019,15,0,5,"Braga",1,"Avenida da Liberdade",20,25,5,33,26,7
1,17,2019,15,0,5,"Braga",2,"Avenida Central",11,18,7,421,257,164
1,17,2019,15,0,5,"Braga",3,"Rua de Caires",18,25,7,5,4,1
1,17,2019,15,0,5,"Braga",4,"N14 Bosch",30,47,17,74,47,27
1,17,2019,15,0,5,"Braga",5,"Avenida João Paulo II",39,39,0,8,8,0
1,17,2019,15,0,5,"Braga",6,"Avenida Padre Júlio Fragata",45,62,17,28,20,8
1,17,2019,15,0,5,"Braga",7,"Rua Nova Santa Cruz",20,28,8,152,108,44
1,17,2019,15,0,5,"Braga",8,"Rua Costa Gomes",28,40,12,61,43,18
1,17,2019,16,0,5,"Braga",1,"Avenida da Liberdade",25,25,0,26,26,0
1,17,2019,16,0,5,"Braga",2,"Avenida Central",13,17,4,356,272,84
1,17,2019,16,0,5,"Braga",3,"Rua de Caires",25,25,0,4,4,0
1,17,2019,16,0,5,"Braga",4,"N14 Bosch",47,47,0,47,47,0
1,17,2019,16,0,5,"Braga",5,"Avenida João Paulo II",29,39,10,12,8,4
1,17,2019,16,0,5,"Braga",6,"Avenida Padre Júlio Fragata",62,62,0,20,20,0
1,17,2019,16,0,5,"Braga",7,"Rua Nova Santa Cruz",29,29,0,104,104,0
1,17,2019,16,0,5,"Braga",8,"Rua Costa Gomes",41,41,0,42,42,0
1,17,2019,17,0,5,"Braga",1,"Avenida da Liberdade",19,25,6,34,26,8
1,17,2019,17,0,5,"Braga",2,"Avenida Central",18,18,0,257,257,0
1,17,2019,17,0,5,"Braga",3,"Rua de Caires",16,25,9,6,4,2
1,17,2019,17,0,5,"Braga",4,"N14 Bosch",17,46,29,132,48,84
1,17,2019,17,0,5,"Braga",5,"Avenida João Paulo II",30,39,9,11,8,3
1,17,2019,17,0,5,"Braga",6,"Avenida Padre Júlio Fragata",43,62,19,29,20,9
1,17,2019,17,0,5,"Braga",7,"Rua Nova Santa Cruz",29,29,0,104,104,0
1,17,2019,17,0,5,"Braga",8,"Rua Costa Gomes",33,41,8,52,42,10
1,17,2019,18,0,5,"Braga",1,"Avenida da Liberdade",16,25,9,41,26,15
1,17,2019,18,0,5,"Braga",2,"Avenida Central",5,18,13,927,257,670
1,17,2019,18,0,5,"Braga",3,"Rua de Caires",6,25,19,17,4,13
1,17,2019,18,0,5,"Braga",4,"N14 Bosch",13,48,35,172,46,126
1,17,2019,18,0,5,"Braga",5,"Avenida João Paulo II",28,38,10,12,9,3
1,17,2019,18,0,5,"Braga",6,"Avenida Padre Júlio Fragata",44,61,17,29,21,8
1,17,2019,18,0,5,"Braga",7,"Rua Nova Santa Cruz",15,29,14,202,104,98
1,17,2019,18,0,5,"Braga",8,"Rua Costa Gomes",17,41,24,101,42,59
1,17,2019,19,0,5,"Braga",1,"Avenida da Liberdade",16,25,9,41,26,15
1,17,2019,19,0,5,"Braga",2,"Avenida Central",5,17,12,927,272,655
1,17,2019,19,0,5,"Braga",3,"Rua de Caires",12,24,12,8,4,4
1,17,2019,19,0,5,"Braga",4,"N14 Bosch",18,47,29,124,47,77
1,17,2019,19,0,5,"Braga",5,"Avenida João Paulo II",27,39,12,12,8,4
1,17,2019,19,0,5,"Braga",6,"Avenida Padre Júlio Fragata",35,61,26,36,21,15
1,17,2019,19,0,5,"Braga",7,"Rua Nova Santa Cruz",18,29,11,169,104,65
1,17,2019,19,0,5,"Braga",8,"Rua Costa Gomes",17,42,25,101,41,60
1,17,2019,20,0,5,"Braga",1,"Avenida da Liberdade",25,25,0,26,26,0
1,17,2019,20,0,5,"Braga",2,"Avenida Central",14,18,4,331,257,74
1,17,2019,20,0,5,"Braga",3,"Rua de Caires",26,26,0,4,4,0
1,17,2019,20,0,5,"Braga",4,"N14 Bosch",18,47,29,124,47,77
1,17,2019,20,0,5,"Braga",5,"Avenida João Paulo II",38,38,0,9,9,0
1,17,2019,20,0,5,"Braga",6,"Avenida Padre Júlio Fragata",50,62,12,25,20,5
1,17,2019,20,0,5,"Braga",7,"Rua Nova Santa Cruz",28,28,0,108,108,0
1,17,2019,20,0,5,"Braga",8,"Rua Costa Gomes",28,40,12,61,43,18
1,17,2019,21,0,5,"Braga",1,"Avenida da Liberdade",25,25,0,26,26,0
1,17,2019,21,0,5,"Braga",2,"Avenida Central",18,18,0,257,257,0
1,17,2019,21,0,5,"Braga",3,"Rua de Caires",26,26,0,4,4,0
1,17,2019,21,0,5,"Braga",4,"N14 Bosch",46,46,0,48,48,0
1,17,2019,21,0,5,"Braga",5,"Avenida João Paulo II",38,38,0,9,9,0
1,17,2019,21,0,5,"Braga",6,"Avenida Padre Júlio Fragata",61,61,0,21,21,0
1,17,2019,21,0,5,"Braga",7,"Rua Nova Santa Cruz",28,28,0,108,108,0
1,17,2019,21,0,5,"Braga",8,"Rua Costa Gomes",41,41,0,42,42,0
1,17,2019,22,0,5,"Braga",1,"Avenida da Liberdade",25,25,0,26,26,0
1,17,2019,22,0,5,"Braga",2,"Avenida Central",18,18,0,257,257,0
1,17,2019,22,0,5,"Braga",3,"Rua de Caires",26,26,0,4,4,0
1,17,2019,22,0,5,"Braga",4,"N14 Bosch",46,46,0,48,48,0
1,17,2019,22,0,5,"Braga",5,"Avenida João Paulo II",38,38,0,9,9,0
1,17,2019,22,0,5,"Braga",6,"Avenida Padre Júlio Fragata",61,61,0,21,21,0
1,17,2019,22,0,5,"Braga",7,"Rua Nova Santa Cruz",28,28,0,108,108,0
1,17,2019,22,0,5,"Braga",8,"Rua Costa Gomes",41,41,0,42,42,0
1,17,2019,23,0,5,"Braga",1,"Avenida da Liberdade",25,25,0,26,26,0
1,17,2019,23,0,5,"Braga",2,"Avenida Central",17,17,0,272,272,0
1,17,2019,23,0,5,"Braga",3,"Rua de Caires",26,26,0,4,4,0
1,17,2019,23,0,5,"Braga",4,"N14 Bosch",46,46,0,48,48,0
1,17,2019,23,0,5,"Braga",5,"Avenida João Paulo II",38,38,0,9,9,0
1,17,2019,23,0,5,"Braga",6,"Avenida Padre Júlio Fragata",61,61,0,21,21,0
1,17,2019,23,0,5,"Braga",7,"Rua Nova Santa Cruz",28,28,0,108,108,0
1,17,2019,23,0,5,"Braga",8,"Rua Costa Gomes",41,41,0,42,42,0
1,18,2019,0,0,6,"Braga",1,"Avenida da Liberdade",25,25,0,26,26,0
1,18,2019,0,0,6,"Braga",2,"Avenida Central",17,17,0,272,272,0
1,18,2019,0,0,6,"Braga",3,"Rua de Caires",26,26,0,4,4,0
1,18,2019,0,0,6,"Braga",4,"N14 Bosch",46,46,0,48,48,0
1,18,2019,0,0,6,"Braga",5,"Avenida João Paulo II",39,39,0,8,8,0
1,18,2019,0,0,6,"Braga",6,"Avenida Padre Júlio Fragata",61,61,0,21,21,0
1,18,2019,0,0,6,"Braga",7,"Rua Nova Santa Cruz",28,28,0,108,108,0
1,18,2019,0,0,6,"Braga",8,"Rua Costa Gomes",41,41,0,42,42,0
1,18,2019,1,0,6,"Braga",1,"Avenida da Liberdade",25,25,0,26,26,0
1,18,2019,1,0,6,"Braga",2,"Avenida Central",17,17,0,272,272,0
1,18,2019,1,0,6,"Braga",3,"Rua de Caires",26,26,0,4,4,0
1,18,2019,1,0,6,"Braga",4,"N14 Bosch",46,46,0,48,48,0
1,18,2019,1,0,6,"Braga",5,"Avenida João Paulo II",39,39,0,8,8,0
1,18,2019,1,0,6,"Braga",6,"Avenida Padre Júlio Fragata",61,61,0,21,21,0
1,18,2019,1,0,6,"Braga",7,"Rua Nova Santa Cruz",28,28,0,108,108,0
1,18,2019,1,0,6,"Braga",8,"Rua Costa Gomes",41,41,0,42,42,0
1,18,2019,2,0,6,"Braga",1,"Avenida da Liberdade",25,25,0,26,26,0
1,18,2019,2,0,6,"Braga",2,"Avenida Central",17,17,0,272,272,0
1,18,2019,2,0,6,"Braga",3,"Rua de Caires",26,26,0,4,4,0
1,18,2019,2,0,6,"Braga",4,"N14 Bosch",46,46,0,48,48,0
1,18,2019,2,0,6,"Braga",5,"Avenida João Paulo II",39,39,0,8,8,0
1,18,2019,2,0,6,"Braga",6,"Avenida Padre Júlio Fragata",61,61,0,21,21,0
1,18,2019,2,0,6,"Braga",7,"Rua Nova Santa Cruz",28,28,0,108,108,0
1,18,2019,2,0,6,"Braga",8,"Rua Costa Gomes",41,41,0,42,42,0
1,18,2019,3,0,6,"Braga",1,"Avenida da Liberdade",25,25,0,26,26,0
1,18,2019,3,0,6,"Braga",2,"Avenida Central",17,17,0,272,272,0
1,18,2019,3,0,6,"Braga",3,"Rua de Caires",26,26,0,4,4,0
1,18,2019,3,0,6,"Braga",4,"N14 Bosch",46,46,0,48,48,0
1,18,2019,3,0,6,"Braga",5,"Avenida João Paulo II",39,39,0,8,8,0
1,18,2019,3,0,6,"Braga",6,"Avenida Padre Júlio Fragata",61,61,0,21,21,0
1,18,2019,3,0,6,"Braga",7,"Rua Nova Santa Cruz",28,28,0,108,108,0
1,18,2019,3,0,6,"Braga",8,"Rua Costa Gomes",41,41,0,42,42,0
1,18,2019,4,0,6,"Braga",1,"Avenida da Liberdade",25,25,0,26,26,0
1,18,2019,4,0,6,"Braga",2,"Avenida Central",17,17,0,272,272,0
1,18,2019,4,0,6,"Braga",3,"Rua de Caires",26,26,0,4,4,0
1,18,2019,4,0,6,"Braga",4,"N14 Bosch",46,46,0,48,48,0
1,18,2019,4,0,6,"Braga",5,"Avenida João Paulo II",39,39,0,8,8,0
1,18,2019,4,0,6,"Braga",6,"Avenida Padre Júlio Fragata",61,61,0,21,21,0
1,18,2019,4,0,6,"Braga",7,"Rua Nova Santa Cruz",28,28,0,108,108,0
1,18,2019,4,0,6,"Braga",8,"Rua Costa Gomes",41,41,0,42,42,0
1,18,2019,5,0,6,"Braga",1,"Avenida da Liberdade",25,25,0,26,26,0
1,18,2019,5,0,6,"Braga",2,"Avenida Central",17,17,0,272,272,0
1,18,2019,5,0,6,"Braga",3,"Rua de Caires",26,26,0,4,4,0
1,18,2019,5,0,6,"Braga",4,"N14 Bosch",46,46,0,48,48,0
1,18,2019,5,0,6,"Braga",5,"Avenida João Paulo II",39,39,0,8,8,0
1,18,2019,5,0,6,"Braga",6,"Avenida Padre Júlio Fragata",61,61,0,21,21,0
1,18,2019,5,0,6,"Braga",7,"Rua Nova Santa Cruz",28,28,0,108,108,0
1,18,2019,5,0,6,"Braga",8,"Rua Costa Gomes",41,41,0,42,42,0
1,18,2019,6,0,6,"Braga",1,"Avenida da Liberdade",25,25,0,26,26,0
1,18,2019,6,0,6,"Braga",2,"Avenida Central",17,17,0,272,272,0
1,18,2019,6,0,6,"Braga",3,"Rua de Caires",26,26,0,4,4,0
1,18,2019,6,0,6,"Braga",4,"N14 Bosch",46,46,0,48,48,0
1,18,2019,6,0,6,"Braga",5,"Avenida João Paulo II",39,39,0,8,8,0
1,18,2019,6,0,6,"Braga",6,"Avenida Padre Júlio Fragata",61,61,0,21,21,0
1,18,2019,6,0,6,"Braga",7,"Rua Nova Santa Cruz",28,28,0,108,108,0
1,18,2019,6,0,6,"Braga",8,"Rua Costa Gomes",41,41,0,42,42,0
1,18,2019,7,0,6,"Braga",1,"Avenida da Liberdade",25,25,0,26,26,0
1,18,2019,7,0,6,"Braga",2,"Avenida Central",17,17,0,272,272,0
1,18,2019,7,0,6,"Braga",3,"Rua de Caires",26,26,0,4,4,0
1,18,2019,7,0,6,"Braga",4,"N14 Bosch",46,46,0,48,48,0
1,18,2019,7,0,6,"Braga",5,"Avenida João Paulo II",39,39,0,8,8,0
1,18,2019,7,0,6,"Braga",6,"Avenida Padre Júlio Fragata",61,61,0,21,21,0
1,18,2019,7,0,6,"Braga",7,"Rua Nova Santa Cruz",28,28,0,108,108,0
1,18,2019,7,0,6,"Braga",8,"Rua Costa Gomes",41,41,0,42,42,0
1,18,2019,8,0,6,"Braga",1,"Avenida da Liberdade",25,25,0,26,26,0
1,18,2019,8,0,6,"Braga",2,"Avenida Central",17,17,0,272,272,0
1,18,2019,8,0,6,"Braga",3,"Rua de Caires",26,26,0,4,4,0
1,18,2019,8,0,6,"Braga",4,"N14 Bosch",32,46,14,70,48,22
1,18,2019,8,0,6,"Braga",5,"Avenida João Paulo II",39,39,0,8,8,0
1,18,2019,8,0,6,"Braga",6,"Avenida Padre Júlio Fragata",61,61,0,21,21,0
1,18,2019,8,0,6,"Braga",7,"Rua Nova Santa Cruz",28,28,0,108,108,0
1,18,2019,8,0,6,"Braga",8,"Rua Costa Gomes",41,41,0,42,42,0
1,18,2019,9,0,6,"Braga",1,"Avenida da Liberdade",25,25,0,26,26,0
1,18,2019,9,0,6,"Braga",2,"Avenida Central",12,18,6,386,257,129
1,18,2019,9,0,6,"Braga",3,"Rua de Caires",20,25,5,5,4,1
1,18,2019,9,0,6,"Braga",4,"N14 Bosch",30,46,16,74,48,26
1,18,2019,9,0,6,"Braga",5,"Avenida João Paulo II",39,39,0,8,8,0
1,18,2019,9,0,6,"Braga",6,"Avenida Padre Júlio Fragata",62,62,0,20,20,0
1,18,2019,9,0,6,"Braga",7,"Rua Nova Santa Cruz",28,28,0,108,108,0
1,18,2019,9,0,6,"Braga",8,"Rua Costa Gomes",27,41,14,63,42,21
1,18,2019,10,0,6,"Braga",1,"Avenida da Liberdade",24,24,0,27,27,0
1,18,2019,10,0,6,"Braga",2,"Avenida Central",17,17,0,272,272,0
1,18,2019,10,0,6,"Braga",3,"Rua de Caires",26,26,0,4,4,0
1,18,2019,10,0,6,"Braga",4,"N14 Bosch",37,46,9,60,48,12
1,18,2019,10,0,6,"Braga",5,"Avenida João Paulo II",39,39,0,8,8,0
1,18,2019,10,0,6,"Braga",6,"Avenida Padre Júlio Fragata",62,62,0,20,20,0
1,18,2019,10,0,6,"Braga",7,"Rua Nova Santa Cruz",29,29,0,104,104,0
1,18,2019,10,0,6,"Braga",8,"Rua Costa Gomes",26,40,14,66,43,23
1,18,2019,11,0,6,"Braga",1,"Avenida da Liberdade",20,20,0,14,14,0
1,18,2019,11,0,6,"Braga",2,"Avenida Central",9,13,4,203,140,63
1,18,2019,11,0,6,"Braga",3,"Rua de Caires",25,35,10,53,38,15
1,18,2019,11,0,6,"Braga",4,"N14 Bosch",23,47,24,97,47,50
1,18,2019,11,0,6,"Braga",5,"Avenida João Paulo II",31,39,8,11,8,3
1,18,2019,11,0,6,"Braga",6,"Avenida Padre Júlio Fragata",62,62,0,20,20,0
1,18,2019,11,0,6,"Braga",7,"Rua Nova Santa Cruz",29,29,0,104,104,0
1,18,2019,11,0,6,"Braga",8,"Rua Costa Gomes",31,40,9,55,43,12
1,18,2019,12,0,6,"Braga",1,"Avenida da Liberdade",20,20,0,14,14,0
1,18,2019,12,0,6,"Braga",2,"Avenida Central",8,13,5,229,140,89
1,18,2019,12,0,6,"Braga",3,"Rua de Caires",12,34,22,112,39,73
1,18,2019,12,0,6,"Braga",4,"N14 Bosch",22,46,24,102,48,54
1,18,2019,12,0,6,"Braga",5,"Avenida João Paulo II",38,38,0,9,9,0
1,18,2019,12,0,6,"Braga",6,"Avenida Padre Júlio Fragata",49,61,12,26,21,5
1,18,2019,12,0,6,"Braga",7,"Rua Nova Santa Cruz",21,29,8,144,104,40
1,18,2019,12,0,6,"Braga",8,"Rua Costa Gomes",29,41,12,59,42,17
1,18,2019,13,0,6,"Braga",1,"Avenida da Liberdade",20,20,0,14,14,0
1,18,2019,13,0,6,"Braga",2,"Avenida Central",7,12,5,261,152,109
1,18,2019,13,0,6,"Braga",3,"Rua de Caires",23,35,12,58,38,20
1,18,2019,13,0,6,"Braga",4,"N14 Bosch",26,46,20,86,48,38
1,18,2019,13,0,6,"Braga",5,"Avenida João Paulo II",39,39,0,8,8,0
1,18,2019,13,0,6,"Braga",6,"Avenida Padre Júlio Fragata",45,61,16,28,21,7
1,18,2019,13,0,6,"Braga",7,"Rua Nova Santa Cruz",28,28,0,108,108,0
1,18,2019,13,0,6,"Braga",8,"Rua Costa Gomes",33,41,8,52,42,10
1,18,2019,14,0,6,"Braga",1,"Avenida da Liberdade",20,20,0,14,14,0
1,18,2019,14,0,6,"Braga",2,"Avenida Central",9,12,3,203,152,51
1,18,2019,14,0,6,"Braga",3,"Rua de Caires",23,36,13,58,37,21
1,18,2019,14,0,6,"Braga",4,"N14 Bosch",22,47,25,102,47,55
1,18,2019,14,0,6,"Braga",5,"Avenida João Paulo II",39,39,0,8,8,0
1,18,2019,14,0,6,"Braga",6,"Avenida Padre Júlio Fragata",49,62,13,26,20,6
1,18,2019,14,0,6,"Braga",7,"Rua Nova Santa Cruz",22,28,6,138,108,30
1,18,2019,14,0,6,"Braga",8,"Rua Costa Gomes",25,41,16,69,42,27
1,18,2019,15,0,6,"Braga",1,"Avenida da Liberdade",20,20,0,14,14,0
1,18,2019,15,0,6,"Braga",2,"Avenida Central",7,12,5,261,152,109
1,18,2019,15,0,6,"Braga",3,"Rua de Caires",35,35,0,38,38,0
1,18,2019,15,0,6,"Braga",4,"N14 Bosch",20,47,27,112,47,65
1,18,2019,15,0,6,"Braga",5,"Avenida João Paulo II",28,39,11,12,8,4
1,18,2019,15,0,6,"Braga",6,"Avenida Padre Júlio Fragata",43,61,18,29,21,8
1,18,2019,15,0,6,"Braga",7,"Rua Nova Santa Cruz",18,28,10,169,108,61
1,18,2019,15,0,6,"Braga",8,"Rua Costa Gomes",16,40,24,107,43,64
1,18,2019,16,0,6,"Braga",1,"Avenida da Liberdade",20,20,0,14,14,0
1,18,2019,16,0,6,"Braga",2,"Avenida Central",12,12,0,152,152,0
1,18,2019,16,0,6,"Braga",3,"Rua de Caires",23,36,13,58,37,21
1,18,2019,16,0,6,"Braga",4,"N14 Bosch",23,46,23,97,48,49
1,18,2019,16,0,6,"Braga",5,"Avenida João Paulo II",26,39,13,13,8,5
1,18,2019,16,0,6,"Braga",6,"Avenida Padre Júlio Fragata",61,61,0,21,21,0
1,18,2019,16,0,6,"Braga",7,"Rua Nova Santa Cruz",21,28,7,144,108,36
1,18,2019,16,0,6,"Braga",8,"Rua Costa Gomes",30,41,11,57,42,15
1,18,2019,17,0,6,"Braga",1,"Avenida da Liberdade",20,20,0,14,14,0
1,18,2019,17,0,6,"Braga",2,"Avenida Central",10,13,3,183,140,43
1,18,2019,17,0,6,"Braga",3,"Rua de Caires",27,36,9,49,37,12
1,18,2019,17,0,6,"Braga",4,"N14 Bosch",35,47,12,64,47,17
1,18,2019,17,0,6,"Braga",5,"Avenida João Paulo II",39,39,0,8,8,0
1,18,2019,17,0,6,"Braga",6,"Avenida Padre Júlio Fragata",37,62,25,34,20,14
1,18,2019,17,0,6,"Braga",7,"Rua Nova Santa Cruz",21,29,8,144,104,40
1,18,2019,17,0,6,"Braga",8,"Rua Costa Gomes",28,40,12,61,43,18
1,18,2019,18,0,6,"Braga",1,"Avenida da Liberdade",20,20,0,14,14,0
1,18,2019,18,0,6,"Braga",2,"Avenida Central",3,11,8,610,166,444
1,18,2019,18,0,6,"Braga",3,"Rua de Caires",20,36,16,67,37,30
1,18,2019,18,0,6,"Braga",4,"N14 Bosch",9,45,36,249,49,200
1,18,2019,18,0,6,"Braga",5,"Avenida João Paulo II",22,39,17,15,8,7
1,18,2019,18,0,6,"Braga",6,"Avenida Padre Júlio Fragata",34,61,27,37,21,16
1,18,2019,18,0,6,"Braga",7,"Rua Nova Santa Cruz",21,29,8,144,104,40
1,18,2019,18,0,6,"Braga",8,"Rua Costa Gomes",27,41,14,63,42,21
1,18,2019,19,0,6,"Braga",1,"Avenida da Liberdade",20,20,0,14,14,0
1,18,2019,19,0,6,"Braga",2,"Avenida Central",5,12,7,366,152,214
1,18,2019,19,0,6,"Braga",3,"Rua de Caires",23,35,12,58,38,20
1,18,2019,19,0,6,"Braga",4,"N14 Bosch",32,47,15,70,47,23
1,18,2019,19,0,6,"Braga",5,"Avenida João Paulo II",31,39,8,11,8,3
1,18,2019,19,0,6,"Braga",6,"Avenida Padre Júlio Fragata",10,65,55,128,19,109
1,18,2019,19,0,6,"Braga",7,"Rua Nova Santa Cruz",19,28,9,160,108,52
1,18,2019,19,0,6,"Braga",8,"Rua Costa Gomes",14,40,26,123,43,80
1,18,2019,20,0,6,"Braga",1,"Avenida da Liberdade",20,20,0,14,14,0
1,18,2019,20,0,6,"Braga",2,"Avenida Central",8,12,4,229,152,77
1,18,2019,20,0,6,"Braga",3,"Rua de Caires",36,36,0,37,37,0
1,18,2019,20,0,6,"Braga",4,"N14 Bosch",28,46,18,80,48,32
1,18,2019,20,0,6,"Braga",5,"Avenida João Paulo II",37,37,0,9,9,0
1,18,2019,20,0,6,"Braga",6,"Avenida Padre Júlio Fragata",23,61,38,55,21,34
1,18,2019,20,0,6,"Braga",7,"Rua Nova Santa Cruz",19,28,9,160,108,52
1,18,2019,20,0,6,"Braga",8,"Rua Costa Gomes",26,40,14,66,43,23
1,18,2019,21,0,6,"Braga",1,"Avenida da Liberdade",20,20,0,14,14,0
1,18,2019,21,0,6,"Braga",2,"Avenida Central",12,12,0,152,152,0
1,18,2019,21,0,6,"Braga",3,"Rua de Caires",36,36,0,37,37,0
1,18,2019,21,0,6,"Braga",4,"N14 Bosch",47,47,0,47,47,0
1,18,2019,21,0,6,"Braga",5,"Avenida João Paulo II",31,39,8,11,8,3
1,18,2019,21,0,6,"Braga",6,"Avenida Padre Júlio Fragata",62,62,0,20,20,0
1,18,2019,21,0,6,"Braga",7,"Rua Nova Santa Cruz",29,29,0,104,104,0
1,18,2019,21,0,6,"Braga",8,"Rua Costa Gomes",30,40,10,57,43,14
1,18,2019,22,0,6,"Braga",1,"Avenida da Liberdade",20,20,0,14,14,0
1,18,2019,22,0,6,"Braga",2,"Avenida Central",12,12,0,152,152,0
1,18,2019,22,0,6,"Braga",3,"Rua de Caires",36,36,0,37,37,0
1,18,2019,22,0,6,"Braga",4,"N14 Bosch",47,47,0,47,47,0
1,18,2019,22,0,6,"Braga",5,"Avenida João Paulo II",38,38,0,9,9,0
1,18,2019,22,0,6,"Braga",6,"Avenida Padre Júlio Fragata",62,62,0,20,20,0
1,18,2019,22,0,6,"Braga",7,"Rua Nova Santa Cruz",28,28,0,108,108,0
1,18,2019,22,0,6,"Braga",8,"Rua Costa Gomes",40,40,0,43,43,0
1,18,2019,23,0,6,"Braga",1,"Avenida da Liberdade",20,20,0,14,14,0
1,18,2019,23,0,6,"Braga",2,"Avenida Central",12,12,0,152,152,0
1,18,2019,23,0,6,"Braga",3,"Rua de Caires",35,35,0,38,38,0
1,18,2019,23,0,6,"Braga",4,"N14 Bosch",47,47,0,47,47,0
1,18,2019,23,0,6,"Braga",5,"Avenida João Paulo II",38,38,0,9,9,0
1,18,2019,23,0,6,"Braga",6,"Avenida Padre Júlio Fragata",62,62,0,20,20,0
1,18,2019,23,0,6,"Braga",7,"Rua Nova Santa Cruz",28,28,0,108,108,0
1,18,2019,23,0,6,"Braga",8,"Rua Costa Gomes",40,40,0,43,43,0
1,19,2019,0,0,7,"Braga",1,"Avenida da Liberdade",20,20,0,14,14,0
1,19,2019,0,0,7,"Braga",2,"Avenida Central",12,12,0,152,152,0
1,19,2019,0,0,7,"Braga",3,"Rua de Caires",35,35,0,38,38,0
1,19,2019,0,0,7,"Braga",4,"N14 Bosch",47,47,0,47,47,0
1,19,2019,0,0,7,"Braga",5,"Avenida João Paulo II",38,38,0,9,9,0
1,19,2019,0,0,7,"Braga",6,"Avenida Padre Júlio Fragata",62,62,0,20,20,0
1,19,2019,0,0,7,"Braga",7,"Rua Nova Santa Cruz",28,28,0,108,108,0
1,19,2019,0,0,7,"Braga",8,"Rua Costa Gomes",40,40,0,43,43,0
1,19,2019,1,0,7,"Braga",1,"Avenida da Liberdade",20,20,0,14,14,0
1,19,2019,1,0,7,"Braga",2,"Avenida Central",13,13,0,140,140,0
1,19,2019,1,0,7,"Braga",3,"Rua de Caires",35,35,0,38,38,0
1,19,2019,1,0,7,"Braga",4,"N14 Bosch",47,47,0,47,47,0
1,19,2019,1,0,7,"Braga",5,"Avenida João Paulo II",38,38,0,9,9,0
1,19,2019,1,0,7,"Braga",6,"Avenida Padre Júlio Fragata",61,61,0,21,21,0
1,19,2019,1,0,7,"Braga",7,"Rua Nova Santa Cruz",28,28,0,108,108,0
1,19,2019,1,0,7,"Braga",8,"Rua Costa Gomes",40,40,0,43,43,0
1,19,2019,2,0,7,"Braga",1,"Avenida da Liberdade",20,20,0,14,14,0
1,19,2019,2,0,7,"Braga",2,"Avenida Central",13,13,0,140,140,0
1,19,2019,2,0,7,"Braga",3,"Rua de Caires",35,35,0,38,38,0
1,19,2019,2,0,7,"Braga",4,"N14 Bosch",47,47,0,47,47,0
1,19,2019,2,0,7,"Braga",5,"Avenida João Paulo II",38,38,0,9,9,0
1,19,2019,2,0,7,"Braga",6,"Avenida Padre Júlio Fragata",61,61,0,21,21,0
1,19,2019,2,0,7,"Braga",7,"Rua Nova Santa Cruz",28,28,0,108,108,0
1,19,2019,2,0,7,"Braga",8,"Rua Costa Gomes",40,40,0,43,43,0
1,19,2019,3,0,7,"Braga",1,"Avenida da Liberdade",20,20,0,14,14,0
1,19,2019,3,0,7,"Braga",2,"Avenida Central",13,13,0,140,140,0
1,19,2019,3,0,7,"Braga",3,"Rua de Caires",35,35,0,38,38,0
1,19,2019,3,0,7,"Braga",4,"N14 Bosch",47,47,0,47,47,0
1,19,2019,3,0,7,"Braga",5,"Avenida João Paulo II",38,38,0,9,9,0
1,19,2019,3,0,7,"Braga",6,"Avenida Padre Júlio Fragata",61,61,0,21,21,0
1,19,2019,3,0,7,"Braga",7,"Rua Nova Santa Cruz",28,28,0,108,108,0
1,19,2019,3,0,7,"Braga",8,"Rua Costa Gomes",40,40,0,43,43,0
1,19,2019,4,0,7,"Braga",1,"Avenida da Liberdade",20,20,0,14,14,0
1,19,2019,4,0,7,"Braga",2,"Avenida Central",13,13,0,140,140,0
1,19,2019,4,0,7,"Braga",3,"Rua de Caires",35,35,0,38,38,0
1,19,2019,4,0,7,"Braga",4,"N14 Bosch",47,47,0,47,47,0
1,19,2019,4,0,7,"Braga",5,"Avenida João Paulo II",38,38,0,9,9,0
1,19,2019,4,0,7,"Braga",6,"Avenida Padre Júlio Fragata",61,61,0,21,21,0
1,19,2019,4,0,7,"Braga",7,"Rua Nova Santa Cruz",28,28,0,108,108,0
1,19,2019,4,0,7,"Braga",8,"Rua Costa Gomes",40,40,0,43,43,0
1,19,2019,5,0,7,"Braga",1,"Avenida da Liberdade",20,20,0,14,14,0
1,19,2019,5,0,7,"Braga",2,"Avenida Central",13,13,0,140,140,0
1,19,2019,5,0,7,"Braga",3,"Rua de Caires",35,35,0,38,38,0
1,19,2019,5,0,7,"Braga",4,"N14 Bosch",47,47,0,47,47,0
1,19,2019,5,0,7,"Braga",5,"Avenida João Paulo II",38,38,0,9,9,0
1,19,2019,5,0,7,"Braga",6,"Avenida Padre Júlio Fragata",61,61,0,21,21,0
1,19,2019,5,0,7,"Braga",7,"Rua Nova Santa Cruz",28,28,0,108,108,0
1,19,2019,5,0,7,"Braga",8,"Rua Costa Gomes",40,40,0,43,43,0
1,19,2019,6,0,7,"Braga",1,"Avenida da Liberdade",20,20,0,14,14,0
1,19,2019,6,0,7,"Braga",2,"Avenida Central",13,13,0,140,140,0
1,19,2019,6,0,7,"Braga",3,"Rua de Caires",35,35,0,38,38,0
1,19,2019,6,0,7,"Braga",4,"N14 Bosch",47,47,0,47,47,0
1,19,2019,6,0,7,"Braga",5,"Avenida João Paulo II",38,38,0,9,9,0
1,19,2019,6,0,7,"Braga",6,"Avenida Padre Júlio Fragata",61,61,0,21,21,0
1,19,2019,6,0,7,"Braga",7,"Rua Nova Santa Cruz",28,28,0,108,108,0
1,19,2019,6,0,7,"Braga",8,"Rua Costa Gomes",40,40,0,43,43,0
1,19,2019,7,0,7,"Braga",4,"N14 Bosch",16,48,32,140,46,94
1,19,2019,7,0,7,"Braga",5,"Avenida João Paulo II",38,38,0,9,9,0
1,19,2019,7,0,7,"Braga",6,"Avenida Padre Júlio Fragata",61,61,0,21,21,0
1,19,2019,7,0,7,"Braga",7,"Rua Nova Santa Cruz",28,28,0,108,108,0
1,19,2019,7,0,7,"Braga",8,"Rua Costa Gomes",40,40,0,43,43,0
1,19,2019,7,0,7,"Braga",1,"Avenida da Liberdade",20,20,0,14,14,0
1,19,2019,7,0,7,"Braga",2,"Avenida Central",13,13,0,140,140,0
1,19,2019,7,0,7,"Braga",3,"Rua de Caires",35,35,0,38,38,0
1,19,2019,7,0,7,"Braga",4,"N14 Bosch",16,48,32,140,46,94
1,19,2019,8,0,7,"Braga",1,"Avenida da Liberdade",20,20,0,14,14,0
1,19,2019,8,0,7,"Braga",2,"Avenida Central",13,13,0,140,140,0
1,19,2019,8,0,7,"Braga",3,"Rua de Caires",35,35,0,38,38,0
1,19,2019,8,0,7,"Braga",4,"N14 Bosch",47,47,0,47,47,0
1,19,2019,8,0,7,"Braga",5,"Avenida João Paulo II",38,38,0,9,9,0
1,19,2019,8,0,7,"Braga",6,"Avenida Padre Júlio Fragata",61,61,0,21,21,0
1,19,2019,8,0,7,"Braga",7,"Rua Nova Santa Cruz",28,28,0,108,108,0
1,19,2019,8,0,7,"Braga",8,"Rua Costa Gomes",40,40,0,43,43,0
1,19,2019,9,0,7,"Braga",1,"Avenida da Liberdade",20,20,0,14,14,0
1,19,2019,9,0,7,"Braga",2,"Avenida Central",13,13,0,140,140,0
1,19,2019,9,0,7,"Braga",3,"Rua de Caires",35,35,0,38,38,0
1,19,2019,9,0,7,"Braga",4,"N14 Bosch",47,47,0,47,47,0
1,19,2019,9,0,7,"Braga",5,"Avenida João Paulo II",38,38,0,9,9,0
1,19,2019,9,0,7,"Braga",6,"Avenida Padre Júlio Fragata",61,61,0,21,21,0
1,19,2019,9,0,7,"Braga",7,"Rua Nova Santa Cruz",28,28,0,108,108,0
1,19,2019,9,0,7,"Braga",8,"Rua Costa Gomes",40,40,0,43,43,0
1,19,2019,10,0,7,"Braga",1,"Avenida da Liberdade",20,20,0,14,14,0
1,19,2019,10,0,7,"Braga",2,"Avenida Central",8,13,5,229,140,89
1,19,2019,10,0,7,"Braga",3,"Rua de Caires",29,36,7,46,37,9
1,19,2019,10,0,7,"Braga",4,"N14 Bosch",46,46,0,48,48,0
1,19,2019,10,0,7,"Braga",5,"Avenida João Paulo II",38,38,0,9,9,0
1,19,2019,10,0,7,"Braga",6,"Avenida Padre Júlio Fragata",61,61,0,21,21,0
1,19,2019,10,0,7,"Braga",7,"Rua Nova Santa Cruz",28,28,0,108,108,0
1,19,2019,10,0,7,"Braga",8,"Rua Costa Gomes",40,40,0,43,43,0
1,19,2019,11,0,7,"Braga",1,"Avenida da Liberdade",20,20,0,14,14,0
1,19,2019,11,0,7,"Braga",2,"Avenida Central",7,12,5,261,152,109
1,19,2019,11,0,7,"Braga",3,"Rua de Caires",26,36,10,51,37,14
1,19,2019,11,0,7,"Braga",4,"N14 Bosch",36,47,11,62,47,15
1,19,2019,11,0,7,"Braga",5,"Avenida João Paulo II",38,38,0,9,9,0
1,19,2019,11,0,7,"Braga",6,"Avenida Padre Júlio Fragata",61,61,0,21,21,0
1,19,2019,11,0,7,"Braga",7,"Rua Nova Santa Cruz",28,28,0,108,108,0
1,19,2019,11,0,7,"Braga",8,"Rua Costa Gomes",40,40,0,43,43,0
1,19,2019,12,0,7,"Braga",1,"Avenida da Liberdade",20,20,0,14,14,0
1,19,2019,12,0,7,"Braga",2,"Avenida Central",4,12,8,458,152,306
1,19,2019,12,0,7,"Braga",3,"Rua de Caires",35,35,0,38,38,0
1,19,2019,12,0,7,"Braga",4,"N14 Bosch",35,46,11,64,48,16
1,19,2019,12,0,7,"Braga",5,"Avenida João Paulo II",38,38,0,9,9,0
1,19,2019,12,0,7,"Braga",6,"Avenida Padre Júlio Fragata",37,62,25,34,20,14
1,19,2019,12,0,7,"Braga",7,"Rua Nova Santa Cruz",28,28,0,108,108,0
1,19,2019,12,0,7,"Braga",8,"Rua Costa Gomes",27,40,13,63,43,20
1,19,2019,13,0,7,"Braga",1,"Avenida da Liberdade",20,20,0,14,14,0
1,19,2019,13,0,7,"Braga",2,"Avenida Central",5,14,9,366,130,236
1,19,2019,13,0,7,"Braga",3,"Rua de Caires",35,35,0,38,38,0
1,19,2019,13,0,7,"Braga",4,"N14 Bosch",37,47,10,60,47,13
1,19,2019,13,0,7,"Braga",5,"Avenida João Paulo II",38,38,0,9,9,0
1,19,2019,13,0,7,"Braga",6,"Avenida Padre Júlio Fragata",48,61,13,26,21,5
1,19,2019,13,0,7,"Braga",7,"Rua Nova Santa Cruz",29,29,0,104,104,0
1,19,2019,13,0,7,"Braga",8,"Rua Costa Gomes",30,41,11,57,42,15
1,19,2019,14,0,7,"Braga",1,"Avenida da Liberdade",20,20,0,14,14,0
1,19,2019,14,0,7,"Braga",2,"Avenida Central",7,12,5,261,152,109
1,19,2019,14,0,7,"Braga",3,"Rua de Caires",36,36,0,37,37,0
1,19,2019,14,0,7,"Braga",4,"N14 Bosch",46,46,0,48,48,0
1,19,2019,14,0,7,"Braga",5,"Avenida João Paulo II",38,38,0,9,9,0
1,19,2019,14,0,7,"Braga",6,"Avenida Padre Júlio Fragata",61,61,0,21,21,0
1,19,2019,14,0,7,"Braga",7,"Rua Nova Santa Cruz",29,29,0,104,104,0
1,19,2019,14,0,7,"Braga",8,"Rua Costa Gomes",40,40,0,43,43,0
1,19,2019,15,0,7,"Braga",1,"Avenida da Liberdade",20,20,0,14,14,0
1,19,2019,15,0,7,"Braga",2,"Avenida Central",8,12,4,229,152,77
1,19,2019,15,0,7,"Braga",3,"Rua de Caires",36,36,0,37,37,0
1,19,2019,15,0,7,"Braga",4,"N14 Bosch",46,46,0,48,48,0
1,19,2019,15,0,7,"Braga",5,"Avenida João Paulo II",9,38,29,38,9,29
1,19,2019,15,0,7,"Braga",6,"Avenida Padre Júlio Fragata",37,61,24,34,21,13
1,19,2019,15,0,7,"Braga",7,"Rua Nova Santa Cruz",29,29,0,104,104,0
1,19,2019,15,0,7,"Braga",8,"Rua Costa Gomes",30,40,10,57,43,14
1,19,2019,16,0,7,"Braga",1,"Avenida da Liberdade",20,20,0,14,14,0
1,19,2019,16,0,7,"Braga",2,"Avenida Central",9,13,4,203,140,63
1,19,2019,16,0,7,"Braga",3,"Rua de Caires",35,35,0,38,38,0
1,19,2019,16,0,7,"Braga",4,"N14 Bosch",34,46,12,66,48,18
1,19,2019,16,0,7,"Braga",5,"Avenida João Paulo II",31,39,8,11,8,3
1,19,2019,16,0,7,"Braga",6,"Avenida Padre Júlio Fragata",26,62,36,49,20,29
1,19,2019,16,0,7,"Braga",7,"Rua Nova Santa Cruz",29,29,0,104,104,0
1,19,2019,16,0,7,"Braga",8,"Rua Costa Gomes",41,41,0,42,42,0
1,19,2019,17,0,7,"Braga",1,"Avenida da Liberdade",20,20,0,14,14,0
1,19,2019,17,0,7,"Braga",2,"Avenida Central",8,12,4,229,152,77
1,19,2019,17,0,7,"Braga",3,"Rua de Caires",35,35,0,38,38,0
1,19,2019,17,0,7,"Braga",4,"N14 Bosch",46,46,0,48,48,0
1,19,2019,17,0,7,"Braga",5,"Avenida João Paulo II",23,38,15,15,9,6
1,19,2019,17,0,7,"Braga",6,"Avenida Padre Júlio Fragata",40,62,22,32,20,12
1,19,2019,17,0,7,"Braga",7,"Rua Nova Santa Cruz",29,29,0,104,104,0
1,19,2019,17,0,7,"Braga",8,"Rua Costa Gomes",19,40,21,90,43,47
1,19,2019,18,0,7,"Braga",1,"Avenida da Liberdade",20,20,0,14,14,0
1,19,2019,18,0,7,"Braga",2,"Avenida Central",8,13,5,229,140,89
1,19,2019,18,0,7,"Braga",3,"Rua de Caires",35,35,0,38,38,0
1,19,2019,18,0,7,"Braga",4,"N14 Bosch",37,47,10,60,47,13
1,19,2019,18,0,7,"Braga",5,"Avenida João Paulo II",28,39,11,12,8,4
1,19,2019,18,0,7,"Braga",6,"Avenida Padre Júlio Fragata",35,61,26,36,21,15
1,19,2019,18,0,7,"Braga",7,"Rua Nova Santa Cruz",29,29,0,104,104,0
1,19,2019,18,0,7,"Braga",8,"Rua Costa Gomes",31,41,10,55,42,13
1,19,2019,19,0,7,"Braga",1,"Avenida da Liberdade",20,20,0,14,14,0
1,19,2019,19,0,7,"Braga",2,"Avenida Central",12,12,0,152,152,0
1,19,2019,19,0,7,"Braga",3,"Rua de Caires",35,35,0,38,38,0
1,19,2019,19,0,7,"Braga",4,"N14 Bosch",47,47,0,47,47,0
1,19,2019,19,0,7,"Braga",5,"Avenida João Paulo II",38,38,0,9,9,0
1,19,2019,19,0,7,"Braga",6,"Avenida Padre Júlio Fragata",33,61,28,38,21,17
1,19,2019,19,0,7,"Braga",7,"Rua Nova Santa Cruz",29,29,0,104,104,0
1,19,2019,19,0,7,"Braga",8,"Rua Costa Gomes",28,40,12,61,43,18
1,19,2019,20,0,7,"Braga",1,"Avenida da Liberdade",20,20,0,14,14,0
1,19,2019,20,0,7,"Braga",2,"Avenida Central",13,13,0,140,140,0
1,19,2019,20,0,7,"Braga",3,"Rua de Caires",35,35,0,38,38,0
1,19,2019,20,0,7,"Braga",4,"N14 Bosch",46,46,0,48,48,0
1,19,2019,20,0,7,"Braga",5,"Avenida João Paulo II",38,38,0,9,9,0
1,19,2019,20,0,7,"Braga",6,"Avenida Padre Júlio Fragata",39,62,23,32,20,12
1,19,2019,20,0,7,"Braga",7,"Rua Nova Santa Cruz",28,28,0,108,108,0
1,19,2019,20,0,7,"Braga",8,"Rua Costa Gomes",29,41,12,59,42,17
1,19,2019,21,0,7,"Braga",1,"Avenida da Liberdade",20,20,0,14,14,0
1,19,2019,21,0,7,"Braga",2,"Avenida Central",12,12,0,152,152,0
1,19,2019,21,0,7,"Braga",3,"Rua de Caires",36,36,0,37,37,0
1,19,2019,21,0,7,"Braga",4,"N14 Bosch",46,46,0,48,48,0
1,19,2019,21,0,7,"Braga",5,"Avenida João Paulo II",38,38,0,9,9,0
1,19,2019,21,0,7,"Braga",6,"Avenida Padre Júlio Fragata",62,62,0,20,20,0
1,19,2019,21,0,7,"Braga",7,"Rua Nova Santa Cruz",22,28,6,138,108,30
1,19,2019,21,0,7,"Braga",8,"Rua Costa Gomes",30,41,11,57,42,15
1,19,2019,22,0,7,"Braga",1,"Avenida da Liberdade",20,20,0,14,14,0
1,19,2019,22,0,7,"Braga",2,"Avenida Central",12,12,0,152,152,0
1,19,2019,22,0,7,"Braga",3,"Rua de Caires",36,36,0,37,37,0
1,19,2019,22,0,7,"Braga",4,"N14 Bosch",46,46,0,48,48,0
1,19,2019,22,0,7,"Braga",5,"Avenida João Paulo II",38,38,0,9,9,0
1,19,2019,22,0,7,"Braga",6,"Avenida Padre Júlio Fragata",31,61,30,41,21,20
1,19,2019,22,0,7,"Braga",7,"Rua Nova Santa Cruz",29,29,0,104,104,0
1,19,2019,22,0,7,"Braga",8,"Rua Costa Gomes",41,41,0,42,42,0
1,19,2019,23,0,7,"Braga",8,"Rua Costa Gomes",41,41,0,42,42,0
1,19,2019,23,0,7,"Braga",1,"Avenida da Liberdade",20,20,0,14,14,0
1,19,2019,23,0,7,"Braga",2,"Avenida Central",12,12,0,152,152,0
1,19,2019,23,0,7,"Braga",3,"Rua de Caires",36,36,0,37,37,0
1,19,2019,23,0,7,"Braga",4,"N14 Bosch",46,46,0,48,48,0
1,19,2019,23,0,7,"Braga",5,"Avenida João Paulo II",38,38,0,9,9,0
1,19,2019,23,0,7,"Braga",6,"Avenida Padre Júlio Fragata",30,62,32,42,20,22
1,19,2019,23,0,7,"Braga",7,"Rua Nova Santa Cruz",29,29,0,104,104,0
1,19,2019,23,0,7,"Braga",8,"Rua Costa Gomes",41,41,0,42,42,0
1,20,2019,0,0,8,"Braga",1,"Avenida da Liberdade",20,20,0,14,14,0
1,20,2019,0,0,8,"Braga",2,"Avenida Central",12,12,0,152,152,0
1,20,2019,0,0,8,"Braga",3,"Rua de Caires",36,36,0,37,37,0
1,20,2019,0,0,8,"Braga",4,"N14 Bosch",46,46,0,48,48,0
1,20,2019,0,0,8,"Braga",5,"Avenida João Paulo II",38,38,0,9,9,0
1,20,2019,0,0,8,"Braga",6,"Avenida Padre Júlio Fragata",22,61,39,58,21,37
1,20,2019,0,0,8,"Braga",7,"Rua Nova Santa Cruz",29,29,0,104,104,0
1,20,2019,0,0,8,"Braga",8,"Rua Costa Gomes",41,41,0,42,42,0
1,20,2019,1,0,8,"Braga",1,"Avenida da Liberdade",20,20,0,14,14,0
1,20,2019,1,0,8,"Braga",2,"Avenida Central",12,12,0,152,152,0
1,20,2019,1,0,8,"Braga",3,"Rua de Caires",36,36,0,37,37,0
1,20,2019,1,0,8,"Braga",4,"N14 Bosch",46,46,0,48,48,0
1,20,2019,1,0,8,"Braga",5,"Avenida João Paulo II",38,38,0,9,9,0
1,20,2019,1,0,8,"Braga",6,"Avenida Padre Júlio Fragata",61,61,0,21,21,0
1,20,2019,1,0,8,"Braga",7,"Rua Nova Santa Cruz",29,29,0,104,104,0
1,20,2019,1,0,8,"Braga",8,"Rua Costa Gomes",41,41,0,42,42,0
1,20,2019,2,0,8,"Braga",1,"Avenida da Liberdade",20,20,0,14,14,0
1,20,2019,2,0,8,"Braga",2,"Avenida Central",12,12,0,152,152,0
1,20,2019,2,0,8,"Braga",3,"Rua de Caires",36,36,0,37,37,0
1,20,2019,2,0,8,"Braga",4,"N14 Bosch",46,46,0,48,48,0
1,20,2019,2,0,8,"Braga",5,"Avenida João Paulo II",38,38,0,9,9,0
1,20,2019,2,0,8,"Braga",6,"Avenida Padre Júlio Fragata",61,61,0,21,21,0
1,20,2019,2,0,8,"Braga",7,"Rua Nova Santa Cruz",29,29,0,104,104,0
1,20,2019,2,0,8,"Braga",8,"Rua Costa Gomes",41,41,0,42,42,0
1,20,2019,3,0,8,"Braga",1,"Avenida da Liberdade",20,20,0,14,14,0
1,20,2019,3,0,8,"Braga",2,"Avenida Central",12,12,0,152,152,0
1,20,2019,3,0,8,"Braga",3,"Rua de Caires",36,36,0,37,37,0
1,20,2019,3,0,8,"Braga",4,"N14 Bosch",46,46,0,48,48,0
1,20,2019,3,0,8,"Braga",5,"Avenida João Paulo II",38,38,0,9,9,0
1,20,2019,3,0,8,"Braga",6,"Avenida Padre Júlio Fragata",61,61,0,21,21,0
1,20,2019,3,0,8,"Braga",7,"Rua Nova Santa Cruz",20,29,9,152,104,48
1,20,2019,3,0,8,"Braga",8,"Rua Costa Gomes",41,41,0,42,42,0
1,20,2019,4,0,8,"Braga",1,"Avenida da Liberdade",20,20,0,14,14,0
1,20,2019,4,0,8,"Braga",2,"Avenida Central",12,12,0,152,152,0
1,20,2019,4,0,8,"Braga",3,"Rua de Caires",36,36,0,37,37,0
1,20,2019,4,0,8,"Braga",4,"N14 Bosch",46,46,0,48,48,0
1,20,2019,4,0,8,"Braga",5,"Avenida João Paulo II",38,38,0,9,9,0
1,20,2019,4,0,8,"Braga",6,"Avenida Padre Júlio Fragata",61,61,0,21,21,0
1,20,2019,4,0,8,"Braga",7,"Rua Nova Santa Cruz",28,28,0,108,108,0
1,20,2019,4,0,8,"Braga",8,"Rua Costa Gomes",41,41,0,42,42,0
1,20,2019,5,0,8,"Braga",1,"Avenida da Liberdade",20,20,0,14,14,0
1,20,2019,5,0,8,"Braga",2,"Avenida Central",12,12,0,152,152,0
1,20,2019,5,0,8,"Braga",3,"Rua de Caires",36,36,0,37,37,0
1,20,2019,5,0,8,"Braga",4,"N14 Bosch",46,46,0,48,48,0
1,20,2019,5,0,8,"Braga",5,"Avenida João Paulo II",38,38,0,9,9,0
1,20,2019,5,0,8,"Braga",6,"Avenida Padre Júlio Fragata",61,61,0,21,21,0
1,20,2019,5,0,8,"Braga",7,"Rua Nova Santa Cruz",28,28,0,108,108,0
1,20,2019,5,0,8,"Braga",8,"Rua Costa Gomes",41,41,0,42,42,0
1,20,2019,6,0,8,"Braga",1,"Avenida da Liberdade",20,20,0,14,14,0
1,20,2019,6,0,8,"Braga",2,"Avenida Central",12,12,0,152,152,0
1,20,2019,6,0,8,"Braga",3,"Rua de Caires",36,36,0,37,37,0
1,20,2019,6,0,8,"Braga",4,"N14 Bosch",46,46,0,48,48,0
1,20,2019,6,0,8,"Braga",5,"Avenida João Paulo II",38,38,0,9,9,0
1,20,2019,6,0,8,"Braga",6,"Avenida Padre Júlio Fragata",61,61,0,21,21,0
1,20,2019,6,0,8,"Braga",7,"Rua Nova Santa Cruz",28,28,0,108,108,0
1,20,2019,6,0,8,"Braga",8,"Rua Costa Gomes",41,41,0,42,42,0
1,20,2019,7,0,8,"Braga",1,"Avenida da Liberdade",20,20,0,14,14,0
1,20,2019,7,0,8,"Braga",2,"Avenida Central",12,12,0,152,152,0
1,20,2019,7,0,8,"Braga",3,"Rua de Caires",36,36,0,37,37,0
1,20,2019,7,0,8,"Braga",4,"N14 Bosch",46,46,0,48,48,0
1,20,2019,7,0,8,"Braga",5,"Avenida João Paulo II",38,38,0,9,9,0
1,20,2019,7,0,8,"Braga",6,"Avenida Padre Júlio Fragata",61,61,0,21,21,0
1,20,2019,7,0,8,"Braga",7,"Rua Nova Santa Cruz",28,28,0,108,108,0
1,20,2019,7,0,8,"Braga",8,"Rua Costa Gomes",41,41,0,42,42,0
1,20,2019,8,0,8,"Braga",1,"Avenida da Liberdade",20,20,0,14,14,0
1,20,2019,8,0,8,"Braga",2,"Avenida Central",12,12,0,152,152,0
1,20,2019,8,0,8,"Braga",3,"Rua de Caires",36,36,0,37,37,0
1,20,2019,8,0,8,"Braga",4,"N14 Bosch",46,46,0,48,48,0
1,20,2019,8,0,8,"Braga",5,"Avenida João Paulo II",38,38,0,9,9,0
1,20,2019,8,0,8,"Braga",6,"Avenida Padre Júlio Fragata",61,61,0,21,21,0
1,20,2019,8,0,8,"Braga",7,"Rua Nova Santa Cruz",28,28,0,108,108,0
1,20,2019,8,0,8,"Braga",8,"Rua Costa Gomes",41,41,0,42,42,0
1,20,2019,9,0,8,"Braga",1,"Avenida da Liberdade",20,20,0,14,14,0
1,20,2019,9,0,8,"Braga",2,"Avenida Central",12,12,0,152,152,0
1,20,2019,9,0,8,"Braga",3,"Rua de Caires",36,36,0,37,37,0
1,20,2019,9,0,8,"Braga",4,"N14 Bosch",46,46,0,48,48,0
1,20,2019,9,0,8,"Braga",5,"Avenida João Paulo II",38,38,0,9,9,0
1,20,2019,9,0,8,"Braga",6,"Avenida Padre Júlio Fragata",61,61,0,21,21,0
1,20,2019,9,0,8,"Braga",7,"Rua Nova Santa Cruz",28,28,0,108,108,0
1,20,2019,9,0,8,"Braga",8,"Rua Costa Gomes",41,41,0,42,42,0
1,20,2019,10,0,8,"Braga",1,"Avenida da Liberdade",20,20,0,14,14,0
1,20,2019,10,0,8,"Braga",2,"Avenida Central",10,12,2,183,152,31
1,20,2019,10,0,8,"Braga",3,"Rua de Caires",16,35,19,84,38,46
1,20,2019,10,0,8,"Braga",4,"N14 Bosch",46,46,0,48,48,0
1,20,2019,10,0,8,"Braga",5,"Avenida João Paulo II",38,38,0,9,9,0
1,20,2019,10,0,8,"Braga",6,"Avenida Padre Júlio Fragata",61,61,0,21,21,0
1,20,2019,10,0,8,"Braga",7,"Rua Nova Santa Cruz",28,28,0,108,108,0
1,20,2019,10,0,8,"Braga",8,"Rua Costa Gomes",41,41,0,42,42,0
1,20,2019,11,0,8,"Braga",1,"Avenida da Liberdade",20,20,0,14,14,0
1,20,2019,11,0,8,"Braga",2,"Avenida Central",12,12,0,152,152,0
1,20,2019,11,0,8,"Braga",3,"Rua de Caires",23,35,12,58,38,20
1,20,2019,11,0,8,"Braga",4,"N14 Bosch",47,47,0,47,47,0
1,20,2019,11,0,8,"Braga",5,"Avenida João Paulo II",38,38,0,9,9,0
1,20,2019,11,0,8,"Braga",6,"Avenida Padre Júlio Fragata",62,62,0,20,20,0
1,20,2019,11,0,8,"Braga",7,"Rua Nova Santa Cruz",28,28,0,108,108,0
1,20,2019,11,0,8,"Braga",8,"Rua Costa Gomes",41,41,0,42,42,0
1,20,2019,12,0,8,"Braga",1,"Avenida da Liberdade",20,20,0,14,14,0
1,20,2019,12,0,8,"Braga",2,"Avenida Central",12,12,0,152,152,0
1,20,2019,12,0,8,"Braga",3,"Rua de Caires",11,35,24,122,38,84
1,20,2019,12,0,8,"Braga",4,"N14 Bosch",47,47,0,47,47,0
1,20,2019,12,0,8,"Braga",5,"Avenida João Paulo II",39,39,0,8,8,0
1,20,2019,12,0,8,"Braga",6,"Avenida Padre Júlio Fragata",61,61,0,21,21,0
1,20,2019,12,0,8,"Braga",7,"Rua Nova Santa Cruz",28,28,0,108,108,0
1,20,2019,12,0,8,"Braga",8,"Rua Costa Gomes",41,41,0,42,42,0
1,20,2019,13,0,8,"Braga",1,"Avenida da Liberdade",20,20,0,14,14,0
1,20,2019,13,0,8,"Braga",2,"Avenida Central",12,12,0,152,152,0
1,20,2019,13,0,8,"Braga",3,"Rua de Caires",8,34,26,168,39,129
1,20,2019,13,0,8,"Braga",4,"N14 Bosch",47,47,0,47,47,0
1,20,2019,13,0,8,"Braga",5,"Avenida João Paulo II",19,40,21,18,8,10
1,20,2019,13,0,8,"Braga",6,"Avenida Padre Júlio Fragata",62,62,0,20,20,0
1,20,2019,13,0,8,"Braga",7,"Rua Nova Santa Cruz",28,28,0,108,108,0
1,20,2019,13,0,8,"Braga",8,"Rua Costa Gomes",41,41,0,42,42,0
1,20,2019,14,0,8,"Braga",1,"Avenida da Liberdade",20,20,0,14,14,0
1,20,2019,14,0,8,"Braga",2,"Avenida Central",13,13,0,140,140,0
1,20,2019,14,0,8,"Braga",3,"Rua de Caires",36,36,0,37,37,0
1,20,2019,14,0,8,"Braga",4,"N14 Bosch",47,47,0,47,47,0
1,20,2019,14,0,8,"Braga",5,"Avenida João Paulo II",40,40,0,8,8,0
1,20,2019,14,0,8,"Braga",6,"Avenida Padre Júlio Fragata",62,62,0,20,20,0
1,20,2019,14,0,8,"Braga",7,"Rua Nova Santa Cruz",28,28,0,108,108,0
1,20,2019,14,0,8,"Braga",8,"Rua Costa Gomes",30,40,10,57,43,14
1,20,2019,15,0,8,"Braga",1,"Avenida da Liberdade",20,20,0,14,14,0
1,20,2019,15,0,8,"Braga",2,"Avenida Central",12,12,0,152,152,0
1,20,2019,15,0,8,"Braga",3,"Rua de Caires",36,36,0,37,37,0
1,20,2019,15,0,8,"Braga",4,"N14 Bosch",46,46,0,48,48,0
1,20,2019,15,0,8,"Braga",5,"Avenida João Paulo II",27,38,11,12,9,3
1,20,2019,15,0,8,"Braga",6,"Avenida Padre Júlio Fragata",48,62,14,26,20,6
1,20,2019,15,0,8,"Braga",7,"Rua Nova Santa Cruz",28,28,0,108,108,0
1,20,2019,15,0,8,"Braga",8,"Rua Costa Gomes",40,40,0,43,43,0
1,20,2019,16,0,8,"Braga",1,"Avenida da Liberdade",20,20,0,14,14,0
1,20,2019,16,0,8,"Braga",2,"Avenida Central",9,13,4,203,140,63
1,20,2019,16,0,8,"Braga",3,"Rua de Caires",36,36,0,37,37,0
1,20,2019,16,0,8,"Braga",4,"N14 Bosch",26,47,21,86,47,39
1,20,2019,16,0,8,"Braga",5,"Avenida João Paulo II",11,39,28,31,8,23
1,20,2019,16,0,8,"Braga",6,"Avenida Padre Júlio Fragata",46,61,15,27,21,6
1,20,2019,16,0,8,"Braga",7,"Rua Nova Santa Cruz",28,28,0,108,108,0
1,20,2019,16,0,8,"Braga",8,"Rua Costa Gomes",41,41,0,42,42,0
1,20,2019,17,0,8,"Braga",1,"Avenida da Liberdade",20,20,0,14,14,0
1,20,2019,17,0,8,"Braga",2,"Avenida Central",8,13,5,229,140,89
1,20,2019,17,0,8,"Braga",3,"Rua de Caires",36,36,0,37,37,0
1,20,2019,17,0,8,"Braga",4,"N14 Bosch",35,47,12,64,47,17
1,20,2019,17,0,8,"Braga",5,"Avenida João Paulo II",30,39,9,11,8,3
1,20,2019,17,0,8,"Braga",6,"Avenida Padre Júlio Fragata",61,61,0,21,21,0
1,20,2019,17,0,8,"Braga",7,"Rua Nova Santa Cruz",28,28,0,108,108,0
1,20,2019,17,0,8,"Braga",8,"Rua Costa Gomes",40,40,0,43,43,0
1,20,2019,18,0,8,"Braga",1,"Avenida da Liberdade",20,20,0,14,14,0
1,20,2019,18,0,8,"Braga",2,"Avenida Central",13,13,0,140,140,0
1,20,2019,18,0,8,"Braga",3,"Rua de Caires",29,36,7,46,37,9
1,20,2019,18,0,8,"Braga",4,"N14 Bosch",38,47,9,59,47,12
1,20,2019,18,0,8,"Braga",5,"Avenida João Paulo II",25,39,14,13,8,5
1,20,2019,18,0,8,"Braga",6,"Avenida Padre Júlio Fragata",45,61,16,28,21,7
1,20,2019,18,0,8,"Braga",7,"Rua Nova Santa Cruz",29,29,0,104,104,0
1,20,2019,18,0,8,"Braga",8,"Rua Costa Gomes",41,41,0,42,42,0
1,20,2019,19,0,8,"Braga",1,"Avenida da Liberdade",20,20,0,14,14,0
1,20,2019,19,0,8,"Braga",2,"Avenida Central",13,13,0,140,140,0
1,20,2019,19,0,8,"Braga",3,"Rua de Caires",26,36,10,51,37,14
1,20,2019,19,0,8,"Braga",4,"N14 Bosch",47,47,0,47,47,0
1,20,2019,19,0,8,"Braga",5,"Avenida João Paulo II",39,39,0,8,8,0
1,20,2019,19,0,8,"Braga",6,"Avenida Padre Júlio Fragata",61,61,0,21,21,0
1,20,2019,19,0,8,"Braga",7,"Rua Nova Santa Cruz",29,29,0,104,104,0
1,20,2019,19,0,8,"Braga",8,"Rua Costa Gomes",41,41,0,42,42,0
1,20,2019,20,0,8,"Braga",1,"Avenida da Liberdade",20,20,0,14,14,0
1,20,2019,20,0,8,"Braga",2,"Avenida Central",13,13,0,140,140,0
1,20,2019,20,0,8,"Braga",3,"Rua de Caires",36,36,0,37,37,0
1,20,2019,20,0,8,"Braga",4,"N14 Bosch",47,47,0,47,47,0
1,20,2019,20,0,8,"Braga",5,"Avenida João Paulo II",39,39,0,8,8,0
1,20,2019,20,0,8,"Braga",6,"Avenida Padre Júlio Fragata",49,61,12,26,21,5
1,20,2019,20,0,8,"Braga",7,"Rua Nova Santa Cruz",29,29,0,104,104,0
1,20,2019,20,0,8,"Braga",8,"Rua Costa Gomes",41,41,0,42,42,0
1,20,2019,21,0,8,"Braga",1,"Avenida da Liberdade",20,20,0,14,14,0
1,20,2019,21,0,8,"Braga",2,"Avenida Central",10,13,3,183,140,43
1,20,2019,21,0,8,"Braga",3,"Rua de Caires",36,36,0,37,37,0
1,20,2019,21,0,8,"Braga",4,"N14 Bosch",47,47,0,47,47,0
1,20,2019,21,0,8,"Braga",5,"Avenida João Paulo II",39,39,0,8,8,0
1,20,2019,21,0,8,"Braga",6,"Avenida Padre Júlio Fragata",30,61,31,42,21,21
1,20,2019,21,0,8,"Braga",7,"Rua Nova Santa Cruz",29,29,0,104,104,0
1,20,2019,21,0,8,"Braga",8,"Rua Costa Gomes",41,41,0,42,42,0
1,20,2019,22,0,8,"Braga",1,"Avenida da Liberdade",20,20,0,14,14,0
1,20,2019,22,0,8,"Braga",2,"Avenida Central",12,12,0,152,152,0
1,20,2019,22,0,8,"Braga",3,"Rua de Caires",36,36,0,37,37,0
1,20,2019,22,0,8,"Braga",4,"N14 Bosch",47,47,0,47,47,0
1,20,2019,22,0,8,"Braga",5,"Avenida João Paulo II",39,39,0,8,8,0
1,20,2019,22,0,8,"Braga",6,"Avenida Padre Júlio Fragata",61,61,0,21,21,0
1,20,2019,22,0,8,"Braga",7,"Rua Nova Santa Cruz",29,29,0,104,104,0
1,20,2019,22,0,8,"Braga",8,"Rua Costa Gomes",41,41,0,42,42,0
1,20,2019,23,0,8,"Braga",1,"Avenida da Liberdade",20,20,0,14,14,0
1,20,2019,23,0,8,"Braga",2,"Avenida Central",12,12,0,152,152,0
1,20,2019,23,0,8,"Braga",3,"Rua de Caires",36,36,0,37,37,0
1,20,2019,23,0,8,"Braga",4,"N14 Bosch",47,47,0,47,47,0
1,20,2019,23,0,8,"Braga",5,"Avenida João Paulo II",39,39,0,8,8,0
1,20,2019,23,0,8,"Braga",6,"Avenida Padre Júlio Fragata",43,61,18,29,21,8
1,20,2019,23,0,8,"Braga",7,"Rua Nova Santa Cruz",29,29,0,104,104,0
1,20,2019,23,0,8,"Braga",8,"Rua Costa Gomes",41,41,0,42,42,0
1,21,2019,0,0,2,"Braga",1,"Avenida da Liberdade",20,20,0,14,14,0
1,21,2019,0,0,2,"Braga",2,"Avenida Central",12,12,0,152,152,0
1,21,2019,0,0,2,"Braga",3,"Rua de Caires",15,36,21,89,37,52
1,21,2019,0,0,2,"Braga",4,"N14 Bosch",47,47,0,47,47,0
1,21,2019,0,0,2,"Braga",5,"Avenida João Paulo II",39,39,0,8,8,0
1,21,2019,0,0,2,"Braga",6,"Avenida Padre Júlio Fragata",61,61,0,21,21,0
1,21,2019,0,0,2,"Braga",7,"Rua Nova Santa Cruz",29,29,0,104,104,0
1,21,2019,0,0,2,"Braga",8,"Rua Costa Gomes",41,41,0,42,42,0
1,21,2019,1,0,2,"Braga",1,"Avenida da Liberdade",20,20,0,14,14,0
1,21,2019,1,0,2,"Braga",2,"Avenida Central",12,12,0,152,152,0
1,21,2019,1,0,2,"Braga",3,"Rua de Caires",36,36,0,37,37,0
1,21,2019,1,0,2,"Braga",4,"N14 Bosch",47,47,0,47,47,0
1,21,2019,1,0,2,"Braga",5,"Avenida João Paulo II",39,39,0,8,8,0
1,21,2019,1,0,2,"Braga",6,"Avenida Padre Júlio Fragata",61,61,0,21,21,0
1,21,2019,1,0,2,"Braga",7,"Rua Nova Santa Cruz",29,29,0,104,104,0
1,21,2019,1,0,2,"Braga",8,"Rua Costa Gomes",41,41,0,42,42,0
1,21,2019,2,0,2,"Braga",1,"Avenida da Liberdade",20,20,0,14,14,0
1,21,2019,2,0,2,"Braga",2,"Avenida Central",12,12,0,152,152,0
1,21,2019,2,0,2,"Braga",3,"Rua de Caires",36,36,0,37,37,0
1,21,2019,2,0,2,"Braga",4,"N14 Bosch",47,47,0,47,47,0
1,21,2019,2,0,2,"Braga",5,"Avenida João Paulo II",39,39,0,8,8,0
1,21,2019,2,0,2,"Braga",6,"Avenida Padre Júlio Fragata",61,61,0,21,21,0
1,21,2019,2,0,2,"Braga",7,"Rua Nova Santa Cruz",29,29,0,104,104,0
1,21,2019,2,0,2,"Braga",8,"Rua Costa Gomes",41,41,0,42,42,0
1,21,2019,3,0,2,"Braga",1,"Avenida da Liberdade",20,20,0,14,14,0
1,21,2019,3,0,2,"Braga",2,"Avenida Central",12,12,0,152,152,0
1,21,2019,3,0,2,"Braga",3,"Rua de Caires",36,36,0,37,37,0
1,21,2019,3,0,2,"Braga",4,"N14 Bosch",47,47,0,47,47,0
1,21,2019,3,0,2,"Braga",5,"Avenida João Paulo II",39,39,0,8,8,0
1,21,2019,3,0,2,"Braga",6,"Avenida Padre Júlio Fragata",61,61,0,21,21,0
1,21,2019,3,0,2,"Braga",7,"Rua Nova Santa Cruz",29,29,0,104,104,0
1,21,2019,3,0,2,"Braga",8,"Rua Costa Gomes",41,41,0,42,42,0
1,21,2019,4,0,2,"Braga",1,"Avenida da Liberdade",20,20,0,14,14,0
1,21,2019,4,0,2,"Braga",2,"Avenida Central",12,12,0,152,152,0
1,21,2019,4,0,2,"Braga",3,"Rua de Caires",36,36,0,37,37,0
1,21,2019,4,0,2,"Braga",4,"N14 Bosch",47,47,0,47,47,0
1,21,2019,4,0,2,"Braga",5,"Avenida João Paulo II",39,39,0,8,8,0
1,21,2019,4,0,2,"Braga",6,"Avenida Padre Júlio Fragata",61,61,0,21,21,0
1,21,2019,4,0,2,"Braga",7,"Rua Nova Santa Cruz",29,29,0,104,104,0
1,21,2019,4,0,2,"Braga",8,"Rua Costa Gomes",41,41,0,42,42,0
1,21,2019,5,0,2,"Braga",1,"Avenida da Liberdade",20,20,0,14,14,0
1,21,2019,5,0,2,"Braga",2,"Avenida Central",12,12,0,152,152,0
1,21,2019,5,0,2,"Braga",3,"Rua de Caires",36,36,0,37,37,0
1,21,2019,5,0,2,"Braga",4,"N14 Bosch",47,47,0,47,47,0
1,21,2019,5,0,2,"Braga",5,"Avenida João Paulo II",39,39,0,8,8,0
1,21,2019,5,0,2,"Braga",6,"Avenida Padre Júlio Fragata",61,61,0,21,21,0
1,21,2019,5,0,2,"Braga",7,"Rua Nova Santa Cruz",29,29,0,104,104,0
1,21,2019,5,0,2,"Braga",8,"Rua Costa Gomes",41,41,0,42,42,0
1,21,2019,6,0,2,"Braga",1,"Avenida da Liberdade",20,20,0,14,14,0
1,21,2019,6,0,2,"Braga",2,"Avenida Central",12,12,0,152,152,0
1,21,2019,6,0,2,"Braga",3,"Rua de Caires",36,36,0,37,37,0
1,21,2019,6,0,2,"Braga",4,"N14 Bosch",47,47,0,47,47,0
1,21,2019,6,0,2,"Braga",5,"Avenida João Paulo II",39,39,0,8,8,0
1,21,2019,6,0,2,"Braga",6,"Avenida Padre Júlio Fragata",61,61,0,21,21,0
1,21,2019,6,0,2,"Braga",7,"Rua Nova Santa Cruz",29,29,0,104,104,0
1,21,2019,6,0,2,"Braga",8,"Rua Costa Gomes",41,41,0,42,42,0
1,21,2019,7,0,2,"Braga",1,"Avenida da Liberdade",20,20,0,14,14,0
1,21,2019,7,0,2,"Braga",2,"Avenida Central",12,12,0,152,152,0
1,21,2019,7,0,2,"Braga",3,"Rua de Caires",36,36,0,37,37,0
1,21,2019,7,0,2,"Braga",4,"N14 Bosch",47,47,0,47,47,0
1,21,2019,7,0,2,"Braga",5,"Avenida João Paulo II",39,39,0,8,8,0
1,21,2019,7,0,2,"Braga",6,"Avenida Padre Júlio Fragata",61,61,0,21,21,0
1,21,2019,7,0,2,"Braga",7,"Rua Nova Santa Cruz",29,29,0,104,104,0
1,21,2019,7,0,2,"Braga",8,"Rua Costa Gomes",41,41,0,42,42,0
1,21,2019,8,0,2,"Braga",1,"Avenida da Liberdade",20,20,0,14,14,0
1,21,2019,8,0,2,"Braga",2,"Avenida Central",10,12,2,183,152,31
1,21,2019,8,0,2,"Braga",3,"Rua de Caires",25,36,11,53,37,16
1,21,2019,8,0,2,"Braga",4,"N14 Bosch",37,46,9,60,48,12
1,21,2019,8,0,2,"Braga",5,"Avenida João Paulo II",39,39,0,8,8,0
1,21,2019,8,0,2,"Braga",6,"Avenida Padre Júlio Fragata",61,61,0,21,21,0
1,21,2019,8,0,2,"Braga",7,"Rua Nova Santa Cruz",29,29,0,104,104,0
1,21,2019,8,0,2,"Braga",8,"Rua Costa Gomes",41,41,0,42,42,0
1,21,2019,9,0,2,"Braga",1,"Avenida da Liberdade",20,20,0,14,14,0
1,21,2019,9,0,2,"Braga",2,"Avenida Central",9,12,3,203,152,51
1,21,2019,9,0,2,"Braga",3,"Rua de Caires",24,35,11,56,38,18
1,21,2019,9,0,2,"Braga",4,"N14 Bosch",34,46,12,66,48,18
1,21,2019,9,0,2,"Braga",5,"Avenida João Paulo II",39,39,0,8,8,0
1,21,2019,9,0,2,"Braga",6,"Avenida Padre Júlio Fragata",61,61,0,21,21,0
1,21,2019,9,0,2,"Braga",7,"Rua Nova Santa Cruz",22,28,6,138,108,30
1,21,2019,9,0,2,"Braga",8,"Rua Costa Gomes",27,41,14,63,42,21
1,21,2019,10,0,2,"Braga",1,"Avenida da Liberdade",20,20,0,14,14,0
1,21,2019,10,0,2,"Braga",2,"Avenida Central",7,12,5,261,152,109
1,21,2019,10,0,2,"Braga",3,"Rua de Caires",25,35,10,53,38,15
1,21,2019,10,0,2,"Braga",4,"N14 Bosch",37,47,10,60,47,13
1,21,2019,10,0,2,"Braga",5,"Avenida João Paulo II",38,38,0,9,9,0
1,21,2019,10,0,2,"Braga",6,"Avenida Padre Júlio Fragata",61,61,0,21,21,0
1,21,2019,10,0,2,"Braga",7,"Rua Nova Santa Cruz",19,29,10,160,104,56
1,21,2019,10,0,2,"Braga",8,"Rua Costa Gomes",41,41,0,42,42,0
1,21,2019,11,0,2,"Braga",1,"Avenida da Liberdade",20,20,0,14,14,0
1,21,2019,11,0,2,"Braga",2,"Avenida Central",12,12,0,152,152,0
1,21,2019,11,0,2,"Braga",3,"Rua de Caires",24,35,11,56,38,18
1,21,2019,11,0,2,"Braga",4,"N14 Bosch",34,47,13,66,47,19
1,21,2019,11,0,2,"Braga",5,"Avenida João Paulo II",38,38,0,9,9,0
1,21,2019,11,0,2,"Braga",6,"Avenida Padre Júlio Fragata",62,62,0,20,20,0
1,21,2019,11,0,2,"Braga",7,"Rua Nova Santa Cruz",29,29,0,104,104,0
1,21,2019,11,0,2,"Braga",8,"Rua Costa Gomes",40,40,0,43,43,0
1,21,2019,12,0,2,"Braga",1,"Avenida da Liberdade",20,20,0,14,14,0
1,21,2019,12,0,2,"Braga",2,"Avenida Central",7,12,5,261,152,109
1,21,2019,12,0,2,"Braga",3,"Rua de Caires",26,35,9,51,38,13
1,21,2019,12,0,2,"Braga",4,"N14 Bosch",31,47,16,72,47,25
1,21,2019,12,0,2,"Braga",5,"Avenida João Paulo II",31,39,8,11,8,3
1,21,2019,12,0,2,"Braga",6,"Avenida Padre Júlio Fragata",62,62,0,20,20,0
1,21,2019,12,0,2,"Braga",7,"Rua Nova Santa Cruz",22,29,7,138,104,34
1,21,2019,12,0,2,"Braga",8,"Rua Costa Gomes",41,41,0,42,42,0
1,21,2019,13,0,2,"Braga",1,"Avenida da Liberdade",20,20,0,14,14,0
1,21,2019,13,0,2,"Braga",2,"Avenida Central",10,13,3,183,140,43
1,21,2019,13,0,2,"Braga",3,"Rua de Caires",27,36,9,49,37,12
1,21,2019,13,0,2,"Braga",4,"N14 Bosch",32,46,14,70,48,22
1,21,2019,13,0,2,"Braga",5,"Avenida João Paulo II",38,38,0,9,9,0
1,21,2019,13,0,2,"Braga",6,"Avenida Padre Júlio Fragata",61,61,0,21,21,0
1,21,2019,13,0,2,"Braga",7,"Rua Nova Santa Cruz",22,28,6,138,108,30
1,21,2019,13,0,2,"Braga",8,"Rua Costa Gomes",27,41,14,63,42,21
1,21,2019,14,0,2,"Braga",1,"Avenida da Liberdade",20,20,0,14,14,0
1,21,2019,14,0,2,"Braga",2,"Avenida Central",7,13,6,261,140,121
1,21,2019,14,0,2,"Braga",3,"Rua de Caires",27,35,8,49,38,11
1,21,2019,14,0,2,"Braga",4,"N14 Bosch",22,47,25,102,47,55
1,21,2019,14,0,2,"Braga",5,"Avenida João Paulo II",39,39,0,8,8,0
1,21,2019,14,0,2,"Braga",6,"Avenida Padre Júlio Fragata",44,62,18,29,20,9
1,21,2019,14,0,2,"Braga",7,"Rua Nova Santa Cruz",22,29,7,138,104,34
1,21,2019,14,0,2,"Braga",8,"Rua Costa Gomes",31,41,10,55,42,13
1,21,2019,15,0,2,"Braga",1,"Avenida da Liberdade",6,20,14,47,14,33
1,21,2019,15,0,2,"Braga",2,"Avenida Central",7,14,7,261,130,131
1,21,2019,15,0,2,"Braga",3,"Rua de Caires",20,36,16,67,37,30
1,21,2019,15,0,2,"Braga",4,"N14 Bosch",33,47,14,68,47,21
1,21,2019,15,0,2,"Braga",5,"Avenida João Paulo II",30,38,8,11,9,2
1,21,2019,15,0,2,"Braga",6,"Avenida Padre Júlio Fragata",62,62,0,20,20,0
1,21,2019,15,0,2,"Braga",7,"Rua Nova Santa Cruz",20,28,8,152,108,44
1,21,2019,15,0,2,"Braga",8,"Rua Costa Gomes",29,41,12,59,42,17
1,21,2019,16,0,2,"Braga",1,"Avenida da Liberdade",20,20,0,14,14,0
1,21,2019,16,0,2,"Braga",2,"Avenida Central",6,14,8,305,130,175
1,21,2019,16,0,2,"Braga",3,"Rua de Caires",23,35,12,58,38,20
1,21,2019,16,0,2,"Braga",4,"N14 Bosch",32,46,14,70,48,22
1,21,2019,16,0,2,"Braga",5,"Avenida João Paulo II",26,38,12,13,9,4
1,21,2019,16,0,2,"Braga",6,"Avenida Padre Júlio Fragata",47,62,15,27,20,7
1,21,2019,16,0,2,"Braga",7,"Rua Nova Santa Cruz",19,29,10,160,104,56
1,21,2019,16,0,2,"Braga",8,"Rua Costa Gomes",22,40,18,78,43,35
1,21,2019,17,0,2,"Braga",1,"Avenida da Liberdade",20,20,0,14,14,0
1,21,2019,17,0,2,"Braga",2,"Avenida Central",10,13,3,183,140,43
1,21,2019,17,0,2,"Braga",3,"Rua de Caires",24,36,12,56,37,19
1,21,2019,17,0,2,"Braga",4,"N14 Bosch",24,47,23,93,47,46
1,21,2019,17,0,2,"Braga",5,"Avenida João Paulo II",23,38,15,15,9,6
1,21,2019,17,0,2,"Braga",6,"Avenida Padre Júlio Fragata",61,61,0,21,21,0
1,21,2019,17,0,2,"Braga",7,"Rua Nova Santa Cruz",21,28,7,144,108,36
1,21,2019,17,0,2,"Braga",8,"Rua Costa Gomes",24,41,17,71,42,29
1,21,2019,18,0,2,"Braga",1,"Avenida da Liberdade",19,19,0,14,14,0
1,21,2019,18,0,2,"Braga",2,"Avenida Central",8,13,5,229,140,89
1,21,2019,18,0,2,"Braga",3,"Rua de Caires",27,35,8,49,38,11
1,21,2019,18,0,2,"Braga",4,"N14 Bosch",11,47,36,204,47,157
1,21,2019,18,0,2,"Braga",5,"Avenida João Paulo II",40,40,0,8,8,0
1,21,2019,18,0,2,"Braga",6,"Avenida Padre Júlio Fragata",38,61,23,33,21,12
1,21,2019,18,0,2,"Braga",7,"Rua Nova Santa Cruz",14,28,14,217,108,109
1,21,2019,18,0,2,"Braga",8,"Rua Costa Gomes",19,40,21,90,43,47
1,21,2019,19,0,2,"Braga",1,"Avenida da Liberdade",19,19,0,14,14,0
1,21,2019,19,0,2,"Braga",2,"Avenida Central",4,13,9,458,140,318
1,21,2019,19,0,2,"Braga",3,"Rua de Caires",22,36,14,61,37,24
1,21,2019,19,0,2,"Braga",4,"N14 Bosch",22,46,24,102,48,54
1,21,2019,19,0,2,"Braga",5,"Avenida João Paulo II",21,38,17,16,9,7
1,21,2019,19,0,2,"Braga",6,"Avenida Padre Júlio Fragata",33,61,28,38,21,17
1,21,2019,19,0,2,"Braga",7,"Rua Nova Santa Cruz",22,28,6,138,108,30
1,21,2019,19,0,2,"Braga",8,"Rua Costa Gomes",14,40,26,123,43,80
1,21,2019,20,0,2,"Braga",1,"Avenida da Liberdade",19,19,0,14,14,0
1,21,2019,20,0,2,"Braga",2,"Avenida Central",8,12,4,229,152,77
1,21,2019,20,0,2,"Braga",3,"Rua de Caires",35,35,0,38,38,0
1,21,2019,20,0,2,"Braga",4,"N14 Bosch",36,46,10,62,48,14
1,21,2019,20,0,2,"Braga",5,"Avenida João Paulo II",31,39,8,11,8,3
1,21,2019,20,0,2,"Braga",6,"Avenida Padre Júlio Fragata",62,62,0,20,20,0
1,21,2019,20,0,2,"Braga",7,"Rua Nova Santa Cruz",23,29,6,132,104,28
1,21,2019,20,0,2,"Braga",8,"Rua Costa Gomes",27,40,13,63,43,20
1,21,2019,21,0,2,"Braga",1,"Avenida da Liberdade",19,19,0,14,14,0
1,21,2019,21,0,2,"Braga",2,"Avenida Central",12,12,0,152,152,0
1,21,2019,21,0,2,"Braga",3,"Rua de Caires",35,35,0,38,38,0
1,21,2019,21,0,2,"Braga",4,"N14 Bosch",46,46,0,48,48,0
1,21,2019,21,0,2,"Braga",5,"Avenida João Paulo II",39,39,0,8,8,0
1,21,2019,21,0,2,"Braga",6,"Avenida Padre Júlio Fragata",61,61,0,21,21,0
1,21,2019,21,0,2,"Braga",7,"Rua Nova Santa Cruz",29,29,0,104,104,0
1,21,2019,21,0,2,"Braga",8,"Rua Costa Gomes",41,41,0,42,42,0
1,21,2019,22,0,2,"Braga",1,"Avenida da Liberdade",19,19,0,14,14,0
1,21,2019,22,0,2,"Braga",2,"Avenida Central",12,12,0,152,152,0
1,21,2019,22,0,2,"Braga",3,"Rua de Caires",35,35,0,38,38,0
1,21,2019,22,0,2,"Braga",4,"N14 Bosch",46,46,0,48,48,0
1,21,2019,22,0,2,"Braga",5,"Avenida João Paulo II",39,39,0,8,8,0
1,21,2019,22,0,2,"Braga",6,"Avenida Padre Júlio Fragata",62,62,0,20,20,0
1,21,2019,22,0,2,"Braga",7,"Rua Nova Santa Cruz",29,29,0,104,104,0
1,21,2019,22,0,2,"Braga",8,"Rua Costa Gomes",41,41,0,42,42,0
1,21,2019,23,0,2,"Braga",1,"Avenida da Liberdade",19,19,0,14,14,0
1,21,2019,23,0,2,"Braga",2,"Avenida Central",10,13,3,183,140,43
1,21,2019,23,0,2,"Braga",3,"Rua de Caires",35,35,0,38,38,0
1,21,2019,23,0,2,"Braga",4,"N14 Bosch",46,46,0,48,48,0
1,21,2019,23,0,2,"Braga",5,"Avenida João Paulo II",39,39,0,8,8,0
1,21,2019,23,0,2,"Braga",6,"Avenida Padre Júlio Fragata",62,62,0,20,20,0
1,21,2019,23,0,2,"Braga",7,"Rua Nova Santa Cruz",29,29,0,104,104,0
1,21,2019,23,0,2,"Braga",8,"Rua Costa Gomes",41,41,0,42,42,0
1,22,2019,0,0,3,"Braga",1,"Avenida da Liberdade",19,19,0,14,14,0
1,22,2019,0,0,3,"Braga",2,"Avenida Central",13,13,0,140,140,0
1,22,2019,0,0,3,"Braga",3,"Rua de Caires",35,35,0,38,38,0
1,22,2019,0,0,3,"Braga",4,"N14 Bosch",46,46,0,48,48,0
1,22,2019,0,0,3,"Braga",5,"Avenida João Paulo II",39,39,0,8,8,0
1,22,2019,0,0,3,"Braga",6,"Avenida Padre Júlio Fragata",62,62,0,20,20,0
1,22,2019,0,0,3,"Braga",7,"Rua Nova Santa Cruz",29,29,0,104,104,0
1,22,2019,0,0,3,"Braga",8,"Rua Costa Gomes",41,41,0,42,42,0
1,22,2019,1,0,3,"Braga",1,"Avenida da Liberdade",19,19,0,14,14,0
1,22,2019,1,0,3,"Braga",2,"Avenida Central",13,13,0,140,140,0
1,22,2019,1,0,3,"Braga",3,"Rua de Caires",35,35,0,38,38,0
1,22,2019,1,0,3,"Braga",4,"N14 Bosch",46,46,0,48,48,0
1,22,2019,1,0,3,"Braga",5,"Avenida João Paulo II",39,39,0,8,8,0
1,22,2019,1,0,3,"Braga",6,"Avenida Padre Júlio Fragata",62,62,0,20,20,0
1,22,2019,1,0,3,"Braga",7,"Rua Nova Santa Cruz",29,29,0,104,104,0
1,22,2019,1,0,3,"Braga",8,"Rua Costa Gomes",41,41,0,42,42,0
1,22,2019,2,0,3,"Braga",1,"Avenida da Liberdade",19,19,0,14,14,0
1,22,2019,2,0,3,"Braga",2,"Avenida Central",13,13,0,140,140,0
1,22,2019,2,0,3,"Braga",3,"Rua de Caires",35,35,0,38,38,0
1,22,2019,2,0,3,"Braga",4,"N14 Bosch",46,46,0,48,48,0
1,22,2019,2,0,3,"Braga",5,"Avenida João Paulo II",39,39,0,8,8,0
1,22,2019,2,0,3,"Braga",6,"Avenida Padre Júlio Fragata",62,62,0,20,20,0
1,22,2019,2,0,3,"Braga",7,"Rua Nova Santa Cruz",29,29,0,104,104,0
1,22,2019,2,0,3,"Braga",8,"Rua Costa Gomes",41,41,0,42,42,0
1,22,2019,3,0,3,"Braga",1,"Avenida da Liberdade",19,19,0,14,14,0
1,22,2019,3,0,3,"Braga",2,"Avenida Central",13,13,0,140,140,0
1,22,2019,3,0,3,"Braga",3,"Rua de Caires",35,35,0,38,38,0
1,22,2019,3,0,3,"Braga",4,"N14 Bosch",46,46,0,48,48,0
1,22,2019,3,0,3,"Braga",5,"Avenida João Paulo II",39,39,0,8,8,0
1,22,2019,3,0,3,"Braga",6,"Avenida Padre Júlio Fragata",62,62,0,20,20,0
1,22,2019,3,0,3,"Braga",7,"Rua Nova Santa Cruz",29,29,0,104,104,0
1,22,2019,3,0,3,"Braga",8,"Rua Costa Gomes",41,41,0,42,42,0
1,22,2019,4,0,3,"Braga",1,"Avenida da Liberdade",19,19,0,14,14,0
1,22,2019,4,0,3,"Braga",2,"Avenida Central",13,13,0,140,140,0
1,22,2019,4,0,3,"Braga",3,"Rua de Caires",35,35,0,38,38,0
1,22,2019,4,0,3,"Braga",4,"N14 Bosch",46,46,0,48,48,0
1,22,2019,4,0,3,"Braga",5,"Avenida João Paulo II",39,39,0,8,8,0
1,22,2019,4,0,3,"Braga",6,"Avenida Padre Júlio Fragata",62,62,0,20,20,0
1,22,2019,4,0,3,"Braga",7,"Rua Nova Santa Cruz",29,29,0,104,104,0
1,22,2019,4,0,3,"Braga",8,"Rua Costa Gomes",41,41,0,42,42,0
1,22,2019,5,0,3,"Braga",1,"Avenida da Liberdade",19,19,0,14,14,0
1,22,2019,5,0,3,"Braga",2,"Avenida Central",13,13,0,140,140,0
1,22,2019,5,0,3,"Braga",3,"Rua de Caires",35,35,0,38,38,0
1,22,2019,5,0,3,"Braga",4,"N14 Bosch",46,46,0,48,48,0
1,22,2019,5,0,3,"Braga",5,"Avenida João Paulo II",39,39,0,8,8,0
1,22,2019,5,0,3,"Braga",6,"Avenida Padre Júlio Fragata",62,62,0,20,20,0
1,22,2019,5,0,3,"Braga",7,"Rua Nova Santa Cruz",29,29,0,104,104,0
1,22,2019,5,0,3,"Braga",8,"Rua Costa Gomes",41,41,0,42,42,0
1,22,2019,6,0,3,"Braga",1,"Avenida da Liberdade",19,19,0,14,14,0
1,22,2019,6,0,3,"Braga",2,"Avenida Central",13,13,0,140,140,0
1,22,2019,6,0,3,"Braga",3,"Rua de Caires",35,35,0,38,38,0
1,22,2019,6,0,3,"Braga",4,"N14 Bosch",46,46,0,48,48,0
1,22,2019,6,0,3,"Braga",5,"Avenida João Paulo II",39,39,0,8,8,0
1,22,2019,6,0,3,"Braga",6,"Avenida Padre Júlio Fragata",62,62,0,20,20,0
1,22,2019,6,0,3,"Braga",7,"Rua Nova Santa Cruz",29,29,0,104,104,0
1,22,2019,6,0,3,"Braga",8,"Rua Costa Gomes",41,41,0,42,42,0
1,22,2019,7,0,3,"Braga",1,"Avenida da Liberdade",19,19,0,14,14,0
1,22,2019,7,0,3,"Braga",2,"Avenida Central",13,13,0,140,140,0
1,22,2019,7,0,3,"Braga",3,"Rua de Caires",35,35,0,38,38,0
1,22,2019,7,0,3,"Braga",4,"N14 Bosch",46,46,0,48,48,0
1,22,2019,7,0,3,"Braga",5,"Avenida João Paulo II",39,39,0,8,8,0
1,22,2019,7,0,3,"Braga",6,"Avenida Padre Júlio Fragata",62,62,0,20,20,0
1,22,2019,7,0,3,"Braga",7,"Rua Nova Santa Cruz",29,29,0,104,104,0
1,22,2019,7,0,3,"Braga",8,"Rua Costa Gomes",41,41,0,42,42,0
1,22,2019,8,0,3,"Braga",1,"Avenida da Liberdade",19,19,0,14,14,0
1,22,2019,8,0,3,"Braga",2,"Avenida Central",10,13,3,183,140,43
1,22,2019,8,0,3,"Braga",3,"Rua de Caires",26,35,9,51,38,13
1,22,2019,8,0,3,"Braga",4,"N14 Bosch",33,47,14,68,47,21
1,22,2019,8,0,3,"Braga",5,"Avenida João Paulo II",39,39,0,8,8,0
1,22,2019,8,0,3,"Braga",6,"Avenida Padre Júlio Fragata",62,62,0,20,20,0
1,22,2019,8,0,3,"Braga",7,"Rua Nova Santa Cruz",23,29,6,132,104,28
1,22,2019,8,0,3,"Braga",8,"Rua Costa Gomes",41,41,0,42,42,0
1,22,2019,9,0,3,"Braga",8,"Rua Costa Gomes",27,41,14,63,42,21
1,22,2019,9,0,3,"Braga",1,"Avenida da Liberdade",19,19,0,14,14,0
1,22,2019,9,0,3,"Braga",2,"Avenida Central",6,13,7,305,140,165
1,22,2019,9,0,3,"Braga",3,"Rua de Caires",24,35,11,56,38,18
1,22,2019,9,0,3,"Braga",4,"N14 Bosch",23,47,24,97,47,50
1,22,2019,9,0,3,"Braga",5,"Avenida João Paulo II",40,40,0,8,8,0
1,22,2019,9,0,3,"Braga",6,"Avenida Padre Júlio Fragata",61,61,0,21,21,0
1,22,2019,9,0,3,"Braga",7,"Rua Nova Santa Cruz",23,29,6,132,104,28
1,22,2019,9,0,3,"Braga",8,"Rua Costa Gomes",27,41,14,63,42,21
1,22,2019,10,0,3,"Braga",1,"Avenida da Liberdade",19,19,0,14,14,0
1,22,2019,10,0,3,"Braga",2,"Avenida Central",9,13,4,203,140,63
1,22,2019,10,0,3,"Braga",3,"Rua de Caires",26,36,10,51,37,14
1,22,2019,10,0,3,"Braga",4,"N14 Bosch",29,46,17,77,48,29
1,22,2019,10,0,3,"Braga",5,"Avenida João Paulo II",40,40,0,8,8,0
1,22,2019,10,0,3,"Braga",6,"Avenida Padre Júlio Fragata",61,61,0,21,21,0
1,22,2019,10,0,3,"Braga",7,"Rua Nova Santa Cruz",13,29,16,234,104,130
1,22,2019,10,0,3,"Braga",8,"Rua Costa Gomes",41,41,0,42,42,0
1,22,2019,11,0,3,"Braga",7,"Rua Nova Santa Cruz",23,29,6,132,104,28
1,22,2019,11,0,3,"Braga",8,"Rua Costa Gomes",41,41,0,42,42,0
1,22,2019,11,0,3,"Braga",1,"Avenida da Liberdade",19,19,0,14,14,0
1,22,2019,11,0,3,"Braga",2,"Avenida Central",6,13,7,305,140,165
1,22,2019,11,0,3,"Braga",3,"Rua de Caires",24,35,11,56,38,18
1,22,2019,11,0,3,"Braga",4,"N14 Bosch",32,47,15,70,47,23
1,22,2019,11,0,3,"Braga",5,"Avenida João Paulo II",31,38,7,11,9,2
1,22,2019,11,0,3,"Braga",6,"Avenida Padre Júlio Fragata",62,62,0,20,20,0
1,22,2019,11,0,3,"Braga",7,"Rua Nova Santa Cruz",23,29,6,132,104,28
1,22,2019,12,0,3,"Braga",1,"Avenida da Liberdade",19,19,0,14,14,0
1,22,2019,12,0,3,"Braga",2,"Avenida Central",7,12,5,261,152,109
1,22,2019,12,0,3,"Braga",3,"Rua de Caires",28,36,8,48,37,11
1,22,2019,12,0,3,"Braga",4,"N14 Bosch",13,47,34,172,47,125
1,22,2019,12,0,3,"Braga",5,"Avenida João Paulo II",30,39,9,11,8,3
1,22,2019,12,0,3,"Braga",6,"Avenida Padre Júlio Fragata",62,62,0,20,20,0
1,22,2019,12,0,3,"Braga",7,"Rua Nova Santa Cruz",22,28,6,138,108,30
1,22,2019,12,0,3,"Braga",8,"Rua Costa Gomes",41,41,0,42,42,0
1,22,2019,13,0,3,"Braga",1,"Avenida da Liberdade",19,19,0,14,14,0
1,22,2019,13,0,3,"Braga",2,"Avenida Central",9,13,4,203,140,63
1,22,2019,13,0,3,"Braga",3,"Rua de Caires",29,36,7,46,37,9
1,22,2019,13,0,3,"Braga",4,"N14 Bosch",20,47,27,112,47,65
1,22,2019,13,0,3,"Braga",5,"Avenida João Paulo II",39,39,0,8,8,0
1,22,2019,13,0,3,"Braga",6,"Avenida Padre Júlio Fragata",61,61,0,21,21,0
1,22,2019,13,0,3,"Braga",7,"Rua Nova Santa Cruz",22,29,7,138,104,34
1,22,2019,13,0,3,"Braga",8,"Rua Costa Gomes",29,41,12,59,42,17
1,22,2019,14,0,3,"Braga",1,"Avenida da Liberdade",19,19,0,14,14,0
1,22,2019,14,0,3,"Braga",2,"Avenida Central",13,13,0,140,140,0
1,22,2019,14,0,3,"Braga",3,"Rua de Caires",24,36,12,56,37,19
1,22,2019,14,0,3,"Braga",4,"N14 Bosch",18,48,30,124,46,78
1,22,2019,14,0,3,"Braga",5,"Avenida João Paulo II",39,39,0,8,8,0
1,22,2019,14,0,3,"Braga",6,"Avenida Padre Júlio Fragata",44,62,18,29,20,9
1,22,2019,14,0,3,"Braga",7,"Rua Nova Santa Cruz",23,28,5,132,108,24
1,22,2019,14,0,3,"Braga",8,"Rua Costa Gomes",28,41,13,61,42,19
1,22,2019,15,0,3,"Braga",1,"Avenida da Liberdade",19,19,0,14,14,0
1,22,2019,15,0,3,"Braga",2,"Avenida Central",8,13,5,229,140,89
1,22,2019,15,0,3,"Braga",3,"Rua de Caires",24,35,11,56,38,18
1,22,2019,15,0,3,"Braga",4,"N14 Bosch",29,47,18,77,47,30
1,22,2019,15,0,3,"Braga",5,"Avenida João Paulo II",39,39,0,8,8,0
1,22,2019,15,0,3,"Braga",6,"Avenida Padre Júlio Fragata",62,62,0,20,20,0
1,22,2019,15,0,3,"Braga",7,"Rua Nova Santa Cruz",21,28,7,144,108,36
1,22,2019,15,0,3,"Braga",8,"Rua Costa Gomes",29,41,12,59,42,17
1,22,2019,16,0,3,"Braga",1,"Avenida da Liberdade",19,19,0,14,14,0
1,22,2019,16,0,3,"Braga",2,"Avenida Central",5,14,9,366,130,236
1,22,2019,16,0,3,"Braga",3,"Rua de Caires",6,37,31,224,36,188
1,22,2019,16,0,3,"Braga",4,"N14 Bosch",37,46,9,60,48,12
1,22,2019,16,0,3,"Braga",5,"Avenida João Paulo II",25,39,14,13,8,5
1,22,2019,16,0,3,"Braga",6,"Avenida Padre Júlio Fragata",61,61,0,21,21,0
1,22,2019,16,0,3,"Braga",7,"Rua Nova Santa Cruz",16,29,13,190,104,86
1,22,2019,16,0,3,"Braga",8,"Rua Costa Gomes",28,41,13,61,42,19
1,22,2019,17,0,3,"Braga",1,"Avenida da Liberdade",20,20,0,14,14,0
1,22,2019,17,0,3,"Braga",2,"Avenida Central",9,13,4,203,140,63
1,22,2019,17,0,3,"Braga",3,"Rua de Caires",27,36,9,49,37,12
1,22,2019,17,0,3,"Braga",4,"N14 Bosch",24,47,23,93,47,46
1,22,2019,17,0,3,"Braga",5,"Avenida João Paulo II",23,39,16,15,8,7
1,22,2019,17,0,3,"Braga",6,"Avenida Padre Júlio Fragata",37,62,25,34,20,14
1,22,2019,17,0,3,"Braga",7,"Rua Nova Santa Cruz",17,29,12,179,104,75
1,22,2019,17,0,3,"Braga",8,"Rua Costa Gomes",23,40,17,75,43,32
1,22,2019,18,0,3,"Braga",1,"Avenida da Liberdade",20,20,0,14,14,0
1,22,2019,18,0,3,"Braga",2,"Avenida Central",5,14,9,366,130,236
1,22,2019,18,0,3,"Braga",3,"Rua de Caires",22,36,14,61,37,24
1,22,2019,18,0,3,"Braga",4,"N14 Bosch",17,46,29,132,48,84
1,22,2019,18,0,3,"Braga",5,"Avenida João Paulo II",6,37,31,58,9,49
1,22,2019,18,0,3,"Braga",6,"Avenida Padre Júlio Fragata",16,63,47,80,20,60
1,22,2019,18,0,3,"Braga",7,"Rua Nova Santa Cruz",13,29,16,234,104,130
1,22,2019,18,0,3,"Braga",8,"Rua Costa Gomes",12,40,28,143,43,100
1,22,2019,19,0,3,"Braga",1,"Avenida da Liberdade",13,19,6,21,14,7
1,22,2019,19,0,3,"Braga",2,"Avenida Central",4,14,10,458,130,328
1,22,2019,19,0,3,"Braga",3,"Rua de Caires",23,36,13,58,37,21
1,22,2019,19,0,3,"Braga",4,"N14 Bosch",19,47,28,118,47,71
1,22,2019,19,0,3,"Braga",5,"Avenida João Paulo II",5,41,36,69,8,61
1,22,2019,19,0,3,"Braga",6,"Avenida Padre Júlio Fragata",13,61,48,98,21,77
1,22,2019,19,0,3,"Braga",7,"Rua Nova Santa Cruz",21,29,8,144,104,40
1,22,2019,19,0,3,"Braga",8,"Rua Costa Gomes",4,44,40,431,39,392
1,22,2019,20,0,3,"Braga",1,"Avenida da Liberdade",19,19,0,14,14,0
1,22,2019,20,0,3,"Braga",2,"Avenida Central",5,12,7,366,152,214
1,22,2019,20,0,3,"Braga",3,"Rua de Caires",36,36,0,37,37,0
1,22,2019,20,0,3,"Braga",4,"N14 Bosch",47,47,0,47,47,0
1,22,2019,20,0,3,"Braga",5,"Avenida João Paulo II",27,38,11,12,9,3
1,22,2019,20,0,3,"Braga",6,"Avenida Padre Júlio Fragata",61,61,0,21,21,0
1,22,2019,20,0,3,"Braga",7,"Rua Nova Santa Cruz",22,29,7,138,104,34
1,22,2019,20,0,3,"Braga",8,"Rua Costa Gomes",12,40,28,143,43,100
1,22,2019,21,0,3,"Braga",1,"Avenida da Liberdade",19,19,0,14,14,0
1,22,2019,21,0,3,"Braga",2,"Avenida Central",13,13,0,140,140,0
1,22,2019,21,0,3,"Braga",3,"Rua de Caires",36,36,0,37,37,0
1,22,2019,21,0,3,"Braga",4,"N14 Bosch",47,47,0,47,47,0
1,22,2019,21,0,3,"Braga",5,"Avenida João Paulo II",38,38,0,9,9,0
1,22,2019,21,0,3,"Braga",6,"Avenida Padre Júlio Fragata",61,61,0,21,21,0
1,22,2019,21,0,3,"Braga",7,"Rua Nova Santa Cruz",28,28,0,108,108,0
1,22,2019,21,0,3,"Braga",8,"Rua Costa Gomes",40,40,0,43,43,0
1,22,2019,22,0,3,"Braga",1,"Avenida da Liberdade",19,19,0,14,14,0
1,22,2019,22,0,3,"Braga",2,"Avenida Central",10,13,3,183,140,43
1,22,2019,22,0,3,"Braga",3,"Rua de Caires",36,36,0,37,37,0
1,22,2019,22,0,3,"Braga",4,"N14 Bosch",47,47,0,47,47,0
1,22,2019,22,0,3,"Braga",5,"Avenida João Paulo II",38,38,0,9,9,0
1,22,2019,22,0,3,"Braga",6,"Avenida Padre Júlio Fragata",35,62,27,36,20,16
1,22,2019,22,0,3,"Braga",7,"Rua Nova Santa Cruz",28,28,0,108,108,0
1,22,2019,22,0,3,"Braga",8,"Rua Costa Gomes",40,40,0,43,43,0
1,22,2019,23,0,3,"Braga",2,"Avenida Central",13,13,0,140,140,0
1,22,2019,23,0,3,"Braga",3,"Rua de Caires",36,36,0,37,37,0
1,22,2019,23,0,3,"Braga",4,"N14 Bosch",47,47,0,47,47,0
1,22,2019,23,0,3,"Braga",5,"Avenida João Paulo II",38,38,0,9,9,0
1,22,2019,23,0,3,"Braga",6,"Avenida Padre Júlio Fragata",61,61,0,21,21,0
1,22,2019,23,0,3,"Braga",7,"Rua Nova Santa Cruz",28,28,0,108,108,0
1,22,2019,23,0,3,"Braga",8,"Rua Costa Gomes",40,40,0,43,43,0
1,22,2019,23,0,3,"Braga",1,"Avenida da Liberdade",19,19,0,14,14,0
1,22,2019,23,0,3,"Braga",2,"Avenida Central",13,13,0,140,140,0
1,23,2019,0,0,4,"Braga",1,"Avenida da Liberdade",12,19,7,23,14,9
1,23,2019,0,0,4,"Braga",2,"Avenida Central",12,12,0,152,152,0
1,23,2019,0,0,4,"Braga",3,"Rua de Caires",36,36,0,37,37,0
1,23,2019,0,0,4,"Braga",4,"N14 Bosch",46,46,0,48,48,0
1,23,2019,0,0,4,"Braga",5,"Avenida João Paulo II",38,38,0,9,9,0
1,23,2019,0,0,4,"Braga",6,"Avenida Padre Júlio Fragata",61,61,0,21,21,0
1,23,2019,0,0,4,"Braga",7,"Rua Nova Santa Cruz",17,28,11,179,108,71
1,23,2019,0,0,4,"Braga",8,"Rua Costa Gomes",33,41,8,52,42,10
1,23,2019,1,0,4,"Braga",1,"Avenida da Liberdade",20,20,0,14,14,0
1,23,2019,1,0,4,"Braga",2,"Avenida Central",12,12,0,152,152,0
1,23,2019,1,0,4,"Braga",3,"Rua de Caires",36,36,0,37,37,0
1,23,2019,1,0,4,"Braga",4,"N14 Bosch",46,46,0,48,48,0
1,23,2019,1,0,4,"Braga",5,"Avenida João Paulo II",38,38,0,9,9,0
1,23,2019,1,0,4,"Braga",6,"Avenida Padre Júlio Fragata",61,61,0,21,21,0
1,23,2019,1,0,4,"Braga",7,"Rua Nova Santa Cruz",28,28,0,108,108,0
1,23,2019,1,0,4,"Braga",8,"Rua Costa Gomes",40,40,0,43,43,0
1,23,2019,2,0,4,"Braga",1,"Avenida da Liberdade",20,20,0,14,14,0
1,23,2019,2,0,4,"Braga",2,"Avenida Central",13,13,0,140,140,0
1,23,2019,2,0,4,"Braga",3,"Rua de Caires",36,36,0,37,37,0
1,23,2019,2,0,4,"Braga",4,"N14 Bosch",46,46,0,48,48,0
1,23,2019,2,0,4,"Braga",5,"Avenida João Paulo II",38,38,0,9,9,0
1,23,2019,2,0,4,"Braga",6,"Avenida Padre Júlio Fragata",61,61,0,21,21,0
1,23,2019,2,0,4,"Braga",7,"Rua Nova Santa Cruz",28,28,0,108,108,0
1,23,2019,2,0,4,"Braga",8,"Rua Costa Gomes",41,41,0,42,42,0
1,23,2019,3,0,4,"Braga",1,"Avenida da Liberdade",20,20,0,14,14,0
1,23,2019,3,0,4,"Braga",2,"Avenida Central",13,13,0,140,140,0
1,23,2019,3,0,4,"Braga",3,"Rua de Caires",36,36,0,37,37,0
1,23,2019,3,0,4,"Braga",4,"N14 Bosch",46,46,0,48,48,0
1,23,2019,3,0,4,"Braga",5,"Avenida João Paulo II",38,38,0,9,9,0
1,23,2019,3,0,4,"Braga",6,"Avenida Padre Júlio Fragata",61,61,0,21,21,0
1,23,2019,3,0,4,"Braga",7,"Rua Nova Santa Cruz",28,28,0,108,108,0
1,23,2019,3,0,4,"Braga",8,"Rua Costa Gomes",41,41,0,42,42,0
1,23,2019,4,0,4,"Braga",1,"Avenida da Liberdade",20,20,0,14,14,0
1,23,2019,4,0,4,"Braga",2,"Avenida Central",13,13,0,140,140,0
1,23,2019,4,0,4,"Braga",3,"Rua de Caires",36,36,0,37,37,0
1,23,2019,4,0,4,"Braga",4,"N14 Bosch",46,46,0,48,48,0
1,23,2019,4,0,4,"Braga",5,"Avenida João Paulo II",38,38,0,9,9,0
1,23,2019,4,0,4,"Braga",6,"Avenida Padre Júlio Fragata",61,61,0,21,21,0
1,23,2019,4,0,4,"Braga",7,"Rua Nova Santa Cruz",28,28,0,108,108,0
1,23,2019,4,0,4,"Braga",8,"Rua Costa Gomes",41,41,0,42,42,0
1,23,2019,5,0,4,"Braga",1,"Avenida da Liberdade",20,20,0,14,14,0
1,23,2019,5,0,4,"Braga",2,"Avenida Central",13,13,0,140,140,0
1,23,2019,5,0,4,"Braga",3,"Rua de Caires",36,36,0,37,37,0
1,23,2019,5,0,4,"Braga",4,"N14 Bosch",46,46,0,48,48,0
1,23,2019,5,0,4,"Braga",5,"Avenida João Paulo II",38,38,0,9,9,0
1,23,2019,5,0,4,"Braga",6,"Avenida Padre Júlio Fragata",61,61,0,21,21,0
1,23,2019,5,0,4,"Braga",7,"Rua Nova Santa Cruz",28,28,0,108,108,0
1,23,2019,5,0,4,"Braga",8,"Rua Costa Gomes",41,41,0,42,42,0
1,23,2019,6,0,4,"Braga",1,"Avenida da Liberdade",20,20,0,14,14,0
1,23,2019,6,0,4,"Braga",2,"Avenida Central",13,13,0,140,140,0
1,23,2019,6,0,4,"Braga",3,"Rua de Caires",36,36,0,37,37,0
1,23,2019,6,0,4,"Braga",4,"N14 Bosch",46,46,0,48,48,0
1,23,2019,6,0,4,"Braga",5,"Avenida João Paulo II",38,38,0,9,9,0
1,23,2019,6,0,4,"Braga",6,"Avenida Padre Júlio Fragata",61,61,0,21,21,0
1,23,2019,6,0,4,"Braga",7,"Rua Nova Santa Cruz",28,28,0,108,108,0
1,23,2019,6,0,4,"Braga",8,"Rua Costa Gomes",41,41,0,42,42,0
1,23,2019,8,0,4,"Braga",1,"Avenida da Liberdade",20,20,0,14,14,0
1,23,2019,8,0,4,"Braga",2,"Avenida Central",13,13,0,140,140,0
1,23,2019,8,0,4,"Braga",3,"Rua de Caires",24,36,12,56,37,19
1,23,2019,8,0,4,"Braga",4,"N14 Bosch",36,47,11,62,47,15
1,23,2019,8,0,4,"Braga",5,"Avenida João Paulo II",38,38,0,9,9,0
1,23,2019,8,0,4,"Braga",6,"Avenida Padre Júlio Fragata",61,61,0,21,21,0
1,23,2019,8,0,4,"Braga",7,"Rua Nova Santa Cruz",28,28,0,108,108,0
1,23,2019,8,0,4,"Braga",8,"Rua Costa Gomes",31,40,9,55,43,12
1,23,2019,9,0,4,"Braga",1,"Avenida da Liberdade",20,20,0,14,14,0
1,23,2019,9,0,4,"Braga",2,"Avenida Central",7,14,7,261,130,131
1,23,2019,9,0,4,"Braga",3,"Rua de Caires",25,36,11,53,37,16
1,23,2019,9,0,4,"Braga",4,"N14 Bosch",27,47,20,83,47,36
1,23,2019,9,0,4,"Braga",5,"Avenida João Paulo II",38,38,0,9,9,0
1,23,2019,9,0,4,"Braga",6,"Avenida Padre Júlio Fragata",36,61,25,35,21,14
1,23,2019,9,0,4,"Braga",7,"Rua Nova Santa Cruz",29,29,0,104,104,0
1,23,2019,9,0,4,"Braga",8,"Rua Costa Gomes",28,40,12,61,43,18
1,23,2019,10,0,4,"Braga",1,"Avenida da Liberdade",20,20,0,14,14,0
1,23,2019,10,0,4,"Braga",2,"Avenida Central",9,13,4,203,140,63
1,23,2019,10,0,4,"Braga",3,"Rua de Caires",25,36,11,53,37,16
1,23,2019,10,0,4,"Braga",4,"N14 Bosch",32,46,14,70,48,22
1,23,2019,10,0,4,"Braga",5,"Avenida João Paulo II",38,38,0,9,9,0
1,23,2019,10,0,4,"Braga",6,"Avenida Padre Júlio Fragata",62,62,0,20,20,0
1,23,2019,10,0,4,"Braga",7,"Rua Nova Santa Cruz",29,29,0,104,104,0
1,23,2019,10,0,4,"Braga",8,"Rua Costa Gomes",41,41,0,42,42,0
1,23,2019,11,0,4,"Braga",1,"Avenida da Liberdade",20,20,0,14,14,0
1,23,2019,11,0,4,"Braga",2,"Avenida Central",8,13,5,229,140,89
1,23,2019,11,0,4,"Braga",3,"Rua de Caires",23,35,12,58,38,20
1,23,2019,11,0,4,"Braga",4,"N14 Bosch",32,46,14,70,48,22
1,23,2019,11,0,4,"Braga",5,"Avenida João Paulo II",38,38,0,9,9,0
1,23,2019,11,0,4,"Braga",6,"Avenida Padre Júlio Fragata",62,62,0,20,20,0
1,23,2019,11,0,4,"Braga",7,"Rua Nova Santa Cruz",29,29,0,104,104,0
1,23,2019,11,0,4,"Braga",8,"Rua Costa Gomes",29,40,11,59,43,16
1,23,2019,12,0,4,"Braga",1,"Avenida da Liberdade",20,20,0,14,14,0
1,23,2019,12,0,4,"Braga",2,"Avenida Central",7,13,6,261,140,121
1,23,2019,12,0,4,"Braga",3,"Rua de Caires",24,36,12,56,37,19
1,23,2019,12,0,4,"Braga",4,"N14 Bosch",29,47,18,77,47,30
1,23,2019,12,0,4,"Braga",5,"Avenida João Paulo II",39,39,0,8,8,0
1,23,2019,12,0,4,"Braga",6,"Avenida Padre Júlio Fragata",62,62,0,20,20,0
1,23,2019,12,0,4,"Braga",7,"Rua Nova Santa Cruz",29,29,0,104,104,0
1,23,2019,12,0,4,"Braga",8,"Rua Costa Gomes",31,41,10,55,42,13
1,23,2019,13,0,4,"Braga",1,"Avenida da Liberdade",20,20,0,14,14,0
1,23,2019,13,0,4,"Braga",2,"Avenida Central",9,13,4,203,140,63
1,23,2019,13,0,4,"Braga",3,"Rua de Caires",28,35,7,48,38,10
1,23,2019,13,0,4,"Braga",4,"N14 Bosch",30,46,16,74,48,26
1,23,2019,13,0,4,"Braga",5,"Avenida João Paulo II",38,38,0,9,9,0
1,23,2019,13,0,4,"Braga",6,"Avenida Padre Júlio Fragata",61,61,0,21,21,0
1,23,2019,13,0,4,"Braga",7,"Rua Nova Santa Cruz",29,29,0,104,104,0
1,23,2019,13,0,4,"Braga",8,"Rua Costa Gomes",28,40,12,61,43,18
1,23,2019,14,0,4,"Braga",1,"Avenida da Liberdade",20,20,0,14,14,0
1,23,2019,14,0,4,"Braga",2,"Avenida Central",10,13,3,183,140,43
1,23,2019,14,0,4,"Braga",3,"Rua de Caires",29,36,7,46,37,9
1,23,2019,14,0,4,"Braga",4,"N14 Bosch",27,46,19,83,48,35
1,23,2019,14,0,4,"Braga",5,"Avenida João Paulo II",30,38,8,11,9,2
1,23,2019,14,0,4,"Braga",6,"Avenida Padre Júlio Fragata",62,62,0,20,20,0
1,23,2019,14,0,4,"Braga",7,"Rua Nova Santa Cruz",22,29,7,138,104,34
1,23,2019,14,0,4,"Braga",8,"Rua Costa Gomes",26,40,14,66,43,23
1,23,2019,15,0,4,"Braga",1,"Avenida da Liberdade",20,20,0,14,14,0
1,23,2019,15,0,4,"Braga",2,"Avenida Central",7,13,6,261,140,121
1,23,2019,15,0,4,"Braga",3,"Rua de Caires",24,36,12,56,37,19
1,23,2019,15,0,4,"Braga",4,"N14 Bosch",30,46,16,74,48,26
1,23,2019,15,0,4,"Braga",5,"Avenida João Paulo II",30,39,9,11,8,3
1,23,2019,15,0,4,"Braga",6,"Avenida Padre Júlio Fragata",36,61,25,35,21,14
1,23,2019,15,0,4,"Braga",7,"Rua Nova Santa Cruz",23,28,5,132,108,24
1,23,2019,15,0,4,"Braga",8,"Rua Costa Gomes",32,41,9,53,42,11
1,23,2019,16,0,4,"Braga",1,"Avenida da Liberdade",21,21,0,13,13,0
1,23,2019,16,0,4,"Braga",2,"Avenida Central",9,12,3,203,152,51
1,23,2019,16,0,4,"Braga",3,"Rua de Caires",27,36,9,49,37,12
1,23,2019,16,0,4,"Braga",4,"N14 Bosch",32,46,14,70,48,22
1,23,2019,16,0,4,"Braga",5,"Avenida João Paulo II",27,39,12,12,8,4
1,23,2019,16,0,4,"Braga",6,"Avenida Padre Júlio Fragata",42,62,20,30,20,10
1,23,2019,16,0,4,"Braga",7,"Rua Nova Santa Cruz",20,29,9,152,104,48
1,23,2019,16,0,4,"Braga",8,"Rua Costa Gomes",29,41,12,59,42,17
1,23,2019,17,0,4,"Braga",1,"Avenida da Liberdade",21,21,0,13,13,0
1,23,2019,17,0,4,"Braga",2,"Avenida Central",8,13,5,229,140,89
1,23,2019,17,0,4,"Braga",3,"Rua de Caires",27,36,9,49,37,12
1,23,2019,17,0,4,"Braga",4,"N14 Bosch",28,47,19,80,47,33
1,23,2019,17,0,4,"Braga",5,"Avenida João Paulo II",23,39,16,15,8,7
1,23,2019,17,0,4,"Braga",6,"Avenida Padre Júlio Fragata",40,61,21,32,21,11
1,23,2019,17,0,4,"Braga",7,"Rua Nova Santa Cruz",19,28,9,160,108,52
1,23,2019,17,0,4,"Braga",8,"Rua Costa Gomes",22,41,19,78,42,36
1,23,2019,18,0,4,"Braga",1,"Avenida da Liberdade",13,19,6,21,14,7
1,23,2019,18,0,4,"Braga",2,"Avenida Central",3,11,8,610,166,444
1,23,2019,18,0,4,"Braga",3,"Rua de Caires",20,35,15,67,38,29
1,23,2019,18,0,4,"Braga",4,"N14 Bosch",19,46,27,118,48,70
1,23,2019,18,0,4,"Braga",5,"Avenida João Paulo II",40,40,0,8,8,0
1,23,2019,18,0,4,"Braga",6,"Avenida Padre Júlio Fragata",43,62,19,29,20,9
1,23,2019,18,0,4,"Braga",7,"Rua Nova Santa Cruz",17,29,12,179,104,75
1,23,2019,18,0,4,"Braga",8,"Rua Costa Gomes",5,41,36,345,42,303
1,23,2019,19,0,4,"Braga",1,"Avenida da Liberdade",14,19,5,20,14,6
1,23,2019,19,0,4,"Braga",2,"Avenida Central",3,12,9,610,152,458
1,23,2019,19,0,4,"Braga",3,"Rua de Caires",12,35,23,112,38,74
1,23,2019,19,0,4,"Braga",4,"N14 Bosch",15,45,30,149,49,100
1,23,2019,19,0,4,"Braga",5,"Avenida João Paulo II",22,39,17,15,8,7
1,23,2019,19,0,4,"Braga",6,"Avenida Padre Júlio Fragata",37,61,24,34,21,13
1,23,2019,19,0,4,"Braga",7,"Rua Nova Santa Cruz",19,29,10,160,104,56
1,23,2019,19,0,4,"Braga",8,"Rua Costa Gomes",4,44,40,431,39,392
1,23,2019,20,0,4,"Braga",1,"Avenida da Liberdade",19,19,0,14,14,0
1,23,2019,20,0,4,"Braga",2,"Avenida Central",9,12,3,203,152,51
1,23,2019,20,0,4,"Braga",3,"Rua de Caires",35,35,0,38,38,0
1,23,2019,20,0,4,"Braga",4,"N14 Bosch",35,46,11,64,48,16
1,23,2019,20,0,4,"Braga",5,"Avenida João Paulo II",30,39,9,11,8,3
1,23,2019,20,0,4,"Braga",6,"Avenida Padre Júlio Fragata",61,61,0,21,21,0
1,23,2019,20,0,4,"Braga",7,"Rua Nova Santa Cruz",22,28,6,138,108,30
1,23,2019,20,0,4,"Braga",8,"Rua Costa Gomes",11,42,31,156,41,115
1,23,2019,21,0,4,"Braga",1,"Avenida da Liberdade",19,19,0,14,14,0
1,23,2019,21,0,4,"Braga",2,"Avenida Central",13,13,0,140,140,0
1,23,2019,21,0,4,"Braga",3,"Rua de Caires",35,35,0,38,38,0
1,23,2019,21,0,4,"Braga",4,"N14 Bosch",47,47,0,47,47,0
1,23,2019,21,0,4,"Braga",5,"Avenida João Paulo II",39,39,0,8,8,0
1,23,2019,21,0,4,"Braga",6,"Avenida Padre Júlio Fragata",38,62,24,33,20,13
1,23,2019,21,0,4,"Braga",7,"Rua Nova Santa Cruz",29,29,0,104,104,0
1,23,2019,21,0,4,"Braga",8,"Rua Costa Gomes",41,41,0,42,42,0
1,23,2019,22,0,4,"Braga",1,"Avenida da Liberdade",19,19,0,14,14,0
1,23,2019,22,0,4,"Braga",2,"Avenida Central",13,13,0,140,140,0
1,23,2019,22,0,4,"Braga",3,"Rua de Caires",35,35,0,38,38,0
1,23,2019,22,0,4,"Braga",4,"N14 Bosch",47,47,0,47,47,0
1,23,2019,22,0,4,"Braga",5,"Avenida João Paulo II",39,39,0,8,8,0
1,23,2019,22,0,4,"Braga",6,"Avenida Padre Júlio Fragata",44,61,17,29,21,8
1,23,2019,22,0,4,"Braga",7,"Rua Nova Santa Cruz",29,29,0,104,104,0
1,23,2019,22,0,4,"Braga",8,"Rua Costa Gomes",41,41,0,42,42,0
1,23,2019,23,0,4,"Braga",1,"Avenida da Liberdade",19,19,0,14,14,0
1,23,2019,23,0,4,"Braga",2,"Avenida Central",12,12,0,152,152,0
1,23,2019,23,0,4,"Braga",3,"Rua de Caires",36,36,0,37,37,0
1,23,2019,23,0,4,"Braga",4,"N14 Bosch",47,47,0,47,47,0
1,23,2019,23,0,4,"Braga",5,"Avenida João Paulo II",39,39,0,8,8,0
1,23,2019,23,0,4,"Braga",6,"Avenida Padre Júlio Fragata",62,62,0,20,20,0
1,23,2019,23,0,4,"Braga",7,"Rua Nova Santa Cruz",29,29,0,104,104,0
1,23,2019,23,0,4,"Braga",8,"Rua Costa Gomes",41,41,0,42,42,0
1,24,2019,0,0,5,"Braga",1,"Avenida da Liberdade",19,19,0,14,14,0
1,24,2019,0,0,5,"Braga",2,"Avenida Central",12,12,0,152,152,0
1,24,2019,0,0,5,"Braga",3,"Rua de Caires",36,36,0,37,37,0
1,24,2019,0,0,5,"Braga",4,"N14 Bosch",47,47,0,47,47,0
1,24,2019,0,0,5,"Braga",5,"Avenida João Paulo II",39,39,0,8,8,0
1,24,2019,0,0,5,"Braga",6,"Avenida Padre Júlio Fragata",62,62,0,20,20,0
1,24,2019,0,0,5,"Braga",7,"Rua Nova Santa Cruz",29,29,0,104,104,0
1,24,2019,0,0,5,"Braga",8,"Rua Costa Gomes",41,41,0,42,42,0
1,24,2019,1,0,5,"Braga",1,"Avenida da Liberdade",19,19,0,14,14,0
1,24,2019,1,0,5,"Braga",2,"Avenida Central",12,12,0,152,152,0
1,24,2019,1,0,5,"Braga",3,"Rua de Caires",36,36,0,37,37,0
1,24,2019,1,0,5,"Braga",4,"N14 Bosch",47,47,0,47,47,0
1,24,2019,1,0,5,"Braga",5,"Avenida João Paulo II",39,39,0,8,8,0
1,24,2019,1,0,5,"Braga",6,"Avenida Padre Júlio Fragata",62,62,0,20,20,0
1,24,2019,1,0,5,"Braga",7,"Rua Nova Santa Cruz",29,29,0,104,104,0
1,24,2019,1,0,5,"Braga",8,"Rua Costa Gomes",41,41,0,42,42,0
1,24,2019,2,0,5,"Braga",1,"Avenida da Liberdade",19,19,0,14,14,0
1,24,2019,2,0,5,"Braga",2,"Avenida Central",12,12,0,152,152,0
1,24,2019,2,0,5,"Braga",3,"Rua de Caires",36,36,0,37,37,0
1,24,2019,2,0,5,"Braga",4,"N14 Bosch",47,47,0,47,47,0
1,24,2019,2,0,5,"Braga",5,"Avenida João Paulo II",39,39,0,8,8,0
1,24,2019,2,0,5,"Braga",6,"Avenida Padre Júlio Fragata",62,62,0,20,20,0
1,24,2019,2,0,5,"Braga",7,"Rua Nova Santa Cruz",29,29,0,104,104,0
1,24,2019,2,0,5,"Braga",8,"Rua Costa Gomes",41,41,0,42,42,0
1,24,2019,3,0,5,"Braga",1,"Avenida da Liberdade",19,19,0,14,14,0
1,24,2019,3,0,5,"Braga",2,"Avenida Central",12,12,0,152,152,0
1,24,2019,3,0,5,"Braga",3,"Rua de Caires",36,36,0,37,37,0
1,24,2019,3,0,5,"Braga",4,"N14 Bosch",47,47,0,47,47,0
1,24,2019,3,0,5,"Braga",5,"Avenida João Paulo II",39,39,0,8,8,0
1,24,2019,3,0,5,"Braga",6,"Avenida Padre Júlio Fragata",62,62,0,20,20,0
1,24,2019,3,0,5,"Braga",7,"Rua Nova Santa Cruz",29,29,0,104,104,0
1,24,2019,3,0,5,"Braga",8,"Rua Costa Gomes",41,41,0,42,42,0
1,24,2019,4,0,5,"Braga",1,"Avenida da Liberdade",19,19,0,14,14,0
1,24,2019,4,0,5,"Braga",2,"Avenida Central",12,12,0,152,152,0
1,24,2019,4,0,5,"Braga",3,"Rua de Caires",36,36,0,37,37,0
1,24,2019,4,0,5,"Braga",4,"N14 Bosch",47,47,0,47,47,0
1,24,2019,4,0,5,"Braga",5,"Avenida João Paulo II",39,39,0,8,8,0
1,24,2019,4,0,5,"Braga",6,"Avenida Padre Júlio Fragata",62,62,0,20,20,0
1,24,2019,4,0,5,"Braga",7,"Rua Nova Santa Cruz",29,29,0,104,104,0
1,24,2019,4,0,5,"Braga",8,"Rua Costa Gomes",41,41,0,42,42,0
1,24,2019,5,0,5,"Braga",1,"Avenida da Liberdade",19,19,0,14,14,0
1,24,2019,5,0,5,"Braga",2,"Avenida Central",12,12,0,152,152,0
1,24,2019,5,0,5,"Braga",3,"Rua de Caires",36,36,0,37,37,0
1,24,2019,5,0,5,"Braga",4,"N14 Bosch",47,47,0,47,47,0
1,24,2019,5,0,5,"Braga",5,"Avenida João Paulo II",39,39,0,8,8,0
1,24,2019,5,0,5,"Braga",6,"Avenida Padre Júlio Fragata",62,62,0,20,20,0
1,24,2019,5,0,5,"Braga",7,"Rua Nova Santa Cruz",29,29,0,104,104,0
1,24,2019,5,0,5,"Braga",8,"Rua Costa Gomes",41,41,0,42,42,0
1,24,2019,6,0,5,"Braga",1,"Avenida da Liberdade",19,19,0,14,14,0
1,24,2019,6,0,5,"Braga",2,"Avenida Central",12,12,0,152,152,0
1,24,2019,6,0,5,"Braga",3,"Rua de Caires",36,36,0,37,37,0
1,24,2019,6,0,5,"Braga",4,"N14 Bosch",47,47,0,47,47,0
1,24,2019,6,0,5,"Braga",5,"Avenida João Paulo II",39,39,0,8,8,0
1,24,2019,6,0,5,"Braga",6,"Avenida Padre Júlio Fragata",62,62,0,20,20,0
1,24,2019,6,0,5,"Braga",7,"Rua Nova Santa Cruz",29,29,0,104,104,0
1,24,2019,6,0,5,"Braga",8,"Rua Costa Gomes",41,41,0,42,42,0
1,24,2019,7,0,5,"Braga",1,"Avenida da Liberdade",19,19,0,14,14,0
1,24,2019,7,0,5,"Braga",2,"Avenida Central",12,12,0,152,152,0
1,24,2019,7,0,5,"Braga",3,"Rua de Caires",36,36,0,37,37,0
1,24,2019,7,0,5,"Braga",4,"N14 Bosch",47,47,0,47,47,0
1,24,2019,7,0,5,"Braga",5,"Avenida João Paulo II",39,39,0,8,8,0
1,24,2019,7,0,5,"Braga",6,"Avenida Padre Júlio Fragata",62,62,0,20,20,0
1,24,2019,7,0,5,"Braga",7,"Rua Nova Santa Cruz",29,29,0,104,104,0
1,24,2019,7,0,5,"Braga",8,"Rua Costa Gomes",41,41,0,42,42,0
1,24,2019,8,0,5,"Braga",1,"Avenida da Liberdade",19,19,0,14,14,0
1,24,2019,8,0,5,"Braga",2,"Avenida Central",12,12,0,152,152,0
1,24,2019,8,0,5,"Braga",3,"Rua de Caires",27,36,9,49,37,12
1,24,2019,8,0,5,"Braga",4,"N14 Bosch",36,46,10,62,48,14
1,24,2019,8,0,5,"Braga",5,"Avenida João Paulo II",39,39,0,8,8,0
1,24,2019,8,0,5,"Braga",6,"Avenida Padre Júlio Fragata",62,62,0,20,20,0
1,24,2019,8,0,5,"Braga",7,"Rua Nova Santa Cruz",29,29,0,104,104,0
1,24,2019,8,0,5,"Braga",8,"Rua Costa Gomes",32,40,8,53,43,10
1,24,2019,9,0,5,"Braga",1,"Avenida da Liberdade",19,19,0,14,14,0
1,24,2019,9,0,5,"Braga",2,"Avenida Central",5,13,8,366,140,226
1,24,2019,9,0,5,"Braga",3,"Rua de Caires",28,36,8,48,37,11
1,24,2019,9,0,5,"Braga",4,"N14 Bosch",24,48,24,93,46,47
1,24,2019,9,0,5,"Braga",5,"Avenida João Paulo II",37,37,0,9,9,0
1,24,2019,9,0,5,"Braga",6,"Avenida Padre Júlio Fragata",38,62,24,33,20,13
1,24,2019,9,0,5,"Braga",7,"Rua Nova Santa Cruz",23,29,6,132,104,28
1,24,2019,9,0,5,"Braga",8,"Rua Costa Gomes",28,41,13,61,42,19
1,24,2019,10,0,5,"Braga",1,"Avenida da Liberdade",19,19,0,14,14,0
1,24,2019,10,0,5,"Braga",2,"Avenida Central",6,12,6,305,152,153
1,24,2019,10,0,5,"Braga",3,"Rua de Caires",27,35,8,49,38,11
1,24,2019,10,0,5,"Braga",4,"N14 Bosch",33,46,13,68,48,20
1,24,2019,10,0,5,"Braga",5,"Avenida João Paulo II",38,38,0,9,9,0
1,24,2019,10,0,5,"Braga",6,"Avenida Padre Júlio Fragata",61,61,0,21,21,0
1,24,2019,10,0,5,"Braga",7,"Rua Nova Santa Cruz",28,28,0,108,108,0
1,24,2019,10,0,5,"Braga",8,"Rua Costa Gomes",31,41,10,55,42,13
1,24,2019,11,0,5,"Braga",1,"Avenida da Liberdade",19,19,0,14,14,0
1,24,2019,11,0,5,"Braga",2,"Avenida Central",7,14,7,261,130,131
1,24,2019,11,0,5,"Braga",3,"Rua de Caires",27,36,9,49,37,12
1,24,2019,11,0,5,"Braga",4,"N14 Bosch",31,46,15,72,48,24
1,24,2019,11,0,5,"Braga",5,"Avenida João Paulo II",38,38,0,9,9,0
1,24,2019,11,0,5,"Braga",6,"Avenida Padre Júlio Fragata",61,61,0,21,21,0
1,24,2019,11,0,5,"Braga",7,"Rua Nova Santa Cruz",22,29,7,138,104,34
1,24,2019,11,0,5,"Braga",8,"Rua Costa Gomes",32,41,9,53,42,11
1,24,2019,12,0,5,"Braga",1,"Avenida da Liberdade",19,19,0,14,14,0
1,24,2019,12,0,5,"Braga",2,"Avenida Central",8,13,5,229,140,89
1,24,2019,12,0,5,"Braga",3,"Rua de Caires",26,36,10,51,37,14
1,24,2019,12,0,5,"Braga",4,"N14 Bosch",29,47,18,77,47,30
1,24,2019,12,0,5,"Braga",5,"Avenida João Paulo II",39,39,0,8,8,0
1,24,2019,12,0,5,"Braga",6,"Avenida Padre Júlio Fragata",61,61,0,21,21,0
1,24,2019,12,0,5,"Braga",7,"Rua Nova Santa Cruz",22,29,7,138,104,34
1,24,2019,12,0,5,"Braga",8,"Rua Costa Gomes",28,40,12,61,43,18
1,24,2019,13,0,5,"Braga",1,"Avenida da Liberdade",19,19,0,14,14,0
1,24,2019,13,0,5,"Braga",2,"Avenida Central",8,12,4,229,152,77
1,24,2019,13,0,5,"Braga",3,"Rua de Caires",26,35,9,51,38,13
1,24,2019,13,0,5,"Braga",4,"N14 Bosch",28,47,19,80,47,33
1,24,2019,13,0,5,"Braga",5,"Avenida João Paulo II",38,38,0,9,9,0
1,24,2019,13,0,5,"Braga",6,"Avenida Padre Júlio Fragata",62,62,0,20,20,0
1,24,2019,13,0,5,"Braga",7,"Rua Nova Santa Cruz",23,29,6,132,104,28
1,24,2019,13,0,5,"Braga",8,"Rua Costa Gomes",33,41,8,52,42,10
1,24,2019,14,0,5,"Braga",1,"Avenida da Liberdade",19,19,0,14,14,0
1,24,2019,14,0,5,"Braga",2,"Avenida Central",9,13,4,203,140,63
1,24,2019,14,0,5,"Braga",3,"Rua de Caires",22,36,14,61,37,24
1,24,2019,14,0,5,"Braga",4,"N14 Bosch",19,47,28,118,47,71
1,24,2019,14,0,5,"Braga",5,"Avenida João Paulo II",38,38,0,9,9,0
1,24,2019,14,0,5,"Braga",6,"Avenida Padre Júlio Fragata",62,62,0,20,20,0
1,24,2019,14,0,5,"Braga",7,"Rua Nova Santa Cruz",21,29,8,144,104,40
1,24,2019,14,0,5,"Braga",8,"Rua Costa Gomes",31,41,10,55,42,13
1,24,2019,15,0,5,"Braga",1,"Avenida da Liberdade",19,19,0,14,14,0
1,24,2019,15,0,5,"Braga",2,"Avenida Central",8,13,5,229,140,89
1,24,2019,15,0,5,"Braga",3,"Rua de Caires",25,35,10,53,38,15
1,24,2019,15,0,5,"Braga",4,"N14 Bosch",30,46,16,74,48,26
1,24,2019,15,0,5,"Braga",5,"Avenida João Paulo II",30,39,9,11,8,3
1,24,2019,15,0,5,"Braga",6,"Avenida Padre Júlio Fragata",49,62,13,26,20,6
1,24,2019,15,0,5,"Braga",7,"Rua Nova Santa Cruz",21,28,7,144,108,36
1,24,2019,15,0,5,"Braga",8,"Rua Costa Gomes",32,41,9,53,42,11
1,24,2019,16,0,5,"Braga",1,"Avenida da Liberdade",19,19,0,14,14,0
1,24,2019,16,0,5,"Braga",2,"Avenida Central",6,13,7,305,140,165
1,24,2019,16,0,5,"Braga",3,"Rua de Caires",28,35,7,48,38,10
1,24,2019,16,0,5,"Braga",4,"N14 Bosch",30,46,16,74,48,26
1,24,2019,16,0,5,"Braga",5,"Avenida João Paulo II",27,38,11,12,9,3
1,24,2019,16,0,5,"Braga",6,"Avenida Padre Júlio Fragata",47,62,15,27,20,7
1,24,2019,16,0,5,"Braga",7,"Rua Nova Santa Cruz",21,29,8,144,104,40
1,24,2019,16,0,5,"Braga",8,"Rua Costa Gomes",29,41,12,59,42,17
1,24,2019,18,0,5,"Braga",1,"Avenida da Liberdade",16,20,4,17,14,3
1,24,2019,18,0,5,"Braga",2,"Avenida Central",5,14,9,366,130,236
1,24,2019,18,0,5,"Braga",3,"Rua de Caires",20,36,16,67,37,30
1,24,2019,18,0,5,"Braga",4,"N14 Bosch",15,46,31,149,48,101
1,24,2019,18,0,5,"Braga",5,"Avenida João Paulo II",18,39,21,19,8,11
1,24,2019,18,0,5,"Braga",6,"Avenida Padre Júlio Fragata",33,61,28,38,21,17
1,24,2019,18,0,5,"Braga",7,"Rua Nova Santa Cruz",23,29,6,132,104,28
1,24,2019,18,0,5,"Braga",8,"Rua Costa Gomes",14,42,28,123,41,82
1,24,2019,19,0,5,"Braga",1,"Avenida da Liberdade",19,19,0,14,14,0
1,24,2019,19,0,5,"Braga",2,"Avenida Central",4,13,9,458,140,318
1,24,2019,19,0,5,"Braga",3,"Rua de Caires",24,35,11,56,38,18
1,24,2019,19,0,5,"Braga",4,"N14 Bosch",26,47,21,86,47,39
1,24,2019,19,0,5,"Braga",5,"Avenida João Paulo II",4,41,37,87,8,79
1,24,2019,19,0,5,"Braga",6,"Avenida Padre Júlio Fragata",16,62,46,80,20,60
1,24,2019,19,0,5,"Braga",7,"Rua Nova Santa Cruz",19,29,10,160,104,56
1,24,2019,19,0,5,"Braga",8,"Rua Costa Gomes",22,40,18,78,43,35
1,24,2019,20,0,5,"Braga",1,"Avenida da Liberdade",19,19,0,14,14,0
1,24,2019,20,0,5,"Braga",2,"Avenida Central",8,12,4,229,152,77
1,24,2019,20,0,5,"Braga",3,"Rua de Caires",36,36,0,37,37,0
1,24,2019,20,0,5,"Braga",4,"N14 Bosch",27,46,19,83,48,35
1,24,2019,20,0,5,"Braga",5,"Avenida João Paulo II",31,38,7,11,9,2
1,24,2019,20,0,5,"Braga",6,"Avenida Padre Júlio Fragata",42,61,19,30,21,9
1,24,2019,20,0,5,"Braga",7,"Rua Nova Santa Cruz",17,28,11,179,108,71
1,24,2019,20,0,5,"Braga",8,"Rua Costa Gomes",27,41,14,63,42,21
1,24,2019,21,0,5,"Braga",1,"Avenida da Liberdade",19,19,0,14,14,0
1,24,2019,21,0,5,"Braga",2,"Avenida Central",9,12,3,203,152,51
1,24,2019,21,0,5,"Braga",3,"Rua de Caires",36,36,0,37,37,0
1,24,2019,21,0,5,"Braga",4,"N14 Bosch",47,47,0,47,47,0
1,24,2019,21,0,5,"Braga",5,"Avenida João Paulo II",39,39,0,8,8,0
1,24,2019,21,0,5,"Braga",6,"Avenida Padre Júlio Fragata",41,62,21,31,20,11
1,24,2019,21,0,5,"Braga",7,"Rua Nova Santa Cruz",28,28,0,108,108,0
1,24,2019,21,0,5,"Braga",8,"Rua Costa Gomes",41,41,0,42,42,0
1,24,2019,22,0,5,"Braga",1,"Avenida da Liberdade",19,19,0,14,14,0
1,24,2019,22,0,5,"Braga",2,"Avenida Central",13,13,0,140,140,0
1,24,2019,22,0,5,"Braga",3,"Rua de Caires",35,35,0,38,38,0
1,24,2019,22,0,5,"Braga",4,"N14 Bosch",47,47,0,47,47,0
1,24,2019,22,0,5,"Braga",5,"Avenida João Paulo II",39,39,0,8,8,0
1,24,2019,22,0,5,"Braga",6,"Avenida Padre Júlio Fragata",62,62,0,20,20,0
1,24,2019,22,0,5,"Braga",7,"Rua Nova Santa Cruz",28,28,0,108,108,0
1,24,2019,22,0,5,"Braga",8,"Rua Costa Gomes",41,41,0,42,42,0
1,24,2019,23,0,5,"Braga",1,"Avenida da Liberdade",19,19,0,14,14,0
1,24,2019,23,0,5,"Braga",2,"Avenida Central",9,12,3,203,152,51
1,24,2019,23,0,5,"Braga",3,"Rua de Caires",35,35,0,38,38,0
1,24,2019,23,0,5,"Braga",4,"N14 Bosch",47,47,0,47,47,0
1,24,2019,23,0,5,"Braga",5,"Avenida João Paulo II",39,39,0,8,8,0
1,24,2019,23,0,5,"Braga",6,"Avenida Padre Júlio Fragata",44,61,17,29,21,8
1,24,2019,23,0,5,"Braga",7,"Rua Nova Santa Cruz",28,28,0,108,108,0
1,24,2019,23,0,5,"Braga",8,"Rua Costa Gomes",41,41,0,42,42,0
1,25,2019,0,0,6,"Braga",1,"Avenida da Liberdade",19,19,0,14,14,0
1,25,2019,0,0,6,"Braga",2,"Avenida Central",12,12,0,152,152,0
1,25,2019,0,0,6,"Braga",3,"Rua de Caires",35,35,0,38,38,0
1,25,2019,0,0,6,"Braga",4,"N14 Bosch",47,47,0,47,47,0
1,25,2019,0,0,6,"Braga",5,"Avenida João Paulo II",39,39,0,8,8,0
1,25,2019,0,0,6,"Braga",6,"Avenida Padre Júlio Fragata",62,62,0,20,20,0
1,25,2019,0,0,6,"Braga",7,"Rua Nova Santa Cruz",28,28,0,108,108,0
1,25,2019,0,0,6,"Braga",8,"Rua Costa Gomes",41,41,0,42,42,0
1,25,2019,1,0,6,"Braga",4,"N14 Bosch",47,47,0,47,47,0
1,25,2019,1,0,6,"Braga",5,"Avenida João Paulo II",39,39,0,8,8,0
1,25,2019,1,0,6,"Braga",6,"Avenida Padre Júlio Fragata",62,62,0,20,20,0
1,25,2019,1,0,6,"Braga",7,"Rua Nova Santa Cruz",28,28,0,108,108,0
1,25,2019,1,0,6,"Braga",8,"Rua Costa Gomes",41,41,0,42,42,0
1,25,2019,1,0,6,"Braga",1,"Avenida da Liberdade",19,19,0,14,14,0
1,25,2019,1,0,6,"Braga",2,"Avenida Central",12,12,0,152,152,0
1,25,2019,1,0,6,"Braga",3,"Rua de Caires",35,35,0,38,38,0
1,25,2019,1,0,6,"Braga",4,"N14 Bosch",47,47,0,47,47,0
1,25,2019,2,0,6,"Braga",1,"Avenida da Liberdade",19,19,0,14,14,0
1,25,2019,2,0,6,"Braga",2,"Avenida Central",12,12,0,152,152,0
1,25,2019,2,0,6,"Braga",3,"Rua de Caires",35,35,0,38,38,0
1,25,2019,2,0,6,"Braga",4,"N14 Bosch",47,47,0,47,47,0
1,25,2019,2,0,6,"Braga",5,"Avenida João Paulo II",39,39,0,8,8,0
1,25,2019,2,0,6,"Braga",6,"Avenida Padre Júlio Fragata",62,62,0,20,20,0
1,25,2019,2,0,6,"Braga",7,"Rua Nova Santa Cruz",28,28,0,108,108,0
1,25,2019,2,0,6,"Braga",8,"Rua Costa Gomes",41,41,0,42,42,0
1,25,2019,3,0,6,"Braga",1,"Avenida da Liberdade",19,19,0,14,14,0
1,25,2019,3,0,6,"Braga",2,"Avenida Central",12,12,0,152,152,0
1,25,2019,3,0,6,"Braga",3,"Rua de Caires",35,35,0,38,38,0
1,25,2019,3,0,6,"Braga",4,"N14 Bosch",47,47,0,47,47,0
1,25,2019,3,0,6,"Braga",5,"Avenida João Paulo II",39,39,0,8,8,0
1,25,2019,3,0,6,"Braga",6,"Avenida Padre Júlio Fragata",62,62,0,20,20,0
1,25,2019,3,0,6,"Braga",7,"Rua Nova Santa Cruz",28,28,0,108,108,0
1,25,2019,3,0,6,"Braga",8,"Rua Costa Gomes",41,41,0,42,42,0
1,25,2019,4,0,6,"Braga",1,"Avenida da Liberdade",19,19,0,14,14,0
1,25,2019,4,0,6,"Braga",2,"Avenida Central",12,12,0,152,152,0
1,25,2019,4,0,6,"Braga",3,"Rua de Caires",35,35,0,38,38,0
1,25,2019,4,0,6,"Braga",4,"N14 Bosch",47,47,0,47,47,0
1,25,2019,4,0,6,"Braga",5,"Avenida João Paulo II",39,39,0,8,8,0
1,25,2019,4,0,6,"Braga",6,"Avenida Padre Júlio Fragata",62,62,0,20,20,0
1,25,2019,4,0,6,"Braga",7,"Rua Nova Santa Cruz",28,28,0,108,108,0
1,25,2019,4,0,6,"Braga",8,"Rua Costa Gomes",41,41,0,42,42,0
1,25,2019,5,0,6,"Braga",1,"Avenida da Liberdade",19,19,0,14,14,0
1,25,2019,5,0,6,"Braga",2,"Avenida Central",12,12,0,152,152,0
1,25,2019,5,0,6,"Braga",3,"Rua de Caires",35,35,0,38,38,0
1,25,2019,5,0,6,"Braga",4,"N14 Bosch",47,47,0,47,47,0
1,25,2019,5,0,6,"Braga",5,"Avenida João Paulo II",39,39,0,8,8,0
1,25,2019,5,0,6,"Braga",6,"Avenida Padre Júlio Fragata",62,62,0,20,20,0
1,25,2019,5,0,6,"Braga",7,"Rua Nova Santa Cruz",28,28,0,108,108,0
1,25,2019,5,0,6,"Braga",8,"Rua Costa Gomes",41,41,0,42,42,0
1,25,2019,6,0,6,"Braga",1,"Avenida da Liberdade",19,19,0,14,14,0
1,25,2019,6,0,6,"Braga",2,"Avenida Central",12,12,0,152,152,0
1,25,2019,6,0,6,"Braga",3,"Rua de Caires",35,35,0,38,38,0
1,25,2019,6,0,6,"Braga",4,"N14 Bosch",47,47,0,47,47,0
1,25,2019,6,0,6,"Braga",5,"Avenida João Paulo II",39,39,0,8,8,0
1,25,2019,6,0,6,"Braga",6,"Avenida Padre Júlio Fragata",62,62,0,20,20,0
1,25,2019,6,0,6,"Braga",7,"Rua Nova Santa Cruz",28,28,0,108,108,0
1,25,2019,6,0,6,"Braga",8,"Rua Costa Gomes",41,41,0,42,42,0
1,25,2019,7,0,6,"Braga",1,"Avenida da Liberdade",19,19,0,14,14,0
1,25,2019,7,0,6,"Braga",2,"Avenida Central",12,12,0,152,152,0
1,25,2019,7,0,6,"Braga",3,"Rua de Caires",35,35,0,38,38,0
1,25,2019,7,0,6,"Braga",4,"N14 Bosch",47,47,0,47,47,0
1,25,2019,7,0,6,"Braga",5,"Avenida João Paulo II",39,39,0,8,8,0
1,25,2019,7,0,6,"Braga",6,"Avenida Padre Júlio Fragata",62,62,0,20,20,0
1,25,2019,7,0,6,"Braga",7,"Rua Nova Santa Cruz",28,28,0,108,108,0
1,25,2019,7,0,6,"Braga",8,"Rua Costa Gomes",41,41,0,42,42,0
1,25,2019,8,0,6,"Braga",1,"Avenida da Liberdade",19,19,0,14,14,0
1,25,2019,8,0,6,"Braga",2,"Avenida Central",12,12,0,152,152,0
1,25,2019,8,0,6,"Braga",3,"Rua de Caires",23,35,12,58,38,20
1,25,2019,8,0,6,"Braga",4,"N14 Bosch",33,47,14,68,47,21
1,25,2019,8,0,6,"Braga",5,"Avenida João Paulo II",39,39,0,8,8,0
1,25,2019,8,0,6,"Braga",6,"Avenida Padre Júlio Fragata",62,62,0,20,20,0
1,25,2019,8,0,6,"Braga",7,"Rua Nova Santa Cruz",28,28,0,108,108,0
1,25,2019,8,0,6,"Braga",8,"Rua Costa Gomes",33,41,8,52,42,10
1,25,2019,9,0,6,"Braga",1,"Avenida da Liberdade",12,19,7,23,14,9
1,25,2019,9,0,6,"Braga",2,"Avenida Central",8,13,5,229,140,89
1,25,2019,9,0,6,"Braga",3,"Rua de Caires",24,35,11,56,38,18
1,25,2019,9,0,6,"Braga",4,"N14 Bosch",24,47,23,93,47,46
1,25,2019,9,0,6,"Braga",5,"Avenida João Paulo II",39,39,0,8,8,0
1,25,2019,9,0,6,"Braga",6,"Avenida Padre Júlio Fragata",45,61,16,28,21,7
1,25,2019,9,0,6,"Braga",7,"Rua Nova Santa Cruz",21,28,7,144,108,36
1,25,2019,9,0,6,"Braga",8,"Rua Costa Gomes",32,40,8,53,43,10
1,25,2019,10,0,6,"Braga",1,"Avenida da Liberdade",20,20,0,14,14,0
1,25,2019,10,0,6,"Braga",2,"Avenida Central",12,12,0,152,152,0
1,25,2019,10,0,6,"Braga",3,"Rua de Caires",24,35,11,56,38,18
1,25,2019,10,0,6,"Braga",4,"N14 Bosch",32,47,15,70,47,23
1,25,2019,10,0,6,"Braga",5,"Avenida João Paulo II",39,39,0,8,8,0
1,25,2019,10,0,6,"Braga",6,"Avenida Padre Júlio Fragata",62,62,0,20,20,0
1,25,2019,10,0,6,"Braga",7,"Rua Nova Santa Cruz",29,29,0,104,104,0
1,25,2019,10,0,6,"Braga",8,"Rua Costa Gomes",31,41,10,55,42,13
1,25,2019,11,0,6,"Braga",1,"Avenida da Liberdade",20,20,0,14,14,0
1,25,2019,11,0,6,"Braga",2,"Avenida Central",7,12,5,261,152,109
1,25,2019,11,0,6,"Braga",3,"Rua de Caires",25,36,11,53,37,16
1,25,2019,11,0,6,"Braga",4,"N14 Bosch",29,47,18,77,47,30
1,25,2019,11,0,6,"Braga",5,"Avenida João Paulo II",39,39,0,8,8,0
1,25,2019,11,0,6,"Braga",6,"Avenida Padre Júlio Fragata",62,62,0,20,20,0
1,25,2019,11,0,6,"Braga",7,"Rua Nova Santa Cruz",17,28,11,179,108,71
1,25,2019,11,0,6,"Braga",8,"Rua Costa Gomes",41,41,0,42,42,0
1,25,2019,12,0,6,"Braga",1,"Avenida da Liberdade",20,20,0,14,14,0
1,25,2019,12,0,6,"Braga",2,"Avenida Central",8,13,5,229,140,89
1,25,2019,12,0,6,"Braga",3,"Rua de Caires",22,36,14,61,37,24
1,25,2019,12,0,6,"Braga",4,"N14 Bosch",32,47,15,70,47,23
1,25,2019,12,0,6,"Braga",5,"Avenida João Paulo II",38,38,0,9,9,0
1,25,2019,12,0,6,"Braga",6,"Avenida Padre Júlio Fragata",49,61,12,26,21,5
1,25,2019,12,0,6,"Braga",7,"Rua Nova Santa Cruz",22,28,6,138,108,30
1,25,2019,12,0,6,"Braga",8,"Rua Costa Gomes",26,40,14,66,43,23
1,25,2019,13,0,6,"Braga",1,"Avenida da Liberdade",20,20,0,14,14,0
1,25,2019,13,0,6,"Braga",2,"Avenida Central",10,12,2,183,152,31
1,25,2019,13,0,6,"Braga",3,"Rua de Caires",29,36,7,46,37,9
1,25,2019,13,0,6,"Braga",4,"N14 Bosch",23,46,23,97,48,49
1,25,2019,13,0,6,"Braga",5,"Avenida João Paulo II",39,39,0,8,8,0
1,25,2019,13,0,6,"Braga",6,"Avenida Padre Júlio Fragata",61,61,0,21,21,0
1,25,2019,13,0,6,"Braga",7,"Rua Nova Santa Cruz",22,28,6,138,108,30
1,25,2019,13,0,6,"Braga",8,"Rua Costa Gomes",41,41,0,42,42,0
1,25,2019,14,0,6,"Braga",1,"Avenida da Liberdade",20,20,0,14,14,0
1,25,2019,14,0,6,"Braga",2,"Avenida Central",8,13,5,229,140,89
1,25,2019,14,0,6,"Braga",3,"Rua de Caires",35,35,0,38,38,0
1,25,2019,14,0,6,"Braga",4,"N14 Bosch",30,46,16,74,48,26
1,25,2019,14,0,6,"Braga",5,"Avenida João Paulo II",38,38,0,9,9,0
1,25,2019,14,0,6,"Braga",6,"Avenida Padre Júlio Fragata",62,62,0,20,20,0
1,25,2019,14,0,6,"Braga",7,"Rua Nova Santa Cruz",20,29,9,152,104,48
1,25,2019,14,0,6,"Braga",8,"Rua Costa Gomes",14,40,26,123,43,80
1,25,2019,15,0,6,"Braga",1,"Avenida da Liberdade",20,20,0,14,14,0
1,25,2019,15,0,6,"Braga",2,"Avenida Central",6,12,6,305,152,153
1,25,2019,15,0,6,"Braga",3,"Rua de Caires",36,36,0,37,37,0
1,25,2019,15,0,6,"Braga",4,"N14 Bosch",23,46,23,97,48,49
1,25,2019,15,0,6,"Braga",5,"Avenida João Paulo II",31,39,8,11,8,3
1,25,2019,15,0,6,"Braga",6,"Avenida Padre Júlio Fragata",61,61,0,21,21,0
1,25,2019,15,0,6,"Braga",7,"Rua Nova Santa Cruz",19,29,10,160,104,56
1,25,2019,15,0,6,"Braga",8,"Rua Costa Gomes",29,40,11,59,43,16
1,25,2019,16,0,6,"Braga",1,"Avenida da Liberdade",11,20,9,25,14,11
1,25,2019,16,0,6,"Braga",2,"Avenida Central",6,13,7,305,140,165
1,25,2019,16,0,6,"Braga",3,"Rua de Caires",27,36,9,49,37,12
1,25,2019,16,0,6,"Braga",4,"N14 Bosch",25,47,22,89,47,42
1,25,2019,16,0,6,"Braga",5,"Avenida João Paulo II",25,39,14,13,8,5
1,25,2019,16,0,6,"Braga",6,"Avenida Padre Júlio Fragata",62,62,0,20,20,0
1,25,2019,16,0,6,"Braga",7,"Rua Nova Santa Cruz",22,29,7,138,104,34
1,25,2019,16,0,6,"Braga",8,"Rua Costa Gomes",30,40,10,57,43,14
1,25,2019,17,0,6,"Braga",1,"Avenida da Liberdade",19,19,0,14,14,0
1,25,2019,17,0,6,"Braga",2,"Avenida Central",7,13,6,261,140,121
1,25,2019,17,0,6,"Braga",3,"Rua de Caires",26,36,10,51,37,14
1,25,2019,17,0,6,"Braga",4,"N14 Bosch",14,45,31,160,49,111
1,25,2019,17,0,6,"Braga",5,"Avenida João Paulo II",21,39,18,16,8,8
1,25,2019,17,0,6,"Braga",6,"Avenida Padre Júlio Fragata",61,61,0,21,21,0
1,25,2019,17,0,6,"Braga",7,"Rua Nova Santa Cruz",16,28,12,190,108,82
1,25,2019,17,0,6,"Braga",8,"Rua Costa Gomes",28,41,13,61,42,19
1,25,2019,18,0,6,"Braga",1,"Avenida da Liberdade",19,19,0,14,14,0
1,25,2019,18,0,6,"Braga",2,"Avenida Central",5,14,9,366,130,236
1,25,2019,18,0,6,"Braga",3,"Rua de Caires",24,36,12,56,37,19
1,25,2019,18,0,6,"Braga",4,"N14 Bosch",13,48,35,172,46,126
1,25,2019,18,0,6,"Braga",5,"Avenida João Paulo II",23,39,16,15,8,7
1,25,2019,18,0,6,"Braga",6,"Avenida Padre Júlio Fragata",33,61,28,38,21,17
1,25,2019,18,0,6,"Braga",7,"Rua Nova Santa Cruz",18,28,10,169,108,61
1,25,2019,18,0,6,"Braga",8,"Rua Costa Gomes",10,41,31,172,42,130
1,25,2019,19,0,6,"Braga",1,"Avenida da Liberdade",16,20,4,17,14,3
1,25,2019,19,0,6,"Braga",2,"Avenida Central",5,14,9,366,130,236
1,25,2019,19,0,6,"Braga",3,"Rua de Caires",15,36,21,89,37,52
1,25,2019,19,0,6,"Braga",4,"N14 Bosch",28,46,18,80,48,32
1,25,2019,19,0,6,"Braga",5,"Avenida João Paulo II",14,39,25,24,8,16
1,25,2019,19,0,6,"Braga",6,"Avenida Padre Júlio Fragata",25,62,37,51,20,31
1,25,2019,19,0,6,"Braga",7,"Rua Nova Santa Cruz",18,29,11,169,104,65
1,25,2019,19,0,6,"Braga",8,"Rua Costa Gomes",8,40,32,215,43,172
1,25,2019,20,0,6,"Braga",1,"Avenida da Liberdade",20,20,0,14,14,0
1,25,2019,20,0,6,"Braga",2,"Avenida Central",7,13,6,261,140,121
1,25,2019,20,0,6,"Braga",3,"Rua de Caires",28,36,8,48,37,11
1,25,2019,20,0,6,"Braga",4,"N14 Bosch",27,46,19,83,48,35
1,25,2019,20,0,6,"Braga",5,"Avenida João Paulo II",14,37,23,24,9,15
1,25,2019,20,0,6,"Braga",6,"Avenida Padre Júlio Fragata",41,61,20,31,21,10
1,25,2019,20,0,6,"Braga",7,"Rua Nova Santa Cruz",16,29,13,190,104,86
1,25,2019,20,0,6,"Braga",8,"Rua Costa Gomes",19,40,21,90,43,47
1,25,2019,21,0,6,"Braga",1,"Avenida da Liberdade",20,20,0,14,14,0
1,25,2019,21,0,6,"Braga",2,"Avenida Central",9,12,3,203,152,51
1,25,2019,21,0,6,"Braga",3,"Rua de Caires",36,36,0,37,37,0
1,25,2019,21,0,6,"Braga",4,"N14 Bosch",46,46,0,48,48,0
1,25,2019,21,0,6,"Braga",5,"Avenida João Paulo II",31,38,7,11,9,2
1,25,2019,21,0,6,"Braga",6,"Avenida Padre Júlio Fragata",41,62,21,31,20,11
1,25,2019,21,0,6,"Braga",7,"Rua Nova Santa Cruz",28,28,0,108,108,0
1,25,2019,21,0,6,"Braga",8,"Rua Costa Gomes",33,41,8,52,42,10
1,25,2019,22,0,6,"Braga",1,"Avenida da Liberdade",20,20,0,14,14,0
1,25,2019,22,0,6,"Braga",2,"Avenida Central",12,12,0,152,152,0
1,25,2019,22,0,6,"Braga",3,"Rua de Caires",36,36,0,37,37,0
1,25,2019,22,0,6,"Braga",4,"N14 Bosch",46,46,0,48,48,0
1,25,2019,22,0,6,"Braga",5,"Avenida João Paulo II",39,39,0,8,8,0
1,25,2019,22,0,6,"Braga",6,"Avenida Padre Júlio Fragata",26,62,36,49,20,29
1,25,2019,22,0,6,"Braga",7,"Rua Nova Santa Cruz",28,28,0,108,108,0
1,25,2019,22,0,6,"Braga",8,"Rua Costa Gomes",41,41,0,42,42,0
1,25,2019,23,0,6,"Braga",1,"Avenida da Liberdade",20,20,0,14,14,0
1,25,2019,23,0,6,"Braga",2,"Avenida Central",13,13,0,140,140,0
1,25,2019,23,0,6,"Braga",3,"Rua de Caires",36,36,0,37,37,0
1,25,2019,23,0,6,"Braga",4,"N14 Bosch",46,46,0,48,48,0
1,25,2019,23,0,6,"Braga",5,"Avenida João Paulo II",39,39,0,8,8,0
1,25,2019,23,0,6,"Braga",6,"Avenida Padre Júlio Fragata",61,61,0,21,21,0
1,25,2019,23,0,6,"Braga",7,"Rua Nova Santa Cruz",28,28,0,108,108,0
1,25,2019,23,0,6,"Braga",8,"Rua Costa Gomes",41,41,0,42,42,0
1,26,2019,0,0,7,"Braga",1,"Avenida da Liberdade",20,20,0,14,14,0
1,26,2019,0,0,7,"Braga",2,"Avenida Central",13,13,0,140,140,0
1,26,2019,0,0,7,"Braga",3,"Rua de Caires",36,36,0,37,37,0
1,26,2019,0,0,7,"Braga",4,"N14 Bosch",47,47,0,47,47,0
1,26,2019,0,0,7,"Braga",5,"Avenida João Paulo II",39,39,0,8,8,0
1,26,2019,0,0,7,"Braga",6,"Avenida Padre Júlio Fragata",41,62,21,31,20,11
1,26,2019,0,0,7,"Braga",7,"Rua Nova Santa Cruz",28,28,0,108,108,0
1,26,2019,0,0,7,"Braga",8,"Rua Costa Gomes",41,41,0,42,42,0
1,26,2019,1,0,7,"Braga",1,"Avenida da Liberdade",20,20,0,14,14,0
1,26,2019,1,0,7,"Braga",2,"Avenida Central",13,13,0,140,140,0
1,26,2019,1,0,7,"Braga",3,"Rua de Caires",35,35,0,38,38,0
1,26,2019,1,0,7,"Braga",4,"N14 Bosch",47,47,0,47,47,0
1,26,2019,1,0,7,"Braga",5,"Avenida João Paulo II",39,39,0,8,8,0
1,26,2019,1,0,7,"Braga",6,"Avenida Padre Júlio Fragata",61,61,0,21,21,0
1,26,2019,1,0,7,"Braga",7,"Rua Nova Santa Cruz",28,28,0,108,108,0
1,26,2019,1,0,7,"Braga",8,"Rua Costa Gomes",41,41,0,42,42,0
1,26,2019,2,0,7,"Braga",1,"Avenida da Liberdade",20,20,0,14,14,0
1,26,2019,2,0,7,"Braga",2,"Avenida Central",13,13,0,140,140,0
1,26,2019,2,0,7,"Braga",3,"Rua de Caires",35,35,0,38,38,0
1,26,2019,2,0,7,"Braga",4,"N14 Bosch",47,47,0,47,47,0
1,26,2019,2,0,7,"Braga",5,"Avenida João Paulo II",39,39,0,8,8,0
1,26,2019,2,0,7,"Braga",6,"Avenida Padre Júlio Fragata",61,61,0,21,21,0
1,26,2019,2,0,7,"Braga",7,"Rua Nova Santa Cruz",29,29,0,104,104,0
1,26,2019,2,0,7,"Braga",8,"Rua Costa Gomes",41,41,0,42,42,0
1,26,2019,3,0,7,"Braga",1,"Avenida da Liberdade",20,20,0,14,14,0
1,26,2019,3,0,7,"Braga",2,"Avenida Central",13,13,0,140,140,0
1,26,2019,3,0,7,"Braga",3,"Rua de Caires",35,35,0,38,38,0
1,26,2019,3,0,7,"Braga",4,"N14 Bosch",47,47,0,47,47,0
1,26,2019,3,0,7,"Braga",5,"Avenida João Paulo II",39,39,0,8,8,0
1,26,2019,3,0,7,"Braga",6,"Avenida Padre Júlio Fragata",61,61,0,21,21,0
1,26,2019,3,0,7,"Braga",7,"Rua Nova Santa Cruz",29,29,0,104,104,0
1,26,2019,3,0,7,"Braga",8,"Rua Costa Gomes",41,41,0,42,42,0
1,26,2019,4,0,7,"Braga",1,"Avenida da Liberdade",20,20,0,14,14,0
1,26,2019,4,0,7,"Braga",2,"Avenida Central",13,13,0,140,140,0
1,26,2019,4,0,7,"Braga",3,"Rua de Caires",35,35,0,38,38,0
1,26,2019,4,0,7,"Braga",4,"N14 Bosch",47,47,0,47,47,0
1,26,2019,4,0,7,"Braga",5,"Avenida João Paulo II",39,39,0,8,8,0
1,26,2019,4,0,7,"Braga",6,"Avenida Padre Júlio Fragata",61,61,0,21,21,0
1,26,2019,4,0,7,"Braga",7,"Rua Nova Santa Cruz",29,29,0,104,104,0
1,26,2019,4,0,7,"Braga",8,"Rua Costa Gomes",41,41,0,42,42,0
1,26,2019,5,0,7,"Braga",4,"N14 Bosch",47,47,0,47,47,0
1,26,2019,5,0,7,"Braga",5,"Avenida João Paulo II",39,39,0,8,8,0
1,26,2019,5,0,7,"Braga",6,"Avenida Padre Júlio Fragata",61,61,0,21,21,0
1,26,2019,5,0,7,"Braga",7,"Rua Nova Santa Cruz",29,29,0,104,104,0
1,26,2019,5,0,7,"Braga",8,"Rua Costa Gomes",41,41,0,42,42,0
1,26,2019,5,0,7,"Braga",1,"Avenida da Liberdade",20,20,0,14,14,0
1,26,2019,5,0,7,"Braga",2,"Avenida Central",13,13,0,140,140,0
1,26,2019,5,0,7,"Braga",3,"Rua de Caires",35,35,0,38,38,0
1,26,2019,5,0,7,"Braga",4,"N14 Bosch",47,47,0,47,47,0
1,26,2019,6,0,7,"Braga",1,"Avenida da Liberdade",20,20,0,14,14,0
1,26,2019,6,0,7,"Braga",2,"Avenida Central",13,13,0,140,140,0
1,26,2019,6,0,7,"Braga",3,"Rua de Caires",35,35,0,38,38,0
1,26,2019,6,0,7,"Braga",4,"N14 Bosch",47,47,0,47,47,0
1,26,2019,6,0,7,"Braga",5,"Avenida João Paulo II",39,39,0,8,8,0
1,26,2019,6,0,7,"Braga",6,"Avenida Padre Júlio Fragata",61,61,0,21,21,0
1,26,2019,6,0,7,"Braga",7,"Rua Nova Santa Cruz",29,29,0,104,104,0
1,26,2019,6,0,7,"Braga",8,"Rua Costa Gomes",41,41,0,42,42,0
1,26,2019,7,0,7,"Braga",1,"Avenida da Liberdade",20,20,0,14,14,0
1,26,2019,7,0,7,"Braga",2,"Avenida Central",13,13,0,140,140,0
1,26,2019,7,0,7,"Braga",3,"Rua de Caires",35,35,0,38,38,0
1,26,2019,7,0,7,"Braga",4,"N14 Bosch",47,47,0,47,47,0
1,26,2019,7,0,7,"Braga",5,"Avenida João Paulo II",39,39,0,8,8,0
1,26,2019,7,0,7,"Braga",6,"Avenida Padre Júlio Fragata",61,61,0,21,21,0
1,26,2019,7,0,7,"Braga",7,"Rua Nova Santa Cruz",29,29,0,104,104,0
1,26,2019,7,0,7,"Braga",8,"Rua Costa Gomes",41,41,0,42,42,0
1,26,2019,8,0,7,"Braga",1,"Avenida da Liberdade",20,20,0,14,14,0
1,26,2019,8,0,7,"Braga",2,"Avenida Central",13,13,0,140,140,0
1,26,2019,8,0,7,"Braga",3,"Rua de Caires",35,35,0,38,38,0
1,26,2019,8,0,7,"Braga",4,"N14 Bosch",47,47,0,47,47,0
1,26,2019,8,0,7,"Braga",5,"Avenida João Paulo II",39,39,0,8,8,0
1,26,2019,8,0,7,"Braga",6,"Avenida Padre Júlio Fragata",61,61,0,21,21,0
1,26,2019,8,0,7,"Braga",7,"Rua Nova Santa Cruz",29,29,0,104,104,0
1,26,2019,8,0,7,"Braga",8,"Rua Costa Gomes",41,41,0,42,42,0
1,26,2019,9,0,7,"Braga",1,"Avenida da Liberdade",20,20,0,14,14,0
1,26,2019,9,0,7,"Braga",2,"Avenida Central",13,13,0,140,140,0
1,26,2019,9,0,7,"Braga",3,"Rua de Caires",35,35,0,38,38,0
1,26,2019,9,0,7,"Braga",4,"N14 Bosch",47,47,0,47,47,0
1,26,2019,9,0,7,"Braga",5,"Avenida João Paulo II",39,39,0,8,8,0
1,26,2019,9,0,7,"Braga",6,"Avenida Padre Júlio Fragata",61,61,0,21,21,0
1,26,2019,9,0,7,"Braga",7,"Rua Nova Santa Cruz",29,29,0,104,104,0
1,26,2019,9,0,7,"Braga",8,"Rua Costa Gomes",40,40,0,43,43,0
1,26,2019,10,0,7,"Braga",1,"Avenida da Liberdade",20,20,0,14,14,0
1,26,2019,10,0,7,"Braga",2,"Avenida Central",9,13,4,203,140,63
1,26,2019,10,0,7,"Braga",3,"Rua de Caires",35,35,0,38,38,0
1,26,2019,10,0,7,"Braga",4,"N14 Bosch",37,46,9,60,48,12
1,26,2019,10,0,7,"Braga",5,"Avenida João Paulo II",39,39,0,8,8,0
1,26,2019,10,0,7,"Braga",6,"Avenida Padre Júlio Fragata",61,61,0,21,21,0
1,26,2019,10,0,7,"Braga",7,"Rua Nova Santa Cruz",29,29,0,104,104,0
1,26,2019,10,0,7,"Braga",8,"Rua Costa Gomes",32,41,9,53,42,11
1,26,2019,11,0,7,"Braga",1,"Avenida da Liberdade",20,20,0,14,14,0
1,26,2019,11,0,7,"Braga",2,"Avenida Central",8,13,5,229,140,89
1,26,2019,11,0,7,"Braga",3,"Rua de Caires",15,36,21,89,37,52
1,26,2019,11,0,7,"Braga",4,"N14 Bosch",35,46,11,64,48,16
1,26,2019,11,0,7,"Braga",5,"Avenida João Paulo II",39,39,0,8,8,0
1,26,2019,11,0,7,"Braga",6,"Avenida Padre Júlio Fragata",61,61,0,21,21,0
1,26,2019,11,0,7,"Braga",7,"Rua Nova Santa Cruz",29,29,0,104,104,0
1,26,2019,11,0,7,"Braga",8,"Rua Costa Gomes",6,41,35,287,42,245
1,26,2019,12,0,7,"Braga",1,"Avenida da Liberdade",20,20,0,14,14,0
1,26,2019,12,0,7,"Braga",2,"Avenida Central",6,13,7,305,140,165
1,26,2019,12,0,7,"Braga",3,"Rua de Caires",27,35,8,49,38,11
1,26,2019,12,0,7,"Braga",4,"N14 Bosch",34,47,13,66,47,19
1,26,2019,12,0,7,"Braga",5,"Avenida João Paulo II",38,38,0,9,9,0
1,26,2019,12,0,7,"Braga",6,"Avenida Padre Júlio Fragata",48,62,14,26,20,6
1,26,2019,12,0,7,"Braga",7,"Rua Nova Santa Cruz",29,29,0,104,104,0
1,26,2019,12,0,7,"Braga",8,"Rua Costa Gomes",28,40,12,61,43,18
1,26,2019,13,0,7,"Braga",1,"Avenida da Liberdade",20,20,0,14,14,0
1,26,2019,13,0,7,"Braga",2,"Avenida Central",7,12,5,261,152,109
1,26,2019,13,0,7,"Braga",3,"Rua de Caires",36,36,0,37,37,0
1,26,2019,13,0,7,"Braga",4,"N14 Bosch",23,46,23,97,48,49
1,26,2019,13,0,7,"Braga",5,"Avenida João Paulo II",38,38,0,9,9,0
1,26,2019,13,0,7,"Braga",6,"Avenida Padre Júlio Fragata",43,61,18,29,21,8
1,26,2019,13,0,7,"Braga",7,"Rua Nova Santa Cruz",29,29,0,104,104,0
1,26,2019,13,0,7,"Braga",8,"Rua Costa Gomes",31,40,9,55,43,12
1,26,2019,14,0,7,"Braga",1,"Avenida da Liberdade",20,20,0,14,14,0
1,26,2019,14,0,7,"Braga",2,"Avenida Central",9,13,4,203,140,63
1,26,2019,14,0,7,"Braga",3,"Rua de Caires",35,35,0,38,38,0
1,26,2019,14,0,7,"Braga",4,"N14 Bosch",37,46,9,60,48,12
1,26,2019,14,0,7,"Braga",5,"Avenida João Paulo II",38,38,0,9,9,0
1,26,2019,14,0,7,"Braga",6,"Avenida Padre Júlio Fragata",61,61,0,21,21,0
1,26,2019,14,0,7,"Braga",7,"Rua Nova Santa Cruz",29,29,0,104,104,0
1,26,2019,14,0,7,"Braga",8,"Rua Costa Gomes",41,41,0,42,42,0
1,26,2019,15,0,7,"Braga",1,"Avenida da Liberdade",20,20,0,14,14,0
1,26,2019,15,0,7,"Braga",2,"Avenida Central",8,13,5,229,140,89
1,26,2019,15,0,7,"Braga",3,"Rua de Caires",24,36,12,56,37,19
1,26,2019,15,0,7,"Braga",4,"N14 Bosch",47,47,0,47,47,0
1,26,2019,15,0,7,"Braga",5,"Avenida João Paulo II",39,39,0,8,8,0
1,26,2019,15,0,7,"Braga",6,"Avenida Padre Júlio Fragata",62,62,0,20,20,0
1,26,2019,15,0,7,"Braga",7,"Rua Nova Santa Cruz",29,29,0,104,104,0
1,26,2019,15,0,7,"Braga",8,"Rua Costa Gomes",24,40,16,71,43,28
1,26,2019,16,0,7,"Braga",1,"Avenida da Liberdade",20,20,0,14,14,0
1,26,2019,16,0,7,"Braga",2,"Avenida Central",7,13,6,261,140,121
1,26,2019,16,0,7,"Braga",3,"Rua de Caires",36,36,0,37,37,0
1,26,2019,16,0,7,"Braga",4,"N14 Bosch",47,47,0,47,47,0
1,26,2019,16,0,7,"Braga",5,"Avenida João Paulo II",24,39,15,14,8,6
1,26,2019,16,0,7,"Braga",6,"Avenida Padre Júlio Fragata",62,62,0,20,20,0
1,26,2019,16,0,7,"Braga",7,"Rua Nova Santa Cruz",28,28,0,108,108,0
1,26,2019,16,0,7,"Braga",8,"Rua Costa Gomes",41,41,0,42,42,0
1,26,2019,17,0,7,"Braga",1,"Avenida da Liberdade",20,20,0,14,14,0
1,26,2019,17,0,7,"Braga",2,"Avenida Central",7,14,7,261,130,131
1,26,2019,17,0,7,"Braga",3,"Rua de Caires",25,36,11,53,37,16
1,26,2019,17,0,7,"Braga",4,"N14 Bosch",26,47,21,86,47,39
1,26,2019,17,0,7,"Braga",5,"Avenida João Paulo II",28,39,11,12,8,4
1,26,2019,17,0,7,"Braga",6,"Avenida Padre Júlio Fragata",62,62,0,20,20,0
1,26,2019,17,0,7,"Braga",7,"Rua Nova Santa Cruz",28,28,0,108,108,0
1,26,2019,17,0,7,"Braga",8,"Rua Costa Gomes",31,41,10,55,42,13
1,26,2019,18,0,7,"Braga",1,"Avenida da Liberdade",20,20,0,14,14,0
1,26,2019,18,0,7,"Braga",2,"Avenida Central",5,12,7,366,152,214
1,26,2019,18,0,7,"Braga",3,"Rua de Caires",24,36,12,56,37,19
1,26,2019,18,0,7,"Braga",4,"N14 Bosch",21,47,26,107,47,60
1,26,2019,18,0,7,"Braga",5,"Avenida João Paulo II",6,38,32,58,9,49
1,26,2019,18,0,7,"Braga",6,"Avenida Padre Júlio Fragata",10,63,53,128,20,108
1,26,2019,18,0,7,"Braga",7,"Rua Nova Santa Cruz",29,29,0,104,104,0
1,26,2019,18,0,7,"Braga",8,"Rua Costa Gomes",18,41,23,95,42,53
1,26,2019,19,0,7,"Braga",1,"Avenida da Liberdade",20,20,0,14,14,0
1,26,2019,19,0,7,"Braga",2,"Avenida Central",6,13,7,305,140,165
1,26,2019,19,0,7,"Braga",3,"Rua de Caires",28,35,7,48,38,10
1,26,2019,19,0,7,"Braga",4,"N14 Bosch",26,47,21,86,47,39
1,26,2019,19,0,7,"Braga",5,"Avenida João Paulo II",28,38,10,12,9,3
1,26,2019,19,0,7,"Braga",6,"Avenida Padre Júlio Fragata",9,59,50,142,21,121
1,26,2019,19,0,7,"Braga",7,"Rua Nova Santa Cruz",29,29,0,104,104,0
1,26,2019,19,0,7,"Braga",8,"Rua Costa Gomes",7,43,36,246,40,206
1,26,2019,20,0,7,"Braga",1,"Avenida da Liberdade",20,20,0,14,14,0
1,26,2019,20,0,7,"Braga",2,"Avenida Central",9,12,3,203,152,51
1,26,2019,20,0,7,"Braga",3,"Rua de Caires",36,36,0,37,37,0
1,26,2019,20,0,7,"Braga",4,"N14 Bosch",47,47,0,47,47,0
1,26,2019,20,0,7,"Braga",5,"Avenida João Paulo II",39,39,0,8,8,0
1,26,2019,20,0,7,"Braga",6,"Avenida Padre Júlio Fragata",49,61,12,26,21,5
1,26,2019,20,0,7,"Braga",7,"Rua Nova Santa Cruz",29,29,0,104,104,0
1,26,2019,20,0,7,"Braga",8,"Rua Costa Gomes",32,40,8,53,43,10
1,26,2019,21,0,7,"Braga",1,"Avenida da Liberdade",20,20,0,14,14,0
1,26,2019,21,0,7,"Braga",2,"Avenida Central",13,13,0,140,140,0
1,26,2019,21,0,7,"Braga",3,"Rua de Caires",34,34,0,39,39,0
1,26,2019,21,0,7,"Braga",4,"N14 Bosch",48,48,0,46,46,0
1,26,2019,21,0,7,"Braga",5,"Avenida João Paulo II",38,38,0,9,9,0
1,26,2019,21,0,7,"Braga",6,"Avenida Padre Júlio Fragata",26,61,35,49,21,28
1,26,2019,21,0,7,"Braga",7,"Rua Nova Santa Cruz",22,29,7,138,104,34
1,26,2019,21,0,7,"Braga",8,"Rua Costa Gomes",41,41,0,42,42,0
1,26,2019,22,0,7,"Braga",1,"Avenida da Liberdade",20,20,0,14,14,0
1,26,2019,22,0,7,"Braga",2,"Avenida Central",10,13,3,183,140,43
1,26,2019,22,0,7,"Braga",3,"Rua de Caires",37,37,0,36,36,0
1,26,2019,22,0,7,"Braga",4,"N14 Bosch",48,48,0,46,46,0
1,26,2019,22,0,7,"Braga",5,"Avenida João Paulo II",38,38,0,9,9,0
1,26,2019,22,0,7,"Braga",6,"Avenida Padre Júlio Fragata",61,61,0,21,21,0
1,26,2019,22,0,7,"Braga",7,"Rua Nova Santa Cruz",28,28,0,108,108,0
1,26,2019,22,0,7,"Braga",8,"Rua Costa Gomes",41,41,0,42,42,0
1,26,2019,23,0,7,"Braga",1,"Avenida da Liberdade",11,19,8,25,14,11
1,26,2019,23,0,7,"Braga",2,"Avenida Central",13,13,0,140,140,0
1,26,2019,23,0,7,"Braga",3,"Rua de Caires",28,35,7,48,38,10
1,26,2019,23,0,7,"Braga",4,"N14 Bosch",48,48,0,46,46,0
1,26,2019,23,0,7,"Braga",5,"Avenida João Paulo II",38,38,0,9,9,0
1,26,2019,23,0,7,"Braga",6,"Avenida Padre Júlio Fragata",61,61,0,21,21,0
1,26,2019,23,0,7,"Braga",7,"Rua Nova Santa Cruz",28,28,0,108,108,0
1,26,2019,23,0,7,"Braga",8,"Rua Costa Gomes",41,41,0,42,42,0
1,27,2019,0,0,8,"Braga",1,"Avenida da Liberdade",20,20,0,14,14,0
1,27,2019,0,0,8,"Braga",2,"Avenida Central",13,13,0,140,140,0
1,27,2019,0,0,8,"Braga",3,"Rua de Caires",35,35,0,38,38,0
1,27,2019,0,0,8,"Braga",4,"N14 Bosch",47,47,0,47,47,0
1,27,2019,0,0,8,"Braga",5,"Avenida João Paulo II",38,38,0,9,9,0
1,27,2019,0,0,8,"Braga",6,"Avenida Padre Júlio Fragata",62,62,0,20,20,0
1,27,2019,0,0,8,"Braga",7,"Rua Nova Santa Cruz",29,29,0,104,104,0
1,27,2019,0,0,8,"Braga",8,"Rua Costa Gomes",29,41,12,59,42,17
1,27,2019,1,0,8,"Braga",1,"Avenida da Liberdade",20,20,0,14,14,0
1,27,2019,1,0,8,"Braga",2,"Avenida Central",12,12,0,152,152,0
1,27,2019,1,0,8,"Braga",3,"Rua de Caires",35,35,0,38,38,0
1,27,2019,1,0,8,"Braga",4,"N14 Bosch",47,47,0,47,47,0
1,27,2019,1,0,8,"Braga",5,"Avenida João Paulo II",38,38,0,9,9,0
1,27,2019,1,0,8,"Braga",6,"Avenida Padre Júlio Fragata",62,62,0,20,20,0
1,27,2019,1,0,8,"Braga",7,"Rua Nova Santa Cruz",28,28,0,108,108,0
1,27,2019,1,0,8,"Braga",8,"Rua Costa Gomes",40,40,0,43,43,0
1,27,2019,2,0,8,"Braga",1,"Avenida da Liberdade",20,20,0,14,14,0
1,27,2019,2,0,8,"Braga",2,"Avenida Central",12,12,0,152,152,0
1,27,2019,2,0,8,"Braga",3,"Rua de Caires",35,35,0,38,38,0
1,27,2019,2,0,8,"Braga",4,"N14 Bosch",47,47,0,47,47,0
1,27,2019,2,0,8,"Braga",5,"Avenida João Paulo II",38,38,0,9,9,0
1,27,2019,2,0,8,"Braga",6,"Avenida Padre Júlio Fragata",62,62,0,20,20,0
1,27,2019,2,0,8,"Braga",7,"Rua Nova Santa Cruz",28,28,0,108,108,0
1,27,2019,2,0,8,"Braga",8,"Rua Costa Gomes",40,40,0,43,43,0
1,27,2019,3,0,8,"Braga",6,"Avenida Padre Júlio Fragata",62,62,0,20,20,0
1,27,2019,3,0,8,"Braga",7,"Rua Nova Santa Cruz",28,28,0,108,108,0
1,27,2019,3,0,8,"Braga",8,"Rua Costa Gomes",40,40,0,43,43,0
1,27,2019,3,0,8,"Braga",1,"Avenida da Liberdade",20,20,0,14,14,0
1,27,2019,3,0,8,"Braga",2,"Avenida Central",12,12,0,152,152,0
1,27,2019,3,0,8,"Braga",3,"Rua de Caires",35,35,0,38,38,0
1,27,2019,3,0,8,"Braga",4,"N14 Bosch",47,47,0,47,47,0
1,27,2019,3,0,8,"Braga",5,"Avenida João Paulo II",38,38,0,9,9,0
1,27,2019,3,0,8,"Braga",6,"Avenida Padre Júlio Fragata",62,62,0,20,20,0
1,27,2019,4,0,8,"Braga",1,"Avenida da Liberdade",20,20,0,14,14,0
1,27,2019,4,0,8,"Braga",2,"Avenida Central",12,12,0,152,152,0
1,27,2019,4,0,8,"Braga",3,"Rua de Caires",35,35,0,38,38,0
1,27,2019,4,0,8,"Braga",4,"N14 Bosch",47,47,0,47,47,0
1,27,2019,4,0,8,"Braga",5,"Avenida João Paulo II",38,38,0,9,9,0
1,27,2019,4,0,8,"Braga",6,"Avenida Padre Júlio Fragata",62,62,0,20,20,0
1,27,2019,4,0,8,"Braga",7,"Rua Nova Santa Cruz",28,28,0,108,108,0
1,27,2019,4,0,8,"Braga",8,"Rua Costa Gomes",40,40,0,43,43,0
1,27,2019,5,0,8,"Braga",1,"Avenida da Liberdade",20,20,0,14,14,0
1,27,2019,5,0,8,"Braga",2,"Avenida Central",12,12,0,152,152,0
1,27,2019,5,0,8,"Braga",3,"Rua de Caires",35,35,0,38,38,0
1,27,2019,5,0,8,"Braga",4,"N14 Bosch",47,47,0,47,47,0
1,27,2019,5,0,8,"Braga",5,"Avenida João Paulo II",38,38,0,9,9,0
1,27,2019,5,0,8,"Braga",6,"Avenida Padre Júlio Fragata",62,62,0,20,20,0
1,27,2019,5,0,8,"Braga",7,"Rua Nova Santa Cruz",28,28,0,108,108,0
1,27,2019,5,0,8,"Braga",8,"Rua Costa Gomes",40,40,0,43,43,0
1,27,2019,6,0,8,"Braga",1,"Avenida da Liberdade",20,20,0,14,14,0
1,27,2019,6,0,8,"Braga",2,"Avenida Central",12,12,0,152,152,0
1,27,2019,6,0,8,"Braga",3,"Rua de Caires",35,35,0,38,38,0
1,27,2019,6,0,8,"Braga",4,"N14 Bosch",47,47,0,47,47,0
1,27,2019,6,0,8,"Braga",5,"Avenida João Paulo II",38,38,0,9,9,0
1,27,2019,6,0,8,"Braga",6,"Avenida Padre Júlio Fragata",62,62,0,20,20,0
1,27,2019,6,0,8,"Braga",7,"Rua Nova Santa Cruz",28,28,0,108,108,0
1,27,2019,6,0,8,"Braga",8,"Rua Costa Gomes",40,40,0,43,43,0
1,27,2019,7,0,8,"Braga",1,"Avenida da Liberdade",20,20,0,14,14,0
1,27,2019,7,0,8,"Braga",2,"Avenida Central",12,12,0,152,152,0
1,27,2019,7,0,8,"Braga",3,"Rua de Caires",35,35,0,38,38,0
1,27,2019,7,0,8,"Braga",4,"N14 Bosch",47,47,0,47,47,0
1,27,2019,7,0,8,"Braga",5,"Avenida João Paulo II",38,38,0,9,9,0
1,27,2019,7,0,8,"Braga",6,"Avenida Padre Júlio Fragata",62,62,0,20,20,0
1,27,2019,7,0,8,"Braga",7,"Rua Nova Santa Cruz",28,28,0,108,108,0
1,27,2019,7,0,8,"Braga",8,"Rua Costa Gomes",40,40,0,43,43,0
1,27,2019,8,0,8,"Braga",1,"Avenida da Liberdade",20,20,0,14,14,0
1,27,2019,8,0,8,"Braga",2,"Avenida Central",12,12,0,152,152,0
1,27,2019,8,0,8,"Braga",3,"Rua de Caires",35,35,0,38,38,0
1,27,2019,8,0,8,"Braga",4,"N14 Bosch",47,47,0,47,47,0
1,27,2019,8,0,8,"Braga",5,"Avenida João Paulo II",38,38,0,9,9,0
1,27,2019,8,0,8,"Braga",6,"Avenida Padre Júlio Fragata",62,62,0,20,20,0
1,27,2019,8,0,8,"Braga",7,"Rua Nova Santa Cruz",28,28,0,108,108,0
1,27,2019,8,0,8,"Braga",8,"Rua Costa Gomes",40,40,0,43,43,0
1,27,2019,9,0,8,"Braga",1,"Avenida da Liberdade",20,20,0,14,14,0
1,27,2019,9,0,8,"Braga",2,"Avenida Central",12,12,0,152,152,0
1,27,2019,9,0,8,"Braga",3,"Rua de Caires",35,35,0,38,38,0
1,27,2019,9,0,8,"Braga",4,"N14 Bosch",47,47,0,47,47,0
1,27,2019,9,0,8,"Braga",5,"Avenida João Paulo II",38,38,0,9,9,0
1,27,2019,9,0,8,"Braga",6,"Avenida Padre Júlio Fragata",62,62,0,20,20,0
1,27,2019,9,0,8,"Braga",7,"Rua Nova Santa Cruz",28,28,0,108,108,0
1,27,2019,9,0,8,"Braga",8,"Rua Costa Gomes",40,40,0,43,43,0
1,27,2019,10,0,8,"Braga",1,"Avenida da Liberdade",20,20,0,14,14,0
1,27,2019,10,0,8,"Braga",2,"Avenida Central",12,12,0,152,152,0
1,27,2019,10,0,8,"Braga",3,"Rua de Caires",35,35,0,38,38,0
1,27,2019,10,0,8,"Braga",4,"N14 Bosch",47,47,0,47,47,0
1,27,2019,10,0,8,"Braga",5,"Avenida João Paulo II",38,38,0,9,9,0
1,27,2019,10,0,8,"Braga",6,"Avenida Padre Júlio Fragata",62,62,0,20,20,0
1,27,2019,10,0,8,"Braga",7,"Rua Nova Santa Cruz",28,28,0,108,108,0
1,27,2019,10,0,8,"Braga",8,"Rua Costa Gomes",40,40,0,43,43,0
1,27,2019,11,0,8,"Braga",1,"Avenida da Liberdade",20,20,0,14,14,0
1,27,2019,11,0,8,"Braga",2,"Avenida Central",12,12,0,152,152,0
1,27,2019,11,0,8,"Braga",3,"Rua de Caires",35,35,0,38,38,0
1,27,2019,11,0,8,"Braga",4,"N14 Bosch",47,47,0,47,47,0
1,27,2019,11,0,8,"Braga",5,"Avenida João Paulo II",38,38,0,9,9,0
1,27,2019,11,0,8,"Braga",6,"Avenida Padre Júlio Fragata",62,62,0,20,20,0
1,27,2019,11,0,8,"Braga",7,"Rua Nova Santa Cruz",28,28,0,108,108,0
1,27,2019,11,0,8,"Braga",8,"Rua Costa Gomes",40,40,0,43,43,0
1,27,2019,12,0,8,"Braga",1,"Avenida da Liberdade",20,20,0,14,14,0
1,27,2019,12,0,8,"Braga",2,"Avenida Central",12,12,0,152,152,0
1,27,2019,12,0,8,"Braga",3,"Rua de Caires",26,35,9,51,38,13
1,27,2019,12,0,8,"Braga",4,"N14 Bosch",47,47,0,47,47,0
1,27,2019,12,0,8,"Braga",5,"Avenida João Paulo II",38,38,0,9,9,0
1,27,2019,12,0,8,"Braga",6,"Avenida Padre Júlio Fragata",40,61,21,32,21,11
1,27,2019,12,0,8,"Braga",7,"Rua Nova Santa Cruz",28,28,0,108,108,0
1,27,2019,12,0,8,"Braga",8,"Rua Costa Gomes",40,40,0,43,43,0
1,27,2019,13,0,8,"Braga",1,"Avenida da Liberdade",20,20,0,14,14,0
1,27,2019,13,0,8,"Braga",2,"Avenida Central",10,13,3,183,140,43
1,27,2019,13,0,8,"Braga",3,"Rua de Caires",11,36,25,122,37,85
1,27,2019,13,0,8,"Braga",4,"N14 Bosch",46,46,0,48,48,0
1,27,2019,13,0,8,"Braga",5,"Avenida João Paulo II",39,39,0,8,8,0
1,27,2019,13,0,8,"Braga",6,"Avenida Padre Júlio Fragata",61,61,0,21,21,0
1,27,2019,13,0,8,"Braga",7,"Rua Nova Santa Cruz",28,28,0,108,108,0
1,27,2019,13,0,8,"Braga",8,"Rua Costa Gomes",40,40,0,43,43,0
1,27,2019,14,0,8,"Braga",1,"Avenida da Liberdade",20,20,0,14,14,0
1,27,2019,14,0,8,"Braga",2,"Avenida Central",12,12,0,152,152,0
1,27,2019,14,0,8,"Braga",3,"Rua de Caires",36,36,0,37,37,0
1,27,2019,14,0,8,"Braga",4,"N14 Bosch",47,47,0,47,47,0
1,27,2019,14,0,8,"Braga",5,"Avenida João Paulo II",39,39,0,8,8,0
1,27,2019,14,0,8,"Braga",6,"Avenida Padre Júlio Fragata",38,62,24,33,20,13
1,27,2019,14,0,8,"Braga",7,"Rua Nova Santa Cruz",28,28,0,108,108,0
1,27,2019,14,0,8,"Braga",8,"Rua Costa Gomes",31,40,9,55,43,12
1,27,2019,15,0,8,"Braga",8,"Rua Costa Gomes",28,41,13,61,42,19
1,27,2019,15,0,8,"Braga",1,"Avenida da Liberdade",20,20,0,14,14,0
1,27,2019,15,0,8,"Braga",2,"Avenida Central",9,12,3,203,152,51
1,27,2019,15,0,8,"Braga",3,"Rua de Caires",36,36,0,37,37,0
1,27,2019,15,0,8,"Braga",4,"N14 Bosch",34,46,12,66,48,18
1,27,2019,15,0,8,"Braga",5,"Avenida João Paulo II",29,38,9,12,9,3
1,27,2019,15,0,8,"Braga",6,"Avenida Padre Júlio Fragata",48,61,13,26,21,5
1,27,2019,15,0,8,"Braga",7,"Rua Nova Santa Cruz",28,28,0,108,108,0
1,27,2019,15,0,8,"Braga",8,"Rua Costa Gomes",28,41,13,61,42,19
1,27,2019,16,0,8,"Braga",1,"Avenida da Liberdade",20,20,0,14,14,0
1,27,2019,16,0,8,"Braga",2,"Avenida Central",6,13,7,305,140,165
1,27,2019,16,0,8,"Braga",3,"Rua de Caires",36,36,0,37,37,0
1,27,2019,16,0,8,"Braga",4,"N14 Bosch",47,47,0,47,47,0
1,27,2019,16,0,8,"Braga",5,"Avenida João Paulo II",20,39,19,17,8,9
1,27,2019,16,0,8,"Braga",6,"Avenida Padre Júlio Fragata",40,61,21,32,21,11
1,27,2019,16,0,8,"Braga",7,"Rua Nova Santa Cruz",28,28,0,108,108,0
1,27,2019,16,0,8,"Braga",8,"Rua Costa Gomes",40,40,0,43,43,0
1,27,2019,17,0,8,"Braga",1,"Avenida da Liberdade",20,20,0,14,14,0
1,27,2019,17,0,8,"Braga",2,"Avenida Central",5,12,7,366,152,214
1,27,2019,17,0,8,"Braga",3,"Rua de Caires",36,36,0,37,37,0
1,27,2019,17,0,8,"Braga",4,"N14 Bosch",36,47,11,62,47,15
1,27,2019,17,0,8,"Braga",5,"Avenida João Paulo II",39,39,0,8,8,0
1,27,2019,17,0,8,"Braga",6,"Avenida Padre Júlio Fragata",30,61,31,42,21,21
1,27,2019,17,0,8,"Braga",7,"Rua Nova Santa Cruz",28,28,0,108,108,0
1,27,2019,17,0,8,"Braga",8,"Rua Costa Gomes",31,40,9,55,43,12
1,27,2019,18,0,8,"Braga",1,"Avenida da Liberdade",20,20,0,14,14,0
1,27,2019,18,0,8,"Braga",2,"Avenida Central",9,12,3,203,152,51
1,27,2019,18,0,8,"Braga",3,"Rua de Caires",14,36,22,96,37,59
1,27,2019,18,0,8,"Braga",4,"N14 Bosch",33,46,13,68,48,20
1,27,2019,18,0,8,"Braga",5,"Avenida João Paulo II",25,39,14,13,8,5
1,27,2019,18,0,8,"Braga",6,"Avenida Padre Júlio Fragata",31,62,31,41,20,21
1,27,2019,18,0,8,"Braga",7,"Rua Nova Santa Cruz",28,28,0,108,108,0
1,27,2019,18,0,8,"Braga",8,"Rua Costa Gomes",22,40,18,78,43,35
1,27,2019,19,0,8,"Braga",1,"Avenida da Liberdade",20,20,0,14,14,0
1,27,2019,19,0,8,"Braga",2,"Avenida Central",13,13,0,140,140,0
1,27,2019,19,0,8,"Braga",3,"Rua de Caires",28,35,7,48,38,10
1,27,2019,19,0,8,"Braga",4,"N14 Bosch",46,46,0,48,48,0
1,27,2019,19,0,8,"Braga",5,"Avenida João Paulo II",38,38,0,9,9,0
1,27,2019,19,0,8,"Braga",6,"Avenida Padre Júlio Fragata",40,62,22,32,20,12
1,27,2019,19,0,8,"Braga",7,"Rua Nova Santa Cruz",28,28,0,108,108,0
1,27,2019,19,0,8,"Braga",8,"Rua Costa Gomes",25,41,16,69,42,27
1,27,2019,20,0,8,"Braga",1,"Avenida da Liberdade",20,20,0,14,14,0
1,27,2019,20,0,8,"Braga",2,"Avenida Central",12,12,0,152,152,0
1,27,2019,20,0,8,"Braga",3,"Rua de Caires",36,36,0,37,37,0
1,27,2019,20,0,8,"Braga",4,"N14 Bosch",46,46,0,48,48,0
1,27,2019,20,0,8,"Braga",5,"Avenida João Paulo II",38,38,0,9,9,0
1,27,2019,20,0,8,"Braga",6,"Avenida Padre Júlio Fragata",48,62,14,26,20,6
1,27,2019,20,0,8,"Braga",7,"Rua Nova Santa Cruz",28,28,0,108,108,0
1,27,2019,20,0,8,"Braga",8,"Rua Costa Gomes",41,41,0,42,42,0
1,27,2019,21,0,8,"Braga",7,"Rua Nova Santa Cruz",28,28,0,108,108,0
1,27,2019,21,0,8,"Braga",8,"Rua Costa Gomes",41,41,0,42,42,0
1,27,2019,21,0,8,"Braga",1,"Avenida da Liberdade",20,20,0,14,14,0
1,27,2019,21,0,8,"Braga",2,"Avenida Central",10,12,2,183,152,31
1,27,2019,21,0,8,"Braga",3,"Rua de Caires",36,36,0,37,37,0
1,27,2019,21,0,8,"Braga",4,"N14 Bosch",46,46,0,48,48,0
1,27,2019,21,0,8,"Braga",5,"Avenida João Paulo II",38,38,0,9,9,0
1,27,2019,21,0,8,"Braga",6,"Avenida Padre Júlio Fragata",61,61,0,21,21,0
1,27,2019,21,0,8,"Braga",7,"Rua Nova Santa Cruz",28,28,0,108,108,0
1,27,2019,22,0,8,"Braga",1,"Avenida da Liberdade",20,20,0,14,14,0
1,27,2019,22,0,8,"Braga",2,"Avenida Central",12,12,0,152,152,0
1,27,2019,22,0,8,"Braga",3,"Rua de Caires",38,38,0,35,35,0
1,27,2019,22,0,8,"Braga",4,"N14 Bosch",46,46,0,48,48,0
1,27,2019,22,0,8,"Braga",5,"Avenida João Paulo II",38,38,0,9,9,0
1,27,2019,22,0,8,"Braga",6,"Avenida Padre Júlio Fragata",62,62,0,20,20,0
1,27,2019,22,0,8,"Braga",7,"Rua Nova Santa Cruz",28,28,0,108,108,0
1,27,2019,22,0,8,"Braga",8,"Rua Costa Gomes",41,41,0,42,42,0
1,27,2019,23,0,8,"Braga",1,"Avenida da Liberdade",20,20,0,14,14,0
1,27,2019,23,0,8,"Braga",2,"Avenida Central",12,12,0,152,152,0
1,27,2019,23,0,8,"Braga",3,"Rua de Caires",38,38,0,35,35,0
1,27,2019,23,0,8,"Braga",4,"N14 Bosch",46,46,0,48,48,0
1,27,2019,23,0,8,"Braga",5,"Avenida João Paulo II",38,38,0,9,9,0
1,27,2019,23,0,8,"Braga",6,"Avenida Padre Júlio Fragata",62,62,0,20,20,0
1,27,2019,23,0,8,"Braga",7,"Rua Nova Santa Cruz",28,28,0,108,108,0
1,27,2019,23,0,8,"Braga",8,"Rua Costa Gomes",41,41,0,42,42,0
1,28,2019,0,0,2,"Braga",1,"Avenida da Liberdade",20,20,0,14,14,0
1,28,2019,0,0,2,"Braga",2,"Avenida Central",12,12,0,152,152,0
1,28,2019,0,0,2,"Braga",3,"Rua de Caires",38,38,0,35,35,0
1,28,2019,0,0,2,"Braga",4,"N14 Bosch",46,46,0,48,48,0
1,28,2019,0,0,2,"Braga",5,"Avenida João Paulo II",38,38,0,9,9,0
1,28,2019,0,0,2,"Braga",6,"Avenida Padre Júlio Fragata",62,62,0,20,20,0
1,28,2019,0,0,2,"Braga",7,"Rua Nova Santa Cruz",28,28,0,108,108,0
1,28,2019,0,0,2,"Braga",8,"Rua Costa Gomes",41,41,0,42,42,0
1,28,2019,1,0,2,"Braga",1,"Avenida da Liberdade",20,20,0,14,14,0
1,28,2019,1,0,2,"Braga",2,"Avenida Central",12,12,0,152,152,0
1,28,2019,1,0,2,"Braga",3,"Rua de Caires",38,38,0,35,35,0
1,28,2019,1,0,2,"Braga",4,"N14 Bosch",46,46,0,48,48,0
1,28,2019,1,0,2,"Braga",5,"Avenida João Paulo II",38,38,0,9,9,0
1,28,2019,1,0,2,"Braga",6,"Avenida Padre Júlio Fragata",62,62,0,20,20,0
1,28,2019,1,0,2,"Braga",7,"Rua Nova Santa Cruz",28,28,0,108,108,0
1,28,2019,1,0,2,"Braga",8,"Rua Costa Gomes",41,41,0,42,42,0
1,28,2019,2,0,2,"Braga",1,"Avenida da Liberdade",20,20,0,14,14,0
1,28,2019,2,0,2,"Braga",2,"Avenida Central",12,12,0,152,152,0
1,28,2019,2,0,2,"Braga",3,"Rua de Caires",38,38,0,35,35,0
1,28,2019,2,0,2,"Braga",4,"N14 Bosch",46,46,0,48,48,0
1,28,2019,2,0,2,"Braga",5,"Avenida João Paulo II",38,38,0,9,9,0
1,28,2019,2,0,2,"Braga",6,"Avenida Padre Júlio Fragata",62,62,0,20,20,0
1,28,2019,2,0,2,"Braga",7,"Rua Nova Santa Cruz",28,28,0,108,108,0
1,28,2019,2,0,2,"Braga",8,"Rua Costa Gomes",41,41,0,42,42,0
1,28,2019,3,0,2,"Braga",1,"Avenida da Liberdade",20,20,0,14,14,0
1,28,2019,3,0,2,"Braga",2,"Avenida Central",12,12,0,152,152,0
1,28,2019,3,0,2,"Braga",3,"Rua de Caires",38,38,0,35,35,0
1,28,2019,3,0,2,"Braga",4,"N14 Bosch",46,46,0,48,48,0
1,28,2019,3,0,2,"Braga",5,"Avenida João Paulo II",38,38,0,9,9,0
1,28,2019,3,0,2,"Braga",6,"Avenida Padre Júlio Fragata",62,62,0,20,20,0
1,28,2019,3,0,2,"Braga",7,"Rua Nova Santa Cruz",28,28,0,108,108,0
1,28,2019,3,0,2,"Braga",8,"Rua Costa Gomes",41,41,0,42,42,0
1,28,2019,4,0,2,"Braga",1,"Avenida da Liberdade",20,20,0,14,14,0
1,28,2019,4,0,2,"Braga",2,"Avenida Central",12,12,0,152,152,0
1,28,2019,4,0,2,"Braga",3,"Rua de Caires",38,38,0,35,35,0
1,28,2019,4,0,2,"Braga",4,"N14 Bosch",46,46,0,48,48,0
1,28,2019,4,0,2,"Braga",5,"Avenida João Paulo II",38,38,0,9,9,0
1,28,2019,4,0,2,"Braga",6,"Avenida Padre Júlio Fragata",62,62,0,20,20,0
1,28,2019,4,0,2,"Braga",7,"Rua Nova Santa Cruz",28,28,0,108,108,0
1,28,2019,4,0,2,"Braga",8,"Rua Costa Gomes",41,41,0,42,42,0
1,28,2019,5,0,2,"Braga",1,"Avenida da Liberdade",20,20,0,14,14,0
1,28,2019,5,0,2,"Braga",2,"Avenida Central",12,12,0,152,152,0
1,28,2019,5,0,2,"Braga",3,"Rua de Caires",38,38,0,35,35,0
1,28,2019,5,0,2,"Braga",4,"N14 Bosch",46,46,0,48,48,0
1,28,2019,5,0,2,"Braga",5,"Avenida João Paulo II",38,38,0,9,9,0
1,28,2019,5,0,2,"Braga",6,"Avenida Padre Júlio Fragata",62,62,0,20,20,0
1,28,2019,5,0,2,"Braga",7,"Rua Nova Santa Cruz",28,28,0,108,108,0
1,28,2019,5,0,2,"Braga",8,"Rua Costa Gomes",41,41,0,42,42,0
1,28,2019,6,0,2,"Braga",1,"Avenida da Liberdade",20,20,0,14,14,0
1,28,2019,6,0,2,"Braga",2,"Avenida Central",12,12,0,152,152,0
1,28,2019,6,0,2,"Braga",3,"Rua de Caires",38,38,0,35,35,0
1,28,2019,6,0,2,"Braga",4,"N14 Bosch",46,46,0,48,48,0
1,28,2019,6,0,2,"Braga",5,"Avenida João Paulo II",38,38,0,9,9,0
1,28,2019,6,0,2,"Braga",6,"Avenida Padre Júlio Fragata",62,62,0,20,20,0
1,28,2019,6,0,2,"Braga",7,"Rua Nova Santa Cruz",28,28,0,108,108,0
1,28,2019,6,0,2,"Braga",8,"Rua Costa Gomes",41,41,0,42,42,0
1,28,2019,7,0,2,"Braga",1,"Avenida da Liberdade",20,20,0,14,14,0
1,28,2019,7,0,2,"Braga",2,"Avenida Central",12,12,0,152,152,0
1,28,2019,7,0,2,"Braga",3,"Rua de Caires",38,38,0,35,35,0
1,28,2019,7,0,2,"Braga",4,"N14 Bosch",46,46,0,48,48,0
1,28,2019,7,0,2,"Braga",5,"Avenida João Paulo II",38,38,0,9,9,0
1,28,2019,7,0,2,"Braga",6,"Avenida Padre Júlio Fragata",62,62,0,20,20,0
1,28,2019,7,0,2,"Braga",7,"Rua Nova Santa Cruz",28,28,0,108,108,0
1,28,2019,7,0,2,"Braga",8,"Rua Costa Gomes",41,41,0,42,42,0
1,28,2019,8,0,2,"Braga",1,"Avenida da Liberdade",20,20,0,14,14,0
1,28,2019,8,0,2,"Braga",2,"Avenida Central",10,12,2,183,152,31
1,28,2019,8,0,2,"Braga",3,"Rua de Caires",28,36,8,48,37,11
1,28,2019,8,0,2,"Braga",4,"N14 Bosch",46,46,0,48,48,0
1,28,2019,8,0,2,"Braga",5,"Avenida João Paulo II",38,38,0,9,9,0
1,28,2019,8,0,2,"Braga",6,"Avenida Padre Júlio Fragata",62,62,0,20,20,0
1,28,2019,8,0,2,"Braga",7,"Rua Nova Santa Cruz",28,28,0,108,108,0
1,28,2019,8,0,2,"Braga",8,"Rua Costa Gomes",41,41,0,42,42,0
1,28,2019,9,0,2,"Braga",1,"Avenida da Liberdade",20,20,0,14,14,0
1,28,2019,9,0,2,"Braga",2,"Avenida Central",7,12,5,261,152,109
1,28,2019,9,0,2,"Braga",3,"Rua de Caires",26,35,9,51,38,13
1,28,2019,9,0,2,"Braga",4,"N14 Bosch",24,47,23,93,47,46
1,28,2019,9,0,2,"Braga",5,"Avenida João Paulo II",11,40,29,31,8,23
1,28,2019,9,0,2,"Braga",6,"Avenida Padre Júlio Fragata",35,62,27,36,20,16
1,28,2019,9,0,2,"Braga",7,"Rua Nova Santa Cruz",20,28,8,152,108,44
1,28,2019,9,0,2,"Braga",8,"Rua Costa Gomes",26,40,14,66,43,23
1,28,2019,10,0,2,"Braga",1,"Avenida da Liberdade",20,20,0,14,14,0
1,28,2019,10,0,2,"Braga",2,"Avenida Central",10,13,3,183,140,43
1,28,2019,10,0,2,"Braga",3,"Rua de Caires",26,36,10,51,37,14
1,28,2019,10,0,2,"Braga",4,"N14 Bosch",35,47,12,64,47,17
1,28,2019,10,0,2,"Braga",5,"Avenida João Paulo II",38,38,0,9,9,0
1,28,2019,10,0,2,"Braga",6,"Avenida Padre Júlio Fragata",61,61,0,21,21,0
1,28,2019,10,0,2,"Braga",7,"Rua Nova Santa Cruz",29,29,0,104,104,0
1,28,2019,10,0,2,"Braga",8,"Rua Costa Gomes",31,41,10,55,42,13
1,28,2019,11,0,2,"Braga",1,"Avenida da Liberdade",20,20,0,14,14,0
1,28,2019,11,0,2,"Braga",2,"Avenida Central",5,12,7,366,152,214
1,28,2019,11,0,2,"Braga",3,"Rua de Caires",24,35,11,56,38,18
1,28,2019,11,0,2,"Braga",4,"N14 Bosch",35,47,12,64,47,17
1,28,2019,11,0,2,"Braga",5,"Avenida João Paulo II",38,38,0,9,9,0
1,28,2019,11,0,2,"Braga",6,"Avenida Padre Júlio Fragata",49,62,13,26,20,6
1,28,2019,11,0,2,"Braga",7,"Rua Nova Santa Cruz",29,29,0,104,104,0
1,28,2019,11,0,2,"Braga",8,"Rua Costa Gomes",41,41,0,42,42,0
1,28,2019,12,0,2,"Braga",1,"Avenida da Liberdade",20,20,0,14,14,0
1,28,2019,12,0,2,"Braga",2,"Avenida Central",9,13,4,203,140,63
1,28,2019,12,0,2,"Braga",3,"Rua de Caires",27,35,8,49,38,11
1,28,2019,12,0,2,"Braga",4,"N14 Bosch",33,47,14,68,47,21
1,28,2019,12,0,2,"Braga",5,"Avenida João Paulo II",31,38,7,11,9,2
1,28,2019,12,0,2,"Braga",6,"Avenida Padre Júlio Fragata",61,61,0,21,21,0
1,28,2019,12,0,2,"Braga",7,"Rua Nova Santa Cruz",29,29,0,104,104,0
1,28,2019,12,0,2,"Braga",8,"Rua Costa Gomes",33,41,8,52,42,10
1,28,2019,13,0,2,"Braga",1,"Avenida da Liberdade",20,20,0,14,14,0
1,28,2019,13,0,2,"Braga",2,"Avenida Central",9,13,4,203,140,63
1,28,2019,13,0,2,"Braga",3,"Rua de Caires",24,35,11,56,38,18
1,28,2019,13,0,2,"Braga",4,"N14 Bosch",28,47,19,80,47,33
1,28,2019,13,0,2,"Braga",5,"Avenida João Paulo II",39,39,0,8,8,0
1,28,2019,13,0,2,"Braga",6,"Avenida Padre Júlio Fragata",61,61,0,21,21,0
1,28,2019,13,0,2,"Braga",7,"Rua Nova Santa Cruz",17,29,12,179,104,75
1,28,2019,13,0,2,"Braga",8,"Rua Costa Gomes",32,41,9,53,42,11
1,28,2019,14,0,2,"Braga",1,"Avenida da Liberdade",20,20,0,14,14,0
1,28,2019,14,0,2,"Braga",2,"Avenida Central",8,13,5,229,140,89
1,28,2019,14,0,2,"Braga",3,"Rua de Caires",28,35,7,48,38,10
1,28,2019,14,0,2,"Braga",4,"N14 Bosch",20,48,28,112,46,66
1,28,2019,14,0,2,"Braga",5,"Avenida João Paulo II",26,39,13,13,8,5
1,28,2019,14,0,2,"Braga",6,"Avenida Padre Júlio Fragata",62,62,0,20,20,0
1,28,2019,14,0,2,"Braga",7,"Rua Nova Santa Cruz",29,29,0,104,104,0
1,28,2019,14,0,2,"Braga",8,"Rua Costa Gomes",31,41,10,55,42,13
1,28,2019,15,0,2,"Braga",1,"Avenida da Liberdade",20,20,0,14,14,0
1,28,2019,15,0,2,"Braga",2,"Avenida Central",10,13,3,183,140,43
1,28,2019,15,0,2,"Braga",3,"Rua de Caires",36,36,0,37,37,0
1,28,2019,15,0,2,"Braga",4,"N14 Bosch",25,47,22,89,47,42
1,28,2019,15,0,2,"Braga",5,"Avenida João Paulo II",39,39,0,8,8,0
1,28,2019,15,0,2,"Braga",6,"Avenida Padre Júlio Fragata",62,62,0,20,20,0
1,28,2019,15,0,2,"Braga",7,"Rua Nova Santa Cruz",18,28,10,169,108,61
1,28,2019,15,0,2,"Braga",8,"Rua Costa Gomes",41,41,0,42,42,0
1,28,2019,16,0,2,"Braga",1,"Avenida da Liberdade",19,19,0,14,14,0
1,28,2019,16,0,2,"Braga",2,"Avenida Central",9,13,4,203,140,63
1,28,2019,16,0,2,"Braga",3,"Rua de Caires",35,35,0,38,38,0
1,28,2019,16,0,2,"Braga",4,"N14 Bosch",18,46,28,124,48,76
1,28,2019,16,0,2,"Braga",5,"Avenida João Paulo II",27,38,11,12,9,3
1,28,2019,16,0,2,"Braga",6,"Avenida Padre Júlio Fragata",48,62,14,26,20,6
1,28,2019,16,0,2,"Braga",7,"Rua Nova Santa Cruz",21,29,8,144,104,40
1,28,2019,16,0,2,"Braga",8,"Rua Costa Gomes",28,40,12,61,43,18
1,28,2019,17,0,2,"Braga",1,"Avenida da Liberdade",19,19,0,14,14,0
1,28,2019,17,0,2,"Braga",2,"Avenida Central",6,14,8,305,130,175
1,28,2019,17,0,2,"Braga",3,"Rua de Caires",25,35,10,53,38,15
1,28,2019,17,0,2,"Braga",4,"N14 Bosch",23,46,23,97,48,49
1,28,2019,17,0,2,"Braga",5,"Avenida João Paulo II",22,38,16,15,9,6
1,28,2019,17,0,2,"Braga",6,"Avenida Padre Júlio Fragata",43,62,19,29,20,9
1,28,2019,17,0,2,"Braga",7,"Rua Nova Santa Cruz",19,28,9,160,108,52
1,28,2019,17,0,2,"Braga",8,"Rua Costa Gomes",25,41,16,69,42,27
1,28,2019,18,0,2,"Braga",1,"Avenida da Liberdade",15,20,5,18,14,4
1,28,2019,18,0,2,"Braga",2,"Avenida Central",6,13,7,305,140,165
1,28,2019,18,0,2,"Braga",3,"Rua de Caires",26,36,10,51,37,14
1,28,2019,18,0,2,"Braga",4,"N14 Bosch",16,47,31,140,47,93
1,28,2019,18,0,2,"Braga",5,"Avenida João Paulo II",40,40,0,8,8,0
1,28,2019,18,0,2,"Braga",6,"Avenida Padre Júlio Fragata",62,62,0,20,20,0
1,28,2019,18,0,2,"Braga",7,"Rua Nova Santa Cruz",18,28,10,169,108,61
1,28,2019,18,0,2,"Braga",8,"Rua Costa Gomes",24,41,17,71,42,29
1,28,2019,19,0,2,"Braga",1,"Avenida da Liberdade",16,20,4,17,14,3
1,28,2019,19,0,2,"Braga",2,"Avenida Central",8,12,4,229,152,77
1,28,2019,19,0,2,"Braga",3,"Rua de Caires",24,35,11,56,38,18
1,28,2019,19,0,2,"Braga",4,"N14 Bosch",22,47,25,102,47,55
1,28,2019,19,0,2,"Braga",5,"Avenida João Paulo II",21,38,17,16,9,7
1,28,2019,19,0,2,"Braga",6,"Avenida Padre Júlio Fragata",25,62,37,51,20,31
1,28,2019,19,0,2,"Braga",7,"Rua Nova Santa Cruz",16,29,13,190,104,86
1,28,2019,19,0,2,"Braga",8,"Rua Costa Gomes",21,40,19,82,43,39
1,28,2019,20,0,2,"Braga",1,"Avenida da Liberdade",20,20,0,14,14,0
1,28,2019,20,0,2,"Braga",2,"Avenida Central",10,13,3,183,140,43
1,28,2019,20,0,2,"Braga",3,"Rua de Caires",28,36,8,48,37,11
1,28,2019,20,0,2,"Braga",4,"N14 Bosch",37,47,10,60,47,13
1,28,2019,20,0,2,"Braga",5,"Avenida João Paulo II",30,38,8,11,9,2
1,28,2019,20,0,2,"Braga",6,"Avenida Padre Júlio Fragata",61,61,0,21,21,0
1,28,2019,20,0,2,"Braga",7,"Rua Nova Santa Cruz",20,28,8,152,108,44
1,28,2019,20,0,2,"Braga",8,"Rua Costa Gomes",28,40,12,61,43,18
1,28,2019,21,0,2,"Braga",1,"Avenida da Liberdade",20,20,0,14,14,0
1,28,2019,21,0,2,"Braga",2,"Avenida Central",13,13,0,140,140,0
1,28,2019,21,0,2,"Braga",3,"Rua de Caires",35,35,0,38,38,0
1,28,2019,21,0,2,"Braga",4,"N14 Bosch",47,47,0,47,47,0
1,28,2019,21,0,2,"Braga",5,"Avenida João Paulo II",39,39,0,8,8,0
1,28,2019,21,0,2,"Braga",6,"Avenida Padre Júlio Fragata",61,61,0,21,21,0
1,28,2019,21,0,2,"Braga",7,"Rua Nova Santa Cruz",29,29,0,104,104,0
1,28,2019,21,0,2,"Braga",8,"Rua Costa Gomes",41,41,0,42,42,0
1,28,2019,22,0,2,"Braga",1,"Avenida da Liberdade",20,20,0,14,14,0
1,28,2019,22,0,2,"Braga",2,"Avenida Central",13,13,0,140,140,0
1,28,2019,22,0,2,"Braga",3,"Rua de Caires",35,35,0,38,38,0
1,28,2019,22,0,2,"Braga",4,"N14 Bosch",47,47,0,47,47,0
1,28,2019,22,0,2,"Braga",5,"Avenida João Paulo II",39,39,0,8,8,0
1,28,2019,22,0,2,"Braga",6,"Avenida Padre Júlio Fragata",61,61,0,21,21,0
1,28,2019,22,0,2,"Braga",7,"Rua Nova Santa Cruz",29,29,0,104,104,0
1,28,2019,22,0,2,"Braga",8,"Rua Costa Gomes",41,41,0,42,42,0
1,28,2019,23,0,2,"Braga",1,"Avenida da Liberdade",20,20,0,14,14,0
1,28,2019,23,0,2,"Braga",2,"Avenida Central",13,13,0,140,140,0
1,28,2019,23,0,2,"Braga",3,"Rua de Caires",35,35,0,38,38,0
1,28,2019,23,0,2,"Braga",4,"N14 Bosch",47,47,0,47,47,0
1,28,2019,23,0,2,"Braga",5,"Avenida João Paulo II",39,39,0,8,8,0
1,28,2019,23,0,2,"Braga",6,"Avenida Padre Júlio Fragata",62,62,0,20,20,0
1,28,2019,23,0,2,"Braga",7,"Rua Nova Santa Cruz",29,29,0,104,104,0
1,28,2019,23,0,2,"Braga",8,"Rua Costa Gomes",41,41,0,42,42,0
1,29,2019,0,0,3,"Braga",1,"Avenida da Liberdade",20,20,0,14,14,0
1,29,2019,0,0,3,"Braga",2,"Avenida Central",13,13,0,140,140,0
1,29,2019,0,0,3,"Braga",3,"Rua de Caires",35,35,0,38,38,0
1,29,2019,0,0,3,"Braga",4,"N14 Bosch",47,47,0,47,47,0
1,29,2019,0,0,3,"Braga",5,"Avenida João Paulo II",39,39,0,8,8,0
1,29,2019,0,0,3,"Braga",6,"Avenida Padre Júlio Fragata",62,62,0,20,20,0
1,29,2019,0,0,3,"Braga",7,"Rua Nova Santa Cruz",29,29,0,104,104,0
1,29,2019,0,0,3,"Braga",8,"Rua Costa Gomes",41,41,0,42,42,0
1,29,2019,1,0,3,"Braga",1,"Avenida da Liberdade",20,20,0,14,14,0
1,29,2019,1,0,3,"Braga",2,"Avenida Central",12,12,0,152,152,0
1,29,2019,1,0,3,"Braga",3,"Rua de Caires",35,35,0,38,38,0
1,29,2019,1,0,3,"Braga",4,"N14 Bosch",47,47,0,47,47,0
1,29,2019,1,0,3,"Braga",5,"Avenida João Paulo II",39,39,0,8,8,0
1,29,2019,1,0,3,"Braga",6,"Avenida Padre Júlio Fragata",62,62,0,20,20,0
1,29,2019,1,0,3,"Braga",7,"Rua Nova Santa Cruz",29,29,0,104,104,0
1,29,2019,1,0,3,"Braga",8,"Rua Costa Gomes",41,41,0,42,42,0
1,29,2019,2,0,3,"Braga",1,"Avenida da Liberdade",20,20,0,14,14,0
1,29,2019,2,0,3,"Braga",2,"Avenida Central",12,12,0,152,152,0
1,29,2019,2,0,3,"Braga",3,"Rua de Caires",35,35,0,38,38,0
1,29,2019,2,0,3,"Braga",4,"N14 Bosch",47,47,0,47,47,0
1,29,2019,2,0,3,"Braga",5,"Avenida João Paulo II",39,39,0,8,8,0
1,29,2019,2,0,3,"Braga",6,"Avenida Padre Júlio Fragata",62,62,0,20,20,0
1,29,2019,2,0,3,"Braga",7,"Rua Nova Santa Cruz",29,29,0,104,104,0
1,29,2019,2,0,3,"Braga",8,"Rua Costa Gomes",41,41,0,42,42,0
1,29,2019,3,0,3,"Braga",1,"Avenida da Liberdade",20,20,0,14,14,0
1,29,2019,3,0,3,"Braga",2,"Avenida Central",12,12,0,152,152,0
1,29,2019,3,0,3,"Braga",3,"Rua de Caires",35,35,0,38,38,0
1,29,2019,3,0,3,"Braga",4,"N14 Bosch",47,47,0,47,47,0
1,29,2019,3,0,3,"Braga",5,"Avenida João Paulo II",39,39,0,8,8,0
1,29,2019,3,0,3,"Braga",6,"Avenida Padre Júlio Fragata",62,62,0,20,20,0
1,29,2019,3,0,3,"Braga",7,"Rua Nova Santa Cruz",29,29,0,104,104,0
1,29,2019,3,0,3,"Braga",8,"Rua Costa Gomes",41,41,0,42,42,0
1,29,2019,4,0,3,"Braga",1,"Avenida da Liberdade",20,20,0,14,14,0
1,29,2019,4,0,3,"Braga",2,"Avenida Central",12,12,0,152,152,0
1,29,2019,4,0,3,"Braga",3,"Rua de Caires",35,35,0,38,38,0
1,29,2019,4,0,3,"Braga",4,"N14 Bosch",47,47,0,47,47,0
1,29,2019,4,0,3,"Braga",5,"Avenida João Paulo II",39,39,0,8,8,0
1,29,2019,4,0,3,"Braga",6,"Avenida Padre Júlio Fragata",62,62,0,20,20,0
1,29,2019,4,0,3,"Braga",7,"Rua Nova Santa Cruz",29,29,0,104,104,0
1,29,2019,4,0,3,"Braga",8,"Rua Costa Gomes",41,41,0,42,42,0
1,29,2019,5,0,3,"Braga",1,"Avenida da Liberdade",20,20,0,14,14,0
1,29,2019,5,0,3,"Braga",2,"Avenida Central",12,12,0,152,152,0
1,29,2019,5,0,3,"Braga",3,"Rua de Caires",35,35,0,38,38,0
1,29,2019,5,0,3,"Braga",4,"N14 Bosch",47,47,0,47,47,0
1,29,2019,5,0,3,"Braga",5,"Avenida João Paulo II",39,39,0,8,8,0
1,29,2019,5,0,3,"Braga",6,"Avenida Padre Júlio Fragata",62,62,0,20,20,0
1,29,2019,5,0,3,"Braga",7,"Rua Nova Santa Cruz",29,29,0,104,104,0
1,29,2019,5,0,3,"Braga",8,"Rua Costa Gomes",41,41,0,42,42,0
1,29,2019,6,0,3,"Braga",1,"Avenida da Liberdade",20,20,0,14,14,0
1,29,2019,6,0,3,"Braga",2,"Avenida Central",12,12,0,152,152,0
1,29,2019,6,0,3,"Braga",3,"Rua de Caires",35,35,0,38,38,0
1,29,2019,6,0,3,"Braga",4,"N14 Bosch",47,47,0,47,47,0
1,29,2019,6,0,3,"Braga",5,"Avenida João Paulo II",39,39,0,8,8,0
1,29,2019,6,0,3,"Braga",6,"Avenida Padre Júlio Fragata",62,62,0,20,20,0
1,29,2019,6,0,3,"Braga",7,"Rua Nova Santa Cruz",29,29,0,104,104,0
1,29,2019,6,0,3,"Braga",8,"Rua Costa Gomes",41,41,0,42,42,0
1,29,2019,7,0,3,"Braga",1,"Avenida da Liberdade",20,20,0,14,14,0
1,29,2019,7,0,3,"Braga",2,"Avenida Central",12,12,0,152,152,0
1,29,2019,7,0,3,"Braga",3,"Rua de Caires",35,35,0,38,38,0
1,29,2019,7,0,3,"Braga",4,"N14 Bosch",47,47,0,47,47,0
1,29,2019,7,0,3,"Braga",5,"Avenida João Paulo II",39,39,0,8,8,0
1,29,2019,7,0,3,"Braga",6,"Avenida Padre Júlio Fragata",62,62,0,20,20,0
1,29,2019,7,0,3,"Braga",7,"Rua Nova Santa Cruz",29,29,0,104,104,0
1,29,2019,7,0,3,"Braga",8,"Rua Costa Gomes",41,41,0,42,42,0
1,29,2019,8,0,3,"Braga",1,"Avenida da Liberdade",20,20,0,14,14,0
1,29,2019,8,0,3,"Braga",2,"Avenida Central",10,12,2,183,152,31
1,29,2019,8,0,3,"Braga",3,"Rua de Caires",26,35,9,51,38,13
1,29,2019,8,0,3,"Braga",4,"N14 Bosch",35,47,12,64,47,17
1,29,2019,8,0,3,"Braga",5,"Avenida João Paulo II",39,39,0,8,8,0
1,29,2019,8,0,3,"Braga",6,"Avenida Padre Júlio Fragata",62,62,0,20,20,0
1,29,2019,8,0,3,"Braga",7,"Rua Nova Santa Cruz",29,29,0,104,104,0
1,29,2019,8,0,3,"Braga",8,"Rua Costa Gomes",32,40,8,53,43,10
1,29,2019,9,0,3,"Braga",1,"Avenida da Liberdade",19,19,0,14,14,0
1,29,2019,9,0,3,"Braga",2,"Avenida Central",4,12,8,458,152,306
1,29,2019,9,0,3,"Braga",3,"Rua de Caires",26,36,10,51,37,14
1,29,2019,9,0,3,"Braga",4,"N14 Bosch",33,47,14,68,47,21
1,29,2019,9,0,3,"Braga",5,"Avenida João Paulo II",10,39,29,34,8,26
1,29,2019,9,0,3,"Braga",6,"Avenida Padre Júlio Fragata",38,61,23,33,21,12
1,29,2019,9,0,3,"Braga",7,"Rua Nova Santa Cruz",29,29,0,104,104,0
1,29,2019,9,0,3,"Braga",8,"Rua Costa Gomes",28,40,12,61,43,18
1,29,2019,10,0,3,"Braga",1,"Avenida da Liberdade",19,19,0,14,14,0
1,29,2019,10,0,3,"Braga",2,"Avenida Central",9,13,4,203,140,63
1,29,2019,10,0,3,"Braga",3,"Rua de Caires",27,35,8,49,38,11
1,29,2019,10,0,3,"Braga",4,"N14 Bosch",33,46,13,68,48,20
1,29,2019,10,0,3,"Braga",5,"Avenida João Paulo II",39,39,0,8,8,0
1,29,2019,10,0,3,"Braga",6,"Avenida Padre Júlio Fragata",62,62,0,20,20,0
1,29,2019,10,0,3,"Braga",7,"Rua Nova Santa Cruz",29,29,0,104,104,0
1,29,2019,10,0,3,"Braga",8,"Rua Costa Gomes",31,41,10,55,42,13
1,29,2019,11,0,3,"Braga",1,"Avenida da Liberdade",19,19,0,14,14,0
1,29,2019,11,0,3,"Braga",2,"Avenida Central",8,12,4,229,152,77
1,29,2019,11,0,3,"Braga",3,"Rua de Caires",27,36,9,49,37,12
1,29,2019,11,0,3,"Braga",4,"N14 Bosch",32,47,15,70,47,23
1,29,2019,11,0,3,"Braga",5,"Avenida João Paulo II",28,38,10,12,9,3
1,29,2019,11,0,3,"Braga",6,"Avenida Padre Júlio Fragata",62,62,0,20,20,0
1,29,2019,11,0,3,"Braga",7,"Rua Nova Santa Cruz",29,29,0,104,104,0
1,29,2019,11,0,3,"Braga",8,"Rua Costa Gomes",31,40,9,55,43,12
1,29,2019,12,0,3,"Braga",1,"Avenida da Liberdade",19,19,0,14,14,0
1,29,2019,12,0,3,"Braga",2,"Avenida Central",9,13,4,203,140,63
1,29,2019,12,0,3,"Braga",3,"Rua de Caires",27,36,9,49,37,12
1,29,2019,12,0,3,"Braga",4,"N14 Bosch",30,47,17,74,47,27
1,29,2019,12,0,3,"Braga",5,"Avenida João Paulo II",38,38,0,9,9,0
1,29,2019,12,0,3,"Braga",6,"Avenida Padre Júlio Fragata",62,62,0,20,20,0
1,29,2019,12,0,3,"Braga",7,"Rua Nova Santa Cruz",21,28,7,144,108,36
1,29,2019,12,0,3,"Braga",8,"Rua Costa Gomes",30,40,10,57,43,14
1,29,2019,13,0,3,"Braga",1,"Avenida da Liberdade",19,19,0,14,14,0
1,29,2019,13,0,3,"Braga",2,"Avenida Central",6,13,7,305,140,165
1,29,2019,13,0,3,"Braga",3,"Rua de Caires",26,35,9,51,38,13
1,29,2019,13,0,3,"Braga",4,"N14 Bosch",18,48,30,124,46,78
1,29,2019,13,0,3,"Braga",5,"Avenida João Paulo II",39,39,0,8,8,0
1,29,2019,13,0,3,"Braga",6,"Avenida Padre Júlio Fragata",61,61,0,21,21,0
1,29,2019,13,0,3,"Braga",7,"Rua Nova Santa Cruz",20,29,9,152,104,48
1,29,2019,13,0,3,"Braga",8,"Rua Costa Gomes",24,40,16,71,43,28
1,29,2019,14,0,3,"Braga",1,"Avenida da Liberdade",19,19,0,14,14,0
1,29,2019,14,0,3,"Braga",2,"Avenida Central",7,12,5,261,152,109
1,29,2019,14,0,3,"Braga",3,"Rua de Caires",29,36,7,46,37,9
1,29,2019,14,0,3,"Braga",4,"N14 Bosch",28,47,19,80,47,33
1,29,2019,14,0,3,"Braga",5,"Avenida João Paulo II",38,38,0,9,9,0
1,29,2019,14,0,3,"Braga",6,"Avenida Padre Júlio Fragata",44,62,18,29,20,9
1,29,2019,14,0,3,"Braga",7,"Rua Nova Santa Cruz",28,28,0,108,108,0
1,29,2019,14,0,3,"Braga",8,"Rua Costa Gomes",27,40,13,63,43,20
1,29,2019,15,0,3,"Braga",1,"Avenida da Liberdade",19,19,0,14,14,0
1,29,2019,15,0,3,"Braga",2,"Avenida Central",7,13,6,261,140,121
1,29,2019,15,0,3,"Braga",3,"Rua de Caires",27,36,9,49,37,12
1,29,2019,15,0,3,"Braga",4,"N14 Bosch",37,47,10,60,47,13
1,29,2019,15,0,3,"Braga",5,"Avenida João Paulo II",31,38,7,11,9,2
1,29,2019,15,0,3,"Braga",6,"Avenida Padre Júlio Fragata",61,61,0,21,21,0
1,29,2019,15,0,3,"Braga",7,"Rua Nova Santa Cruz",21,28,7,144,108,36
1,29,2019,15,0,3,"Braga",8,"Rua Costa Gomes",41,41,0,42,42,0
1,29,2019,16,0,3,"Braga",1,"Avenida da Liberdade",22,22,0,30,30,0
1,29,2019,16,0,3,"Braga",2,"Avenida Central",14,17,3,331,272,59
1,29,2019,16,0,3,"Braga",3,"Rua de Caires",26,34,8,51,39,12
1,29,2019,16,0,3,"Braga",4,"N14 Bosch",34,45,11,66,49,17
1,29,2019,16,0,3,"Braga",5,"Avenida João Paulo II",27,40,13,12,8,4
1,29,2019,16,0,3,"Braga",6,"Avenida Padre Júlio Fragata",42,60,18,30,21,9
1,29,2019,16,0,3,"Braga",7,"Rua Nova Santa Cruz",23,29,6,132,104,28
1,29,2019,16,0,3,"Braga",8,"Rua Costa Gomes",29,40,11,59,43,16
1,29,2019,17,0,3,"Braga",1,"Avenida da Liberdade",12,22,10,55,30,25
1,29,2019,17,0,3,"Braga",2,"Avenida Central",13,17,4,356,272,84
1,29,2019,17,0,3,"Braga",3,"Rua de Caires",23,34,11,58,39,19
1,29,2019,17,0,3,"Braga",4,"N14 Bosch",30,46,16,74,48,26
1,29,2019,17,0,3,"Braga",5,"Avenida João Paulo II",23,40,17,15,8,7
1,29,2019,17,0,3,"Braga",6,"Avenida Padre Júlio Fragata",48,60,12,26,21,5
1,29,2019,17,0,3,"Braga",7,"Rua Nova Santa Cruz",19,28,9,160,108,52
1,29,2019,17,0,3,"Braga",8,"Rua Costa Gomes",25,40,15,69,43,26
1,29,2019,18,0,3,"Braga",1,"Avenida da Liberdade",16,22,6,41,30,11
1,29,2019,18,0,3,"Braga",2,"Avenida Central",11,18,7,421,257,164
1,29,2019,18,0,3,"Braga",3,"Rua de Caires",24,34,10,56,39,17
1,29,2019,18,0,3,"Braga",4,"N14 Bosch",15,46,31,149,48,101
1,29,2019,18,0,3,"Braga",5,"Avenida João Paulo II",30,39,9,11,8,3
1,29,2019,18,0,3,"Braga",6,"Avenida Padre Júlio Fragata",26,60,34,49,21,28
1,29,2019,18,0,3,"Braga",7,"Rua Nova Santa Cruz",17,29,12,179,104,75
1,29,2019,18,0,3,"Braga",8,"Rua Costa Gomes",23,39,16,75,44,31
1,29,2019,19,0,3,"Braga",1,"Avenida da Liberdade",16,21,5,41,31,10
1,29,2019,19,0,3,"Braga",2,"Avenida Central",8,18,10,579,257,322
1,29,2019,19,0,3,"Braga",3,"Rua de Caires",25,34,9,53,39,14
1,29,2019,19,0,3,"Braga",4,"N14 Bosch",25,46,21,89,48,41
1,29,2019,19,0,3,"Braga",5,"Avenida João Paulo II",22,39,17,15,8,7
1,29,2019,19,0,3,"Braga",6,"Avenida Padre Júlio Fragata",35,60,25,36,21,15
1,29,2019,19,0,3,"Braga",7,"Rua Nova Santa Cruz",19,29,10,160,104,56
1,29,2019,19,0,3,"Braga",8,"Rua Costa Gomes",19,40,21,90,43,47
1,29,2019,20,0,3,"Braga",1,"Avenida da Liberdade",21,21,0,31,31,0
1,29,2019,20,0,3,"Braga",2,"Avenida Central",14,17,3,331,272,59
1,29,2019,20,0,3,"Braga",3,"Rua de Caires",35,35,0,38,38,0
1,29,2019,20,0,3,"Braga",4,"N14 Bosch",33,45,12,68,49,19
1,29,2019,20,0,3,"Braga",5,"Avenida João Paulo II",28,39,11,12,8,4
1,29,2019,20,0,3,"Braga",6,"Avenida Padre Júlio Fragata",60,60,0,21,21,0
1,29,2019,20,0,3,"Braga",7,"Rua Nova Santa Cruz",20,29,9,152,104,48
1,29,2019,20,0,3,"Braga",8,"Rua Costa Gomes",27,39,12,63,44,19
1,29,2019,21,0,3,"Braga",1,"Avenida da Liberdade",21,21,0,31,31,0
1,29,2019,21,0,3,"Braga",2,"Avenida Central",17,17,0,272,272,0
1,29,2019,21,0,3,"Braga",3,"Rua de Caires",35,35,0,38,38,0
1,29,2019,21,0,3,"Braga",4,"N14 Bosch",46,46,0,48,48,0
1,29,2019,21,0,3,"Braga",5,"Avenida João Paulo II",40,40,0,8,8,0
1,29,2019,21,0,3,"Braga",6,"Avenida Padre Júlio Fragata",60,60,0,21,21,0
1,29,2019,21,0,3,"Braga",7,"Rua Nova Santa Cruz",28,28,0,108,108,0
1,29,2019,21,0,3,"Braga",8,"Rua Costa Gomes",40,40,0,43,43,0
1,29,2019,22,0,3,"Braga",1,"Avenida da Liberdade",21,21,0,31,31,0
1,29,2019,22,0,3,"Braga",2,"Avenida Central",17,17,0,272,272,0
1,29,2019,22,0,3,"Braga",3,"Rua de Caires",34,34,0,39,39,0
1,29,2019,22,0,3,"Braga",4,"N14 Bosch",46,46,0,48,48,0
1,29,2019,22,0,3,"Braga",5,"Avenida João Paulo II",40,40,0,8,8,0
1,29,2019,22,0,3,"Braga",6,"Avenida Padre Júlio Fragata",60,60,0,21,21,0
1,29,2019,22,0,3,"Braga",7,"Rua Nova Santa Cruz",28,28,0,108,108,0
1,29,2019,22,0,3,"Braga",8,"Rua Costa Gomes",40,40,0,43,43,0
1,29,2019,23,0,3,"Braga",1,"Avenida da Liberdade",21,21,0,31,31,0
1,29,2019,23,0,3,"Braga",2,"Avenida Central",17,17,0,272,272,0
1,29,2019,23,0,3,"Braga",3,"Rua de Caires",34,34,0,39,39,0
1,29,2019,23,0,3,"Braga",4,"N14 Bosch",46,46,0,48,48,0
1,29,2019,23,0,3,"Braga",5,"Avenida João Paulo II",40,40,0,8,8,0
1,29,2019,23,0,3,"Braga",6,"Avenida Padre Júlio Fragata",60,60,0,21,21,0
1,29,2019,23,0,3,"Braga",7,"Rua Nova Santa Cruz",28,28,0,108,108,0
1,29,2019,23,0,3,"Braga",8,"Rua Costa Gomes",40,40,0,43,43,0
1,30,2019,0,0,4,"Braga",1,"Avenida da Liberdade",21,21,0,31,31,0
1,30,2019,0,0,4,"Braga",2,"Avenida Central",17,17,0,272,272,0
1,30,2019,0,0,4,"Braga",3,"Rua de Caires",34,34,0,39,39,0
1,30,2019,0,0,4,"Braga",4,"N14 Bosch",46,46,0,48,48,0
1,30,2019,0,0,4,"Braga",5,"Avenida João Paulo II",40,40,0,8,8,0
1,30,2019,0,0,4,"Braga",6,"Avenida Padre Júlio Fragata",60,60,0,21,21,0
1,30,2019,0,0,4,"Braga",7,"Rua Nova Santa Cruz",28,28,0,108,108,0
1,30,2019,0,0,4,"Braga",8,"Rua Costa Gomes",40,40,0,43,43,0
1,30,2019,1,0,4,"Braga",1,"Avenida da Liberdade",21,21,0,31,31,0
1,30,2019,1,0,4,"Braga",2,"Avenida Central",17,17,0,272,272,0
1,30,2019,1,0,4,"Braga",3,"Rua de Caires",34,34,0,39,39,0
1,30,2019,1,0,4,"Braga",4,"N14 Bosch",46,46,0,48,48,0
1,30,2019,1,0,4,"Braga",5,"Avenida João Paulo II",40,40,0,8,8,0
1,30,2019,1,0,4,"Braga",6,"Avenida Padre Júlio Fragata",60,60,0,21,21,0
1,30,2019,1,0,4,"Braga",7,"Rua Nova Santa Cruz",28,28,0,108,108,0
1,30,2019,1,0,4,"Braga",8,"Rua Costa Gomes",40,40,0,43,43,0
1,30,2019,2,0,4,"Braga",1,"Avenida da Liberdade",21,21,0,31,31,0
1,30,2019,2,0,4,"Braga",2,"Avenida Central",17,17,0,272,272,0
1,30,2019,2,0,4,"Braga",3,"Rua de Caires",34,34,0,39,39,0
1,30,2019,2,0,4,"Braga",4,"N14 Bosch",46,46,0,48,48,0
1,30,2019,2,0,4,"Braga",5,"Avenida João Paulo II",40,40,0,8,8,0
1,30,2019,2,0,4,"Braga",6,"Avenida Padre Júlio Fragata",60,60,0,21,21,0
1,30,2019,2,0,4,"Braga",7,"Rua Nova Santa Cruz",28,28,0,108,108,0
1,30,2019,2,0,4,"Braga",8,"Rua Costa Gomes",40,40,0,43,43,0
1,30,2019,3,0,4,"Braga",1,"Avenida da Liberdade",21,21,0,31,31,0
1,30,2019,3,0,4,"Braga",2,"Avenida Central",17,17,0,272,272,0
1,30,2019,3,0,4,"Braga",3,"Rua de Caires",34,34,0,39,39,0
1,30,2019,3,0,4,"Braga",4,"N14 Bosch",46,46,0,48,48,0
1,30,2019,3,0,4,"Braga",5,"Avenida João Paulo II",40,40,0,8,8,0
1,30,2019,3,0,4,"Braga",6,"Avenida Padre Júlio Fragata",60,60,0,21,21,0
1,30,2019,3,0,4,"Braga",7,"Rua Nova Santa Cruz",28,28,0,108,108,0
1,30,2019,3,0,4,"Braga",8,"Rua Costa Gomes",40,40,0,43,43,0
1,30,2019,4,0,4,"Braga",1,"Avenida da Liberdade",21,21,0,31,31,0
1,30,2019,4,0,4,"Braga",2,"Avenida Central",17,17,0,272,272,0
1,30,2019,4,0,4,"Braga",3,"Rua de Caires",34,34,0,39,39,0
1,30,2019,4,0,4,"Braga",4,"N14 Bosch",46,46,0,48,48,0
1,30,2019,4,0,4,"Braga",5,"Avenida João Paulo II",40,40,0,8,8,0
1,30,2019,4,0,4,"Braga",6,"Avenida Padre Júlio Fragata",60,60,0,21,21,0
1,30,2019,4,0,4,"Braga",7,"Rua Nova Santa Cruz",28,28,0,108,108,0
1,30,2019,4,0,4,"Braga",8,"Rua Costa Gomes",40,40,0,43,43,0
1,30,2019,5,0,4,"Braga",1,"Avenida da Liberdade",21,21,0,31,31,0
1,30,2019,5,0,4,"Braga",2,"Avenida Central",17,17,0,272,272,0
1,30,2019,5,0,4,"Braga",3,"Rua de Caires",34,34,0,39,39,0
1,30,2019,5,0,4,"Braga",4,"N14 Bosch",46,46,0,48,48,0
1,30,2019,5,0,4,"Braga",5,"Avenida João Paulo II",40,40,0,8,8,0
1,30,2019,5,0,4,"Braga",6,"Avenida Padre Júlio Fragata",60,60,0,21,21,0
1,30,2019,5,0,4,"Braga",7,"Rua Nova Santa Cruz",28,28,0,108,108,0
1,30,2019,5,0,4,"Braga",8,"Rua Costa Gomes",40,40,0,43,43,0
1,30,2019,6,0,4,"Braga",1,"Avenida da Liberdade",21,21,0,31,31,0
1,30,2019,6,0,4,"Braga",2,"Avenida Central",17,17,0,272,272,0
1,30,2019,6,0,4,"Braga",3,"Rua de Caires",34,34,0,39,39,0
1,30,2019,6,0,4,"Braga",4,"N14 Bosch",46,46,0,48,48,0
1,30,2019,6,0,4,"Braga",5,"Avenida João Paulo II",40,40,0,8,8,0
1,30,2019,6,0,4,"Braga",6,"Avenida Padre Júlio Fragata",60,60,0,21,21,0
1,30,2019,6,0,4,"Braga",7,"Rua Nova Santa Cruz",28,28,0,108,108,0
1,30,2019,6,0,4,"Braga",8,"Rua Costa Gomes",40,40,0,43,43,0
1,30,2019,7,0,4,"Braga",1,"Avenida da Liberdade",21,21,0,31,31,0
1,30,2019,7,0,4,"Braga",2,"Avenida Central",17,17,0,272,272,0
1,30,2019,7,0,4,"Braga",3,"Rua de Caires",34,34,0,39,39,0
1,30,2019,7,0,4,"Braga",4,"N14 Bosch",46,46,0,48,48,0
1,30,2019,7,0,4,"Braga",5,"Avenida João Paulo II",40,40,0,8,8,0
1,30,2019,7,0,4,"Braga",6,"Avenida Padre Júlio Fragata",60,60,0,21,21,0
1,30,2019,7,0,4,"Braga",7,"Rua Nova Santa Cruz",28,28,0,108,108,0
1,30,2019,7,0,4,"Braga",8,"Rua Costa Gomes",40,40,0,43,43,0
1,30,2019,8,0,4,"Braga",1,"Avenida da Liberdade",21,21,0,31,31,0
1,30,2019,8,0,4,"Braga",2,"Avenida Central",17,17,0,272,272,0
1,30,2019,8,0,4,"Braga",3,"Rua de Caires",26,35,9,51,38,13
1,30,2019,8,0,4,"Braga",4,"N14 Bosch",33,45,12,68,49,19
1,30,2019,8,0,4,"Braga",5,"Avenida João Paulo II",40,40,0,8,8,0
1,30,2019,8,0,4,"Braga",6,"Avenida Padre Júlio Fragata",60,60,0,21,21,0
1,30,2019,8,0,4,"Braga",7,"Rua Nova Santa Cruz",23,29,6,132,104,28
1,30,2019,8,0,4,"Braga",8,"Rua Costa Gomes",31,39,8,55,44,11
1,30,2019,9,0,4,"Braga",1,"Avenida da Liberdade",21,21,0,31,31,0
1,30,2019,9,0,4,"Braga",2,"Avenida Central",12,17,5,386,272,114
1,30,2019,9,0,4,"Braga",3,"Rua de Caires",24,34,10,56,39,17
1,30,2019,9,0,4,"Braga",4,"N14 Bosch",27,45,18,83,49,34
1,30,2019,9,0,4,"Braga",5,"Avenida João Paulo II",30,40,10,11,8,3
1,30,2019,9,0,4,"Braga",6,"Avenida Padre Júlio Fragata",35,61,26,36,21,15
1,30,2019,9,0,4,"Braga",7,"Rua Nova Santa Cruz",20,28,8,152,108,44
1,30,2019,9,0,4,"Braga",8,"Rua Costa Gomes",31,39,8,55,44,11
1,30,2019,10,0,4,"Braga",1,"Avenida da Liberdade",17,21,4,39,31,8
1,30,2019,10,0,4,"Braga",2,"Avenida Central",14,18,4,331,257,74
1,30,2019,10,0,4,"Braga",3,"Rua de Caires",27,35,8,49,38,11
1,30,2019,10,0,4,"Braga",4,"N14 Bosch",33,46,13,68,48,20
1,30,2019,10,0,4,"Braga",5,"Avenida João Paulo II",40,40,0,8,8,0
1,30,2019,10,0,4,"Braga",6,"Avenida Padre Júlio Fragata",61,61,0,21,21,0
1,30,2019,10,0,4,"Braga",7,"Rua Nova Santa Cruz",23,29,6,132,104,28
1,30,2019,10,0,4,"Braga",8,"Rua Costa Gomes",29,40,11,59,43,16
1,30,2019,11,0,4,"Braga",1,"Avenida da Liberdade",17,21,4,39,31,8
1,30,2019,11,0,4,"Braga",2,"Avenida Central",17,17,0,272,272,0
1,30,2019,11,0,4,"Braga",3,"Rua de Caires",21,34,13,64,39,25
1,30,2019,11,0,4,"Braga",4,"N14 Bosch",29,45,16,77,49,28
1,30,2019,11,0,4,"Braga",5,"Avenida João Paulo II",40,40,0,8,8,0
1,30,2019,11,0,4,"Braga",6,"Avenida Padre Júlio Fragata",61,61,0,21,21,0
1,30,2019,11,0,4,"Braga",7,"Rua Nova Santa Cruz",29,29,0,104,104,0
1,30,2019,11,0,4,"Braga",8,"Rua Costa Gomes",31,40,9,55,43,12
1,30,2019,12,0,4,"Braga",1,"Avenida da Liberdade",22,22,0,30,30,0
1,30,2019,12,0,4,"Braga",2,"Avenida Central",14,17,3,331,272,59
1,30,2019,12,0,4,"Braga",3,"Rua de Caires",28,35,7,48,38,10
1,30,2019,12,0,4,"Braga",4,"N14 Bosch",29,46,17,77,48,29
1,30,2019,12,0,4,"Braga",5,"Avenida João Paulo II",40,40,0,8,8,0
1,30,2019,12,0,4,"Braga",6,"Avenida Padre Júlio Fragata",33,61,28,38,21,17
1,30,2019,12,0,4,"Braga",7,"Rua Nova Santa Cruz",23,29,6,132,104,28
1,30,2019,12,0,4,"Braga",8,"Rua Costa Gomes",31,40,9,55,43,12
1,30,2019,13,0,4,"Braga",1,"Avenida da Liberdade",22,22,0,30,30,0
1,30,2019,13,0,4,"Braga",2,"Avenida Central",18,18,0,257,257,0
1,30,2019,13,0,4,"Braga",3,"Rua de Caires",35,35,0,38,38,0
1,30,2019,13,0,4,"Braga",4,"N14 Bosch",28,45,17,80,49,31
1,30,2019,13,0,4,"Braga",5,"Avenida João Paulo II",39,39,0,8,8,0
1,30,2019,13,0,4,"Braga",6,"Avenida Padre Júlio Fragata",61,61,0,21,21,0
1,30,2019,13,0,4,"Braga",7,"Rua Nova Santa Cruz",23,29,6,132,104,28
1,30,2019,13,0,4,"Braga",8,"Rua Costa Gomes",40,40,0,43,43,0
1,30,2019,14,0,4,"Braga",1,"Avenida da Liberdade",22,22,0,30,30,0
1,30,2019,14,0,4,"Braga",2,"Avenida Central",12,17,5,386,272,114
1,30,2019,14,0,4,"Braga",3,"Rua de Caires",23,35,12,58,38,20
1,30,2019,14,0,4,"Braga",4,"N14 Bosch",18,44,26,124,51,73
1,30,2019,14,0,4,"Braga",5,"Avenida João Paulo II",32,40,8,10,8,2
1,30,2019,14,0,4,"Braga",6,"Avenida Padre Júlio Fragata",41,60,19,31,21,10
1,30,2019,14,0,4,"Braga",7,"Rua Nova Santa Cruz",22,28,6,138,108,30
1,30,2019,14,0,4,"Braga",8,"Rua Costa Gomes",30,39,9,57,44,13
1,30,2019,15,0,4,"Braga",1,"Avenida da Liberdade",17,22,5,39,30,9
1,30,2019,15,0,4,"Braga",2,"Avenida Central",9,18,9,515,257,258
1,30,2019,15,0,4,"Braga",3,"Rua de Caires",27,35,8,49,38,11
1,30,2019,15,0,4,"Braga",4,"N14 Bosch",31,45,14,72,49,23
1,30,2019,15,0,4,"Braga",5,"Avenida João Paulo II",31,39,8,11,8,3
1,30,2019,15,0,4,"Braga",6,"Avenida Padre Júlio Fragata",46,60,14,27,21,6
1,30,2019,15,0,4,"Braga",7,"Rua Nova Santa Cruz",29,29,0,104,104,0
1,30,2019,15,0,4,"Braga",8,"Rua Costa Gomes",26,40,14,66,43,23
1,30,2019,16,0,4,"Braga",1,"Avenida da Liberdade",17,21,4,39,31,8
1,30,2019,16,0,4,"Braga",2,"Avenida Central",11,18,7,421,257,164
1,30,2019,16,0,4,"Braga",3,"Rua de Caires",26,34,8,51,39,12
1,30,2019,16,0,4,"Braga",4,"N14 Bosch",16,45,29,140,49,91
1,30,2019,16,0,4,"Braga",5,"Avenida João Paulo II",28,39,11,12,8,4
1,30,2019,16,0,4,"Braga",6,"Avenida Padre Júlio Fragata",49,61,12,26,21,5
1,30,2019,16,0,4,"Braga",7,"Rua Nova Santa Cruz",23,28,5,132,108,24
1,30,2019,16,0,4,"Braga",8,"Rua Costa Gomes",28,39,11,61,44,17
1,30,2019,17,0,4,"Braga",1,"Avenida da Liberdade",17,21,4,39,31,8
1,30,2019,17,0,4,"Braga",2,"Avenida Central",9,18,9,515,257,258
1,30,2019,17,0,4,"Braga",3,"Rua de Caires",24,35,11,56,38,18
1,30,2019,17,0,4,"Braga",4,"N14 Bosch",31,46,15,72,48,24
1,30,2019,17,0,4,"Braga",5,"Avenida João Paulo II",23,40,17,15,8,7
1,30,2019,17,0,4,"Braga",6,"Avenida Padre Júlio Fragata",61,61,0,21,21,0
1,30,2019,17,0,4,"Braga",7,"Rua Nova Santa Cruz",8,27,19,380,112,268
1,30,2019,17,0,4,"Braga",8,"Rua Costa Gomes",24,39,15,71,44,27
1,30,2019,18,0,4,"Braga",1,"Avenida da Liberdade",17,22,5,39,30,9
1,30,2019,18,0,4,"Braga",2,"Avenida Central",13,18,5,356,257,99
1,30,2019,18,0,4,"Braga",3,"Rua de Caires",14,34,20,96,39,57
1,30,2019,18,0,4,"Braga",4,"N14 Bosch",12,45,33,187,49,138
1,30,2019,18,0,4,"Braga",5,"Avenida João Paulo II",10,42,32,34,8,26
1,30,2019,18,0,4,"Braga",6,"Avenida Padre Júlio Fragata",18,61,43,71,21,50
1,30,2019,18,0,4,"Braga",7,"Rua Nova Santa Cruz",11,28,17,276,108,168
1,30,2019,18,0,4,"Braga",8,"Rua Costa Gomes",14,40,26,123,43,80
1,30,2019,19,0,4,"Braga",1,"Avenida da Liberdade",15,22,7,44,30,14
1,30,2019,19,0,4,"Braga",2,"Avenida Central",12,18,6,386,257,129
1,30,2019,19,0,4,"Braga",3,"Rua de Caires",25,35,10,53,38,15
1,30,2019,19,0,4,"Braga",4,"N14 Bosch",19,45,26,118,49,69
1,30,2019,19,0,4,"Braga",5,"Avenida João Paulo II",22,39,17,15,8,7
1,30,2019,19,0,4,"Braga",6,"Avenida Padre Júlio Fragata",29,60,31,44,21,23
1,30,2019,19,0,4,"Braga",7,"Rua Nova Santa Cruz",19,29,10,160,104,56
1,30,2019,19,0,4,"Braga",8,"Rua Costa Gomes",30,39,9,57,44,13
1,30,2019,20,0,4,"Braga",1,"Avenida da Liberdade",21,21,0,31,31,0
1,30,2019,20,0,4,"Braga",2,"Avenida Central",14,18,4,331,257,74
1,30,2019,20,0,4,"Braga",3,"Rua de Caires",35,35,0,38,38,0
1,30,2019,20,0,4,"Braga",4,"N14 Bosch",35,46,11,64,48,16
1,30,2019,20,0,4,"Braga",5,"Avenida João Paulo II",30,40,10,11,8,3
1,30,2019,20,0,4,"Braga",6,"Avenida Padre Júlio Fragata",61,61,0,21,21,0
1,30,2019,20,0,4,"Braga",7,"Rua Nova Santa Cruz",28,28,0,108,108,0
1,30,2019,20,0,4,"Braga",8,"Rua Costa Gomes",25,40,15,69,43,26
1,30,2019,21,0,4,"Braga",1,"Avenida da Liberdade",21,21,0,31,31,0
1,30,2019,21,0,4,"Braga",2,"Avenida Central",11,18,7,421,257,164
1,30,2019,21,0,4,"Braga",3,"Rua de Caires",35,35,0,38,38,0
1,30,2019,21,0,4,"Braga",4,"N14 Bosch",46,46,0,48,48,0
1,30,2019,21,0,4,"Braga",5,"Avenida João Paulo II",40,40,0,8,8,0
1,30,2019,21,0,4,"Braga",6,"Avenida Padre Júlio Fragata",61,61,0,21,21,0
1,30,2019,21,0,4,"Braga",7,"Rua Nova Santa Cruz",29,29,0,104,104,0
1,30,2019,21,0,4,"Braga",8,"Rua Costa Gomes",40,40,0,43,43,0
1,30,2019,22,0,4,"Braga",1,"Avenida da Liberdade",21,21,0,31,31,0
1,30,2019,22,0,4,"Braga",2,"Avenida Central",17,17,0,272,272,0
1,30,2019,22,0,4,"Braga",3,"Rua de Caires",35,35,0,38,38,0
1,30,2019,22,0,4,"Braga",4,"N14 Bosch",46,46,0,48,48,0
1,30,2019,22,0,4,"Braga",5,"Avenida João Paulo II",40,40,0,8,8,0
1,30,2019,22,0,4,"Braga",6,"Avenida Padre Júlio Fragata",61,61,0,21,21,0
1,30,2019,22,0,4,"Braga",7,"Rua Nova Santa Cruz",29,29,0,104,104,0
1,30,2019,22,0,4,"Braga",8,"Rua Costa Gomes",40,40,0,43,43,0
1,30,2019,23,0,4,"Braga",1,"Avenida da Liberdade",21,21,0,31,31,0
1,30,2019,23,0,4,"Braga",2,"Avenida Central",17,17,0,272,272,0
1,30,2019,23,0,4,"Braga",3,"Rua de Caires",35,35,0,38,38,0
1,30,2019,23,0,4,"Braga",4,"N14 Bosch",46,46,0,48,48,0
1,30,2019,23,0,4,"Braga",5,"Avenida João Paulo II",40,40,0,8,8,0
1,30,2019,23,0,4,"Braga",6,"Avenida Padre Júlio Fragata",61,61,0,21,21,0
1,30,2019,23,0,4,"Braga",7,"Rua Nova Santa Cruz",29,29,0,104,104,0
1,30,2019,23,0,4,"Braga",8,"Rua Costa Gomes",40,40,0,43,43,0
1,31,2019,0,0,5,"Braga",1,"Avenida da Liberdade",21,21,0,31,31,0
1,31,2019,0,0,5,"Braga",2,"Avenida Central",17,17,0,272,272,0
1,31,2019,0,0,5,"Braga",3,"Rua de Caires",35,35,0,38,38,0
1,31,2019,0,0,5,"Braga",4,"N14 Bosch",46,46,0,48,48,0
1,31,2019,0,0,5,"Braga",5,"Avenida João Paulo II",40,40,0,8,8,0
1,31,2019,0,0,5,"Braga",6,"Avenida Padre Júlio Fragata",61,61,0,21,21,0
1,31,2019,0,0,5,"Braga",7,"Rua Nova Santa Cruz",29,29,0,104,104,0
1,31,2019,0,0,5,"Braga",8,"Rua Costa Gomes",40,40,0,43,43,0
1,31,2019,1,0,5,"Braga",1,"Avenida da Liberdade",21,21,0,31,31,0
1,31,2019,1,0,5,"Braga",2,"Avenida Central",17,17,0,272,272,0
1,31,2019,1,0,5,"Braga",3,"Rua de Caires",35,35,0,38,38,0
1,31,2019,1,0,5,"Braga",4,"N14 Bosch",46,46,0,48,48,0
1,31,2019,1,0,5,"Braga",5,"Avenida João Paulo II",40,40,0,8,8,0
1,31,2019,1,0,5,"Braga",6,"Avenida Padre Júlio Fragata",61,61,0,21,21,0
1,31,2019,1,0,5,"Braga",7,"Rua Nova Santa Cruz",29,29,0,104,104,0
1,31,2019,1,0,5,"Braga",8,"Rua Costa Gomes",40,40,0,43,43,0
1,31,2019,2,0,5,"Braga",1,"Avenida da Liberdade",21,21,0,31,31,0
1,31,2019,2,0,5,"Braga",2,"Avenida Central",17,17,0,272,272,0
1,31,2019,2,0,5,"Braga",3,"Rua de Caires",35,35,0,38,38,0
1,31,2019,2,0,5,"Braga",4,"N14 Bosch",46,46,0,48,48,0
1,31,2019,2,0,5,"Braga",5,"Avenida João Paulo II",40,40,0,8,8,0
1,31,2019,2,0,5,"Braga",6,"Avenida Padre Júlio Fragata",61,61,0,21,21,0
1,31,2019,2,0,5,"Braga",7,"Rua Nova Santa Cruz",29,29,0,104,104,0
1,31,2019,2,0,5,"Braga",8,"Rua Costa Gomes",40,40,0,43,43,0
1,31,2019,3,0,5,"Braga",1,"Avenida da Liberdade",21,21,0,31,31,0
1,31,2019,3,0,5,"Braga",2,"Avenida Central",17,17,0,272,272,0
1,31,2019,3,0,5,"Braga",3,"Rua de Caires",35,35,0,38,38,0
1,31,2019,3,0,5,"Braga",4,"N14 Bosch",46,46,0,48,48,0
1,31,2019,3,0,5,"Braga",5,"Avenida João Paulo II",40,40,0,8,8,0
1,31,2019,3,0,5,"Braga",6,"Avenida Padre Júlio Fragata",61,61,0,21,21,0
1,31,2019,3,0,5,"Braga",7,"Rua Nova Santa Cruz",29,29,0,104,104,0
1,31,2019,3,0,5,"Braga",8,"Rua Costa Gomes",40,40,0,43,43,0
1,31,2019,4,0,5,"Braga",1,"Avenida da Liberdade",21,21,0,31,31,0
1,31,2019,4,0,5,"Braga",2,"Avenida Central",17,17,0,272,272,0
1,31,2019,4,0,5,"Braga",3,"Rua de Caires",35,35,0,38,38,0
1,31,2019,4,0,5,"Braga",4,"N14 Bosch",46,46,0,48,48,0
1,31,2019,4,0,5,"Braga",5,"Avenida João Paulo II",40,40,0,8,8,0
1,31,2019,4,0,5,"Braga",6,"Avenida Padre Júlio Fragata",61,61,0,21,21,0
1,31,2019,4,0,5,"Braga",7,"Rua Nova Santa Cruz",29,29,0,104,104,0
1,31,2019,4,0,5,"Braga",8,"Rua Costa Gomes",40,40,0,43,43,0
1,31,2019,5,0,5,"Braga",1,"Avenida da Liberdade",21,21,0,31,31,0
1,31,2019,5,0,5,"Braga",2,"Avenida Central",17,17,0,272,272,0
1,31,2019,5,0,5,"Braga",3,"Rua de Caires",35,35,0,38,38,0
1,31,2019,5,0,5,"Braga",4,"N14 Bosch",46,46,0,48,48,0
1,31,2019,5,0,5,"Braga",5,"Avenida João Paulo II",40,40,0,8,8,0
1,31,2019,5,0,5,"Braga",6,"Avenida Padre Júlio Fragata",61,61,0,21,21,0
1,31,2019,5,0,5,"Braga",7,"Rua Nova Santa Cruz",29,29,0,104,104,0
1,31,2019,5,0,5,"Braga",8,"Rua Costa Gomes",40,40,0,43,43,0
1,31,2019,6,0,5,"Braga",1,"Avenida da Liberdade",21,21,0,31,31,0
1,31,2019,6,0,5,"Braga",2,"Avenida Central",17,17,0,272,272,0
1,31,2019,6,0,5,"Braga",3,"Rua de Caires",35,35,0,38,38,0
1,31,2019,6,0,5,"Braga",4,"N14 Bosch",46,46,0,48,48,0
1,31,2019,6,0,5,"Braga",5,"Avenida João Paulo II",40,40,0,8,8,0
1,31,2019,6,0,5,"Braga",6,"Avenida Padre Júlio Fragata",61,61,0,21,21,0
1,31,2019,6,0,5,"Braga",7,"Rua Nova Santa Cruz",29,29,0,104,104,0
1,31,2019,6,0,5,"Braga",8,"Rua Costa Gomes",40,40,0,43,43,0
1,31,2019,7,0,5,"Braga",1,"Avenida da Liberdade",21,21,0,31,31,0
1,31,2019,7,0,5,"Braga",2,"Avenida Central",17,17,0,272,272,0
1,31,2019,7,0,5,"Braga",3,"Rua de Caires",35,35,0,38,38,0
1,31,2019,7,0,5,"Braga",4,"N14 Bosch",46,46,0,48,48,0
1,31,2019,7,0,5,"Braga",5,"Avenida João Paulo II",40,40,0,8,8,0
1,31,2019,7,0,5,"Braga",6,"Avenida Padre Júlio Fragata",61,61,0,21,21,0
1,31,2019,7,0,5,"Braga",7,"Rua Nova Santa Cruz",29,29,0,104,104,0
1,31,2019,7,0,5,"Braga",8,"Rua Costa Gomes",40,40,0,43,43,0
1,31,2019,8,0,5,"Braga",1,"Avenida da Liberdade",21,21,0,31,31,0
1,31,2019,8,0,5,"Braga",2,"Avenida Central",13,17,4,356,272,84
1,31,2019,8,0,5,"Braga",3,"Rua de Caires",24,34,10,56,39,17
1,31,2019,8,0,5,"Braga",4,"N14 Bosch",36,46,10,62,48,14
1,31,2019,8,0,5,"Braga",5,"Avenida João Paulo II",40,40,0,8,8,0
1,31,2019,8,0,5,"Braga",6,"Avenida Padre Júlio Fragata",61,61,0,21,21,0
1,31,2019,8,0,5,"Braga",7,"Rua Nova Santa Cruz",29,29,0,104,104,0
1,31,2019,8,0,5,"Braga",8,"Rua Costa Gomes",28,39,11,61,44,17
1,31,2019,9,0,5,"Braga",1,"Avenida da Liberdade",21,21,0,31,31,0
1,31,2019,9,0,5,"Braga",2,"Avenida Central",9,17,8,515,272,243
1,31,2019,9,0,5,"Braga",3,"Rua de Caires",27,35,8,49,38,11
1,31,2019,9,0,5,"Braga",4,"N14 Bosch",22,46,24,102,48,54
1,31,2019,9,0,5,"Braga",5,"Avenida João Paulo II",14,41,27,24,8,16
1,31,2019,9,0,5,"Braga",6,"Avenida Padre Júlio Fragata",25,60,35,51,21,30
1,31,2019,9,0,5,"Braga",7,"Rua Nova Santa Cruz",29,29,0,104,104,0
1,31,2019,9,0,5,"Braga",8,"Rua Costa Gomes",22,40,18,78,43,35
1,31,2019,10,0,5,"Braga",1,"Avenida da Liberdade",17,22,5,39,30,9
1,31,2019,10,0,5,"Braga",2,"Avenida Central",14,18,4,331,257,74
1,31,2019,10,0,5,"Braga",3,"Rua de Caires",19,34,15,70,39,31
1,31,2019,10,0,5,"Braga",4,"N14 Bosch",33,45,12,68,49,19
1,31,2019,10,0,5,"Braga",5,"Avenida João Paulo II",39,39,0,8,8,0
1,31,2019,10,0,5,"Braga",6,"Avenida Padre Júlio Fragata",60,60,0,21,21,0
1,31,2019,10,0,5,"Braga",7,"Rua Nova Santa Cruz",29,29,0,104,104,0
1,31,2019,10,0,5,"Braga",8,"Rua Costa Gomes",31,39,8,55,44,11
1,31,2019,11,0,5,"Braga",1,"Avenida da Liberdade",17,21,4,39,31,8
1,31,2019,11,0,5,"Braga",2,"Avenida Central",12,17,5,386,272,114
1,31,2019,11,0,5,"Braga",3,"Rua de Caires",25,35,10,53,38,15
1,31,2019,11,0,5,"Braga",4,"N14 Bosch",30,45,15,74,49,25
1,31,2019,11,0,5,"Braga",5,"Avenida João Paulo II",32,40,8,10,8,2
1,31,2019,11,0,5,"Braga",6,"Avenida Padre Júlio Fragata",60,60,0,21,21,0
1,31,2019,11,0,5,"Braga",7,"Rua Nova Santa Cruz",28,28,0,108,108,0
1,31,2019,11,0,5,"Braga",8,"Rua Costa Gomes",28,40,12,61,43,18
1,31,2019,12,0,5,"Braga",1,"Avenida da Liberdade",17,21,4,39,31,8
1,31,2019,12,0,5,"Braga",2,"Avenida Central",12,18,6,386,257,129
1,31,2019,12,0,5,"Braga",3,"Rua de Caires",24,35,11,56,38,18
1,31,2019,12,0,5,"Braga",4,"N14 Bosch",31,45,14,72,49,23
1,31,2019,12,0,5,"Braga",5,"Avenida João Paulo II",30,39,9,11,8,3
1,31,2019,12,0,5,"Braga",6,"Avenida Padre Júlio Fragata",60,60,0,21,21,0
1,31,2019,12,0,5,"Braga",7,"Rua Nova Santa Cruz",22,29,7,138,104,34
1,31,2019,12,0,5,"Braga",8,"Rua Costa Gomes",30,40,10,57,43,14
1,31,2019,13,0,5,"Braga",1,"Avenida da Liberdade",21,21,0,31,31,0
1,31,2019,13,0,5,"Braga",2,"Avenida Central",14,18,4,331,257,74
1,31,2019,13,0,5,"Braga",3,"Rua de Caires",25,34,9,53,39,14
1,31,2019,13,0,5,"Braga",4,"N14 Bosch",31,45,14,72,49,23
1,31,2019,13,0,5,"Braga",5,"Avenida João Paulo II",40,40,0,8,8,0
1,31,2019,13,0,5,"Braga",6,"Avenida Padre Júlio Fragata",30,60,30,42,21,21
1,31,2019,13,0,5,"Braga",7,"Rua Nova Santa Cruz",29,29,0,104,104,0
1,31,2019,13,0,5,"Braga",8,"Rua Costa Gomes",29,40,11,59,43,16
1,31,2019,14,0,5,"Braga",1,"Avenida da Liberdade",21,21,0,31,31,0
1,31,2019,14,0,5,"Braga",2,"Avenida Central",14,17,3,331,272,59
1,31,2019,14,0,5,"Braga",3,"Rua de Caires",28,35,7,48,38,10
1,31,2019,14,0,5,"Braga",4,"N14 Bosch",25,46,21,89,48,41
1,31,2019,14,0,5,"Braga",5,"Avenida João Paulo II",39,39,0,8,8,0
1,31,2019,14,0,5,"Braga",6,"Avenida Padre Júlio Fragata",46,60,14,27,21,6
1,31,2019,14,0,5,"Braga",7,"Rua Nova Santa Cruz",28,28,0,108,108,0
1,31,2019,14,0,5,"Braga",8,"Rua Costa Gomes",30,39,9,57,44,13
1,31,2019,15,0,5,"Braga",1,"Avenida da Liberdade",21,21,0,31,31,0
1,31,2019,15,0,5,"Braga",2,"Avenida Central",13,18,5,356,257,99
1,31,2019,15,0,5,"Braga",3,"Rua de Caires",35,35,0,38,38,0
1,31,2019,15,0,5,"Braga",4,"N14 Bosch",18,46,28,124,48,76
1,31,2019,15,0,5,"Braga",5,"Avenida João Paulo II",28,39,11,12,8,4
1,31,2019,15,0,5,"Braga",6,"Avenida Padre Júlio Fragata",48,60,12,26,21,5
1,31,2019,15,0,5,"Braga",7,"Rua Nova Santa Cruz",20,28,8,152,108,44
1,31,2019,15,0,5,"Braga",8,"Rua Costa Gomes",31,40,9,55,43,12
1,31,2019,16,0,5,"Braga",1,"Avenida da Liberdade",21,21,0,31,31,0
1,31,2019,16,0,5,"Braga",2,"Avenida Central",13,18,5,356,257,99
1,31,2019,16,0,5,"Braga",3,"Rua de Caires",27,35,8,49,38,11
1,31,2019,16,0,5,"Braga",4,"N14 Bosch",20,45,25,112,49,63
1,31,2019,16,0,5,"Braga",5,"Avenida João Paulo II",28,39,11,12,8,4
1,31,2019,16,0,5,"Braga",6,"Avenida Padre Júlio Fragata",42,60,18,30,21,9
1,31,2019,16,0,5,"Braga",7,"Rua Nova Santa Cruz",18,28,10,169,108,61
1,31,2019,16,0,5,"Braga",8,"Rua Costa Gomes",40,40,0,43,43,0
1,31,2019,17,0,5,"Braga",1,"Avenida da Liberdade",17,21,4,39,31,8
1,31,2019,17,0,5,"Braga",2,"Avenida Central",12,18,6,386,257,129
1,31,2019,17,0,5,"Braga",3,"Rua de Caires",23,35,12,58,38,20
1,31,2019,17,0,5,"Braga",4,"N14 Bosch",18,46,28,124,48,76
1,31,2019,17,0,5,"Braga",5,"Avenida João Paulo II",23,40,17,15,8,7
1,31,2019,17,0,5,"Braga",6,"Avenida Padre Júlio Fragata",46,61,15,27,21,6
1,31,2019,17,0,5,"Braga",7,"Rua Nova Santa Cruz",18,28,10,169,108,61
1,31,2019,17,0,5,"Braga",8,"Rua Costa Gomes",21,39,18,82,44,38
1,31,2019,18,0,5,"Braga",1,"Avenida da Liberdade",13,22,9,51,30,21
1,31,2019,18,0,5,"Braga",2,"Avenida Central",10,18,8,463,257,206
1,31,2019,18,0,5,"Braga",3,"Rua de Caires",21,35,14,64,38,26
1,31,2019,18,0,5,"Braga",4,"N14 Bosch",17,47,30,132,47,85
1,31,2019,18,0,5,"Braga",5,"Avenida João Paulo II",29,40,11,12,8,4
1,31,2019,18,0,5,"Braga",6,"Avenida Padre Júlio Fragata",38,60,22,33,21,12
1,31,2019,18,0,5,"Braga",7,"Rua Nova Santa Cruz",13,28,15,234,108,126
1,31,2019,18,0,5,"Braga",8,"Rua Costa Gomes",13,40,27,132,43,89
1,31,2019,19,0,5,"Braga",1,"Avenida da Liberdade",13,21,8,51,31,20
1,31,2019,19,0,5,"Braga",2,"Avenida Central",6,18,12,772,257,515
1,31,2019,19,0,5,"Braga",3,"Rua de Caires",24,34,10,56,39,17
1,31,2019,19,0,5,"Braga",4,"N14 Bosch",27,46,19,83,48,35
1,31,2019,19,0,5,"Braga",5,"Avenida João Paulo II",22,39,17,15,8,7
1,31,2019,19,0,5,"Braga",6,"Avenida Padre Júlio Fragata",38,61,23,33,21,12
1,31,2019,19,0,5,"Braga",7,"Rua Nova Santa Cruz",23,29,6,132,104,28
1,31,2019,19,0,5,"Braga",8,"Rua Costa Gomes",22,39,17,78,44,34
1,31,2019,20,0,5,"Braga",1,"Avenida da Liberdade",21,21,0,31,31,0
1,31,2019,20,0,5,"Braga",2,"Avenida Central",10,17,7,463,272,191
1,31,2019,20,0,5,"Braga",3,"Rua de Caires",34,34,0,39,39,0
1,31,2019,20,0,5,"Braga",4,"N14 Bosch",33,46,13,68,48,20
1,31,2019,20,0,5,"Braga",5,"Avenida João Paulo II",30,39,9,11,8,3
1,31,2019,20,0,5,"Braga",6,"Avenida Padre Júlio Fragata",60,60,0,21,21,0
1,31,2019,20,0,5,"Braga",7,"Rua Nova Santa Cruz",20,29,9,152,104,48
1,31,2019,20,0,5,"Braga",8,"Rua Costa Gomes",21,39,18,82,44,38
1,31,2019,21,0,5,"Braga",1,"Avenida da Liberdade",21,21,0,31,31,0
1,31,2019,21,0,5,"Braga",2,"Avenida Central",17,17,0,272,272,0
1,31,2019,21,0,5,"Braga",3,"Rua de Caires",35,35,0,38,38,0
1,31,2019,21,0,5,"Braga",4,"N14 Bosch",45,45,0,49,49,0
1,31,2019,21,0,5,"Braga",5,"Avenida João Paulo II",40,40,0,8,8,0
1,31,2019,21,0,5,"Braga",6,"Avenida Padre Júlio Fragata",61,61,0,21,21,0
1,31,2019,21,0,5,"Braga",7,"Rua Nova Santa Cruz",29,29,0,104,104,0
1,31,2019,21,0,5,"Braga",8,"Rua Costa Gomes",40,40,0,43,43,0
1,31,2019,22,0,5,"Braga",1,"Avenida da Liberdade",21,21,0,31,31,0
1,31,2019,22,0,5,"Braga",2,"Avenida Central",17,17,0,272,272,0
1,31,2019,22,0,5,"Braga",3,"Rua de Caires",35,35,0,38,38,0
1,31,2019,22,0,5,"Braga",4,"N14 Bosch",45,45,0,49,49,0
1,31,2019,22,0,5,"Braga",5,"Avenida João Paulo II",40,40,0,8,8,0
1,31,2019,22,0,5,"Braga",6,"Avenida Padre Júlio Fragata",61,61,0,21,21,0
1,31,2019,22,0,5,"Braga",7,"Rua Nova Santa Cruz",29,29,0,104,104,0
1,31,2019,22,0,5,"Braga",8,"Rua Costa Gomes",40,40,0,43,43,0
1,31,2019,23,0,5,"Braga",1,"Avenida da Liberdade",21,21,0,31,31,0
1,31,2019,23,0,5,"Braga",2,"Avenida Central",17,17,0,272,272,0
1,31,2019,23,0,5,"Braga",3,"Rua de Caires",35,35,0,38,38,0
1,31,2019,23,0,5,"Braga",4,"N14 Bosch",45,45,0,49,49,0
1,31,2019,23,0,5,"Braga",5,"Avenida João Paulo II",40,40,0,8,8,0
1,31,2019,23,0,5,"Braga",6,"Avenida Padre Júlio Fragata",61,61,0,21,21,0
1,31,2019,23,0,5,"Braga",7,"Rua Nova Santa Cruz",29,29,0,104,104,0
1,31,2019,23,0,5,"Braga",8,"Rua Costa Gomes",40,40,0,43,43,0
2,1,2019,0,0,6,"Braga",1,"Avenida da Liberdade",21,21,0,31,31,0
2,1,2019,0,0,6,"Braga",2,"Avenida Central",17,17,0,272,272,0
2,1,2019,0,0,6,"Braga",3,"Rua de Caires",35,35,0,38,38,0
2,1,2019,0,0,6,"Braga",4,"N14 Bosch",46,46,0,48,48,0
2,1,2019,0,0,6,"Braga",5,"Avenida João Paulo II",40,40,0,8,8,0
2,1,2019,0,0,6,"Braga",6,"Avenida Padre Júlio Fragata",61,61,0,21,21,0
2,1,2019,0,0,6,"Braga",7,"Rua Nova Santa Cruz",29,29,0,104,104,0
2,1,2019,0,0,6,"Braga",8,"Rua Costa Gomes",40,40,0,43,43,0
2,1,2019,1,0,6,"Braga",1,"Avenida da Liberdade",21,21,0,31,31,0
2,1,2019,1,0,6,"Braga",2,"Avenida Central",17,17,0,272,272,0
2,1,2019,1,0,6,"Braga",3,"Rua de Caires",35,35,0,38,38,0
2,1,2019,1,0,6,"Braga",4,"N14 Bosch",46,46,0,48,48,0
2,1,2019,1,0,6,"Braga",5,"Avenida João Paulo II",40,40,0,8,8,0
2,1,2019,1,0,6,"Braga",6,"Avenida Padre Júlio Fragata",61,61,0,21,21,0
2,1,2019,1,0,6,"Braga",7,"Rua Nova Santa Cruz",29,29,0,104,104,0
2,1,2019,1,0,6,"Braga",8,"Rua Costa Gomes",40,40,0,43,43,0
2,1,2019,2,0,6,"Braga",1,"Avenida da Liberdade",21,21,0,31,31,0
2,1,2019,2,0,6,"Braga",2,"Avenida Central",17,17,0,272,272,0
2,1,2019,2,0,6,"Braga",3,"Rua de Caires",35,35,0,38,38,0
2,1,2019,2,0,6,"Braga",4,"N14 Bosch",46,46,0,48,48,0
2,1,2019,2,0,6,"Braga",5,"Avenida João Paulo II",40,40,0,8,8,0
2,1,2019,2,0,6,"Braga",6,"Avenida Padre Júlio Fragata",61,61,0,21,21,0
2,1,2019,2,0,6,"Braga",7,"Rua Nova Santa Cruz",29,29,0,104,104,0
2,1,2019,2,0,6,"Braga",8,"Rua Costa Gomes",40,40,0,43,43,0
2,1,2019,3,0,6,"Braga",1,"Avenida da Liberdade",21,21,0,31,31,0
2,1,2019,3,0,6,"Braga",2,"Avenida Central",17,17,0,272,272,0
2,1,2019,3,0,6,"Braga",3,"Rua de Caires",35,35,0,38,38,0
2,1,2019,3,0,6,"Braga",4,"N14 Bosch",46,46,0,48,48,0
2,1,2019,3,0,6,"Braga",5,"Avenida João Paulo II",40,40,0,8,8,0
2,1,2019,3,0,6,"Braga",6,"Avenida Padre Júlio Fragata",61,61,0,21,21,0
2,1,2019,3,0,6,"Braga",7,"Rua Nova Santa Cruz",29,29,0,104,104,0
2,1,2019,3,0,6,"Braga",8,"Rua Costa Gomes",40,40,0,43,43,0
2,1,2019,4,0,6,"Braga",1,"Avenida da Liberdade",21,21,0,31,31,0
2,1,2019,4,0,6,"Braga",2,"Avenida Central",17,17,0,272,272,0
2,1,2019,4,0,6,"Braga",3,"Rua de Caires",35,35,0,38,38,0
2,1,2019,4,0,6,"Braga",4,"N14 Bosch",46,46,0,48,48,0
2,1,2019,4,0,6,"Braga",5,"Avenida João Paulo II",40,40,0,8,8,0
2,1,2019,4,0,6,"Braga",6,"Avenida Padre Júlio Fragata",61,61,0,21,21,0
2,1,2019,4,0,6,"Braga",7,"Rua Nova Santa Cruz",29,29,0,104,104,0
2,1,2019,4,0,6,"Braga",8,"Rua Costa Gomes",40,40,0,43,43,0
2,1,2019,5,0,6,"Braga",1,"Avenida da Liberdade",21,21,0,31,31,0
2,1,2019,5,0,6,"Braga",2,"Avenida Central",17,17,0,272,272,0
2,1,2019,5,0,6,"Braga",3,"Rua de Caires",35,35,0,38,38,0
2,1,2019,5,0,6,"Braga",4,"N14 Bosch",46,46,0,48,48,0
2,1,2019,5,0,6,"Braga",5,"Avenida João Paulo II",40,40,0,8,8,0
2,1,2019,5,0,6,"Braga",6,"Avenida Padre Júlio Fragata",61,61,0,21,21,0
2,1,2019,5,0,6,"Braga",7,"Rua Nova Santa Cruz",29,29,0,104,104,0
2,1,2019,5,0,6,"Braga",8,"Rua Costa Gomes",40,40,0,43,43,0
2,1,2019,6,0,6,"Braga",1,"Avenida da Liberdade",21,21,0,31,31,0
2,1,2019,6,0,6,"Braga",2,"Avenida Central",17,17,0,272,272,0
2,1,2019,6,0,6,"Braga",3,"Rua de Caires",35,35,0,38,38,0
2,1,2019,6,0,6,"Braga",4,"N14 Bosch",46,46,0,48,48,0
2,1,2019,6,0,6,"Braga",5,"Avenida João Paulo II",40,40,0,8,8,0
2,1,2019,6,0,6,"Braga",6,"Avenida Padre Júlio Fragata",61,61,0,21,21,0
2,1,2019,6,0,6,"Braga",7,"Rua Nova Santa Cruz",29,29,0,104,104,0
2,1,2019,6,0,6,"Braga",8,"Rua Costa Gomes",40,40,0,43,43,0
2,1,2019,7,0,6,"Braga",1,"Avenida da Liberdade",21,21,0,31,31,0
2,1,2019,7,0,6,"Braga",2,"Avenida Central",17,17,0,272,272,0
2,1,2019,7,0,6,"Braga",3,"Rua de Caires",35,35,0,38,38,0
2,1,2019,7,0,6,"Braga",4,"N14 Bosch",46,46,0,48,48,0
2,1,2019,7,0,6,"Braga",5,"Avenida João Paulo II",40,40,0,8,8,0
2,1,2019,7,0,6,"Braga",6,"Avenida Padre Júlio Fragata",61,61,0,21,21,0
2,1,2019,7,0,6,"Braga",7,"Rua Nova Santa Cruz",29,29,0,104,104,0
2,1,2019,7,0,6,"Braga",8,"Rua Costa Gomes",40,40,0,43,43,0
2,1,2019,8,0,6,"Braga",1,"Avenida da Liberdade",21,21,0,31,31,0
2,1,2019,8,0,6,"Braga",2,"Avenida Central",17,17,0,272,272,0
2,1,2019,8,0,6,"Braga",3,"Rua de Caires",26,35,9,51,38,13
2,1,2019,8,0,6,"Braga",4,"N14 Bosch",33,45,12,68,49,19
2,1,2019,8,0,6,"Braga",5,"Avenida João Paulo II",40,40,0,8,8,0
2,1,2019,8,0,6,"Braga",6,"Avenida Padre Júlio Fragata",61,61,0,21,21,0
2,1,2019,8,0,6,"Braga",7,"Rua Nova Santa Cruz",29,29,0,104,104,0
2,1,2019,8,0,6,"Braga",8,"Rua Costa Gomes",28,40,12,61,43,18
2,1,2019,9,0,6,"Braga",1,"Avenida da Liberdade",21,21,0,31,31,0
2,1,2019,9,0,6,"Braga",2,"Avenida Central",14,18,4,331,257,74
2,1,2019,9,0,6,"Braga",3,"Rua de Caires",25,34,9,53,39,14
2,1,2019,9,0,6,"Braga",4,"N14 Bosch",26,46,20,86,48,38
2,1,2019,9,0,6,"Braga",5,"Avenida João Paulo II",7,39,32,49,8,41
2,1,2019,9,0,6,"Braga",6,"Avenida Padre Júlio Fragata",22,60,38,58,21,37
2,1,2019,9,0,6,"Braga",7,"Rua Nova Santa Cruz",29,29,0,104,104,0
2,1,2019,9,0,6,"Braga",8,"Rua Costa Gomes",24,40,16,71,43,28
2,1,2019,10,0,6,"Braga",1,"Avenida da Liberdade",17,21,4,39,31,8
2,1,2019,10,0,6,"Braga",2,"Avenida Central",14,18,4,331,257,74
2,1,2019,10,0,6,"Braga",3,"Rua de Caires",24,35,11,56,38,18
2,1,2019,10,0,6,"Braga",4,"N14 Bosch",27,45,18,83,49,34
2,1,2019,10,0,6,"Braga",5,"Avenida João Paulo II",39,39,0,8,8,0
2,1,2019,10,0,6,"Braga",6,"Avenida Padre Júlio Fragata",60,60,0,21,21,0
2,1,2019,10,0,6,"Braga",7,"Rua Nova Santa Cruz",29,29,0,104,104,0
2,1,2019,10,0,6,"Braga",8,"Rua Costa Gomes",31,39,8,55,44,11
2,1,2019,11,0,6,"Braga",1,"Avenida da Liberdade",17,21,4,39,31,8
2,1,2019,11,0,6,"Braga",2,"Avenida Central",14,18,4,331,257,74
2,1,2019,11,0,6,"Braga",3,"Rua de Caires",23,34,11,58,39,19
2,1,2019,11,0,6,"Braga",4,"N14 Bosch",24,46,22,93,48,45
2,1,2019,11,0,6,"Braga",5,"Avenida João Paulo II",39,39,0,8,8,0
2,1,2019,11,0,6,"Braga",6,"Avenida Padre Júlio Fragata",60,60,0,21,21,0
2,1,2019,11,0,6,"Braga",7,"Rua Nova Santa Cruz",16,28,12,190,108,82
2,1,2019,11,0,6,"Braga",8,"Rua Costa Gomes",28,40,12,61,43,18
2,1,2019,12,0,6,"Braga",1,"Avenida da Liberdade",22,22,0,30,30,0
2,1,2019,12,0,6,"Braga",2,"Avenida Central",12,18,6,386,257,129
2,1,2019,12,0,6,"Braga",3,"Rua de Caires",24,35,11,56,38,18
2,1,2019,12,0,6,"Braga",4,"N14 Bosch",30,46,16,74,48,26
2,1,2019,12,0,6,"Braga",5,"Avenida João Paulo II",40,40,0,8,8,0
2,1,2019,12,0,6,"Braga",6,"Avenida Padre Júlio Fragata",47,61,14,27,21,6
2,1,2019,12,0,6,"Braga",7,"Rua Nova Santa Cruz",22,29,7,138,104,34
2,1,2019,12,0,6,"Braga",8,"Rua Costa Gomes",26,39,13,66,44,22
2,1,2019,13,0,6,"Braga",1,"Avenida da Liberdade",22,22,0,30,30,0
2,1,2019,13,0,6,"Braga",2,"Avenida Central",12,17,5,386,272,114
2,1,2019,13,0,6,"Braga",3,"Rua de Caires",20,34,14,67,39,28
2,1,2019,13,0,6,"Braga",4,"N14 Bosch",24,45,21,93,49,44
2,1,2019,13,0,6,"Braga",5,"Avenida João Paulo II",40,40,0,8,8,0
2,1,2019,13,0,6,"Braga",6,"Avenida Padre Júlio Fragata",61,61,0,21,21,0
2,1,2019,13,0,6,"Braga",7,"Rua Nova Santa Cruz",22,29,7,138,104,34
2,1,2019,13,0,6,"Braga",8,"Rua Costa Gomes",30,39,9,57,44,13
2,1,2019,14,0,6,"Braga",1,"Avenida da Liberdade",21,21,0,31,31,0
2,1,2019,14,0,6,"Braga",2,"Avenida Central",10,17,7,463,272,191
2,1,2019,14,0,6,"Braga",3,"Rua de Caires",28,35,7,48,38,10
2,1,2019,14,0,6,"Braga",4,"N14 Bosch",28,46,18,80,48,32
2,1,2019,14,0,6,"Braga",5,"Avenida João Paulo II",40,40,0,8,8,0
2,1,2019,14,0,6,"Braga",6,"Avenida Padre Júlio Fragata",61,61,0,21,21,0
2,1,2019,14,0,6,"Braga",7,"Rua Nova Santa Cruz",19,29,10,160,104,56
2,1,2019,14,0,6,"Braga",8,"Rua Costa Gomes",29,39,10,59,44,15
2,1,2019,15,0,6,"Braga",1,"Avenida da Liberdade",22,22,0,30,30,0
2,1,2019,15,0,6,"Braga",2,"Avenida Central",8,17,9,579,272,307
2,1,2019,15,0,6,"Braga",3,"Rua de Caires",34,34,0,39,39,0
2,1,2019,15,0,6,"Braga",4,"N14 Bosch",22,46,24,102,48,54
2,1,2019,15,0,6,"Braga",5,"Avenida João Paulo II",31,40,9,11,8,3
2,1,2019,15,0,6,"Braga",6,"Avenida Padre Júlio Fragata",39,60,21,32,21,11
2,1,2019,15,0,6,"Braga",7,"Rua Nova Santa Cruz",20,29,9,152,104,48
2,1,2019,15,0,6,"Braga",8,"Rua Costa Gomes",31,39,8,55,44,11
2,1,2019,16,0,6,"Braga",1,"Avenida da Liberdade",17,22,5,39,30,9
2,1,2019,16,0,6,"Braga",2,"Avenida Central",12,18,6,386,257,129
2,1,2019,16,0,6,"Braga",3,"Rua de Caires",22,34,12,61,39,22
2,1,2019,16,0,6,"Braga",4,"N14 Bosch",27,45,18,83,49,34
2,1,2019,16,0,6,"Braga",5,"Avenida João Paulo II",26,40,14,13,8,5
2,1,2019,16,0,6,"Braga",6,"Avenida Padre Júlio Fragata",29,61,32,44,21,23
2,1,2019,16,0,6,"Braga",7,"Rua Nova Santa Cruz",22,29,7,138,104,34
2,1,2019,16,0,6,"Braga",8,"Rua Costa Gomes",30,40,10,57,43,14
2,1,2019,17,0,6,"Braga",1,"Avenida da Liberdade",17,21,4,39,31,8
2,1,2019,17,0,6,"Braga",2,"Avenida Central",9,18,9,515,257,258
2,1,2019,17,0,6,"Braga",3,"Rua de Caires",24,35,11,56,38,18
2,1,2019,17,0,6,"Braga",4,"N14 Bosch",21,46,25,107,48,59
2,1,2019,17,0,6,"Braga",5,"Avenida João Paulo II",40,40,0,8,8,0
2,1,2019,17,0,6,"Braga",6,"Avenida Padre Júlio Fragata",21,59,38,61,21,40
2,1,2019,17,0,6,"Braga",7,"Rua Nova Santa Cruz",18,28,10,169,108,61
2,1,2019,17,0,6,"Braga",8,"Rua Costa Gomes",25,39,14,69,44,25
2,1,2019,18,0,6,"Braga",1,"Avenida da Liberdade",16,22,6,41,30,11
2,1,2019,18,0,6,"Braga",2,"Avenida Central",10,18,8,463,257,206
2,1,2019,18,0,6,"Braga",3,"Rua de Caires",19,35,16,70,38,32
2,1,2019,18,0,6,"Braga",4,"N14 Bosch",12,47,35,187,47,140
2,1,2019,18,0,6,"Braga",5,"Avenida João Paulo II",7,40,33,49,8,41
2,1,2019,18,0,6,"Braga",6,"Avenida Padre Júlio Fragata",24,61,37,53,21,32
2,1,2019,18,0,6,"Braga",7,"Rua Nova Santa Cruz",21,29,8,144,104,40
2,1,2019,18,0,6,"Braga",8,"Rua Costa Gomes",24,40,16,71,43,28
2,1,2019,19,0,6,"Braga",1,"Avenida da Liberdade",22,22,0,30,30,0
2,1,2019,19,0,6,"Braga",2,"Avenida Central",11,17,6,421,272,149
2,1,2019,19,0,6,"Braga",3,"Rua de Caires",23,35,12,58,38,20
2,1,2019,19,0,6,"Braga",4,"N14 Bosch",23,46,23,97,48,49
2,1,2019,19,0,6,"Braga",5,"Avenida João Paulo II",12,40,28,29,8,21
2,1,2019,19,0,6,"Braga",6,"Avenida Padre Júlio Fragata",26,61,35,49,21,28
2,1,2019,19,0,6,"Braga",7,"Rua Nova Santa Cruz",16,29,13,190,104,86
2,1,2019,19,0,6,"Braga",8,"Rua Costa Gomes",10,39,29,172,44,128
2,1,2019,20,0,6,"Braga",1,"Avenida da Liberdade",21,21,0,31,31,0
2,1,2019,20,0,6,"Braga",2,"Avenida Central",13,17,4,356,272,84
2,1,2019,20,0,6,"Braga",3,"Rua de Caires",35,35,0,38,38,0
2,1,2019,20,0,6,"Braga",4,"N14 Bosch",28,45,17,80,49,31
2,1,2019,20,0,6,"Braga",5,"Avenida João Paulo II",30,39,9,11,8,3
2,1,2019,20,0,6,"Braga",6,"Avenida Padre Júlio Fragata",37,60,23,34,21,13
2,1,2019,20,0,6,"Braga",7,"Rua Nova Santa Cruz",19,29,10,160,104,56
2,1,2019,20,0,6,"Braga",8,"Rua Costa Gomes",20,39,19,86,44,42
2,1,2019,21,0,6,"Braga",1,"Avenida da Liberdade",22,22,0,30,30,0
2,1,2019,21,0,6,"Braga",2,"Avenida Central",17,17,0,272,272,0
2,1,2019,21,0,6,"Braga",3,"Rua de Caires",34,34,0,39,39,0
2,1,2019,21,0,6,"Braga",4,"N14 Bosch",45,45,0,49,49,0
2,1,2019,21,0,6,"Braga",5,"Avenida João Paulo II",31,40,9,11,8,3
2,1,2019,21,0,6,"Braga",6,"Avenida Padre Júlio Fragata",37,60,23,34,21,13
2,1,2019,21,0,6,"Braga",7,"Rua Nova Santa Cruz",28,28,0,108,108,0
2,1,2019,21,0,6,"Braga",8,"Rua Costa Gomes",32,40,8,53,43,10
2,1,2019,22,0,6,"Braga",1,"Avenida da Liberdade",22,22,0,30,30,0
2,1,2019,22,0,6,"Braga",2,"Avenida Central",17,17,0,272,272,0
2,1,2019,22,0,6,"Braga",3,"Rua de Caires",34,34,0,39,39,0
2,1,2019,22,0,6,"Braga",4,"N14 Bosch",45,45,0,49,49,0
2,1,2019,22,0,6,"Braga",5,"Avenida João Paulo II",40,40,0,8,8,0
2,1,2019,22,0,6,"Braga",6,"Avenida Padre Júlio Fragata",61,61,0,21,21,0
2,1,2019,22,0,6,"Braga",7,"Rua Nova Santa Cruz",28,28,0,108,108,0
2,1,2019,22,0,6,"Braga",8,"Rua Costa Gomes",31,40,9,55,43,12
2,1,2019,23,0,6,"Braga",1,"Avenida da Liberdade",22,22,0,30,30,0
2,1,2019,23,0,6,"Braga",2,"Avenida Central",17,17,0,272,272,0
2,1,2019,23,0,6,"Braga",3,"Rua de Caires",34,34,0,39,39,0
2,1,2019,23,0,6,"Braga",4,"N14 Bosch",45,45,0,49,49,0
2,1,2019,23,0,6,"Braga",5,"Avenida João Paulo II",40,40,0,8,8,0
2,1,2019,23,0,6,"Braga",6,"Avenida Padre Júlio Fragata",45,60,15,28,21,7
2,1,2019,23,0,6,"Braga",7,"Rua Nova Santa Cruz",28,28,0,108,108,0
2,1,2019,23,0,6,"Braga",8,"Rua Costa Gomes",39,39,0,44,44,0
2,2,2019,0,0,7,"Braga",1,"Avenida da Liberdade",22,22,0,30,30,0
2,2,2019,0,0,7,"Braga",2,"Avenida Central",17,17,0,272,272,0
2,2,2019,0,0,7,"Braga",3,"Rua de Caires",34,34,0,39,39,0
2,2,2019,0,0,7,"Braga",4,"N14 Bosch",45,45,0,49,49,0
2,2,2019,0,0,7,"Braga",5,"Avenida João Paulo II",40,40,0,8,8,0
2,2,2019,0,0,7,"Braga",6,"Avenida Padre Júlio Fragata",61,61,0,21,21,0
2,2,2019,0,0,7,"Braga",7,"Rua Nova Santa Cruz",28,28,0,108,108,0
2,2,2019,0,0,7,"Braga",8,"Rua Costa Gomes",39,39,0,44,44,0
2,2,2019,1,0,7,"Braga",1,"Avenida da Liberdade",22,22,0,30,30,0
2,2,2019,1,0,7,"Braga",2,"Avenida Central",17,17,0,272,272,0
2,2,2019,1,0,7,"Braga",3,"Rua de Caires",34,34,0,39,39,0
2,2,2019,1,0,7,"Braga",4,"N14 Bosch",45,45,0,49,49,0
2,2,2019,1,0,7,"Braga",5,"Avenida João Paulo II",40,40,0,8,8,0
2,2,2019,1,0,7,"Braga",6,"Avenida Padre Júlio Fragata",61,61,0,21,21,0
2,2,2019,1,0,7,"Braga",7,"Rua Nova Santa Cruz",28,28,0,108,108,0
2,2,2019,1,0,7,"Braga",8,"Rua Costa Gomes",39,39,0,44,44,0
2,2,2019,2,0,7,"Braga",1,"Avenida da Liberdade",22,22,0,30,30,0
2,2,2019,2,0,7,"Braga",2,"Avenida Central",17,17,0,272,272,0
2,2,2019,2,0,7,"Braga",3,"Rua de Caires",34,34,0,39,39,0
2,2,2019,2,0,7,"Braga",4,"N14 Bosch",45,45,0,49,49,0
2,2,2019,2,0,7,"Braga",5,"Avenida João Paulo II",40,40,0,8,8,0
2,2,2019,2,0,7,"Braga",6,"Avenida Padre Júlio Fragata",61,61,0,21,21,0
2,2,2019,2,0,7,"Braga",7,"Rua Nova Santa Cruz",28,28,0,108,108,0
2,2,2019,2,0,7,"Braga",8,"Rua Costa Gomes",39,39,0,44,44,0
2,2,2019,3,0,7,"Braga",1,"Avenida da Liberdade",22,22,0,30,30,0
2,2,2019,3,0,7,"Braga",2,"Avenida Central",17,17,0,272,272,0
2,2,2019,3,0,7,"Braga",3,"Rua de Caires",34,34,0,39,39,0
2,2,2019,3,0,7,"Braga",4,"N14 Bosch",45,45,0,49,49,0
2,2,2019,3,0,7,"Braga",5,"Avenida João Paulo II",40,40,0,8,8,0
2,2,2019,3,0,7,"Braga",6,"Avenida Padre Júlio Fragata",61,61,0,21,21,0
2,2,2019,3,0,7,"Braga",7,"Rua Nova Santa Cruz",28,28,0,108,108,0
2,2,2019,3,0,7,"Braga",8,"Rua Costa Gomes",39,39,0,44,44,0
2,2,2019,4,0,7,"Braga",1,"Avenida da Liberdade",22,22,0,30,30,0
2,2,2019,4,0,7,"Braga",2,"Avenida Central",17,17,0,272,272,0
2,2,2019,4,0,7,"Braga",3,"Rua de Caires",34,34,0,39,39,0
2,2,2019,4,0,7,"Braga",4,"N14 Bosch",45,45,0,49,49,0
2,2,2019,4,0,7,"Braga",5,"Avenida João Paulo II",40,40,0,8,8,0
2,2,2019,4,0,7,"Braga",6,"Avenida Padre Júlio Fragata",61,61,0,21,21,0
2,2,2019,4,0,7,"Braga",7,"Rua Nova Santa Cruz",28,28,0,108,108,0
2,2,2019,4,0,7,"Braga",8,"Rua Costa Gomes",39,39,0,44,44,0
2,2,2019,5,0,7,"Braga",1,"Avenida da Liberdade",22,22,0,30,30,0
2,2,2019,5,0,7,"Braga",2,"Avenida Central",17,17,0,272,272,0
2,2,2019,5,0,7,"Braga",3,"Rua de Caires",34,34,0,39,39,0
2,2,2019,5,0,7,"Braga",4,"N14 Bosch",45,45,0,49,49,0
2,2,2019,5,0,7,"Braga",5,"Avenida João Paulo II",40,40,0,8,8,0
2,2,2019,5,0,7,"Braga",6,"Avenida Padre Júlio Fragata",61,61,0,21,21,0
2,2,2019,5,0,7,"Braga",7,"Rua Nova Santa Cruz",28,28,0,108,108,0
2,2,2019,5,0,7,"Braga",8,"Rua Costa Gomes",39,39,0,44,44,0
2,2,2019,6,0,7,"Braga",1,"Avenida da Liberdade",22,22,0,30,30,0
2,2,2019,6,0,7,"Braga",2,"Avenida Central",17,17,0,272,272,0
2,2,2019,6,0,7,"Braga",3,"Rua de Caires",34,34,0,39,39,0
2,2,2019,6,0,7,"Braga",4,"N14 Bosch",45,45,0,49,49,0
2,2,2019,6,0,7,"Braga",5,"Avenida João Paulo II",40,40,0,8,8,0
2,2,2019,6,0,7,"Braga",6,"Avenida Padre Júlio Fragata",61,61,0,21,21,0
2,2,2019,6,0,7,"Braga",7,"Rua Nova Santa Cruz",28,28,0,108,108,0
2,2,2019,6,0,7,"Braga",8,"Rua Costa Gomes",39,39,0,44,44,0
2,2,2019,7,0,7,"Braga",1,"Avenida da Liberdade",22,22,0,30,30,0
2,2,2019,7,0,7,"Braga",2,"Avenida Central",17,17,0,272,272,0
2,2,2019,7,0,7,"Braga",3,"Rua de Caires",34,34,0,39,39,0
2,2,2019,7,0,7,"Braga",4,"N14 Bosch",45,45,0,49,49,0
2,2,2019,7,0,7,"Braga",5,"Avenida João Paulo II",40,40,0,8,8,0
2,2,2019,7,0,7,"Braga",6,"Avenida Padre Júlio Fragata",61,61,0,21,21,0
2,2,2019,7,0,7,"Braga",7,"Rua Nova Santa Cruz",28,28,0,108,108,0
2,2,2019,7,0,7,"Braga",8,"Rua Costa Gomes",39,39,0,44,44,0
2,2,2019,8,0,7,"Braga",1,"Avenida da Liberdade",22,22,0,30,30,0
2,2,2019,8,0,7,"Braga",2,"Avenida Central",17,17,0,272,272,0
2,2,2019,8,0,7,"Braga",3,"Rua de Caires",34,34,0,39,39,0
2,2,2019,8,0,7,"Braga",4,"N14 Bosch",45,45,0,49,49,0
2,2,2019,8,0,7,"Braga",5,"Avenida João Paulo II",40,40,0,8,8,0
2,2,2019,8,0,7,"Braga",6,"Avenida Padre Júlio Fragata",61,61,0,21,21,0
2,2,2019,8,0,7,"Braga",7,"Rua Nova Santa Cruz",28,28,0,108,108,0
2,2,2019,8,0,7,"Braga",8,"Rua Costa Gomes",39,39,0,44,44,0
2,2,2019,9,0,7,"Braga",1,"Avenida da Liberdade",22,22,0,30,30,0
2,2,2019,9,0,7,"Braga",2,"Avenida Central",12,17,5,386,272,114
2,2,2019,9,0,7,"Braga",3,"Rua de Caires",35,35,0,38,38,0
2,2,2019,9,0,7,"Braga",4,"N14 Bosch",45,45,0,49,49,0
2,2,2019,9,0,7,"Braga",5,"Avenida João Paulo II",40,40,0,8,8,0
2,2,2019,9,0,7,"Braga",6,"Avenida Padre Júlio Fragata",61,61,0,21,21,0
2,2,2019,9,0,7,"Braga",7,"Rua Nova Santa Cruz",28,28,0,108,108,0
2,2,2019,9,0,7,"Braga",8,"Rua Costa Gomes",39,39,0,44,44,0
2,2,2019,10,0,7,"Braga",1,"Avenida da Liberdade",22,22,0,30,30,0
2,2,2019,10,0,7,"Braga",2,"Avenida Central",14,18,4,331,257,74
2,2,2019,10,0,7,"Braga",3,"Rua de Caires",35,35,0,38,38,0
2,2,2019,10,0,7,"Braga",4,"N14 Bosch",46,46,0,48,48,0
2,2,2019,10,0,7,"Braga",5,"Avenida João Paulo II",40,40,0,8,8,0
2,2,2019,10,0,7,"Braga",6,"Avenida Padre Júlio Fragata",61,61,0,21,21,0
2,2,2019,10,0,7,"Braga",7,"Rua Nova Santa Cruz",28,28,0,108,108,0
2,2,2019,10,0,7,"Braga",8,"Rua Costa Gomes",39,39,0,44,44,0
2,2,2019,11,0,7,"Braga",1,"Avenida da Liberdade",22,22,0,30,30,0
2,2,2019,11,0,7,"Braga",2,"Avenida Central",12,18,6,386,257,129
2,2,2019,11,0,7,"Braga",3,"Rua de Caires",35,35,0,38,38,0
2,2,2019,11,0,7,"Braga",4,"N14 Bosch",45,45,0,49,49,0
2,2,2019,11,0,7,"Braga",5,"Avenida João Paulo II",40,40,0,8,8,0
2,2,2019,11,0,7,"Braga",6,"Avenida Padre Júlio Fragata",61,61,0,21,21,0
2,2,2019,11,0,7,"Braga",7,"Rua Nova Santa Cruz",28,28,0,108,108,0
2,2,2019,11,0,7,"Braga",8,"Rua Costa Gomes",27,39,12,63,44,19
2,2,2019,12,0,7,"Braga",1,"Avenida da Liberdade",22,22,0,30,30,0
2,2,2019,12,0,7,"Braga",2,"Avenida Central",11,17,6,421,272,149
2,2,2019,12,0,7,"Braga",3,"Rua de Caires",35,35,0,38,38,0
2,2,2019,12,0,7,"Braga",4,"N14 Bosch",36,46,10,62,48,14
2,2,2019,12,0,7,"Braga",5,"Avenida João Paulo II",40,40,0,8,8,0
2,2,2019,12,0,7,"Braga",6,"Avenida Padre Júlio Fragata",61,61,0,21,21,0
2,2,2019,12,0,7,"Braga",7,"Rua Nova Santa Cruz",28,28,0,108,108,0
2,2,2019,12,0,7,"Braga",8,"Rua Costa Gomes",30,39,9,57,44,13
2,2,2019,13,0,7,"Braga",1,"Avenida da Liberdade",22,22,0,30,30,0
2,2,2019,13,0,7,"Braga",2,"Avenida Central",14,18,4,331,257,74
2,2,2019,13,0,7,"Braga",3,"Rua de Caires",27,35,8,49,38,11
2,2,2019,13,0,7,"Braga",4,"N14 Bosch",46,46,0,48,48,0
2,2,2019,13,0,7,"Braga",5,"Avenida João Paulo II",40,40,0,8,8,0
2,2,2019,13,0,7,"Braga",6,"Avenida Padre Júlio Fragata",48,61,13,26,21,5
2,2,2019,13,0,7,"Braga",7,"Rua Nova Santa Cruz",28,28,0,108,108,0
2,2,2019,13,0,7,"Braga",8,"Rua Costa Gomes",30,40,10,57,43,14
2,2,2019,14,0,7,"Braga",1,"Avenida da Liberdade",22,22,0,30,30,0
2,2,2019,14,0,7,"Braga",2,"Avenida Central",11,18,7,421,257,164
2,2,2019,14,0,7,"Braga",3,"Rua de Caires",35,35,0,38,38,0
2,2,2019,14,0,7,"Braga",4,"N14 Bosch",46,46,0,48,48,0
2,2,2019,14,0,7,"Braga",5,"Avenida João Paulo II",40,40,0,8,8,0
2,2,2019,14,0,7,"Braga",6,"Avenida Padre Júlio Fragata",60,60,0,21,21,0
2,2,2019,14,0,7,"Braga",7,"Rua Nova Santa Cruz",28,28,0,108,108,0
2,2,2019,14,0,7,"Braga",8,"Rua Costa Gomes",31,40,9,55,43,12
2,2,2019,15,0,7,"Braga",1,"Avenida da Liberdade",22,22,0,30,30,0
2,2,2019,15,0,7,"Braga",2,"Avenida Central",9,18,9,515,257,258
2,2,2019,15,0,7,"Braga",3,"Rua de Caires",35,35,0,38,38,0
2,2,2019,15,0,7,"Braga",4,"N14 Bosch",36,46,10,62,48,14
2,2,2019,15,0,7,"Braga",5,"Avenida João Paulo II",26,40,14,13,8,5
2,2,2019,15,0,7,"Braga",6,"Avenida Padre Júlio Fragata",45,61,16,28,21,7
2,2,2019,15,0,7,"Braga",7,"Rua Nova Santa Cruz",28,28,0,108,108,0
2,2,2019,15,0,7,"Braga",8,"Rua Costa Gomes",27,39,12,63,44,19
2,2,2019,16,0,7,"Braga",1,"Avenida da Liberdade",22,22,0,30,30,0
2,2,2019,16,0,7,"Braga",2,"Avenida Central",11,18,7,421,257,164
2,2,2019,16,0,7,"Braga",3,"Rua de Caires",35,35,0,38,38,0
2,2,2019,16,0,7,"Braga",4,"N14 Bosch",32,45,13,70,49,21
2,2,2019,16,0,7,"Braga",5,"Avenida João Paulo II",10,38,28,34,9,25
2,2,2019,16,0,7,"Braga",6,"Avenida Padre Júlio Fragata",42,61,19,30,21,9
2,2,2019,16,0,7,"Braga",7,"Rua Nova Santa Cruz",28,28,0,108,108,0
2,2,2019,16,0,7,"Braga",8,"Rua Costa Gomes",40,40,0,43,43,0
2,2,2019,17,0,7,"Braga",1,"Avenida da Liberdade",22,22,0,30,30,0
2,2,2019,17,0,7,"Braga",2,"Avenida Central",14,18,4,331,257,74
2,2,2019,17,0,7,"Braga",3,"Rua de Caires",35,35,0,38,38,0
2,2,2019,17,0,7,"Braga",4,"N14 Bosch",45,45,0,49,49,0
2,2,2019,17,0,7,"Braga",5,"Avenida João Paulo II",12,41,29,29,8,21
2,2,2019,17,0,7,"Braga",6,"Avenida Padre Júlio Fragata",42,61,19,30,21,9
2,2,2019,17,0,7,"Braga",7,"Rua Nova Santa Cruz",14,29,15,217,104,113
2,2,2019,17,0,7,"Braga",8,"Rua Costa Gomes",28,39,11,61,44,17
2,2,2019,18,0,7,"Braga",1,"Avenida da Liberdade",22,22,0,30,30,0
2,2,2019,18,0,7,"Braga",2,"Avenida Central",14,18,4,331,257,74
2,2,2019,18,0,7,"Braga",3,"Rua de Caires",34,34,0,39,39,0
2,2,2019,18,0,7,"Braga",4,"N14 Bosch",37,46,9,60,48,12
2,2,2019,18,0,7,"Braga",5,"Avenida João Paulo II",25,40,15,13,8,5
2,2,2019,18,0,7,"Braga",6,"Avenida Padre Júlio Fragata",47,60,13,27,21,6
2,2,2019,18,0,7,"Braga",7,"Rua Nova Santa Cruz",29,29,0,104,104,0
2,2,2019,18,0,7,"Braga",8,"Rua Costa Gomes",29,40,11,59,43,16
2,2,2019,19,0,7,"Braga",1,"Avenida da Liberdade",22,22,0,30,30,0
2,2,2019,19,0,7,"Braga",2,"Avenida Central",18,18,0,257,257,0
2,2,2019,19,0,7,"Braga",3,"Rua de Caires",20,34,14,67,39,28
2,2,2019,19,0,7,"Braga",4,"N14 Bosch",46,46,0,48,48,0
2,2,2019,19,0,7,"Braga",5,"Avenida João Paulo II",40,40,0,8,8,0
2,2,2019,19,0,7,"Braga",6,"Avenida Padre Júlio Fragata",41,61,20,31,21,10
2,2,2019,19,0,7,"Braga",7,"Rua Nova Santa Cruz",29,29,0,104,104,0
2,2,2019,19,0,7,"Braga",8,"Rua Costa Gomes",18,39,21,95,44,51
2,2,2019,20,0,7,"Braga",1,"Avenida da Liberdade",22,22,0,30,30,0
2,2,2019,20,0,7,"Braga",2,"Avenida Central",18,18,0,257,257,0
2,2,2019,20,0,7,"Braga",3,"Rua de Caires",27,34,7,49,39,10
2,2,2019,20,0,7,"Braga",4,"N14 Bosch",46,46,0,48,48,0
2,2,2019,20,0,7,"Braga",5,"Avenida João Paulo II",40,40,0,8,8,0
2,2,2019,20,0,7,"Braga",6,"Avenida Padre Júlio Fragata",61,61,0,21,21,0
2,2,2019,20,0,7,"Braga",7,"Rua Nova Santa Cruz",22,28,6,138,108,30
2,2,2019,20,0,7,"Braga",8,"Rua Costa Gomes",26,39,13,66,44,22
2,2,2019,21,0,7,"Braga",1,"Avenida da Liberdade",22,22,0,30,30,0
2,2,2019,21,0,7,"Braga",2,"Avenida Central",18,18,0,257,257,0
2,2,2019,21,0,7,"Braga",3,"Rua de Caires",35,35,0,38,38,0
2,2,2019,21,0,7,"Braga",4,"N14 Bosch",46,46,0,48,48,0
2,2,2019,21,0,7,"Braga",5,"Avenida João Paulo II",40,40,0,8,8,0
2,2,2019,21,0,7,"Braga",6,"Avenida Padre Júlio Fragata",44,61,17,29,21,8
2,2,2019,21,0,7,"Braga",7,"Rua Nova Santa Cruz",29,29,0,104,104,0
2,2,2019,21,0,7,"Braga",8,"Rua Costa Gomes",40,40,0,43,43,0
2,2,2019,22,0,7,"Braga",1,"Avenida da Liberdade",22,22,0,30,30,0
2,2,2019,22,0,7,"Braga",2,"Avenida Central",18,18,0,257,257,0
2,2,2019,22,0,7,"Braga",3,"Rua de Caires",35,35,0,38,38,0
2,2,2019,22,0,7,"Braga",4,"N14 Bosch",46,46,0,48,48,0
2,2,2019,22,0,7,"Braga",5,"Avenida João Paulo II",40,40,0,8,8,0
2,2,2019,22,0,7,"Braga",6,"Avenida Padre Júlio Fragata",60,60,0,21,21,0
2,2,2019,22,0,7,"Braga",7,"Rua Nova Santa Cruz",29,29,0,104,104,0
2,2,2019,22,0,7,"Braga",8,"Rua Costa Gomes",40,40,0,43,43,0
2,2,2019,23,0,7,"Braga",1,"Avenida da Liberdade",22,22,0,30,30,0
2,2,2019,23,0,7,"Braga",2,"Avenida Central",18,18,0,257,257,0
2,2,2019,23,0,7,"Braga",3,"Rua de Caires",35,35,0,38,38,0
2,2,2019,23,0,7,"Braga",4,"N14 Bosch",46,46,0,48,48,0
2,2,2019,23,0,7,"Braga",5,"Avenida João Paulo II",40,40,0,8,8,0
2,2,2019,23,0,7,"Braga",6,"Avenida Padre Júlio Fragata",60,60,0,21,21,0
2,2,2019,23,0,7,"Braga",7,"Rua Nova Santa Cruz",29,29,0,104,104,0
2,2,2019,23,0,7,"Braga",8,"Rua Costa Gomes",40,40,0,43,43,0
2,3,2019,0,0,8,"Braga",1,"Avenida da Liberdade",22,22,0,30,30,0
2,3,2019,0,0,8,"Braga",2,"Avenida Central",18,18,0,257,257,0
2,3,2019,0,0,8,"Braga",3,"Rua de Caires",35,35,0,38,38,0
2,3,2019,0,0,8,"Braga",4,"N14 Bosch",46,46,0,48,48,0
2,3,2019,0,0,8,"Braga",5,"Avenida João Paulo II",40,40,0,8,8,0
2,3,2019,0,0,8,"Braga",6,"Avenida Padre Júlio Fragata",33,61,28,38,21,17
2,3,2019,0,0,8,"Braga",7,"Rua Nova Santa Cruz",29,29,0,104,104,0
2,3,2019,0,0,8,"Braga",8,"Rua Costa Gomes",40,40,0,43,43,0
2,3,2019,1,0,8,"Braga",1,"Avenida da Liberdade",22,22,0,30,30,0
2,3,2019,1,0,8,"Braga",2,"Avenida Central",18,18,0,257,257,0
2,3,2019,1,0,8,"Braga",3,"Rua de Caires",35,35,0,38,38,0
2,3,2019,1,0,8,"Braga",4,"N14 Bosch",46,46,0,48,48,0
2,3,2019,1,0,8,"Braga",5,"Avenida João Paulo II",40,40,0,8,8,0
2,3,2019,1,0,8,"Braga",6,"Avenida Padre Júlio Fragata",61,61,0,21,21,0
2,3,2019,1,0,8,"Braga",7,"Rua Nova Santa Cruz",29,29,0,104,104,0
2,3,2019,1,0,8,"Braga",8,"Rua Costa Gomes",40,40,0,43,43,0
2,3,2019,2,0,8,"Braga",1,"Avenida da Liberdade",22,22,0,30,30,0
2,3,2019,2,0,8,"Braga",2,"Avenida Central",18,18,0,257,257,0
2,3,2019,2,0,8,"Braga",3,"Rua de Caires",35,35,0,38,38,0
2,3,2019,2,0,8,"Braga",4,"N14 Bosch",46,46,0,48,48,0
2,3,2019,2,0,8,"Braga",5,"Avenida João Paulo II",40,40,0,8,8,0
2,3,2019,2,0,8,"Braga",6,"Avenida Padre Júlio Fragata",61,61,0,21,21,0
2,3,2019,2,0,8,"Braga",7,"Rua Nova Santa Cruz",29,29,0,104,104,0
2,3,2019,2,0,8,"Braga",8,"Rua Costa Gomes",40,40,0,43,43,0
2,3,2019,3,0,8,"Braga",1,"Avenida da Liberdade",22,22,0,30,30,0
2,3,2019,3,0,8,"Braga",2,"Avenida Central",18,18,0,257,257,0
2,3,2019,3,0,8,"Braga",3,"Rua de Caires",35,35,0,38,38,0
2,3,2019,3,0,8,"Braga",4,"N14 Bosch",46,46,0,48,48,0
2,3,2019,3,0,8,"Braga",5,"Avenida João Paulo II",40,40,0,8,8,0
2,3,2019,3,0,8,"Braga",6,"Avenida Padre Júlio Fragata",61,61,0,21,21,0
2,3,2019,3,0,8,"Braga",7,"Rua Nova Santa Cruz",29,29,0,104,104,0
2,3,2019,3,0,8,"Braga",8,"Rua Costa Gomes",40,40,0,43,43,0
2,3,2019,4,0,8,"Braga",4,"N14 Bosch",46,46,0,48,48,0
2,3,2019,4,0,8,"Braga",5,"Avenida João Paulo II",40,40,0,8,8,0
2,3,2019,4,0,8,"Braga",6,"Avenida Padre Júlio Fragata",61,61,0,21,21,0
2,3,2019,4,0,8,"Braga",7,"Rua Nova Santa Cruz",29,29,0,104,104,0
2,3,2019,4,0,8,"Braga",8,"Rua Costa Gomes",40,40,0,43,43,0
2,3,2019,4,0,8,"Braga",1,"Avenida da Liberdade",22,22,0,30,30,0
2,3,2019,4,0,8,"Braga",2,"Avenida Central",18,18,0,257,257,0
2,3,2019,4,0,8,"Braga",3,"Rua de Caires",35,35,0,38,38,0
2,3,2019,4,0,8,"Braga",4,"N14 Bosch",46,46,0,48,48,0
2,3,2019,5,0,8,"Braga",1,"Avenida da Liberdade",22,22,0,30,30,0
2,3,2019,5,0,8,"Braga",2,"Avenida Central",18,18,0,257,257,0
2,3,2019,5,0,8,"Braga",3,"Rua de Caires",35,35,0,38,38,0
2,3,2019,5,0,8,"Braga",4,"N14 Bosch",46,46,0,48,48,0
2,3,2019,5,0,8,"Braga",5,"Avenida João Paulo II",40,40,0,8,8,0
2,3,2019,5,0,8,"Braga",6,"Avenida Padre Júlio Fragata",61,61,0,21,21,0
2,3,2019,5,0,8,"Braga",7,"Rua Nova Santa Cruz",29,29,0,104,104,0
2,3,2019,5,0,8,"Braga",8,"Rua Costa Gomes",40,40,0,43,43,0
2,3,2019,6,0,8,"Braga",1,"Avenida da Liberdade",22,22,0,30,30,0
2,3,2019,6,0,8,"Braga",2,"Avenida Central",18,18,0,257,257,0
2,3,2019,6,0,8,"Braga",3,"Rua de Caires",35,35,0,38,38,0
2,3,2019,6,0,8,"Braga",4,"N14 Bosch",46,46,0,48,48,0
2,3,2019,6,0,8,"Braga",5,"Avenida João Paulo II",40,40,0,8,8,0
2,3,2019,6,0,8,"Braga",6,"Avenida Padre Júlio Fragata",61,61,0,21,21,0
2,3,2019,6,0,8,"Braga",7,"Rua Nova Santa Cruz",29,29,0,104,104,0
2,3,2019,6,0,8,"Braga",8,"Rua Costa Gomes",40,40,0,43,43,0
2,3,2019,7,0,8,"Braga",1,"Avenida da Liberdade",22,22,0,30,30,0
2,3,2019,7,0,8,"Braga",2,"Avenida Central",18,18,0,257,257,0
2,3,2019,7,0,8,"Braga",3,"Rua de Caires",35,35,0,38,38,0
2,3,2019,7,0,8,"Braga",4,"N14 Bosch",46,46,0,48,48,0
2,3,2019,7,0,8,"Braga",5,"Avenida João Paulo II",40,40,0,8,8,0
2,3,2019,7,0,8,"Braga",6,"Avenida Padre Júlio Fragata",61,61,0,21,21,0
2,3,2019,7,0,8,"Braga",7,"Rua Nova Santa Cruz",29,29,0,104,104,0
2,3,2019,7,0,8,"Braga",8,"Rua Costa Gomes",40,40,0,43,43,0
2,3,2019,8,0,8,"Braga",1,"Avenida da Liberdade",22,22,0,30,30,0
2,3,2019,8,0,8,"Braga",2,"Avenida Central",18,18,0,257,257,0
2,3,2019,8,0,8,"Braga",3,"Rua de Caires",35,35,0,38,38,0
2,3,2019,8,0,8,"Braga",4,"N14 Bosch",46,46,0,48,48,0
2,3,2019,8,0,8,"Braga",5,"Avenida João Paulo II",40,40,0,8,8,0
2,3,2019,8,0,8,"Braga",6,"Avenida Padre Júlio Fragata",61,61,0,21,21,0
2,3,2019,8,0,8,"Braga",7,"Rua Nova Santa Cruz",29,29,0,104,104,0
2,3,2019,8,0,8,"Braga",8,"Rua Costa Gomes",40,40,0,43,43,0
2,3,2019,9,0,8,"Braga",1,"Avenida da Liberdade",22,22,0,30,30,0
2,3,2019,9,0,8,"Braga",2,"Avenida Central",18,18,0,257,257,0
2,3,2019,9,0,8,"Braga",3,"Rua de Caires",35,35,0,38,38,0
2,3,2019,9,0,8,"Braga",4,"N14 Bosch",46,46,0,48,48,0
2,3,2019,9,0,8,"Braga",5,"Avenida João Paulo II",40,40,0,8,8,0
2,3,2019,9,0,8,"Braga",6,"Avenida Padre Júlio Fragata",61,61,0,21,21,0
2,3,2019,9,0,8,"Braga",7,"Rua Nova Santa Cruz",29,29,0,104,104,0
2,3,2019,9,0,8,"Braga",8,"Rua Costa Gomes",40,40,0,43,43,0
2,3,2019,10,0,8,"Braga",1,"Avenida da Liberdade",22,22,0,30,30,0
2,3,2019,10,0,8,"Braga",2,"Avenida Central",18,18,0,257,257,0
2,3,2019,10,0,8,"Braga",3,"Rua de Caires",35,35,0,38,38,0
2,3,2019,10,0,8,"Braga",4,"N14 Bosch",46,46,0,48,48,0
2,3,2019,10,0,8,"Braga",5,"Avenida João Paulo II",40,40,0,8,8,0
2,3,2019,10,0,8,"Braga",6,"Avenida Padre Júlio Fragata",61,61,0,21,21,0
2,3,2019,10,0,8,"Braga",7,"Rua Nova Santa Cruz",29,29,0,104,104,0
2,3,2019,10,0,8,"Braga",8,"Rua Costa Gomes",40,40,0,43,43,0
2,3,2019,11,0,8,"Braga",1,"Avenida da Liberdade",22,22,0,30,30,0
2,3,2019,11,0,8,"Braga",2,"Avenida Central",18,18,0,257,257,0
2,3,2019,11,0,8,"Braga",3,"Rua de Caires",35,35,0,38,38,0
2,3,2019,11,0,8,"Braga",4,"N14 Bosch",46,46,0,48,48,0
2,3,2019,11,0,8,"Braga",5,"Avenida João Paulo II",40,40,0,8,8,0
2,3,2019,11,0,8,"Braga",6,"Avenida Padre Júlio Fragata",61,61,0,21,21,0
2,3,2019,11,0,8,"Braga",7,"Rua Nova Santa Cruz",29,29,0,104,104,0
2,3,2019,11,0,8,"Braga",8,"Rua Costa Gomes",40,40,0,43,43,0
2,3,2019,12,0,8,"Braga",1,"Avenida da Liberdade",22,22,0,30,30,0
2,3,2019,12,0,8,"Braga",2,"Avenida Central",18,18,0,257,257,0
2,3,2019,12,0,8,"Braga",3,"Rua de Caires",35,35,0,38,38,0
2,3,2019,12,0,8,"Braga",4,"N14 Bosch",46,46,0,48,48,0
2,3,2019,12,0,8,"Braga",5,"Avenida João Paulo II",39,39,0,8,8,0
2,3,2019,12,0,8,"Braga",6,"Avenida Padre Júlio Fragata",61,61,0,21,21,0
2,3,2019,12,0,8,"Braga",7,"Rua Nova Santa Cruz",29,29,0,104,104,0
2,3,2019,12,0,8,"Braga",8,"Rua Costa Gomes",40,40,0,43,43,0
2,3,2019,13,0,8,"Braga",1,"Avenida da Liberdade",22,22,0,30,30,0
2,3,2019,13,0,8,"Braga",2,"Avenida Central",18,18,0,257,257,0
2,3,2019,13,0,8,"Braga",3,"Rua de Caires",35,35,0,38,38,0
2,3,2019,13,0,8,"Braga",4,"N14 Bosch",45,45,0,49,49,0
2,3,2019,13,0,8,"Braga",5,"Avenida João Paulo II",40,40,0,8,8,0
2,3,2019,13,0,8,"Braga",6,"Avenida Padre Júlio Fragata",61,61,0,21,21,0
2,3,2019,13,0,8,"Braga",7,"Rua Nova Santa Cruz",29,29,0,104,104,0
2,3,2019,13,0,8,"Braga",8,"Rua Costa Gomes",30,39,9,57,44,13
2,3,2019,14,0,8,"Braga",1,"Avenida da Liberdade",22,22,0,30,30,0
2,3,2019,14,0,8,"Braga",2,"Avenida Central",18,18,0,257,257,0
2,3,2019,14,0,8,"Braga",3,"Rua de Caires",35,35,0,38,38,0
2,3,2019,14,0,8,"Braga",4,"N14 Bosch",45,45,0,49,49,0
2,3,2019,14,0,8,"Braga",5,"Avenida João Paulo II",40,40,0,8,8,0
2,3,2019,14,0,8,"Braga",6,"Avenida Padre Júlio Fragata",60,60,0,21,21,0
2,3,2019,14,0,8,"Braga",7,"Rua Nova Santa Cruz",29,29,0,104,104,0
2,3,2019,14,0,8,"Braga",8,"Rua Costa Gomes",32,40,8,53,43,10
2,3,2019,15,0,8,"Braga",1,"Avenida da Liberdade",22,22,0,30,30,0
2,3,2019,15,0,8,"Braga",2,"Avenida Central",18,18,0,257,257,0
2,3,2019,15,0,8,"Braga",3,"Rua de Caires",35,35,0,38,38,0
2,3,2019,15,0,8,"Braga",4,"N14 Bosch",45,45,0,49,49,0
2,3,2019,15,0,8,"Braga",5,"Avenida João Paulo II",30,39,9,11,8,3
2,3,2019,15,0,8,"Braga",6,"Avenida Padre Júlio Fragata",60,60,0,21,21,0
2,3,2019,15,0,8,"Braga",7,"Rua Nova Santa Cruz",29,29,0,104,104,0
2,3,2019,15,0,8,"Braga",8,"Rua Costa Gomes",40,40,0,43,43,0
2,3,2019,16,0,8,"Braga",1,"Avenida da Liberdade",22,22,0,30,30,0
2,3,2019,16,0,8,"Braga",2,"Avenida Central",12,17,5,386,272,114
2,3,2019,16,0,8,"Braga",3,"Rua de Caires",35,35,0,38,38,0
2,3,2019,16,0,8,"Braga",4,"N14 Bosch",36,46,10,62,48,14
2,3,2019,16,0,8,"Braga",5,"Avenida João Paulo II",16,40,24,21,8,13
2,3,2019,16,0,8,"Braga",6,"Avenida Padre Júlio Fragata",60,60,0,21,21,0
2,3,2019,16,0,8,"Braga",7,"Rua Nova Santa Cruz",29,29,0,104,104,0
2,3,2019,16,0,8,"Braga",8,"Rua Costa Gomes",29,40,11,59,43,16
2,3,2019,17,0,8,"Braga",1,"Avenida da Liberdade",22,22,0,30,30,0
2,3,2019,17,0,8,"Braga",2,"Avenida Central",12,17,5,386,272,114
2,3,2019,17,0,8,"Braga",3,"Rua de Caires",34,34,0,39,39,0
2,3,2019,17,0,8,"Braga",4,"N14 Bosch",33,46,13,68,48,20
2,3,2019,17,0,8,"Braga",5,"Avenida João Paulo II",15,40,25,23,8,15
2,3,2019,17,0,8,"Braga",6,"Avenida Padre Júlio Fragata",43,61,18,29,21,8
2,3,2019,17,0,8,"Braga",7,"Rua Nova Santa Cruz",29,29,0,104,104,0
2,3,2019,17,0,8,"Braga",8,"Rua Costa Gomes",27,40,13,63,43,20
2,3,2019,18,0,8,"Braga",1,"Avenida da Liberdade",22,22,0,30,30,0
2,3,2019,18,0,8,"Braga",2,"Avenida Central",18,18,0,257,257,0
2,3,2019,18,0,8,"Braga",3,"Rua de Caires",35,35,0,38,38,0
2,3,2019,18,0,8,"Braga",4,"N14 Bosch",46,46,0,48,48,0
2,3,2019,18,0,8,"Braga",5,"Avenida João Paulo II",26,40,14,13,8,5
2,3,2019,18,0,8,"Braga",6,"Avenida Padre Júlio Fragata",35,61,26,36,21,15
2,3,2019,18,0,8,"Braga",7,"Rua Nova Santa Cruz",29,29,0,104,104,0
2,3,2019,18,0,8,"Braga",8,"Rua Costa Gomes",27,40,13,63,43,20
2,3,2019,19,0,8,"Braga",1,"Avenida da Liberdade",22,22,0,30,30,0
2,3,2019,19,0,8,"Braga",2,"Avenida Central",18,18,0,257,257,0
2,3,2019,19,0,8,"Braga",3,"Rua de Caires",34,34,0,39,39,0
2,3,2019,19,0,8,"Braga",4,"N14 Bosch",46,46,0,48,48,0
2,3,2019,19,0,8,"Braga",5,"Avenida João Paulo II",40,40,0,8,8,0
2,3,2019,19,0,8,"Braga",6,"Avenida Padre Júlio Fragata",46,61,15,27,21,6
2,3,2019,19,0,8,"Braga",7,"Rua Nova Santa Cruz",29,29,0,104,104,0
2,3,2019,19,0,8,"Braga",8,"Rua Costa Gomes",40,40,0,43,43,0
2,3,2019,20,0,8,"Braga",1,"Avenida da Liberdade",22,22,0,30,30,0
2,3,2019,20,0,8,"Braga",2,"Avenida Central",18,18,0,257,257,0
2,3,2019,20,0,8,"Braga",3,"Rua de Caires",35,35,0,38,38,0
2,3,2019,20,0,8,"Braga",4,"N14 Bosch",46,46,0,48,48,0
2,3,2019,20,0,8,"Braga",5,"Avenida João Paulo II",40,40,0,8,8,0
2,3,2019,20,0,8,"Braga",6,"Avenida Padre Júlio Fragata",61,61,0,21,21,0
2,3,2019,20,0,8,"Braga",7,"Rua Nova Santa Cruz",29,29,0,104,104,0
2,3,2019,20,0,8,"Braga",8,"Rua Costa Gomes",40,40,0,43,43,0
2,3,2019,21,0,8,"Braga",2,"Avenida Central",18,18,0,257,257,0
2,3,2019,21,0,8,"Braga",3,"Rua de Caires",35,35,0,38,38,0
2,3,2019,21,0,8,"Braga",4,"N14 Bosch",46,46,0,48,48,0
2,3,2019,21,0,8,"Braga",5,"Avenida João Paulo II",40,40,0,8,8,0
2,3,2019,21,0,8,"Braga",6,"Avenida Padre Júlio Fragata",61,61,0,21,21,0
2,3,2019,21,0,8,"Braga",7,"Rua Nova Santa Cruz",29,29,0,104,104,0
2,3,2019,21,0,8,"Braga",8,"Rua Costa Gomes",40,40,0,43,43,0
2,3,2019,21,0,8,"Braga",1,"Avenida da Liberdade",22,22,0,30,30,0
2,3,2019,21,0,8,"Braga",2,"Avenida Central",18,18,0,257,257,0
2,3,2019,22,0,8,"Braga",1,"Avenida da Liberdade",22,22,0,30,30,0
2,3,2019,22,0,8,"Braga",2,"Avenida Central",18,18,0,257,257,0
2,3,2019,22,0,8,"Braga",3,"Rua de Caires",35,35,0,38,38,0
2,3,2019,22,0,8,"Braga",4,"N14 Bosch",46,46,0,48,48,0
2,3,2019,22,0,8,"Braga",5,"Avenida João Paulo II",40,40,0,8,8,0
2,3,2019,22,0,8,"Braga",6,"Avenida Padre Júlio Fragata",61,61,0,21,21,0
2,3,2019,22,0,8,"Braga",7,"Rua Nova Santa Cruz",19,29,10,160,104,56
2,3,2019,22,0,8,"Braga",8,"Rua Costa Gomes",40,40,0,43,43,0
2,3,2019,23,0,8,"Braga",1,"Avenida da Liberdade",22,22,0,30,30,0
2,3,2019,23,0,8,"Braga",2,"Avenida Central",18,18,0,257,257,0
2,3,2019,23,0,8,"Braga",3,"Rua de Caires",35,35,0,38,38,0
2,3,2019,23,0,8,"Braga",4,"N14 Bosch",29,46,17,77,48,29
2,3,2019,23,0,8,"Braga",5,"Avenida João Paulo II",40,40,0,8,8,0
2,3,2019,23,0,8,"Braga",6,"Avenida Padre Júlio Fragata",61,61,0,21,21,0
2,3,2019,23,0,8,"Braga",7,"Rua Nova Santa Cruz",29,29,0,104,104,0
2,3,2019,23,0,8,"Braga",8,"Rua Costa Gomes",40,40,0,43,43,0
2,4,2019,1,0,2,"Braga",2,"Avenida Central",18,18,0,257,257,0
2,4,2019,1,0,2,"Braga",3,"Rua de Caires",35,35,0,38,38,0
2,4,2019,1,0,2,"Braga",4,"N14 Bosch",46,46,0,48,48,0
2,4,2019,1,0,2,"Braga",5,"Avenida João Paulo II",40,40,0,8,8,0
2,4,2019,1,0,2,"Braga",6,"Avenida Padre Júlio Fragata",61,61,0,21,21,0
2,4,2019,1,0,2,"Braga",7,"Rua Nova Santa Cruz",29,29,0,104,104,0
2,4,2019,1,0,2,"Braga",8,"Rua Costa Gomes",40,40,0,43,43,0
2,4,2019,1,0,2,"Braga",1,"Avenida da Liberdade",22,22,0,30,30,0
2,4,2019,1,0,2,"Braga",2,"Avenida Central",18,18,0,257,257,0
2,4,2019,2,0,2,"Braga",1,"Avenida da Liberdade",22,22,0,30,30,0
2,4,2019,2,0,2,"Braga",2,"Avenida Central",18,18,0,257,257,0
2,4,2019,2,0,2,"Braga",3,"Rua de Caires",35,35,0,38,38,0
2,4,2019,2,0,2,"Braga",4,"N14 Bosch",46,46,0,48,48,0
2,4,2019,2,0,2,"Braga",5,"Avenida João Paulo II",40,40,0,8,8,0
2,4,2019,2,0,2,"Braga",6,"Avenida Padre Júlio Fragata",61,61,0,21,21,0
2,4,2019,2,0,2,"Braga",7,"Rua Nova Santa Cruz",29,29,0,104,104,0
2,4,2019,2,0,2,"Braga",8,"Rua Costa Gomes",40,40,0,43,43,0
2,4,2019,3,0,2,"Braga",1,"Avenida da Liberdade",22,22,0,30,30,0
2,4,2019,3,0,2,"Braga",2,"Avenida Central",18,18,0,257,257,0
2,4,2019,3,0,2,"Braga",3,"Rua de Caires",35,35,0,38,38,0
2,4,2019,3,0,2,"Braga",4,"N14 Bosch",46,46,0,48,48,0
2,4,2019,3,0,2,"Braga",5,"Avenida João Paulo II",40,40,0,8,8,0
2,4,2019,3,0,2,"Braga",6,"Avenida Padre Júlio Fragata",61,61,0,21,21,0
2,4,2019,3,0,2,"Braga",7,"Rua Nova Santa Cruz",29,29,0,104,104,0
2,4,2019,3,0,2,"Braga",8,"Rua Costa Gomes",40,40,0,43,43,0
2,4,2019,4,0,2,"Braga",1,"Avenida da Liberdade",22,22,0,30,30,0
2,4,2019,4,0,2,"Braga",2,"Avenida Central",18,18,0,257,257,0
2,4,2019,4,0,2,"Braga",3,"Rua de Caires",35,35,0,38,38,0
2,4,2019,4,0,2,"Braga",4,"N14 Bosch",46,46,0,48,48,0
2,4,2019,4,0,2,"Braga",5,"Avenida João Paulo II",40,40,0,8,8,0
2,4,2019,4,0,2,"Braga",6,"Avenida Padre Júlio Fragata",61,61,0,21,21,0
2,4,2019,4,0,2,"Braga",7,"Rua Nova Santa Cruz",29,29,0,104,104,0
2,4,2019,4,0,2,"Braga",8,"Rua Costa Gomes",40,40,0,43,43,0
2,4,2019,5,0,2,"Braga",1,"Avenida da Liberdade",22,22,0,30,30,0
2,4,2019,5,0,2,"Braga",2,"Avenida Central",18,18,0,257,257,0
2,4,2019,5,0,2,"Braga",3,"Rua de Caires",35,35,0,38,38,0
2,4,2019,5,0,2,"Braga",4,"N14 Bosch",46,46,0,48,48,0
2,4,2019,5,0,2,"Braga",5,"Avenida João Paulo II",40,40,0,8,8,0
2,4,2019,5,0,2,"Braga",6,"Avenida Padre Júlio Fragata",61,61,0,21,21,0
2,4,2019,5,0,2,"Braga",7,"Rua Nova Santa Cruz",29,29,0,104,104,0
2,4,2019,5,0,2,"Braga",8,"Rua Costa Gomes",40,40,0,43,43,0
2,4,2019,6,0,2,"Braga",1,"Avenida da Liberdade",22,22,0,30,30,0
2,4,2019,6,0,2,"Braga",2,"Avenida Central",18,18,0,257,257,0
2,4,2019,6,0,2,"Braga",3,"Rua de Caires",35,35,0,38,38,0
2,4,2019,6,0,2,"Braga",4,"N14 Bosch",46,46,0,48,48,0
2,4,2019,6,0,2,"Braga",5,"Avenida João Paulo II",40,40,0,8,8,0
2,4,2019,6,0,2,"Braga",6,"Avenida Padre Júlio Fragata",61,61,0,21,21,0
2,4,2019,6,0,2,"Braga",7,"Rua Nova Santa Cruz",29,29,0,104,104,0
2,4,2019,6,0,2,"Braga",8,"Rua Costa Gomes",40,40,0,43,43,0
2,4,2019,7,0,2,"Braga",1,"Avenida da Liberdade",22,22,0,30,30,0
2,4,2019,7,0,2,"Braga",2,"Avenida Central",18,18,0,257,257,0
2,4,2019,7,0,2,"Braga",3,"Rua de Caires",35,35,0,38,38,0
2,4,2019,7,0,2,"Braga",4,"N14 Bosch",46,46,0,48,48,0
2,4,2019,7,0,2,"Braga",5,"Avenida João Paulo II",40,40,0,8,8,0
2,4,2019,7,0,2,"Braga",6,"Avenida Padre Júlio Fragata",61,61,0,21,21,0
2,4,2019,7,0,2,"Braga",7,"Rua Nova Santa Cruz",29,29,0,104,104,0
2,4,2019,7,0,2,"Braga",8,"Rua Costa Gomes",40,40,0,43,43,0
2,4,2019,8,0,2,"Braga",1,"Avenida da Liberdade",22,22,0,30,30,0
2,4,2019,8,0,2,"Braga",2,"Avenida Central",13,17,4,372,284,88
2,4,2019,8,0,2,"Braga",3,"Rua de Caires",24,35,11,53,36,17
2,4,2019,8,0,2,"Braga",4,"N14 Bosch",36,46,10,94,74,20
2,4,2019,8,0,2,"Braga",5,"Avenida João Paulo II",40,40,0,8,8,0
2,4,2019,8,0,2,"Braga",6,"Avenida Padre Júlio Fragata",61,61,0,20,20,0
2,4,2019,8,0,2,"Braga",7,"Rua Nova Santa Cruz",29,29,0,111,111,0
2,4,2019,8,0,2,"Braga",8,"Rua Costa Gomes",31,40,9,54,42,12
2,4,2019,9,0,2,"Braga",1,"Avenida da Liberdade",22,22,0,30,30,0
2,4,2019,9,0,2,"Braga",2,"Avenida Central",13,17,4,372,284,88
2,4,2019,9,0,2,"Braga",3,"Rua de Caires",24,35,11,53,36,17
2,4,2019,9,0,2,"Braga",4,"N14 Bosch",26,46,20,131,74,57
2,4,2019,9,0,2,"Braga",5,"Avenida João Paulo II",40,40,0,8,8,0
2,4,2019,9,0,2,"Braga",6,"Avenida Padre Júlio Fragata",61,61,0,20,20,0
2,4,2019,9,0,2,"Braga",7,"Rua Nova Santa Cruz",19,28,9,169,115,54
2,4,2019,9,0,2,"Braga",8,"Rua Costa Gomes",22,40,18,76,42,34
2,4,2019,10,0,2,"Braga",1,"Avenida da Liberdade",15,21,6,44,32,12
2,4,2019,10,0,2,"Braga",2,"Avenida Central",17,17,0,284,284,0
2,4,2019,10,0,2,"Braga",3,"Rua de Caires",27,35,8,47,36,11
2,4,2019,10,0,2,"Braga",4,"N14 Bosch",36,46,10,94,74,20
2,4,2019,10,0,2,"Braga",5,"Avenida João Paulo II",40,40,0,8,8,0
2,4,2019,10,0,2,"Braga",6,"Avenida Padre Júlio Fragata",61,61,0,20,20,0
2,4,2019,10,0,2,"Braga",7,"Rua Nova Santa Cruz",21,29,8,153,111,42
2,4,2019,10,0,2,"Braga",8,"Rua Costa Gomes",39,39,0,43,43,0
2,4,2019,11,0,2,"Braga",1,"Avenida da Liberdade",15,21,6,44,32,12
2,4,2019,11,0,2,"Braga",2,"Avenida Central",12,17,5,403,284,119
2,4,2019,11,0,2,"Braga",3,"Rua de Caires",25,35,10,51,36,15
2,4,2019,11,0,2,"Braga",4,"N14 Bosch",25,46,21,136,74,62
2,4,2019,11,0,2,"Braga",5,"Avenida João Paulo II",40,40,0,8,8,0
2,4,2019,11,0,2,"Braga",6,"Avenida Padre Júlio Fragata",61,61,0,20,20,0
2,4,2019,11,0,2,"Braga",7,"Rua Nova Santa Cruz",22,29,7,146,111,35
2,4,2019,11,0,2,"Braga",8,"Rua Costa Gomes",30,40,10,56,42,14
2,4,2019,12,0,2,"Braga",1,"Avenida da Liberdade",17,21,4,39,32,7
2,4,2019,12,0,2,"Braga",2,"Avenida Central",12,18,6,403,268,135
2,4,2019,12,0,2,"Braga",3,"Rua de Caires",26,35,9,49,36,13
2,4,2019,12,0,2,"Braga",4,"N14 Bosch",30,46,16,113,74,39
2,4,2019,12,0,2,"Braga",5,"Avenida João Paulo II",40,40,0,8,8,0
2,4,2019,12,0,2,"Braga",6,"Avenida Padre Júlio Fragata",61,61,0,20,20,0
2,4,2019,12,0,2,"Braga",7,"Rua Nova Santa Cruz",21,28,7,153,115,38
2,4,2019,12,0,2,"Braga",8,"Rua Costa Gomes",32,40,8,52,42,10
2,4,2019,13,0,2,"Braga",1,"Avenida da Liberdade",21,21,0,32,32,0
2,4,2019,13,0,2,"Braga",2,"Avenida Central",12,18,6,403,268,135
2,4,2019,13,0,2,"Braga",3,"Rua de Caires",26,34,8,49,37,12
2,4,2019,13,0,2,"Braga",4,"N14 Bosch",31,46,15,110,74,36
2,4,2019,13,0,2,"Braga",5,"Avenida João Paulo II",32,40,8,10,8,2
2,4,2019,13,0,2,"Braga",6,"Avenida Padre Júlio Fragata",61,61,0,20,20,0
2,4,2019,13,0,2,"Braga",7,"Rua Nova Santa Cruz",16,28,12,201,115,86
2,4,2019,13,0,2,"Braga",8,"Rua Costa Gomes",29,40,11,57,42,15
2,4,2019,14,0,2,"Braga",1,"Avenida da Liberdade",17,21,4,39,32,7
2,4,2019,14,0,2,"Braga",2,"Avenida Central",17,17,0,284,284,0
2,4,2019,14,0,2,"Braga",3,"Rua de Caires",20,34,14,64,37,27
2,4,2019,14,0,2,"Braga",4,"N14 Bosch",18,45,27,189,75,114
2,4,2019,14,0,2,"Braga",5,"Avenida João Paulo II",30,39,9,11,8,3
2,4,2019,14,0,2,"Braga",6,"Avenida Padre Júlio Fragata",61,61,0,20,20,0
2,4,2019,14,0,2,"Braga",7,"Rua Nova Santa Cruz",22,28,6,146,115,31
2,4,2019,14,0,2,"Braga",8,"Rua Costa Gomes",25,40,15,67,42,25
2,4,2019,15,0,2,"Braga",1,"Avenida da Liberdade",21,21,0,32,32,0
2,4,2019,15,0,2,"Braga",2,"Avenida Central",12,18,6,403,268,135
2,4,2019,15,0,2,"Braga",3,"Rua de Caires",35,35,0,36,36,0
2,4,2019,15,0,2,"Braga",4,"N14 Bosch",27,45,18,126,75,51
2,4,2019,15,0,2,"Braga",5,"Avenida João Paulo II",29,39,10,11,8,3
2,4,2019,15,0,2,"Braga",6,"Avenida Padre Júlio Fragata",46,60,14,27,21,6
2,4,2019,15,0,2,"Braga",7,"Rua Nova Santa Cruz",21,29,8,153,111,42
2,4,2019,15,0,2,"Braga",8,"Rua Costa Gomes",28,40,12,60,42,18
2,4,2019,16,0,2,"Braga",1,"Avenida da Liberdade",21,21,0,32,32,0
2,4,2019,16,0,2,"Braga",2,"Avenida Central",13,18,5,372,268,104
2,4,2019,16,0,2,"Braga",3,"Rua de Caires",20,34,14,64,37,27
2,4,2019,16,0,2,"Braga",4,"N14 Bosch",37,46,9,92,74,18
2,4,2019,16,0,2,"Braga",5,"Avenida João Paulo II",26,39,13,13,8,5
2,4,2019,16,0,2,"Braga",6,"Avenida Padre Júlio Fragata",49,61,12,26,20,6
2,4,2019,16,0,2,"Braga",7,"Rua Nova Santa Cruz",20,28,8,161,115,46
2,4,2019,16,0,2,"Braga",8,"Rua Costa Gomes",29,40,11,57,42,15
2,4,2019,17,0,2,"Braga",3,"Rua de Caires",17,34,17,75,37,38
2,4,2019,17,0,2,"Braga",4,"N14 Bosch",21,45,24,162,75,87
2,4,2019,17,0,2,"Braga",5,"Avenida João Paulo II",23,39,16,14,8,6
2,4,2019,17,0,2,"Braga",6,"Avenida Padre Júlio Fragata",43,60,17,29,21,8
2,4,2019,17,0,2,"Braga",7,"Rua Nova Santa Cruz",19,29,10,169,111,58
2,4,2019,17,0,2,"Braga",8,"Rua Costa Gomes",21,39,18,80,43,37
2,4,2019,17,0,2,"Braga",1,"Avenida da Liberdade",17,22,5,39,30,9
2,4,2019,17,0,2,"Braga",2,"Avenida Central",12,17,5,403,284,119
2,4,2019,17,0,2,"Braga",3,"Rua de Caires",17,34,17,75,37,38
2,4,2019,18,0,2,"Braga",1,"Avenida da Liberdade",17,22,5,39,30,9
2,4,2019,18,0,2,"Braga",2,"Avenida Central",11,17,6,439,284,155
2,4,2019,18,0,2,"Braga",3,"Rua de Caires",23,34,11,55,37,18
2,4,2019,18,0,2,"Braga",4,"N14 Bosch",14,45,31,243,75,168
2,4,2019,18,0,2,"Braga",5,"Avenida João Paulo II",13,38,25,26,9,17
2,4,2019,18,0,2,"Braga",6,"Avenida Padre Júlio Fragata",27,61,34,47,20,27
2,4,2019,18,0,2,"Braga",7,"Rua Nova Santa Cruz",18,29,11,179,111,68
2,4,2019,18,0,2,"Braga",8,"Rua Costa Gomes",18,39,21,93,43,50
2,4,2019,19,0,2,"Braga",1,"Avenida da Liberdade",17,21,4,39,32,7
2,4,2019,19,0,2,"Braga",2,"Avenida Central",9,18,9,537,268,269
2,4,2019,19,0,2,"Braga",3,"Rua de Caires",24,35,11,53,36,17
2,4,2019,19,0,2,"Braga",4,"N14 Bosch",23,46,23,148,74,74
2,4,2019,19,0,2,"Braga",5,"Avenida João Paulo II",9,41,32,38,8,30
2,4,2019,19,0,2,"Braga",6,"Avenida Padre Júlio Fragata",26,61,35,49,20,29
2,4,2019,19,0,2,"Braga",7,"Rua Nova Santa Cruz",18,29,11,179,111,68
2,4,2019,19,0,2,"Braga",8,"Rua Costa Gomes",6,41,35,280,40,240
2,4,2019,20,0,2,"Braga",1,"Avenida da Liberdade",21,21,0,32,32,0
2,4,2019,20,0,2,"Braga",2,"Avenida Central",18,18,0,268,268,0
2,4,2019,20,0,2,"Braga",3,"Rua de Caires",35,35,0,36,36,0
2,4,2019,20,0,2,"Braga",4,"N14 Bosch",24,46,22,142,74,68
2,4,2019,20,0,2,"Braga",5,"Avenida João Paulo II",28,39,11,12,8,4
2,4,2019,20,0,2,"Braga",6,"Avenida Padre Júlio Fragata",42,61,19,30,20,10
2,4,2019,20,0,2,"Braga",7,"Rua Nova Santa Cruz",21,29,8,153,111,42
2,4,2019,20,0,2,"Braga",8,"Rua Costa Gomes",30,40,10,56,42,14
2,4,2019,21,0,2,"Braga",1,"Avenida da Liberdade",21,21,0,32,32,0
2,4,2019,21,0,2,"Braga",2,"Avenida Central",18,18,0,268,268,0
2,4,2019,21,0,2,"Braga",3,"Rua de Caires",35,35,0,36,36,0
2,4,2019,21,0,2,"Braga",4,"N14 Bosch",46,46,0,74,74,0
2,4,2019,21,0,2,"Braga",5,"Avenida João Paulo II",40,40,0,8,8,0
2,4,2019,21,0,2,"Braga",6,"Avenida Padre Júlio Fragata",61,61,0,20,20,0
2,4,2019,21,0,2,"Braga",7,"Rua Nova Santa Cruz",29,29,0,111,111,0
2,4,2019,21,0,2,"Braga",8,"Rua Costa Gomes",39,39,0,43,43,0
2,4,2019,22,0,2,"Braga",1,"Avenida da Liberdade",21,21,0,32,32,0
2,4,2019,22,0,2,"Braga",2,"Avenida Central",18,18,0,268,268,0
2,4,2019,22,0,2,"Braga",3,"Rua de Caires",35,35,0,36,36,0
2,4,2019,22,0,2,"Braga",4,"N14 Bosch",46,46,0,74,74,0
2,4,2019,22,0,2,"Braga",5,"Avenida João Paulo II",40,40,0,8,8,0
2,4,2019,22,0,2,"Braga",6,"Avenida Padre Júlio Fragata",61,61,0,20,20,0
2,4,2019,22,0,2,"Braga",7,"Rua Nova Santa Cruz",21,29,8,153,111,42
2,4,2019,22,0,2,"Braga",8,"Rua Costa Gomes",39,39,0,43,43,0
2,4,2019,23,0,2,"Braga",1,"Avenida da Liberdade",21,21,0,32,32,0
2,4,2019,23,0,2,"Braga",2,"Avenida Central",18,18,0,268,268,0
2,4,2019,23,0,2,"Braga",3,"Rua de Caires",35,35,0,36,36,0
2,4,2019,23,0,2,"Braga",4,"N14 Bosch",46,46,0,74,74,0
2,4,2019,23,0,2,"Braga",5,"Avenida João Paulo II",40,40,0,8,8,0
2,4,2019,23,0,2,"Braga",6,"Avenida Padre Júlio Fragata",61,61,0,20,20,0
2,4,2019,23,0,2,"Braga",7,"Rua Nova Santa Cruz",28,28,0,115,115,0
2,4,2019,23,0,2,"Braga",8,"Rua Costa Gomes",39,39,0,43,43,0
2,5,2019,0,0,3,"Braga",2,"Avenida Central",18,18,0,268,268,0
2,5,2019,0,0,3,"Braga",3,"Rua de Caires",35,35,0,36,36,0
2,5,2019,0,0,3,"Braga",4,"N14 Bosch",46,46,0,74,74,0
2,5,2019,0,0,3,"Braga",5,"Avenida João Paulo II",40,40,0,8,8,0
2,5,2019,0,0,3,"Braga",6,"Avenida Padre Júlio Fragata",61,61,0,20,20,0
2,5,2019,0,0,3,"Braga",7,"Rua Nova Santa Cruz",28,28,0,115,115,0
2,5,2019,0,0,3,"Braga",8,"Rua Costa Gomes",39,39,0,43,43,0
2,5,2019,0,0,3,"Braga",1,"Avenida da Liberdade",21,21,0,32,32,0
2,5,2019,0,0,3,"Braga",2,"Avenida Central",18,18,0,268,268,0
2,5,2019,1,0,3,"Braga",1,"Avenida da Liberdade",21,21,0,32,32,0
2,5,2019,1,0,3,"Braga",2,"Avenida Central",18,18,0,268,268,0
2,5,2019,1,0,3,"Braga",3,"Rua de Caires",35,35,0,36,36,0
2,5,2019,1,0,3,"Braga",4,"N14 Bosch",46,46,0,74,74,0
2,5,2019,1,0,3,"Braga",5,"Avenida João Paulo II",40,40,0,8,8,0
2,5,2019,1,0,3,"Braga",6,"Avenida Padre Júlio Fragata",61,61,0,20,20,0
2,5,2019,1,0,3,"Braga",7,"Rua Nova Santa Cruz",28,28,0,115,115,0
2,5,2019,1,0,3,"Braga",8,"Rua Costa Gomes",39,39,0,43,43,0
2,5,2019,2,0,3,"Braga",1,"Avenida da Liberdade",21,21,0,32,32,0
2,5,2019,2,0,3,"Braga",2,"Avenida Central",18,18,0,268,268,0
2,5,2019,2,0,3,"Braga",3,"Rua de Caires",35,35,0,36,36,0
2,5,2019,2,0,3,"Braga",4,"N14 Bosch",46,46,0,74,74,0
2,5,2019,2,0,3,"Braga",5,"Avenida João Paulo II",40,40,0,8,8,0
2,5,2019,2,0,3,"Braga",6,"Avenida Padre Júlio Fragata",61,61,0,20,20,0
2,5,2019,2,0,3,"Braga",7,"Rua Nova Santa Cruz",28,28,0,115,115,0
2,5,2019,2,0,3,"Braga",8,"Rua Costa Gomes",39,39,0,43,43,0
2,5,2019,3,0,3,"Braga",1,"Avenida da Liberdade",21,21,0,32,32,0
2,5,2019,3,0,3,"Braga",2,"Avenida Central",18,18,0,268,268,0
2,5,2019,3,0,3,"Braga",3,"Rua de Caires",35,35,0,36,36,0
2,5,2019,3,0,3,"Braga",4,"N14 Bosch",46,46,0,74,74,0
2,5,2019,3,0,3,"Braga",5,"Avenida João Paulo II",40,40,0,8,8,0
2,5,2019,3,0,3,"Braga",6,"Avenida Padre Júlio Fragata",61,61,0,20,20,0
2,5,2019,3,0,3,"Braga",7,"Rua Nova Santa Cruz",28,28,0,115,115,0
2,5,2019,3,0,3,"Braga",8,"Rua Costa Gomes",39,39,0,43,43,0
2,5,2019,4,0,3,"Braga",1,"Avenida da Liberdade",21,21,0,32,32,0
2,5,2019,4,0,3,"Braga",2,"Avenida Central",18,18,0,268,268,0
2,5,2019,4,0,3,"Braga",3,"Rua de Caires",35,35,0,36,36,0
2,5,2019,4,0,3,"Braga",4,"N14 Bosch",46,46,0,74,74,0
2,5,2019,4,0,3,"Braga",5,"Avenida João Paulo II",40,40,0,8,8,0
2,5,2019,4,0,3,"Braga",6,"Avenida Padre Júlio Fragata",61,61,0,20,20,0
2,5,2019,4,0,3,"Braga",7,"Rua Nova Santa Cruz",28,28,0,115,115,0
2,5,2019,4,0,3,"Braga",8,"Rua Costa Gomes",39,39,0,43,43,0
2,5,2019,5,0,3,"Braga",1,"Avenida da Liberdade",21,21,0,32,32,0
2,5,2019,5,0,3,"Braga",2,"Avenida Central",18,18,0,268,268,0
2,5,2019,5,0,3,"Braga",3,"Rua de Caires",35,35,0,36,36,0
2,5,2019,5,0,3,"Braga",4,"N14 Bosch",46,46,0,74,74,0
2,5,2019,5,0,3,"Braga",5,"Avenida João Paulo II",40,40,0,8,8,0
2,5,2019,5,0,3,"Braga",6,"Avenida Padre Júlio Fragata",61,61,0,20,20,0
2,5,2019,5,0,3,"Braga",7,"Rua Nova Santa Cruz",28,28,0,115,115,0
2,5,2019,5,0,3,"Braga",8,"Rua Costa Gomes",39,39,0,43,43,0
2,5,2019,6,0,3,"Braga",1,"Avenida da Liberdade",21,21,0,32,32,0
2,5,2019,6,0,3,"Braga",2,"Avenida Central",18,18,0,268,268,0
2,5,2019,6,0,3,"Braga",3,"Rua de Caires",35,35,0,36,36,0
2,5,2019,6,0,3,"Braga",4,"N14 Bosch",46,46,0,74,74,0
2,5,2019,6,0,3,"Braga",5,"Avenida João Paulo II",40,40,0,8,8,0
2,5,2019,6,0,3,"Braga",6,"Avenida Padre Júlio Fragata",61,61,0,20,20,0
2,5,2019,6,0,3,"Braga",7,"Rua Nova Santa Cruz",28,28,0,115,115,0
2,5,2019,6,0,3,"Braga",8,"Rua Costa Gomes",39,39,0,43,43,0
2,5,2019,7,0,3,"Braga",1,"Avenida da Liberdade",21,21,0,32,32,0
2,5,2019,7,0,3,"Braga",2,"Avenida Central",18,18,0,268,268,0
2,5,2019,7,0,3,"Braga",3,"Rua de Caires",35,35,0,36,36,0
2,5,2019,7,0,3,"Braga",4,"N14 Bosch",46,46,0,74,74,0
2,5,2019,7,0,3,"Braga",5,"Avenida João Paulo II",40,40,0,8,8,0
2,5,2019,7,0,3,"Braga",6,"Avenida Padre Júlio Fragata",61,61,0,20,20,0
2,5,2019,7,0,3,"Braga",7,"Rua Nova Santa Cruz",28,28,0,115,115,0
2,5,2019,7,0,3,"Braga",8,"Rua Costa Gomes",39,39,0,43,43,0
2,5,2019,8,0,3,"Braga",1,"Avenida da Liberdade",21,21,0,32,32,0
2,5,2019,8,0,3,"Braga",2,"Avenida Central",18,18,0,268,268,0
2,5,2019,8,0,3,"Braga",3,"Rua de Caires",27,34,7,47,37,10
2,5,2019,8,0,3,"Braga",4,"N14 Bosch",37,46,9,92,74,18
2,5,2019,8,0,3,"Braga",5,"Avenida João Paulo II",40,40,0,8,8,0
2,5,2019,8,0,3,"Braga",6,"Avenida Padre Júlio Fragata",61,61,0,20,20,0
2,5,2019,8,0,3,"Braga",7,"Rua Nova Santa Cruz",28,28,0,115,115,0
2,5,2019,8,0,3,"Braga",8,"Rua Costa Gomes",28,39,11,60,43,17
2,5,2019,9,0,3,"Braga",1,"Avenida da Liberdade",15,21,6,44,32,12
2,5,2019,9,0,3,"Braga",2,"Avenida Central",14,17,3,345,284,61
2,5,2019,9,0,3,"Braga",3,"Rua de Caires",18,34,16,71,37,34
2,5,2019,9,0,3,"Braga",4,"N14 Bosch",25,46,21,136,74,62
2,5,2019,9,0,3,"Braga",5,"Avenida João Paulo II",40,40,0,8,8,0
2,5,2019,9,0,3,"Braga",6,"Avenida Padre Júlio Fragata",42,60,18,30,21,9
2,5,2019,9,0,3,"Braga",7,"Rua Nova Santa Cruz",28,28,0,115,115,0
2,5,2019,9,0,3,"Braga",8,"Rua Costa Gomes",30,40,10,56,42,14
2,5,2019,10,0,3,"Braga",1,"Avenida da Liberdade",15,22,7,44,30,14
2,5,2019,10,0,3,"Braga",2,"Avenida Central",12,18,6,403,268,135
2,5,2019,10,0,3,"Braga",3,"Rua de Caires",24,35,11,53,36,17
2,5,2019,10,0,3,"Braga",4,"N14 Bosch",33,45,12,103,75,28
2,5,2019,10,0,3,"Braga",5,"Avenida João Paulo II",40,40,0,8,8,0
2,5,2019,10,0,3,"Braga",6,"Avenida Padre Júlio Fragata",61,61,0,20,20,0
2,5,2019,10,0,3,"Braga",7,"Rua Nova Santa Cruz",20,29,9,161,111,50
2,5,2019,10,0,3,"Braga",8,"Rua Costa Gomes",28,40,12,60,42,18
2,5,2019,11,0,3,"Braga",1,"Avenida da Liberdade",18,22,4,37,30,7
2,5,2019,11,0,3,"Braga",2,"Avenida Central",10,17,7,483,284,199
2,5,2019,11,0,3,"Braga",3,"Rua de Caires",27,35,8,47,36,11
2,5,2019,11,0,3,"Braga",4,"N14 Bosch",25,46,21,136,74,62
2,5,2019,11,0,3,"Braga",5,"Avenida João Paulo II",27,40,13,12,8,4
2,5,2019,11,0,3,"Braga",6,"Avenida Padre Júlio Fragata",61,61,0,20,20,0
2,5,2019,11,0,3,"Braga",7,"Rua Nova Santa Cruz",29,29,0,111,111,0
2,5,2019,11,0,3,"Braga",8,"Rua Costa Gomes",20,39,19,84,43,41
2,5,2019,12,0,3,"Braga",1,"Avenida da Liberdade",22,22,0,30,30,0
2,5,2019,12,0,3,"Braga",2,"Avenida Central",14,18,4,345,268,77
2,5,2019,12,0,3,"Braga",3,"Rua de Caires",27,34,7,47,37,10
2,5,2019,12,0,3,"Braga",4,"N14 Bosch",27,46,19,126,74,52
2,5,2019,12,0,3,"Braga",5,"Avenida João Paulo II",32,40,8,10,8,2
2,5,2019,12,0,3,"Braga",6,"Avenida Padre Júlio Fragata",61,61,0,20,20,0
2,5,2019,12,0,3,"Braga",7,"Rua Nova Santa Cruz",22,29,7,146,111,35
2,5,2019,12,0,3,"Braga",8,"Rua Costa Gomes",28,39,11,60,43,17
2,5,2019,13,0,3,"Braga",1,"Avenida da Liberdade",22,22,0,30,30,0
2,5,2019,13,0,3,"Braga",2,"Avenida Central",11,18,7,439,268,171
2,5,2019,13,0,3,"Braga",3,"Rua de Caires",35,35,0,36,36,0
2,5,2019,13,0,3,"Braga",4,"N14 Bosch",28,46,18,121,74,47
2,5,2019,13,0,3,"Braga",5,"Avenida João Paulo II",40,40,0,8,8,0
2,5,2019,13,0,3,"Braga",6,"Avenida Padre Júlio Fragata",61,61,0,20,20,0
2,5,2019,13,0,3,"Braga",7,"Rua Nova Santa Cruz",12,28,16,268,115,153
2,5,2019,13,0,3,"Braga",8,"Rua Costa Gomes",40,40,0,42,42,0
2,5,2019,14,0,3,"Braga",1,"Avenida da Liberdade",22,22,0,30,30,0
2,5,2019,14,0,3,"Braga",2,"Avenida Central",14,18,4,345,268,77
2,5,2019,14,0,3,"Braga",3,"Rua de Caires",21,34,13,61,37,24
2,5,2019,14,0,3,"Braga",4,"N14 Bosch",15,46,31,227,74,153
2,5,2019,14,0,3,"Braga",5,"Avenida João Paulo II",40,40,0,8,8,0
2,5,2019,14,0,3,"Braga",6,"Avenida Padre Júlio Fragata",46,60,14,27,21,6
2,5,2019,14,0,3,"Braga",7,"Rua Nova Santa Cruz",13,28,15,248,115,133
2,5,2019,14,0,3,"Braga",8,"Rua Costa Gomes",30,39,9,56,43,13
2,5,2019,15,0,3,"Braga",1,"Avenida da Liberdade",17,21,4,39,32,7
2,5,2019,15,0,3,"Braga",2,"Avenida Central",11,18,7,439,268,171
2,5,2019,15,0,3,"Braga",3,"Rua de Caires",25,34,9,51,37,14
2,5,2019,15,0,3,"Braga",4,"N14 Bosch",21,46,25,162,74,88
2,5,2019,15,0,3,"Braga",5,"Avenida João Paulo II",40,40,0,8,8,0
2,5,2019,15,0,3,"Braga",6,"Avenida Padre Júlio Fragata",60,60,0,21,21,0
2,5,2019,15,0,3,"Braga",7,"Rua Nova Santa Cruz",19,29,10,169,111,58
2,5,2019,15,0,3,"Braga",8,"Rua Costa Gomes",26,40,14,64,42,22
2,5,2019,16,0,3,"Braga",1,"Avenida da Liberdade",21,21,0,32,32,0
2,5,2019,16,0,3,"Braga",2,"Avenida Central",13,17,4,372,284,88
2,5,2019,16,0,3,"Braga",3,"Rua de Caires",27,35,8,47,36,11
2,5,2019,16,0,3,"Braga",4,"N14 Bosch",31,45,14,110,75,35
2,5,2019,16,0,3,"Braga",5,"Avenida João Paulo II",29,39,10,11,8,3
2,5,2019,16,0,3,"Braga",6,"Avenida Padre Júlio Fragata",61,61,0,20,20,0
2,5,2019,16,0,3,"Braga",7,"Rua Nova Santa Cruz",20,29,9,161,111,50
2,5,2019,16,0,3,"Braga",8,"Rua Costa Gomes",29,40,11,57,42,15
2,5,2019,17,0,3,"Braga",1,"Avenida da Liberdade",22,22,0,30,30,0
2,5,2019,17,0,3,"Braga",2,"Avenida Central",9,17,8,537,284,253
2,5,2019,17,0,3,"Braga",3,"Rua de Caires",22,34,12,58,37,21
2,5,2019,17,0,3,"Braga",4,"N14 Bosch",25,46,21,136,74,62
2,5,2019,17,0,3,"Braga",5,"Avenida João Paulo II",23,40,17,14,8,6
2,5,2019,17,0,3,"Braga",6,"Avenida Padre Júlio Fragata",45,61,16,28,20,8
2,5,2019,17,0,3,"Braga",7,"Rua Nova Santa Cruz",16,28,12,201,115,86
2,5,2019,17,0,3,"Braga",8,"Rua Costa Gomes",24,39,15,70,43,27
2,5,2019,18,0,3,"Braga",1,"Avenida da Liberdade",22,22,0,30,30,0
2,5,2019,18,0,3,"Braga",2,"Avenida Central",7,17,10,691,284,407
2,5,2019,18,0,3,"Braga",3,"Rua de Caires",24,34,10,53,37,16
2,5,2019,18,0,3,"Braga",4,"N14 Bosch",12,47,35,284,72,212
2,5,2019,18,0,3,"Braga",5,"Avenida João Paulo II",39,39,0,8,8,0
2,5,2019,18,0,3,"Braga",6,"Avenida Padre Júlio Fragata",49,61,12,26,20,6
2,5,2019,18,0,3,"Braga",7,"Rua Nova Santa Cruz",11,30,19,293,107,186
2,5,2019,18,0,3,"Braga",8,"Rua Costa Gomes",16,39,23,105,43,62
2,5,2019,19,0,3,"Braga",1,"Avenida da Liberdade",15,22,7,44,30,14
2,5,2019,19,0,3,"Braga",2,"Avenida Central",8,18,10,604,268,336
2,5,2019,19,0,3,"Braga",3,"Rua de Caires",17,34,17,75,37,38
2,5,2019,19,0,3,"Braga",4,"N14 Bosch",28,46,18,121,74,47
2,5,2019,19,0,3,"Braga",5,"Avenida João Paulo II",22,40,18,15,8,7
2,5,2019,19,0,3,"Braga",6,"Avenida Padre Júlio Fragata",31,61,30,41,20,21
2,5,2019,19,0,3,"Braga",7,"Rua Nova Santa Cruz",15,28,13,215,115,100
2,5,2019,19,0,3,"Braga",8,"Rua Costa Gomes",20,40,20,84,42,42
2,5,2019,20,0,3,"Braga",1,"Avenida da Liberdade",17,22,5,39,30,9
2,5,2019,20,0,3,"Braga",2,"Avenida Central",17,17,0,284,284,0
2,5,2019,20,0,3,"Braga",3,"Rua de Caires",35,35,0,36,36,0
2,5,2019,20,0,3,"Braga",4,"N14 Bosch",33,45,12,103,75,28
2,5,2019,20,0,3,"Braga",5,"Avenida João Paulo II",30,40,10,11,8,3
2,5,2019,20,0,3,"Braga",6,"Avenida Padre Júlio Fragata",60,60,0,21,21,0
2,5,2019,20,0,3,"Braga",7,"Rua Nova Santa Cruz",8,28,20,403,115,288
2,5,2019,20,0,3,"Braga",8,"Rua Costa Gomes",27,40,13,62,42,20
2,5,2019,21,0,3,"Braga",1,"Avenida da Liberdade",22,22,0,30,30,0
2,5,2019,21,0,3,"Braga",2,"Avenida Central",17,17,0,284,284,0
2,5,2019,21,0,3,"Braga",3,"Rua de Caires",35,35,0,36,36,0
2,5,2019,21,0,3,"Braga",4,"N14 Bosch",46,46,0,74,74,0
2,5,2019,21,0,3,"Braga",5,"Avenida João Paulo II",40,40,0,8,8,0
2,5,2019,21,0,3,"Braga",6,"Avenida Padre Júlio Fragata",61,61,0,20,20,0
2,5,2019,21,0,3,"Braga",7,"Rua Nova Santa Cruz",27,27,0,119,119,0
2,5,2019,21,0,3,"Braga",8,"Rua Costa Gomes",40,40,0,42,42,0
2,5,2019,22,0,3,"Braga",1,"Avenida da Liberdade",22,22,0,30,30,0
2,5,2019,22,0,3,"Braga",2,"Avenida Central",17,17,0,284,284,0
2,5,2019,22,0,3,"Braga",3,"Rua de Caires",35,35,0,36,36,0
2,5,2019,22,0,3,"Braga",4,"N14 Bosch",46,46,0,74,74,0
2,5,2019,22,0,3,"Braga",5,"Avenida João Paulo II",40,40,0,8,8,0
2,5,2019,22,0,3,"Braga",6,"Avenida Padre Júlio Fragata",60,60,0,21,21,0
2,5,2019,22,0,3,"Braga",7,"Rua Nova Santa Cruz",27,27,0,119,119,0
2,5,2019,22,0,3,"Braga",8,"Rua Costa Gomes",40,40,0,42,42,0
2,5,2019,23,0,3,"Braga",1,"Avenida da Liberdade",22,22,0,30,30,0
2,5,2019,23,0,3,"Braga",2,"Avenida Central",17,17,0,284,284,0
2,5,2019,23,0,3,"Braga",3,"Rua de Caires",35,35,0,36,36,0
2,5,2019,23,0,3,"Braga",4,"N14 Bosch",46,46,0,74,74,0
2,5,2019,23,0,3,"Braga",5,"Avenida João Paulo II",40,40,0,8,8,0
2,5,2019,23,0,3,"Braga",6,"Avenida Padre Júlio Fragata",60,60,0,21,21,0
2,5,2019,23,0,3,"Braga",7,"Rua Nova Santa Cruz",27,27,0,119,119,0
2,5,2019,23,0,3,"Braga",8,"Rua Costa Gomes",40,40,0,42,42,0
2,6,2019,0,0,4,"Braga",1,"Avenida da Liberdade",22,22,0,30,30,0
2,6,2019,0,0,4,"Braga",2,"Avenida Central",17,17,0,284,284,0
2,6,2019,0,0,4,"Braga",3,"Rua de Caires",35,35,0,36,36,0
2,6,2019,0,0,4,"Braga",4,"N14 Bosch",46,46,0,74,74,0
2,6,2019,0,0,4,"Braga",5,"Avenida João Paulo II",40,40,0,8,8,0
2,6,2019,0,0,4,"Braga",6,"Avenida Padre Júlio Fragata",60,60,0,21,21,0
2,6,2019,0,0,4,"Braga",7,"Rua Nova Santa Cruz",27,27,0,119,119,0
2,6,2019,0,0,4,"Braga",8,"Rua Costa Gomes",40,40,0,42,42,0
2,6,2019,1,0,4,"Braga",1,"Avenida da Liberdade",22,22,0,30,30,0
2,6,2019,1,0,4,"Braga",2,"Avenida Central",17,17,0,284,284,0
2,6,2019,1,0,4,"Braga",3,"Rua de Caires",35,35,0,36,36,0
2,6,2019,1,0,4,"Braga",4,"N14 Bosch",46,46,0,74,74,0
2,6,2019,1,0,4,"Braga",5,"Avenida João Paulo II",40,40,0,8,8,0
2,6,2019,1,0,4,"Braga",6,"Avenida Padre Júlio Fragata",60,60,0,21,21,0
2,6,2019,1,0,4,"Braga",7,"Rua Nova Santa Cruz",27,27,0,119,119,0
2,6,2019,1,0,4,"Braga",8,"Rua Costa Gomes",40,40,0,42,42,0
2,6,2019,2,0,4,"Braga",1,"Avenida da Liberdade",22,22,0,30,30,0
2,6,2019,2,0,4,"Braga",2,"Avenida Central",17,17,0,284,284,0
2,6,2019,2,0,4,"Braga",3,"Rua de Caires",35,35,0,36,36,0
2,6,2019,2,0,4,"Braga",4,"N14 Bosch",46,46,0,74,74,0
2,6,2019,2,0,4,"Braga",5,"Avenida João Paulo II",40,40,0,8,8,0
2,6,2019,2,0,4,"Braga",6,"Avenida Padre Júlio Fragata",60,60,0,21,21,0
2,6,2019,2,0,4,"Braga",7,"Rua Nova Santa Cruz",27,27,0,119,119,0
2,6,2019,2,0,4,"Braga",8,"Rua Costa Gomes",40,40,0,42,42,0
2,6,2019,3,0,4,"Braga",1,"Avenida da Liberdade",22,22,0,30,30,0
2,6,2019,3,0,4,"Braga",2,"Avenida Central",17,17,0,284,284,0
2,6,2019,3,0,4,"Braga",3,"Rua de Caires",35,35,0,36,36,0
2,6,2019,3,0,4,"Braga",4,"N14 Bosch",46,46,0,74,74,0
2,6,2019,3,0,4,"Braga",5,"Avenida João Paulo II",40,40,0,8,8,0
2,6,2019,3,0,4,"Braga",6,"Avenida Padre Júlio Fragata",60,60,0,21,21,0
2,6,2019,3,0,4,"Braga",7,"Rua Nova Santa Cruz",27,27,0,119,119,0
2,6,2019,3,0,4,"Braga",8,"Rua Costa Gomes",40,40,0,42,42,0
2,6,2019,7,0,4,"Braga",1,"Avenida da Liberdade",22,22,0,30,30,0
2,6,2019,7,0,4,"Braga",2,"Avenida Central",17,17,0,284,284,0
2,6,2019,7,0,4,"Braga",3,"Rua de Caires",35,35,0,36,36,0
2,6,2019,7,0,4,"Braga",4,"N14 Bosch",46,46,0,74,74,0
2,6,2019,7,0,4,"Braga",5,"Avenida João Paulo II",40,40,0,8,8,0
2,6,2019,7,0,4,"Braga",6,"Avenida Padre Júlio Fragata",60,60,0,21,21,0
2,6,2019,7,0,4,"Braga",7,"Rua Nova Santa Cruz",27,27,0,119,119,0
2,6,2019,7,0,4,"Braga",8,"Rua Costa Gomes",40,40,0,42,42,0
2,6,2019,8,0,4,"Braga",1,"Avenida da Liberdade",22,22,0,30,30,0
2,6,2019,8,0,4,"Braga",2,"Avenida Central",17,17,0,284,284,0
2,6,2019,8,0,4,"Braga",3,"Rua de Caires",27,35,8,47,36,11
2,6,2019,8,0,4,"Braga",4,"N14 Bosch",46,46,0,74,74,0
2,6,2019,8,0,4,"Braga",5,"Avenida João Paulo II",40,40,0,8,8,0
2,6,2019,8,0,4,"Braga",6,"Avenida Padre Júlio Fragata",60,60,0,21,21,0
2,6,2019,8,0,4,"Braga",7,"Rua Nova Santa Cruz",23,29,6,140,111,29
2,6,2019,8,0,4,"Braga",8,"Rua Costa Gomes",32,40,8,52,42,10
2,6,2019,9,0,4,"Braga",1,"Avenida da Liberdade",21,21,0,32,32,0
2,6,2019,9,0,4,"Braga",2,"Avenida Central",13,18,5,372,268,104
2,6,2019,9,0,4,"Braga",3,"Rua de Caires",11,34,23,116,37,79
2,6,2019,9,0,4,"Braga",4,"N14 Bosch",32,46,14,106,74,32
2,6,2019,9,0,4,"Braga",5,"Avenida João Paulo II",38,38,0,9,9,0
2,6,2019,9,0,4,"Braga",6,"Avenida Padre Júlio Fragata",41,60,19,31,21,10
2,6,2019,9,0,4,"Braga",7,"Rua Nova Santa Cruz",14,28,14,230,115,115
2,6,2019,9,0,4,"Braga",8,"Rua Costa Gomes",23,39,16,73,43,30
2,6,2019,10,0,4,"Braga",1,"Avenida da Liberdade",22,22,0,30,30,0
2,6,2019,10,0,4,"Braga",2,"Avenida Central",13,17,4,372,284,88
2,6,2019,10,0,4,"Braga",3,"Rua de Caires",26,35,9,49,36,13
2,6,2019,10,0,4,"Braga",4,"N14 Bosch",27,45,18,126,75,51
2,6,2019,10,0,4,"Braga",5,"Avenida João Paulo II",30,40,10,11,8,3
2,6,2019,10,0,4,"Braga",6,"Avenida Padre Júlio Fragata",60,60,0,21,21,0
2,6,2019,10,0,4,"Braga",7,"Rua Nova Santa Cruz",29,29,0,111,111,0
2,6,2019,10,0,4,"Braga",8,"Rua Costa Gomes",27,40,13,62,42,20
2,6,2019,11,0,4,"Braga",1,"Avenida da Liberdade",17,21,4,39,32,7
2,6,2019,11,0,4,"Braga",2,"Avenida Central",11,18,7,439,268,171
2,6,2019,11,0,4,"Braga",3,"Rua de Caires",26,34,8,49,37,12
2,6,2019,11,0,4,"Braga",4,"N14 Bosch",30,45,15,113,75,38
2,6,2019,11,0,4,"Braga",5,"Avenida João Paulo II",31,40,9,11,8,3
2,6,2019,11,0,4,"Braga",6,"Avenida Padre Júlio Fragata",61,61,0,20,20,0
2,6,2019,11,0,4,"Braga",7,"Rua Nova Santa Cruz",23,28,5,140,115,25
2,6,2019,11,0,4,"Braga",8,"Rua Costa Gomes",31,40,9,54,42,12
2,6,2019,12,0,4,"Braga",1,"Avenida da Liberdade",17,21,4,39,32,7
2,6,2019,12,0,4,"Braga",2,"Avenida Central",13,18,5,372,268,104
2,6,2019,12,0,4,"Braga",3,"Rua de Caires",25,34,9,51,37,14
2,6,2019,12,0,4,"Braga",4,"N14 Bosch",29,46,17,117,74,43
2,6,2019,12,0,4,"Braga",5,"Avenida João Paulo II",39,39,0,8,8,0
2,6,2019,12,0,4,"Braga",6,"Avenida Padre Júlio Fragata",47,61,14,27,20,7
2,6,2019,12,0,4,"Braga",7,"Rua Nova Santa Cruz",21,28,7,153,115,38
2,6,2019,12,0,4,"Braga",8,"Rua Costa Gomes",30,40,10,56,42,14
2,6,2019,13,0,4,"Braga",1,"Avenida da Liberdade",22,22,0,30,30,0
2,6,2019,13,0,4,"Braga",2,"Avenida Central",11,18,7,439,268,171
2,6,2019,13,0,4,"Braga",3,"Rua de Caires",23,34,11,55,37,18
2,6,2019,13,0,4,"Braga",4,"N14 Bosch",28,46,18,121,74,47
2,6,2019,13,0,4,"Braga",5,"Avenida João Paulo II",31,40,9,11,8,3
2,6,2019,13,0,4,"Braga",6,"Avenida Padre Júlio Fragata",60,60,0,21,21,0
2,6,2019,13,0,4,"Braga",7,"Rua Nova Santa Cruz",23,29,6,140,111,29
2,6,2019,13,0,4,"Braga",8,"Rua Costa Gomes",39,39,0,43,43,0
2,6,2019,14,0,4,"Braga",1,"Avenida da Liberdade",22,22,0,30,30,0
2,6,2019,14,0,4,"Braga",2,"Avenida Central",12,18,6,403,268,135
2,6,2019,14,0,4,"Braga",3,"Rua de Caires",27,35,8,47,36,11
2,6,2019,14,0,4,"Braga",4,"N14 Bosch",18,46,28,189,74,115
2,6,2019,14,0,4,"Braga",5,"Avenida João Paulo II",39,39,0,8,8,0
2,6,2019,14,0,4,"Braga",6,"Avenida Padre Júlio Fragata",61,61,0,20,20,0
2,6,2019,14,0,4,"Braga",7,"Rua Nova Santa Cruz",16,28,12,201,115,86
2,6,2019,14,0,4,"Braga",8,"Rua Costa Gomes",21,40,19,80,42,38
2,6,2019,15,0,4,"Braga",1,"Avenida da Liberdade",21,21,0,32,32,0
2,6,2019,15,0,4,"Braga",2,"Avenida Central",13,17,4,372,284,88
2,6,2019,15,0,4,"Braga",3,"Rua de Caires",27,35,8,47,36,11
2,6,2019,15,0,4,"Braga",4,"N14 Bosch",22,46,24,155,74,81
2,6,2019,15,0,4,"Braga",5,"Avenida João Paulo II",39,39,0,8,8,0
2,6,2019,15,0,4,"Braga",6,"Avenida Padre Júlio Fragata",61,61,0,20,20,0
2,6,2019,15,0,4,"Braga",7,"Rua Nova Santa Cruz",22,29,7,146,111,35
2,6,2019,15,0,4,"Braga",8,"Rua Costa Gomes",30,39,9,56,43,13
2,6,2019,16,0,4,"Braga",1,"Avenida da Liberdade",21,21,0,32,32,0
2,6,2019,16,0,4,"Braga",2,"Avenida Central",12,18,6,403,268,135
2,6,2019,16,0,4,"Braga",3,"Rua de Caires",27,35,8,47,36,11
2,6,2019,16,0,4,"Braga",4,"N14 Bosch",19,47,28,179,72,107
2,6,2019,16,0,4,"Braga",5,"Avenida João Paulo II",27,40,13,12,8,4
2,6,2019,16,0,4,"Braga",6,"Avenida Padre Júlio Fragata",61,61,0,20,20,0
2,6,2019,16,0,4,"Braga",7,"Rua Nova Santa Cruz",12,28,16,268,115,153
2,6,2019,16,0,4,"Braga",8,"Rua Costa Gomes",27,40,13,62,42,20
2,6,2019,17,0,4,"Braga",1,"Avenida da Liberdade",17,21,4,39,32,7
2,6,2019,17,0,4,"Braga",2,"Avenida Central",11,18,7,439,268,171
2,6,2019,17,0,4,"Braga",3,"Rua de Caires",25,35,10,51,36,15
2,6,2019,17,0,4,"Braga",4,"N14 Bosch",30,46,16,113,74,39
2,6,2019,17,0,4,"Braga",5,"Avenida João Paulo II",23,40,17,14,8,6
2,6,2019,17,0,4,"Braga",6,"Avenida Padre Júlio Fragata",61,61,0,20,20,0
2,6,2019,17,0,4,"Braga",7,"Rua Nova Santa Cruz",17,29,12,189,111,78
2,6,2019,17,0,4,"Braga",8,"Rua Costa Gomes",24,40,16,70,42,28
2,6,2019,18,0,4,"Braga",1,"Avenida da Liberdade",15,21,6,44,32,12
2,6,2019,18,0,4,"Braga",2,"Avenida Central",12,17,5,403,284,119
2,6,2019,18,0,4,"Braga",3,"Rua de Caires",21,34,13,61,37,24
2,6,2019,18,0,4,"Braga",4,"N14 Bosch",14,47,33,243,72,171
2,6,2019,18,0,4,"Braga",5,"Avenida João Paulo II",24,40,16,14,8,6
2,6,2019,18,0,4,"Braga",6,"Avenida Padre Júlio Fragata",41,60,19,31,21,10
2,6,2019,18,0,4,"Braga",7,"Rua Nova Santa Cruz",6,27,21,537,119,418
2,6,2019,18,0,4,"Braga",8,"Rua Costa Gomes",18,40,22,93,42,51
2,6,2019,19,0,4,"Braga",1,"Avenida da Liberdade",14,22,8,48,30,18
2,6,2019,19,0,4,"Braga",2,"Avenida Central",8,18,10,604,268,336
2,6,2019,19,0,4,"Braga",3,"Rua de Caires",25,34,9,51,37,14
2,6,2019,19,0,4,"Braga",4,"N14 Bosch",17,46,29,200,74,126
2,6,2019,19,0,4,"Braga",5,"Avenida João Paulo II",6,41,35,57,8,49
2,6,2019,19,0,4,"Braga",6,"Avenida Padre Júlio Fragata",16,61,45,79,20,59
2,6,2019,19,0,4,"Braga",7,"Rua Nova Santa Cruz",11,29,18,293,111,182
2,6,2019,19,0,4,"Braga",8,"Rua Costa Gomes",13,40,27,129,42,87
2,6,2019,20,0,4,"Braga",1,"Avenida da Liberdade",21,21,0,32,32,0
2,6,2019,20,0,4,"Braga",2,"Avenida Central",9,18,9,537,268,269
2,6,2019,20,0,4,"Braga",3,"Rua de Caires",34,34,0,37,37,0
2,6,2019,20,0,4,"Braga",4,"N14 Bosch",36,45,9,94,75,19
2,6,2019,20,0,4,"Braga",5,"Avenida João Paulo II",30,39,9,11,8,3
2,6,2019,20,0,4,"Braga",6,"Avenida Padre Júlio Fragata",44,60,16,29,21,8
2,6,2019,20,0,4,"Braga",7,"Rua Nova Santa Cruz",29,29,0,111,111,0
2,6,2019,20,0,4,"Braga",8,"Rua Costa Gomes",27,40,13,62,42,20
2,6,2019,21,0,4,"Braga",1,"Avenida da Liberdade",21,21,0,32,32,0
2,6,2019,21,0,4,"Braga",2,"Avenida Central",17,17,0,284,284,0
2,6,2019,21,0,4,"Braga",3,"Rua de Caires",34,34,0,37,37,0
2,6,2019,21,0,4,"Braga",4,"N14 Bosch",46,46,0,74,74,0
2,6,2019,21,0,4,"Braga",5,"Avenida João Paulo II",40,40,0,8,8,0
2,6,2019,21,0,4,"Braga",6,"Avenida Padre Júlio Fragata",61,61,0,20,20,0
2,6,2019,21,0,4,"Braga",7,"Rua Nova Santa Cruz",29,29,0,111,111,0
2,6,2019,21,0,4,"Braga",8,"Rua Costa Gomes",40,40,0,42,42,0
2,6,2019,22,0,4,"Braga",1,"Avenida da Liberdade",21,21,0,32,32,0
2,6,2019,22,0,4,"Braga",2,"Avenida Central",17,17,0,284,284,0
2,6,2019,22,0,4,"Braga",3,"Rua de Caires",34,34,0,37,37,0
2,6,2019,22,0,4,"Braga",4,"N14 Bosch",46,46,0,74,74,0
2,6,2019,22,0,4,"Braga",5,"Avenida João Paulo II",40,40,0,8,8,0
2,6,2019,22,0,4,"Braga",6,"Avenida Padre Júlio Fragata",60,60,0,21,21,0
2,6,2019,22,0,4,"Braga",7,"Rua Nova Santa Cruz",29,29,0,111,111,0
2,6,2019,22,0,4,"Braga",8,"Rua Costa Gomes",40,40,0,42,42,0
2,6,2019,23,0,4,"Braga",1,"Avenida da Liberdade",21,21,0,32,32,0
2,6,2019,23,0,4,"Braga",2,"Avenida Central",17,17,0,284,284,0
2,6,2019,23,0,4,"Braga",3,"Rua de Caires",34,34,0,37,37,0
2,6,2019,23,0,4,"Braga",4,"N14 Bosch",45,45,0,75,75,0
2,6,2019,23,0,4,"Braga",5,"Avenida João Paulo II",40,40,0,8,8,0
2,6,2019,23,0,4,"Braga",6,"Avenida Padre Júlio Fragata",61,61,0,20,20,0
2,6,2019,23,0,4,"Braga",7,"Rua Nova Santa Cruz",29,29,0,111,111,0
2,6,2019,23,0,4,"Braga",8,"Rua Costa Gomes",40,40,0,42,42,0
2,7,2019,0,0,5,"Braga",1,"Avenida da Liberdade",21,21,0,32,32,0
2,7,2019,0,0,5,"Braga",2,"Avenida Central",17,17,0,284,284,0
2,7,2019,0,0,5,"Braga",3,"Rua de Caires",34,34,0,37,37,0
2,7,2019,0,0,5,"Braga",4,"N14 Bosch",45,45,0,75,75,0
2,7,2019,0,0,5,"Braga",5,"Avenida João Paulo II",40,40,0,8,8,0
2,7,2019,0,0,5,"Braga",6,"Avenida Padre Júlio Fragata",61,61,0,20,20,0
2,7,2019,0,0,5,"Braga",7,"Rua Nova Santa Cruz",29,29,0,111,111,0
2,7,2019,0,0,5,"Braga",8,"Rua Costa Gomes",40,40,0,42,42,0
2,7,2019,1,0,5,"Braga",1,"Avenida da Liberdade",21,21,0,32,32,0
2,7,2019,1,0,5,"Braga",2,"Avenida Central",17,17,0,284,284,0
2,7,2019,1,0,5,"Braga",3,"Rua de Caires",34,34,0,37,37,0
2,7,2019,1,0,5,"Braga",4,"N14 Bosch",45,45,0,75,75,0
2,7,2019,1,0,5,"Braga",5,"Avenida João Paulo II",40,40,0,8,8,0
2,7,2019,1,0,5,"Braga",6,"Avenida Padre Júlio Fragata",61,61,0,20,20,0
2,7,2019,1,0,5,"Braga",7,"Rua Nova Santa Cruz",29,29,0,111,111,0
2,7,2019,1,0,5,"Braga",8,"Rua Costa Gomes",40,40,0,42,42,0
2,7,2019,2,0,5,"Braga",1,"Avenida da Liberdade",21,21,0,32,32,0
2,7,2019,2,0,5,"Braga",2,"Avenida Central",17,17,0,284,284,0
2,7,2019,2,0,5,"Braga",3,"Rua de Caires",34,34,0,37,37,0
2,7,2019,2,0,5,"Braga",4,"N14 Bosch",45,45,0,75,75,0
2,7,2019,2,0,5,"Braga",5,"Avenida João Paulo II",40,40,0,8,8,0
2,7,2019,2,0,5,"Braga",6,"Avenida Padre Júlio Fragata",61,61,0,20,20,0
2,7,2019,2,0,5,"Braga",7,"Rua Nova Santa Cruz",17,29,12,189,111,78
2,7,2019,2,0,5,"Braga",8,"Rua Costa Gomes",40,40,0,42,42,0
2,7,2019,3,0,5,"Braga",1,"Avenida da Liberdade",21,21,0,32,32,0
2,7,2019,3,0,5,"Braga",2,"Avenida Central",17,17,0,284,284,0
2,7,2019,3,0,5,"Braga",3,"Rua de Caires",34,34,0,37,37,0
2,7,2019,3,0,5,"Braga",4,"N14 Bosch",45,45,0,75,75,0
2,7,2019,3,0,5,"Braga",5,"Avenida João Paulo II",40,40,0,8,8,0
2,7,2019,3,0,5,"Braga",6,"Avenida Padre Júlio Fragata",61,61,0,20,20,0
2,7,2019,3,0,5,"Braga",7,"Rua Nova Santa Cruz",28,28,0,115,115,0
2,7,2019,3,0,5,"Braga",8,"Rua Costa Gomes",40,40,0,42,42,0
2,7,2019,4,0,5,"Braga",1,"Avenida da Liberdade",21,21,0,32,32,0
2,7,2019,4,0,5,"Braga",2,"Avenida Central",17,17,0,284,284,0
2,7,2019,4,0,5,"Braga",3,"Rua de Caires",34,34,0,37,37,0
2,7,2019,4,0,5,"Braga",4,"N14 Bosch",45,45,0,75,75,0
2,7,2019,4,0,5,"Braga",5,"Avenida João Paulo II",40,40,0,8,8,0
2,7,2019,4,0,5,"Braga",6,"Avenida Padre Júlio Fragata",61,61,0,20,20,0
2,7,2019,4,0,5,"Braga",7,"Rua Nova Santa Cruz",28,28,0,115,115,0
2,7,2019,4,0,5,"Braga",8,"Rua Costa Gomes",40,40,0,42,42,0
2,7,2019,5,0,5,"Braga",1,"Avenida da Liberdade",21,21,0,32,32,0
2,7,2019,5,0,5,"Braga",2,"Avenida Central",17,17,0,284,284,0
2,7,2019,5,0,5,"Braga",3,"Rua de Caires",34,34,0,37,37,0
2,7,2019,5,0,5,"Braga",4,"N14 Bosch",45,45,0,75,75,0
2,7,2019,5,0,5,"Braga",5,"Avenida João Paulo II",40,40,0,8,8,0
2,7,2019,5,0,5,"Braga",6,"Avenida Padre Júlio Fragata",61,61,0,20,20,0
2,7,2019,5,0,5,"Braga",7,"Rua Nova Santa Cruz",28,28,0,115,115,0
2,7,2019,5,0,5,"Braga",8,"Rua Costa Gomes",40,40,0,42,42,0
2,7,2019,6,0,5,"Braga",1,"Avenida da Liberdade",21,21,0,32,32,0
2,7,2019,6,0,5,"Braga",2,"Avenida Central",17,17,0,284,284,0
2,7,2019,6,0,5,"Braga",3,"Rua de Caires",34,34,0,37,37,0
2,7,2019,6,0,5,"Braga",4,"N14 Bosch",45,45,0,75,75,0
2,7,2019,6,0,5,"Braga",5,"Avenida João Paulo II",40,40,0,8,8,0
2,7,2019,6,0,5,"Braga",6,"Avenida Padre Júlio Fragata",61,61,0,20,20,0
2,7,2019,6,0,5,"Braga",7,"Rua Nova Santa Cruz",28,28,0,115,115,0
2,7,2019,6,0,5,"Braga",8,"Rua Costa Gomes",40,40,0,42,42,0
2,7,2019,7,0,5,"Braga",1,"Avenida da Liberdade",21,21,0,32,32,0
2,7,2019,7,0,5,"Braga",2,"Avenida Central",17,17,0,284,284,0
2,7,2019,7,0,5,"Braga",3,"Rua de Caires",34,34,0,37,37,0
2,7,2019,7,0,5,"Braga",4,"N14 Bosch",45,45,0,75,75,0
2,7,2019,7,0,5,"Braga",5,"Avenida João Paulo II",40,40,0,8,8,0
2,7,2019,7,0,5,"Braga",6,"Avenida Padre Júlio Fragata",61,61,0,20,20,0
2,7,2019,7,0,5,"Braga",7,"Rua Nova Santa Cruz",28,28,0,115,115,0
2,7,2019,7,0,5,"Braga",8,"Rua Costa Gomes",40,40,0,42,42,0
2,7,2019,8,0,5,"Braga",1,"Avenida da Liberdade",21,21,0,32,32,0
2,7,2019,8,0,5,"Braga",2,"Avenida Central",17,17,0,284,284,0
2,7,2019,8,0,5,"Braga",3,"Rua de Caires",25,35,10,51,36,15
2,7,2019,8,0,5,"Braga",4,"N14 Bosch",46,46,0,74,74,0
2,7,2019,8,0,5,"Braga",5,"Avenida João Paulo II",40,40,0,8,8,0
2,7,2019,8,0,5,"Braga",6,"Avenida Padre Júlio Fragata",61,61,0,20,20,0
2,7,2019,8,0,5,"Braga",7,"Rua Nova Santa Cruz",28,28,0,115,115,0
2,7,2019,8,0,5,"Braga",8,"Rua Costa Gomes",28,39,11,60,43,17
2,7,2019,9,0,5,"Braga",1,"Avenida da Liberdade",15,21,6,44,32,12
2,7,2019,9,0,5,"Braga",2,"Avenida Central",13,17,4,372,284,88
2,7,2019,9,0,5,"Braga",3,"Rua de Caires",25,35,10,51,36,15
2,7,2019,9,0,5,"Braga",4,"N14 Bosch",26,45,19,131,75,56
2,7,2019,9,0,5,"Braga",5,"Avenida João Paulo II",39,39,0,8,8,0
2,7,2019,9,0,5,"Braga",6,"Avenida Padre Júlio Fragata",35,61,26,36,20,16
2,7,2019,9,0,5,"Braga",7,"Rua Nova Santa Cruz",23,29,6,140,111,29
2,7,2019,9,0,5,"Braga",8,"Rua Costa Gomes",23,39,16,73,43,30
2,7,2019,10,0,5,"Braga",1,"Avenida da Liberdade",17,21,4,39,32,7
2,7,2019,10,0,5,"Braga",2,"Avenida Central",17,17,0,284,284,0
2,7,2019,10,0,5,"Braga",3,"Rua de Caires",6,33,27,214,38,176
2,7,2019,10,0,5,"Braga",4,"N14 Bosch",35,46,11,97,74,23
2,7,2019,10,0,5,"Braga",5,"Avenida João Paulo II",39,39,0,8,8,0
2,7,2019,10,0,5,"Braga",6,"Avenida Padre Júlio Fragata",61,61,0,20,20,0
2,7,2019,10,0,5,"Braga",7,"Rua Nova Santa Cruz",22,29,7,146,111,35
2,7,2019,10,0,5,"Braga",8,"Rua Costa Gomes",31,40,9,54,42,12
2,7,2019,11,0,5,"Braga",1,"Avenida da Liberdade",17,21,4,39,32,7
2,7,2019,11,0,5,"Braga",2,"Avenida Central",13,18,5,372,268,104
2,7,2019,11,0,5,"Braga",3,"Rua de Caires",23,35,12,55,36,19
2,7,2019,11,0,5,"Braga",4,"N14 Bosch",32,46,14,106,74,32
2,7,2019,11,0,5,"Braga",5,"Avenida João Paulo II",30,39,9,11,8,3
2,7,2019,11,0,5,"Braga",6,"Avenida Padre Júlio Fragata",60,60,0,21,21,0
2,7,2019,11,0,5,"Braga",7,"Rua Nova Santa Cruz",28,28,0,115,115,0
2,7,2019,11,0,5,"Braga",8,"Rua Costa Gomes",17,41,24,98,40,58
2,7,2019,12,0,5,"Braga",1,"Avenida da Liberdade",22,22,0,30,30,0
2,7,2019,12,0,5,"Braga",2,"Avenida Central",13,18,5,372,268,104
2,7,2019,12,0,5,"Braga",3,"Rua de Caires",27,35,8,47,36,11
2,7,2019,12,0,5,"Braga",4,"N14 Bosch",31,46,15,110,74,36
2,7,2019,12,0,5,"Braga",5,"Avenida João Paulo II",32,40,8,10,8,2
2,7,2019,12,0,5,"Braga",6,"Avenida Padre Júlio Fragata",60,60,0,21,21,0
2,7,2019,12,0,5,"Braga",7,"Rua Nova Santa Cruz",23,29,6,140,111,29
2,7,2019,12,0,5,"Braga",8,"Rua Costa Gomes",32,40,8,52,42,10
2,7,2019,13,0,5,"Braga",1,"Avenida da Liberdade",22,22,0,30,30,0
2,7,2019,13,0,5,"Braga",2,"Avenida Central",12,18,6,403,268,135
2,7,2019,13,0,5,"Braga",3,"Rua de Caires",19,35,16,67,36,31
2,7,2019,13,0,5,"Braga",4,"N14 Bosch",30,45,15,113,75,38
2,7,2019,13,0,5,"Braga",5,"Avenida João Paulo II",31,40,9,11,8,3
2,7,2019,13,0,5,"Braga",6,"Avenida Padre Júlio Fragata",60,60,0,21,21,0
2,7,2019,13,0,5,"Braga",7,"Rua Nova Santa Cruz",28,28,0,115,115,0
2,7,2019,13,0,5,"Braga",8,"Rua Costa Gomes",28,39,11,60,43,17
2,7,2019,14,0,5,"Braga",1,"Avenida da Liberdade",22,22,0,30,30,0
2,7,2019,14,0,5,"Braga",2,"Avenida Central",13,17,4,372,284,88
2,7,2019,14,0,5,"Braga",3,"Rua de Caires",20,34,14,64,37,27
2,7,2019,14,0,5,"Braga",4,"N14 Bosch",22,45,23,155,75,80
2,7,2019,14,0,5,"Braga",5,"Avenida João Paulo II",27,40,13,12,8,4
2,7,2019,14,0,5,"Braga",6,"Avenida Padre Júlio Fragata",38,60,22,33,21,12
2,7,2019,14,0,5,"Braga",7,"Rua Nova Santa Cruz",29,29,0,111,111,0
2,7,2019,14,0,5,"Braga",8,"Rua Costa Gomes",29,40,11,57,42,15
2,7,2019,15,0,5,"Braga",1,"Avenida da Liberdade",22,22,0,30,30,0
2,7,2019,15,0,5,"Braga",2,"Avenida Central",9,17,8,537,284,253
2,7,2019,15,0,5,"Braga",3,"Rua de Caires",35,35,0,36,36,0
2,7,2019,15,0,5,"Braga",4,"N14 Bosch",36,46,10,94,74,20
2,7,2019,15,0,5,"Braga",5,"Avenida João Paulo II",39,39,0,8,8,0
2,7,2019,15,0,5,"Braga",6,"Avenida Padre Júlio Fragata",48,60,12,26,21,5
2,7,2019,15,0,5,"Braga",7,"Rua Nova Santa Cruz",17,29,12,189,111,78
2,7,2019,15,0,5,"Braga",8,"Rua Costa Gomes",31,40,9,54,42,12
2,7,2019,16,0,5,"Braga",1,"Avenida da Liberdade",22,22,0,30,30,0
2,7,2019,16,0,5,"Braga",2,"Avenida Central",17,17,0,284,284,0
2,7,2019,16,0,5,"Braga",3,"Rua de Caires",28,35,7,45,36,9
2,7,2019,16,0,5,"Braga",4,"N14 Bosch",21,45,24,162,75,87
2,7,2019,16,0,5,"Braga",5,"Avenida João Paulo II",19,39,20,18,8,10
2,7,2019,16,0,5,"Braga",6,"Avenida Padre Júlio Fragata",60,60,0,21,21,0
2,7,2019,16,0,5,"Braga",7,"Rua Nova Santa Cruz",22,28,6,146,115,31
2,7,2019,16,0,5,"Braga",8,"Rua Costa Gomes",31,39,8,54,43,11
2,7,2019,17,0,5,"Braga",1,"Avenida da Liberdade",21,21,0,32,32,0
2,7,2019,17,0,5,"Braga",2,"Avenida Central",11,18,7,439,268,171
2,7,2019,17,0,5,"Braga",3,"Rua de Caires",35,35,0,36,36,0
2,7,2019,17,0,5,"Braga",4,"N14 Bosch",17,45,28,200,75,125
2,7,2019,17,0,5,"Braga",5,"Avenida João Paulo II",24,40,16,14,8,6
2,7,2019,17,0,5,"Braga",6,"Avenida Padre Júlio Fragata",61,61,0,20,20,0
2,7,2019,17,0,5,"Braga",7,"Rua Nova Santa Cruz",19,28,9,169,115,54
2,7,2019,17,0,5,"Braga",8,"Rua Costa Gomes",28,39,11,60,43,17
2,7,2019,18,0,5,"Braga",1,"Avenida da Liberdade",15,22,7,44,30,14
2,7,2019,18,0,5,"Braga",2,"Avenida Central",7,17,10,691,284,407
2,7,2019,18,0,5,"Braga",3,"Rua de Caires",22,35,13,58,36,22
2,7,2019,18,0,5,"Braga",4,"N14 Bosch",12,47,35,284,72,212
2,7,2019,18,0,5,"Braga",5,"Avenida João Paulo II",20,39,19,17,8,9
2,7,2019,18,0,5,"Braga",6,"Avenida Padre Júlio Fragata",36,61,25,35,20,15
2,7,2019,18,0,5,"Braga",7,"Rua Nova Santa Cruz",10,30,20,322,107,215
2,7,2019,18,0,5,"Braga",8,"Rua Costa Gomes",19,40,21,88,42,46
2,7,2019,19,0,5,"Braga",1,"Avenida da Liberdade",14,22,8,48,30,18
2,7,2019,19,0,5,"Braga",2,"Avenida Central",8,18,10,604,268,336
2,7,2019,19,0,5,"Braga",3,"Rua de Caires",26,34,8,49,37,12
2,7,2019,19,0,5,"Braga",4,"N14 Bosch",25,45,20,136,75,61
2,7,2019,19,0,5,"Braga",5,"Avenida João Paulo II",22,40,18,15,8,7
2,7,2019,19,0,5,"Braga",6,"Avenida Padre Júlio Fragata",24,61,37,53,20,33
2,7,2019,19,0,5,"Braga",7,"Rua Nova Santa Cruz",17,28,11,189,115,74
2,7,2019,19,0,5,"Braga",8,"Rua Costa Gomes",9,39,30,186,43,143
2,7,2019,20,0,5,"Braga",1,"Avenida da Liberdade",17,21,4,39,32,7
2,7,2019,20,0,5,"Braga",2,"Avenida Central",14,17,3,345,284,61
2,7,2019,20,0,5,"Braga",3,"Rua de Caires",28,35,7,45,36,9
2,7,2019,20,0,5,"Braga",4,"N14 Bosch",28,46,18,121,74,47
2,7,2019,20,0,5,"Braga",5,"Avenida João Paulo II",31,39,8,11,8,3
2,7,2019,20,0,5,"Braga",6,"Avenida Padre Júlio Fragata",48,60,12,26,21,5
2,7,2019,20,0,5,"Braga",7,"Rua Nova Santa Cruz",20,29,9,161,111,50
2,7,2019,20,0,5,"Braga",8,"Rua Costa Gomes",25,39,14,67,43,24
2,7,2019,21,0,5,"Braga",1,"Avenida da Liberdade",21,21,0,32,32,0
2,7,2019,21,0,5,"Braga",2,"Avenida Central",17,17,0,284,284,0
2,7,2019,21,0,5,"Braga",3,"Rua de Caires",35,35,0,36,36,0
2,7,2019,21,0,5,"Braga",4,"N14 Bosch",46,46,0,74,74,0
2,7,2019,21,0,5,"Braga",5,"Avenida João Paulo II",40,40,0,8,8,0
2,7,2019,21,0,5,"Braga",6,"Avenida Padre Júlio Fragata",60,60,0,21,21,0
2,7,2019,21,0,5,"Braga",7,"Rua Nova Santa Cruz",28,28,0,115,115,0
2,7,2019,21,0,5,"Braga",8,"Rua Costa Gomes",40,40,0,42,42,0
2,7,2019,22,0,5,"Braga",1,"Avenida da Liberdade",21,21,0,32,32,0
2,7,2019,22,0,5,"Braga",2,"Avenida Central",17,17,0,284,284,0
2,7,2019,22,0,5,"Braga",3,"Rua de Caires",35,35,0,36,36,0
2,7,2019,22,0,5,"Braga",4,"N14 Bosch",46,46,0,74,74,0
2,7,2019,22,0,5,"Braga",5,"Avenida João Paulo II",40,40,0,8,8,0
2,7,2019,22,0,5,"Braga",6,"Avenida Padre Júlio Fragata",60,60,0,21,21,0
2,7,2019,22,0,5,"Braga",7,"Rua Nova Santa Cruz",28,28,0,115,115,0
2,7,2019,22,0,5,"Braga",8,"Rua Costa Gomes",40,40,0,42,42,0
2,7,2019,23,0,5,"Braga",1,"Avenida da Liberdade",21,21,0,32,32,0
2,7,2019,23,0,5,"Braga",2,"Avenida Central",17,17,0,284,284,0
2,7,2019,23,0,5,"Braga",3,"Rua de Caires",35,35,0,36,36,0
2,7,2019,23,0,5,"Braga",4,"N14 Bosch",46,46,0,74,74,0
2,7,2019,23,0,5,"Braga",5,"Avenida João Paulo II",40,40,0,8,8,0
2,7,2019,23,0,5,"Braga",6,"Avenida Padre Júlio Fragata",60,60,0,21,21,0
2,7,2019,23,0,5,"Braga",7,"Rua Nova Santa Cruz",28,28,0,115,115,0
2,7,2019,23,0,5,"Braga",8,"Rua Costa Gomes",40,40,0,42,42,0
2,8,2019,0,0,6,"Braga",1,"Avenida da Liberdade",21,21,0,32,32,0
2,8,2019,0,0,6,"Braga",2,"Avenida Central",17,17,0,284,284,0
2,8,2019,0,0,6,"Braga",3,"Rua de Caires",35,35,0,36,36,0
2,8,2019,0,0,6,"Braga",4,"N14 Bosch",46,46,0,74,74,0
2,8,2019,0,0,6,"Braga",5,"Avenida João Paulo II",40,40,0,8,8,0
2,8,2019,0,0,6,"Braga",6,"Avenida Padre Júlio Fragata",60,60,0,21,21,0
2,8,2019,0,0,6,"Braga",7,"Rua Nova Santa Cruz",28,28,0,115,115,0
2,8,2019,0,0,6,"Braga",8,"Rua Costa Gomes",40,40,0,42,42,0
2,8,2019,1,0,6,"Braga",1,"Avenida da Liberdade",21,21,0,32,32,0
2,8,2019,1,0,6,"Braga",2,"Avenida Central",17,17,0,284,284,0
2,8,2019,1,0,6,"Braga",3,"Rua de Caires",35,35,0,36,36,0
2,8,2019,1,0,6,"Braga",4,"N14 Bosch",46,46,0,74,74,0
2,8,2019,1,0,6,"Braga",5,"Avenida João Paulo II",40,40,0,8,8,0
2,8,2019,1,0,6,"Braga",6,"Avenida Padre Júlio Fragata",60,60,0,21,21,0
2,8,2019,1,0,6,"Braga",7,"Rua Nova Santa Cruz",28,28,0,115,115,0
2,8,2019,1,0,6,"Braga",8,"Rua Costa Gomes",40,40,0,42,42,0
2,8,2019,2,0,6,"Braga",1,"Avenida da Liberdade",21,21,0,32,32,0
2,8,2019,2,0,6,"Braga",2,"Avenida Central",17,17,0,284,284,0
2,8,2019,2,0,6,"Braga",3,"Rua de Caires",35,35,0,36,36,0
2,8,2019,2,0,6,"Braga",4,"N14 Bosch",46,46,0,74,74,0
2,8,2019,2,0,6,"Braga",5,"Avenida João Paulo II",40,40,0,8,8,0
2,8,2019,2,0,6,"Braga",6,"Avenida Padre Júlio Fragata",60,60,0,21,21,0
2,8,2019,2,0,6,"Braga",7,"Rua Nova Santa Cruz",28,28,0,115,115,0
2,8,2019,2,0,6,"Braga",8,"Rua Costa Gomes",40,40,0,42,42,0
2,8,2019,3,0,6,"Braga",1,"Avenida da Liberdade",21,21,0,32,32,0
2,8,2019,3,0,6,"Braga",2,"Avenida Central",17,17,0,284,284,0
2,8,2019,3,0,6,"Braga",3,"Rua de Caires",35,35,0,36,36,0
2,8,2019,3,0,6,"Braga",4,"N14 Bosch",46,46,0,74,74,0
2,8,2019,3,0,6,"Braga",5,"Avenida João Paulo II",40,40,0,8,8,0
2,8,2019,3,0,6,"Braga",6,"Avenida Padre Júlio Fragata",60,60,0,21,21,0
2,8,2019,3,0,6,"Braga",7,"Rua Nova Santa Cruz",28,28,0,115,115,0
2,8,2019,3,0,6,"Braga",8,"Rua Costa Gomes",40,40,0,42,42,0
2,8,2019,4,0,6,"Braga",1,"Avenida da Liberdade",21,21,0,32,32,0
2,8,2019,4,0,6,"Braga",2,"Avenida Central",17,17,0,284,284,0
2,8,2019,4,0,6,"Braga",3,"Rua de Caires",35,35,0,36,36,0
2,8,2019,4,0,6,"Braga",4,"N14 Bosch",46,46,0,74,74,0
2,8,2019,4,0,6,"Braga",5,"Avenida João Paulo II",40,40,0,8,8,0
2,8,2019,4,0,6,"Braga",6,"Avenida Padre Júlio Fragata",60,60,0,21,21,0
2,8,2019,4,0,6,"Braga",7,"Rua Nova Santa Cruz",28,28,0,115,115,0
2,8,2019,4,0,6,"Braga",8,"Rua Costa Gomes",40,40,0,42,42,0
2,8,2019,5,0,6,"Braga",1,"Avenida da Liberdade",21,21,0,32,32,0
2,8,2019,5,0,6,"Braga",2,"Avenida Central",17,17,0,284,284,0
2,8,2019,5,0,6,"Braga",3,"Rua de Caires",35,35,0,36,36,0
2,8,2019,5,0,6,"Braga",4,"N14 Bosch",46,46,0,74,74,0
2,8,2019,5,0,6,"Braga",5,"Avenida João Paulo II",40,40,0,8,8,0
2,8,2019,5,0,6,"Braga",6,"Avenida Padre Júlio Fragata",60,60,0,21,21,0
2,8,2019,5,0,6,"Braga",7,"Rua Nova Santa Cruz",28,28,0,115,115,0
2,8,2019,5,0,6,"Braga",8,"Rua Costa Gomes",40,40,0,42,42,0
2,8,2019,6,0,6,"Braga",1,"Avenida da Liberdade",21,21,0,32,32,0
2,8,2019,6,0,6,"Braga",2,"Avenida Central",17,17,0,284,284,0
2,8,2019,6,0,6,"Braga",3,"Rua de Caires",35,35,0,36,36,0
2,8,2019,6,0,6,"Braga",4,"N14 Bosch",46,46,0,74,74,0
2,8,2019,6,0,6,"Braga",5,"Avenida João Paulo II",40,40,0,8,8,0
2,8,2019,6,0,6,"Braga",6,"Avenida Padre Júlio Fragata",60,60,0,21,21,0
2,8,2019,6,0,6,"Braga",7,"Rua Nova Santa Cruz",28,28,0,115,115,0
2,8,2019,6,0,6,"Braga",8,"Rua Costa Gomes",40,40,0,42,42,0
2,8,2019,7,0,6,"Braga",6,"Avenida Padre Júlio Fragata",60,60,0,21,21,0
2,8,2019,7,0,6,"Braga",7,"Rua Nova Santa Cruz",28,28,0,115,115,0
2,8,2019,7,0,6,"Braga",8,"Rua Costa Gomes",40,40,0,42,42,0
2,8,2019,7,0,6,"Braga",1,"Avenida da Liberdade",21,21,0,32,32,0
2,8,2019,7,0,6,"Braga",2,"Avenida Central",17,17,0,284,284,0
2,8,2019,7,0,6,"Braga",3,"Rua de Caires",35,35,0,36,36,0
2,8,2019,7,0,6,"Braga",4,"N14 Bosch",46,46,0,74,74,0
2,8,2019,7,0,6,"Braga",5,"Avenida João Paulo II",40,40,0,8,8,0
2,8,2019,7,0,6,"Braga",6,"Avenida Padre Júlio Fragata",60,60,0,21,21,0
2,8,2019,8,0,6,"Braga",1,"Avenida da Liberdade",21,21,0,32,32,0
2,8,2019,8,0,6,"Braga",2,"Avenida Central",17,17,0,284,284,0
2,8,2019,8,0,6,"Braga",3,"Rua de Caires",27,35,8,47,36,11
2,8,2019,8,0,6,"Braga",4,"N14 Bosch",35,46,11,97,74,23
2,8,2019,8,0,6,"Braga",5,"Avenida João Paulo II",40,40,0,8,8,0
2,8,2019,8,0,6,"Braga",6,"Avenida Padre Júlio Fragata",60,60,0,21,21,0
2,8,2019,8,0,6,"Braga",7,"Rua Nova Santa Cruz",28,28,0,115,115,0
2,8,2019,8,0,6,"Braga",8,"Rua Costa Gomes",28,40,12,60,42,18
2,8,2019,9,0,6,"Braga",1,"Avenida da Liberdade",21,21,0,32,32,0
2,8,2019,9,0,6,"Braga",2,"Avenida Central",11,18,7,439,268,171
2,8,2019,9,0,6,"Braga",3,"Rua de Caires",21,35,14,61,36,25
2,8,2019,9,0,6,"Braga",4,"N14 Bosch",28,46,18,121,74,47
2,8,2019,9,0,6,"Braga",5,"Avenida João Paulo II",30,40,10,11,8,3
2,8,2019,9,0,6,"Braga",6,"Avenida Padre Júlio Fragata",41,60,19,31,21,10
2,8,2019,9,0,6,"Braga",7,"Rua Nova Santa Cruz",22,28,6,146,115,31
2,8,2019,9,0,6,"Braga",8,"Rua Costa Gomes",26,40,14,64,42,22
2,8,2019,10,0,6,"Braga",1,"Avenida da Liberdade",22,22,0,30,30,0
2,8,2019,10,0,6,"Braga",2,"Avenida Central",17,17,0,284,284,0
2,8,2019,10,0,6,"Braga",3,"Rua de Caires",24,35,11,53,36,17
2,8,2019,10,0,6,"Braga",4,"N14 Bosch",33,46,13,103,74,29
2,8,2019,10,0,6,"Braga",5,"Avenida João Paulo II",40,40,0,8,8,0
2,8,2019,10,0,6,"Braga",6,"Avenida Padre Júlio Fragata",60,60,0,21,21,0
2,8,2019,10,0,6,"Braga",7,"Rua Nova Santa Cruz",29,29,0,111,111,0
2,8,2019,10,0,6,"Braga",8,"Rua Costa Gomes",31,40,9,54,42,12
2,8,2019,11,0,6,"Braga",1,"Avenida da Liberdade",17,21,4,39,32,7
2,8,2019,11,0,6,"Braga",2,"Avenida Central",17,17,0,284,284,0
2,8,2019,11,0,6,"Braga",3,"Rua de Caires",23,34,11,55,37,18
2,8,2019,11,0,6,"Braga",4,"N14 Bosch",29,45,16,117,75,42
2,8,2019,11,0,6,"Braga",5,"Avenida João Paulo II",40,40,0,8,8,0
2,8,2019,11,0,6,"Braga",6,"Avenida Padre Júlio Fragata",60,60,0,21,21,0
2,8,2019,11,0,6,"Braga",7,"Rua Nova Santa Cruz",23,29,6,140,111,29
2,8,2019,11,0,6,"Braga",8,"Rua Costa Gomes",30,40,10,56,42,14
2,8,2019,12,0,6,"Braga",1,"Avenida da Liberdade",18,22,4,37,30,7
2,8,2019,12,0,6,"Braga",2,"Avenida Central",10,17,7,483,284,199
2,8,2019,12,0,6,"Braga",3,"Rua de Caires",23,34,11,55,37,18
2,8,2019,12,0,6,"Braga",4,"N14 Bosch",31,46,15,110,74,36
2,8,2019,12,0,6,"Braga",5,"Avenida João Paulo II",40,40,0,8,8,0
2,8,2019,12,0,6,"Braga",6,"Avenida Padre Júlio Fragata",60,60,0,21,21,0
2,8,2019,12,0,6,"Braga",7,"Rua Nova Santa Cruz",20,28,8,161,115,46
2,8,2019,12,0,6,"Braga",8,"Rua Costa Gomes",30,39,9,56,43,13
2,8,2019,13,0,6,"Braga",1,"Avenida da Liberdade",22,22,0,30,30,0
2,8,2019,13,0,6,"Braga",2,"Avenida Central",13,18,5,372,268,104
2,8,2019,13,0,6,"Braga",3,"Rua de Caires",27,35,8,47,36,11
2,8,2019,13,0,6,"Braga",4,"N14 Bosch",31,45,14,110,75,35
2,8,2019,13,0,6,"Braga",5,"Avenida João Paulo II",40,40,0,8,8,0
2,8,2019,13,0,6,"Braga",6,"Avenida Padre Júlio Fragata",60,60,0,21,21,0
2,8,2019,13,0,6,"Braga",7,"Rua Nova Santa Cruz",14,29,15,230,111,119
2,8,2019,13,0,6,"Braga",8,"Rua Costa Gomes",30,40,10,56,42,14
2,8,2019,14,0,6,"Braga",1,"Avenida da Liberdade",17,21,4,39,32,7
2,8,2019,14,0,6,"Braga",2,"Avenida Central",12,17,5,403,284,119
2,8,2019,14,0,6,"Braga",3,"Rua de Caires",24,35,11,53,36,17
2,8,2019,14,0,6,"Braga",4,"N14 Bosch",28,46,18,121,74,47
2,8,2019,14,0,6,"Braga",5,"Avenida João Paulo II",40,40,0,8,8,0
2,8,2019,14,0,6,"Braga",6,"Avenida Padre Júlio Fragata",60,60,0,21,21,0
2,8,2019,14,0,6,"Braga",7,"Rua Nova Santa Cruz",21,29,8,153,111,42
2,8,2019,14,0,6,"Braga",8,"Rua Costa Gomes",30,39,9,56,43,13
2,8,2019,15,0,6,"Braga",1,"Avenida da Liberdade",22,22,0,30,30,0
2,8,2019,15,0,6,"Braga",2,"Avenida Central",13,17,4,372,284,88
2,8,2019,15,0,6,"Braga",3,"Rua de Caires",24,35,11,53,36,17
2,8,2019,15,0,6,"Braga",4,"N14 Bosch",30,46,16,113,74,39
2,8,2019,15,0,6,"Braga",5,"Avenida João Paulo II",30,39,9,11,8,3
2,8,2019,15,0,6,"Braga",6,"Avenida Padre Júlio Fragata",60,60,0,21,21,0
2,8,2019,15,0,6,"Braga",7,"Rua Nova Santa Cruz",21,29,8,153,111,42
2,8,2019,15,0,6,"Braga",8,"Rua Costa Gomes",27,40,13,62,42,20
2,8,2019,16,0,6,"Braga",1,"Avenida da Liberdade",17,21,4,39,32,7
2,8,2019,16,0,6,"Braga",2,"Avenida Central",10,18,8,483,268,215
2,8,2019,16,0,6,"Braga",3,"Rua de Caires",24,34,10,53,37,16
2,8,2019,16,0,6,"Braga",4,"N14 Bosch",17,47,30,200,72,128
2,8,2019,16,0,6,"Braga",5,"Avenida João Paulo II",25,39,14,13,8,5
2,8,2019,16,0,6,"Braga",6,"Avenida Padre Júlio Fragata",43,61,18,29,20,9
2,8,2019,16,0,6,"Braga",7,"Rua Nova Santa Cruz",21,29,8,153,111,42
2,8,2019,16,0,6,"Braga",8,"Rua Costa Gomes",30,39,9,56,43,13
2,8,2019,17,0,6,"Braga",1,"Avenida da Liberdade",17,21,4,39,32,7
2,8,2019,17,0,6,"Braga",2,"Avenida Central",9,17,8,537,284,253
2,8,2019,17,0,6,"Braga",3,"Rua de Caires",23,35,12,55,36,19
2,8,2019,17,0,6,"Braga",4,"N14 Bosch",24,46,22,142,74,68
2,8,2019,17,0,6,"Braga",5,"Avenida João Paulo II",29,40,11,11,8,3
2,8,2019,17,0,6,"Braga",6,"Avenida Padre Júlio Fragata",43,61,18,29,20,9
2,8,2019,17,0,6,"Braga",7,"Rua Nova Santa Cruz",18,28,10,179,115,64
2,8,2019,17,0,6,"Braga",8,"Rua Costa Gomes",26,40,14,64,42,22
2,8,2019,18,0,6,"Braga",1,"Avenida da Liberdade",15,22,7,44,30,14
2,8,2019,18,0,6,"Braga",2,"Avenida Central",8,17,9,604,284,320
2,8,2019,18,0,6,"Braga",3,"Rua de Caires",15,34,19,85,37,48
2,8,2019,18,0,6,"Braga",4,"N14 Bosch",15,45,30,227,75,152
2,8,2019,18,0,6,"Braga",5,"Avenida João Paulo II",16,40,24,21,8,13
2,8,2019,18,0,6,"Braga",6,"Avenida Padre Júlio Fragata",22,60,38,58,21,37
2,8,2019,18,0,6,"Braga",7,"Rua Nova Santa Cruz",7,28,21,460,115,345
2,8,2019,18,0,6,"Braga",8,"Rua Costa Gomes",13,40,27,129,42,87
2,8,2019,19,0,6,"Braga",1,"Avenida da Liberdade",22,22,0,30,30,0
2,8,2019,19,0,6,"Braga",2,"Avenida Central",8,18,10,604,268,336
2,8,2019,19,0,6,"Braga",3,"Rua de Caires",19,35,16,67,36,31
2,8,2019,19,0,6,"Braga",4,"N14 Bosch",32,45,13,106,75,31
2,8,2019,19,0,6,"Braga",5,"Avenida João Paulo II",10,40,30,34,8,26
2,8,2019,19,0,6,"Braga",6,"Avenida Padre Júlio Fragata",19,62,43,67,20,47
2,8,2019,19,0,6,"Braga",7,"Rua Nova Santa Cruz",9,30,21,358,107,251
2,8,2019,19,0,6,"Braga",8,"Rua Costa Gomes",7,41,34,240,40,200
2,8,2019,20,0,6,"Braga",1,"Avenida da Liberdade",17,22,5,39,30,9
2,8,2019,20,0,6,"Braga",2,"Avenida Central",13,18,5,372,268,104
2,8,2019,20,0,6,"Braga",3,"Rua de Caires",27,34,7,47,37,10
2,8,2019,20,0,6,"Braga",4,"N14 Bosch",28,45,17,121,75,46
2,8,2019,20,0,6,"Braga",5,"Avenida João Paulo II",28,40,12,12,8,4
2,8,2019,20,0,6,"Braga",6,"Avenida Padre Júlio Fragata",39,60,21,32,21,11
2,8,2019,20,0,6,"Braga",7,"Rua Nova Santa Cruz",19,29,10,169,111,58
2,8,2019,20,0,6,"Braga",8,"Rua Costa Gomes",20,39,19,84,43,41
2,8,2019,21,0,6,"Braga",1,"Avenida da Liberdade",22,22,0,30,30,0
2,8,2019,21,0,6,"Braga",2,"Avenida Central",17,17,0,284,284,0
2,8,2019,21,0,6,"Braga",3,"Rua de Caires",35,35,0,36,36,0
2,8,2019,21,0,6,"Braga",4,"N14 Bosch",45,45,0,75,75,0
2,8,2019,21,0,6,"Braga",5,"Avenida João Paulo II",40,40,0,8,8,0
2,8,2019,21,0,6,"Braga",6,"Avenida Padre Júlio Fragata",61,61,0,20,20,0
2,8,2019,21,0,6,"Braga",7,"Rua Nova Santa Cruz",28,28,0,115,115,0
2,8,2019,21,0,6,"Braga",8,"Rua Costa Gomes",31,40,9,54,42,12
2,8,2019,22,0,6,"Braga",1,"Avenida da Liberdade",22,22,0,30,30,0
2,8,2019,22,0,6,"Braga",2,"Avenida Central",17,17,0,284,284,0
2,8,2019,22,0,6,"Braga",3,"Rua de Caires",35,35,0,36,36,0
2,8,2019,22,0,6,"Braga",4,"N14 Bosch",46,46,0,74,74,0
2,8,2019,22,0,6,"Braga",5,"Avenida João Paulo II",40,40,0,8,8,0
2,8,2019,22,0,6,"Braga",6,"Avenida Padre Júlio Fragata",60,60,0,21,21,0
2,8,2019,22,0,6,"Braga",7,"Rua Nova Santa Cruz",28,28,0,115,115,0
2,8,2019,22,0,6,"Braga",8,"Rua Costa Gomes",40,40,0,42,42,0
2,8,2019,23,0,6,"Braga",1,"Avenida da Liberdade",22,22,0,30,30,0
2,8,2019,23,0,6,"Braga",2,"Avenida Central",17,17,0,284,284,0
2,8,2019,23,0,6,"Braga",3,"Rua de Caires",35,35,0,36,36,0
2,8,2019,23,0,6,"Braga",4,"N14 Bosch",46,46,0,74,74,0
2,8,2019,23,0,6,"Braga",5,"Avenida João Paulo II",40,40,0,8,8,0
2,8,2019,23,0,6,"Braga",6,"Avenida Padre Júlio Fragata",61,61,0,20,20,0
2,8,2019,23,0,6,"Braga",7,"Rua Nova Santa Cruz",28,28,0,115,115,0
2,8,2019,23,0,6,"Braga",8,"Rua Costa Gomes",40,40,0,42,42,0
2,9,2019,0,0,7,"Braga",1,"Avenida da Liberdade",22,22,0,30,30,0
2,9,2019,0,0,7,"Braga",2,"Avenida Central",17,17,0,284,284,0
2,9,2019,0,0,7,"Braga",3,"Rua de Caires",35,35,0,36,36,0
2,9,2019,0,0,7,"Braga",4,"N14 Bosch",46,46,0,74,74,0
2,9,2019,0,0,7,"Braga",5,"Avenida João Paulo II",40,40,0,8,8,0
2,9,2019,0,0,7,"Braga",6,"Avenida Padre Júlio Fragata",61,61,0,20,20,0
2,9,2019,0,0,7,"Braga",7,"Rua Nova Santa Cruz",28,28,0,115,115,0
2,9,2019,0,0,7,"Braga",8,"Rua Costa Gomes",40,40,0,42,42,0
2,9,2019,1,0,7,"Braga",1,"Avenida da Liberdade",22,22,0,30,30,0
2,9,2019,1,0,7,"Braga",2,"Avenida Central",17,17,0,284,284,0
2,9,2019,1,0,7,"Braga",3,"Rua de Caires",35,35,0,36,36,0
2,9,2019,1,0,7,"Braga",4,"N14 Bosch",46,46,0,74,74,0
2,9,2019,1,0,7,"Braga",5,"Avenida João Paulo II",40,40,0,8,8,0
2,9,2019,1,0,7,"Braga",6,"Avenida Padre Júlio Fragata",61,61,0,20,20,0
2,9,2019,1,0,7,"Braga",7,"Rua Nova Santa Cruz",28,28,0,115,115,0
2,9,2019,1,0,7,"Braga",8,"Rua Costa Gomes",40,40,0,42,42,0
2,9,2019,2,0,7,"Braga",1,"Avenida da Liberdade",22,22,0,30,30,0
2,9,2019,2,0,7,"Braga",2,"Avenida Central",17,17,0,284,284,0
2,9,2019,2,0,7,"Braga",3,"Rua de Caires",35,35,0,36,36,0
2,9,2019,2,0,7,"Braga",4,"N14 Bosch",46,46,0,74,74,0
2,9,2019,2,0,7,"Braga",5,"Avenida João Paulo II",40,40,0,8,8,0
2,9,2019,2,0,7,"Braga",6,"Avenida Padre Júlio Fragata",61,61,0,20,20,0
2,9,2019,2,0,7,"Braga",7,"Rua Nova Santa Cruz",28,28,0,115,115,0
2,9,2019,2,0,7,"Braga",8,"Rua Costa Gomes",40,40,0,42,42,0
2,9,2019,3,0,7,"Braga",1,"Avenida da Liberdade",22,22,0,30,30,0
2,9,2019,3,0,7,"Braga",2,"Avenida Central",17,17,0,284,284,0
2,9,2019,3,0,7,"Braga",3,"Rua de Caires",35,35,0,36,36,0
2,9,2019,3,0,7,"Braga",4,"N14 Bosch",46,46,0,74,74,0
2,9,2019,3,0,7,"Braga",5,"Avenida João Paulo II",40,40,0,8,8,0
2,9,2019,3,0,7,"Braga",6,"Avenida Padre Júlio Fragata",61,61,0,20,20,0
2,9,2019,3,0,7,"Braga",7,"Rua Nova Santa Cruz",28,28,0,115,115,0
2,9,2019,3,0,7,"Braga",8,"Rua Costa Gomes",40,40,0,42,42,0
2,9,2019,4,0,7,"Braga",1,"Avenida da Liberdade",22,22,0,30,30,0
2,9,2019,4,0,7,"Braga",2,"Avenida Central",17,17,0,284,284,0
2,9,2019,4,0,7,"Braga",3,"Rua de Caires",35,35,0,36,36,0
2,9,2019,4,0,7,"Braga",4,"N14 Bosch",46,46,0,74,74,0
2,9,2019,4,0,7,"Braga",5,"Avenida João Paulo II",40,40,0,8,8,0
2,9,2019,4,0,7,"Braga",6,"Avenida Padre Júlio Fragata",61,61,0,20,20,0
2,9,2019,4,0,7,"Braga",7,"Rua Nova Santa Cruz",28,28,0,115,115,0
2,9,2019,4,0,7,"Braga",8,"Rua Costa Gomes",40,40,0,42,42,0
2,9,2019,5,0,7,"Braga",1,"Avenida da Liberdade",22,22,0,30,30,0
2,9,2019,5,0,7,"Braga",2,"Avenida Central",17,17,0,284,284,0
2,9,2019,5,0,7,"Braga",3,"Rua de Caires",35,35,0,36,36,0
2,9,2019,5,0,7,"Braga",4,"N14 Bosch",46,46,0,74,74,0
2,9,2019,5,0,7,"Braga",5,"Avenida João Paulo II",40,40,0,8,8,0
2,9,2019,5,0,7,"Braga",6,"Avenida Padre Júlio Fragata",61,61,0,20,20,0
2,9,2019,5,0,7,"Braga",7,"Rua Nova Santa Cruz",28,28,0,115,115,0
2,9,2019,5,0,7,"Braga",8,"Rua Costa Gomes",40,40,0,42,42,0
2,9,2019,6,0,7,"Braga",1,"Avenida da Liberdade",22,22,0,30,30,0
2,9,2019,6,0,7,"Braga",2,"Avenida Central",17,17,0,284,284,0
2,9,2019,6,0,7,"Braga",3,"Rua de Caires",35,35,0,36,36,0
2,9,2019,6,0,7,"Braga",4,"N14 Bosch",46,46,0,74,74,0
2,9,2019,6,0,7,"Braga",5,"Avenida João Paulo II",40,40,0,8,8,0
2,9,2019,6,0,7,"Braga",6,"Avenida Padre Júlio Fragata",61,61,0,20,20,0
2,9,2019,6,0,7,"Braga",7,"Rua Nova Santa Cruz",28,28,0,115,115,0
2,9,2019,6,0,7,"Braga",8,"Rua Costa Gomes",40,40,0,42,42,0
2,9,2019,7,0,7,"Braga",1,"Avenida da Liberdade",22,22,0,30,30,0
2,9,2019,7,0,7,"Braga",2,"Avenida Central",17,17,0,284,284,0
2,9,2019,7,0,7,"Braga",3,"Rua de Caires",35,35,0,36,36,0
2,9,2019,7,0,7,"Braga",4,"N14 Bosch",46,46,0,74,74,0
2,9,2019,7,0,7,"Braga",5,"Avenida João Paulo II",40,40,0,8,8,0
2,9,2019,7,0,7,"Braga",6,"Avenida Padre Júlio Fragata",61,61,0,20,20,0
2,9,2019,7,0,7,"Braga",7,"Rua Nova Santa Cruz",28,28,0,115,115,0
2,9,2019,7,0,7,"Braga",8,"Rua Costa Gomes",40,40,0,42,42,0
2,9,2019,8,0,7,"Braga",1,"Avenida da Liberdade",22,22,0,30,30,0
2,9,2019,8,0,7,"Braga",2,"Avenida Central",17,17,0,284,284,0
2,9,2019,8,0,7,"Braga",3,"Rua de Caires",35,35,0,36,36,0
2,9,2019,8,0,7,"Braga",4,"N14 Bosch",46,46,0,74,74,0
2,9,2019,8,0,7,"Braga",5,"Avenida João Paulo II",40,40,0,8,8,0
2,9,2019,8,0,7,"Braga",6,"Avenida Padre Júlio Fragata",61,61,0,20,20,0
2,9,2019,8,0,7,"Braga",7,"Rua Nova Santa Cruz",28,28,0,115,115,0
2,9,2019,8,0,7,"Braga",8,"Rua Costa Gomes",40,40,0,42,42,0
2,9,2019,9,0,7,"Braga",1,"Avenida da Liberdade",22,22,0,30,30,0
2,9,2019,9,0,7,"Braga",2,"Avenida Central",17,17,0,284,284,0
2,9,2019,9,0,7,"Braga",3,"Rua de Caires",35,35,0,36,36,0
2,9,2019,9,0,7,"Braga",4,"N14 Bosch",46,46,0,74,74,0
2,9,2019,9,0,7,"Braga",5,"Avenida João Paulo II",40,40,0,8,8,0
2,9,2019,9,0,7,"Braga",6,"Avenida Padre Júlio Fragata",61,61,0,20,20,0
2,9,2019,9,0,7,"Braga",7,"Rua Nova Santa Cruz",28,28,0,115,115,0
2,9,2019,9,0,7,"Braga",8,"Rua Costa Gomes",40,40,0,42,42,0
2,9,2019,10,0,7,"Braga",1,"Avenida da Liberdade",22,22,0,30,30,0
2,9,2019,10,0,7,"Braga",2,"Avenida Central",13,18,5,372,268,104
2,9,2019,10,0,7,"Braga",3,"Rua de Caires",8,34,26,160,37,123
2,9,2019,10,0,7,"Braga",4,"N14 Bosch",36,45,9,94,75,19
2,9,2019,10,0,7,"Braga",5,"Avenida João Paulo II",40,40,0,8,8,0
2,9,2019,10,0,7,"Braga",6,"Avenida Padre Júlio Fragata",61,61,0,20,20,0
2,9,2019,10,0,7,"Braga",7,"Rua Nova Santa Cruz",28,28,0,115,115,0
2,9,2019,10,0,7,"Braga",8,"Rua Costa Gomes",40,40,0,42,42,0
2,9,2019,11,0,7,"Braga",1,"Avenida da Liberdade",22,22,0,30,30,0
2,9,2019,11,0,7,"Braga",2,"Avenida Central",11,17,6,439,284,155
2,9,2019,11,0,7,"Braga",3,"Rua de Caires",19,34,15,67,37,30
2,9,2019,11,0,7,"Braga",4,"N14 Bosch",46,46,0,74,74,0
2,9,2019,11,0,7,"Braga",5,"Avenida João Paulo II",40,40,0,8,8,0
2,9,2019,11,0,7,"Braga",6,"Avenida Padre Júlio Fragata",61,61,0,20,20,0
2,9,2019,11,0,7,"Braga",7,"Rua Nova Santa Cruz",28,28,0,115,115,0
2,9,2019,11,0,7,"Braga",8,"Rua Costa Gomes",32,40,8,52,42,10
2,9,2019,12,0,7,"Braga",1,"Avenida da Liberdade",22,22,0,30,30,0
2,9,2019,12,0,7,"Braga",2,"Avenida Central",7,18,11,691,268,423
2,9,2019,12,0,7,"Braga",3,"Rua de Caires",25,35,10,51,36,15
2,9,2019,12,0,7,"Braga",4,"N14 Bosch",46,46,0,74,74,0
2,9,2019,12,0,7,"Braga",5,"Avenida João Paulo II",40,40,0,8,8,0
2,9,2019,12,0,7,"Braga",6,"Avenida Padre Júlio Fragata",61,61,0,20,20,0
2,9,2019,12,0,7,"Braga",7,"Rua Nova Santa Cruz",28,28,0,115,115,0
2,9,2019,12,0,7,"Braga",8,"Rua Costa Gomes",31,39,8,54,43,11
2,9,2019,13,0,7,"Braga",1,"Avenida da Liberdade",22,22,0,30,30,0
2,9,2019,13,0,7,"Braga",2,"Avenida Central",17,17,0,284,284,0
2,9,2019,13,0,7,"Braga",3,"Rua de Caires",27,34,7,47,37,10
2,9,2019,13,0,7,"Braga",4,"N14 Bosch",36,45,9,94,75,19
2,9,2019,13,0,7,"Braga",5,"Avenida João Paulo II",40,40,0,8,8,0
2,9,2019,13,0,7,"Braga",6,"Avenida Padre Júlio Fragata",61,61,0,20,20,0
2,9,2019,13,0,7,"Braga",7,"Rua Nova Santa Cruz",28,28,0,115,115,0
2,9,2019,13,0,7,"Braga",8,"Rua Costa Gomes",26,39,13,64,43,21
2,9,2019,14,0,7,"Braga",1,"Avenida da Liberdade",22,22,0,30,30,0
2,9,2019,14,0,7,"Braga",2,"Avenida Central",17,17,0,284,284,0
2,9,2019,14,0,7,"Braga",3,"Rua de Caires",34,34,0,37,37,0
2,9,2019,14,0,7,"Braga",4,"N14 Bosch",45,45,0,75,75,0
2,9,2019,14,0,7,"Braga",5,"Avenida João Paulo II",40,40,0,8,8,0
2,9,2019,14,0,7,"Braga",6,"Avenida Padre Júlio Fragata",47,61,14,27,20,7
2,9,2019,14,0,7,"Braga",7,"Rua Nova Santa Cruz",20,29,9,161,111,50
2,9,2019,14,0,7,"Braga",8,"Rua Costa Gomes",31,40,9,54,42,12
2,9,2019,15,0,7,"Braga",7,"Rua Nova Santa Cruz",29,29,0,111,111,0
2,9,2019,15,0,7,"Braga",8,"Rua Costa Gomes",40,40,0,42,42,0
2,9,2019,15,0,7,"Braga",1,"Avenida da Liberdade",22,22,0,30,30,0
2,9,2019,15,0,7,"Braga",2,"Avenida Central",12,18,6,403,268,135
2,9,2019,15,0,7,"Braga",3,"Rua de Caires",25,34,9,51,37,14
2,9,2019,15,0,7,"Braga",4,"N14 Bosch",34,46,12,100,74,26
2,9,2019,15,0,7,"Braga",5,"Avenida João Paulo II",16,39,23,21,8,13
2,9,2019,15,0,7,"Braga",6,"Avenida Padre Júlio Fragata",45,60,15,28,21,7
2,9,2019,15,0,7,"Braga",7,"Rua Nova Santa Cruz",29,29,0,111,111,0
2,9,2019,16,0,7,"Braga",1,"Avenida da Liberdade",22,22,0,30,30,0
2,9,2019,16,0,7,"Braga",2,"Avenida Central",11,18,7,439,268,171
2,9,2019,16,0,7,"Braga",3,"Rua de Caires",28,35,7,45,36,9
2,9,2019,16,0,7,"Braga",4,"N14 Bosch",46,46,0,74,74,0
2,9,2019,16,0,7,"Braga",5,"Avenida João Paulo II",31,40,9,11,8,3
2,9,2019,16,0,7,"Braga",6,"Avenida Padre Júlio Fragata",47,61,14,27,20,7
2,9,2019,16,0,7,"Braga",7,"Rua Nova Santa Cruz",29,29,0,111,111,0
2,9,2019,16,0,7,"Braga",8,"Rua Costa Gomes",28,39,11,60,43,17
2,9,2019,17,0,7,"Braga",1,"Avenida da Liberdade",22,22,0,30,30,0
2,9,2019,17,0,7,"Braga",2,"Avenida Central",11,18,7,439,268,171
2,9,2019,17,0,7,"Braga",3,"Rua de Caires",35,35,0,36,36,0
2,9,2019,17,0,7,"Braga",4,"N14 Bosch",35,46,11,97,74,23
2,9,2019,17,0,7,"Braga",5,"Avenida João Paulo II",27,39,12,12,8,4
2,9,2019,17,0,7,"Braga",6,"Avenida Padre Júlio Fragata",45,60,15,28,21,7
2,9,2019,17,0,7,"Braga",7,"Rua Nova Santa Cruz",29,29,0,111,111,0
2,9,2019,17,0,7,"Braga",8,"Rua Costa Gomes",28,39,11,60,43,17
2,9,2019,18,0,7,"Braga",1,"Avenida da Liberdade",22,22,0,30,30,0
2,9,2019,18,0,7,"Braga",2,"Avenida Central",12,17,5,403,284,119
2,9,2019,18,0,7,"Braga",3,"Rua de Caires",18,34,16,71,37,34
2,9,2019,18,0,7,"Braga",4,"N14 Bosch",24,46,22,142,74,68
2,9,2019,18,0,7,"Braga",5,"Avenida João Paulo II",27,40,13,12,8,4
2,9,2019,18,0,7,"Braga",6,"Avenida Padre Júlio Fragata",34,61,27,37,20,17
2,9,2019,18,0,7,"Braga",7,"Rua Nova Santa Cruz",29,29,0,111,111,0
2,9,2019,18,0,7,"Braga",8,"Rua Costa Gomes",28,39,11,60,43,17
2,9,2019,19,0,7,"Braga",1,"Avenida da Liberdade",22,22,0,30,30,0
2,9,2019,19,0,7,"Braga",2,"Avenida Central",13,18,5,372,268,104
2,9,2019,19,0,7,"Braga",3,"Rua de Caires",35,35,0,36,36,0
2,9,2019,19,0,7,"Braga",4,"N14 Bosch",46,46,0,74,74,0
2,9,2019,19,0,7,"Braga",5,"Avenida João Paulo II",40,40,0,8,8,0
2,9,2019,19,0,7,"Braga",6,"Avenida Padre Júlio Fragata",29,61,32,44,20,24
2,9,2019,19,0,7,"Braga",7,"Rua Nova Santa Cruz",29,29,0,111,111,0
2,9,2019,19,0,7,"Braga",8,"Rua Costa Gomes",30,40,10,56,42,14
2,9,2019,20,0,7,"Braga",1,"Avenida da Liberdade",22,22,0,30,30,0
2,9,2019,20,0,7,"Braga",2,"Avenida Central",18,18,0,268,268,0
2,9,2019,20,0,7,"Braga",3,"Rua de Caires",27,35,8,47,36,11
2,9,2019,20,0,7,"Braga",4,"N14 Bosch",31,46,15,110,74,36
2,9,2019,20,0,7,"Braga",5,"Avenida João Paulo II",39,39,0,8,8,0
2,9,2019,20,0,7,"Braga",6,"Avenida Padre Júlio Fragata",39,61,22,32,20,12
2,9,2019,20,0,7,"Braga",7,"Rua Nova Santa Cruz",28,28,0,115,115,0
2,9,2019,20,0,7,"Braga",8,"Rua Costa Gomes",30,39,9,56,43,13
2,9,2019,21,0,7,"Braga",1,"Avenida da Liberdade",22,22,0,30,30,0
2,9,2019,21,0,7,"Braga",2,"Avenida Central",18,18,0,268,268,0
2,9,2019,21,0,7,"Braga",3,"Rua de Caires",35,35,0,36,36,0
2,9,2019,21,0,7,"Braga",4,"N14 Bosch",46,46,0,74,74,0
2,9,2019,21,0,7,"Braga",5,"Avenida João Paulo II",39,39,0,8,8,0
2,9,2019,21,0,7,"Braga",6,"Avenida Padre Júlio Fragata",38,60,22,33,21,12
2,9,2019,21,0,7,"Braga",7,"Rua Nova Santa Cruz",22,29,7,146,111,35
2,9,2019,21,0,7,"Braga",8,"Rua Costa Gomes",30,39,9,56,43,13
2,9,2019,22,0,7,"Braga",1,"Avenida da Liberdade",22,22,0,30,30,0
2,9,2019,22,0,7,"Braga",2,"Avenida Central",18,18,0,268,268,0
2,9,2019,22,0,7,"Braga",3,"Rua de Caires",34,34,0,37,37,0
2,9,2019,22,0,7,"Braga",4,"N14 Bosch",46,46,0,74,74,0
2,9,2019,22,0,7,"Braga",5,"Avenida João Paulo II",39,39,0,8,8,0
2,9,2019,22,0,7,"Braga",6,"Avenida Padre Júlio Fragata",40,61,21,31,20,11
2,9,2019,22,0,7,"Braga",7,"Rua Nova Santa Cruz",29,29,0,111,111,0
2,9,2019,22,0,7,"Braga",8,"Rua Costa Gomes",40,40,0,42,42,0
2,9,2019,23,0,7,"Braga",1,"Avenida da Liberdade",22,22,0,30,30,0
2,9,2019,23,0,7,"Braga",2,"Avenida Central",18,18,0,268,268,0
2,9,2019,23,0,7,"Braga",3,"Rua de Caires",34,34,0,37,37,0
2,9,2019,23,0,7,"Braga",4,"N14 Bosch",46,46,0,74,74,0
2,9,2019,23,0,7,"Braga",5,"Avenida João Paulo II",39,39,0,8,8,0
2,9,2019,23,0,7,"Braga",6,"Avenida Padre Júlio Fragata",61,61,0,20,20,0
2,9,2019,23,0,7,"Braga",7,"Rua Nova Santa Cruz",29,29,0,111,111,0
2,9,2019,23,0,7,"Braga",8,"Rua Costa Gomes",40,40,0,42,42,0
2,10,2019,0,0,8,"Braga",1,"Avenida da Liberdade",22,22,0,30,30,0
2,10,2019,0,0,8,"Braga",2,"Avenida Central",18,18,0,268,268,0
2,10,2019,0,0,8,"Braga",3,"Rua de Caires",34,34,0,37,37,0
2,10,2019,0,0,8,"Braga",4,"N14 Bosch",46,46,0,74,74,0
2,10,2019,0,0,8,"Braga",5,"Avenida João Paulo II",39,39,0,8,8,0
2,10,2019,0,0,8,"Braga",6,"Avenida Padre Júlio Fragata",33,60,27,38,21,17
2,10,2019,0,0,8,"Braga",7,"Rua Nova Santa Cruz",29,29,0,111,111,0
2,10,2019,0,0,8,"Braga",8,"Rua Costa Gomes",40,40,0,42,42,0
2,10,2019,1,0,8,"Braga",1,"Avenida da Liberdade",22,22,0,30,30,0
2,10,2019,1,0,8,"Braga",2,"Avenida Central",18,18,0,268,268,0
2,10,2019,1,0,8,"Braga",3,"Rua de Caires",34,34,0,37,37,0
2,10,2019,1,0,8,"Braga",4,"N14 Bosch",46,46,0,74,74,0
2,10,2019,1,0,8,"Braga",5,"Avenida João Paulo II",39,39,0,8,8,0
2,10,2019,1,0,8,"Braga",6,"Avenida Padre Júlio Fragata",60,60,0,21,21,0
2,10,2019,1,0,8,"Braga",7,"Rua Nova Santa Cruz",29,29,0,111,111,0
2,10,2019,1,0,8,"Braga",8,"Rua Costa Gomes",40,40,0,42,42,0
2,10,2019,2,0,8,"Braga",1,"Avenida da Liberdade",22,22,0,30,30,0
2,10,2019,2,0,8,"Braga",2,"Avenida Central",18,18,0,268,268,0
2,10,2019,2,0,8,"Braga",3,"Rua de Caires",34,34,0,37,37,0
2,10,2019,2,0,8,"Braga",4,"N14 Bosch",46,46,0,74,74,0
2,10,2019,2,0,8,"Braga",5,"Avenida João Paulo II",39,39,0,8,8,0
2,10,2019,2,0,8,"Braga",6,"Avenida Padre Júlio Fragata",60,60,0,21,21,0
2,10,2019,2,0,8,"Braga",7,"Rua Nova Santa Cruz",29,29,0,111,111,0
2,10,2019,2,0,8,"Braga",8,"Rua Costa Gomes",40,40,0,42,42,0
2,10,2019,3,0,8,"Braga",1,"Avenida da Liberdade",22,22,0,30,30,0
2,10,2019,3,0,8,"Braga",2,"Avenida Central",18,18,0,268,268,0
2,10,2019,3,0,8,"Braga",3,"Rua de Caires",34,34,0,37,37,0
2,10,2019,3,0,8,"Braga",4,"N14 Bosch",46,46,0,74,74,0
2,10,2019,3,0,8,"Braga",5,"Avenida João Paulo II",39,39,0,8,8,0
2,10,2019,3,0,8,"Braga",6,"Avenida Padre Júlio Fragata",60,60,0,21,21,0
2,10,2019,3,0,8,"Braga",7,"Rua Nova Santa Cruz",29,29,0,111,111,0
2,10,2019,3,0,8,"Braga",8,"Rua Costa Gomes",40,40,0,42,42,0
2,10,2019,4,0,8,"Braga",1,"Avenida da Liberdade",22,22,0,30,30,0
2,10,2019,4,0,8,"Braga",2,"Avenida Central",18,18,0,268,268,0
2,10,2019,4,0,8,"Braga",3,"Rua de Caires",34,34,0,37,37,0
2,10,2019,4,0,8,"Braga",4,"N14 Bosch",46,46,0,74,74,0
2,10,2019,4,0,8,"Braga",5,"Avenida João Paulo II",39,39,0,8,8,0
2,10,2019,4,0,8,"Braga",6,"Avenida Padre Júlio Fragata",60,60,0,21,21,0
2,10,2019,4,0,8,"Braga",7,"Rua Nova Santa Cruz",29,29,0,111,111,0
2,10,2019,4,0,8,"Braga",8,"Rua Costa Gomes",40,40,0,42,42,0
2,10,2019,5,0,8,"Braga",1,"Avenida da Liberdade",22,22,0,30,30,0
2,10,2019,5,0,8,"Braga",2,"Avenida Central",18,18,0,268,268,0
2,10,2019,5,0,8,"Braga",3,"Rua de Caires",34,34,0,37,37,0
2,10,2019,5,0,8,"Braga",4,"N14 Bosch",46,46,0,74,74,0
2,10,2019,5,0,8,"Braga",5,"Avenida João Paulo II",39,39,0,8,8,0
2,10,2019,5,0,8,"Braga",6,"Avenida Padre Júlio Fragata",60,60,0,21,21,0
2,10,2019,5,0,8,"Braga",7,"Rua Nova Santa Cruz",29,29,0,111,111,0
2,10,2019,5,0,8,"Braga",8,"Rua Costa Gomes",40,40,0,42,42,0
2,10,2019,6,0,8,"Braga",1,"Avenida da Liberdade",22,22,0,30,30,0
2,10,2019,6,0,8,"Braga",2,"Avenida Central",18,18,0,268,268,0
2,10,2019,6,0,8,"Braga",3,"Rua de Caires",34,34,0,37,37,0
2,10,2019,6,0,8,"Braga",4,"N14 Bosch",46,46,0,74,74,0
2,10,2019,6,0,8,"Braga",5,"Avenida João Paulo II",39,39,0,8,8,0
2,10,2019,6,0,8,"Braga",6,"Avenida Padre Júlio Fragata",60,60,0,21,21,0
2,10,2019,6,0,8,"Braga",7,"Rua Nova Santa Cruz",29,29,0,111,111,0
2,10,2019,6,0,8,"Braga",8,"Rua Costa Gomes",40,40,0,42,42,0
2,10,2019,7,0,8,"Braga",1,"Avenida da Liberdade",22,22,0,30,30,0
2,10,2019,7,0,8,"Braga",2,"Avenida Central",18,18,0,268,268,0
2,10,2019,7,0,8,"Braga",3,"Rua de Caires",34,34,0,37,37,0
2,10,2019,7,0,8,"Braga",4,"N14 Bosch",46,46,0,74,74,0
2,10,2019,7,0,8,"Braga",5,"Avenida João Paulo II",39,39,0,8,8,0
2,10,2019,7,0,8,"Braga",6,"Avenida Padre Júlio Fragata",60,60,0,21,21,0
2,10,2019,7,0,8,"Braga",7,"Rua Nova Santa Cruz",29,29,0,111,111,0
2,10,2019,7,0,8,"Braga",8,"Rua Costa Gomes",40,40,0,42,42,0
2,10,2019,8,0,8,"Braga",1,"Avenida da Liberdade",22,22,0,30,30,0
2,10,2019,8,0,8,"Braga",2,"Avenida Central",17,17,0,284,284,0
2,10,2019,8,0,8,"Braga",3,"Rua de Caires",34,34,0,37,37,0
2,10,2019,8,0,8,"Braga",4,"N14 Bosch",46,46,0,74,74,0
2,10,2019,8,0,8,"Braga",5,"Avenida João Paulo II",39,39,0,8,8,0
2,10,2019,8,0,8,"Braga",6,"Avenida Padre Júlio Fragata",60,60,0,21,21,0
2,10,2019,8,0,8,"Braga",7,"Rua Nova Santa Cruz",29,29,0,111,111,0
2,10,2019,8,0,8,"Braga",8,"Rua Costa Gomes",40,40,0,42,42,0
2,10,2019,9,0,8,"Braga",1,"Avenida da Liberdade",22,22,0,30,30,0
2,10,2019,9,0,8,"Braga",2,"Avenida Central",17,17,0,284,284,0
2,10,2019,9,0,8,"Braga",3,"Rua de Caires",34,34,0,37,37,0
2,10,2019,9,0,8,"Braga",4,"N14 Bosch",46,46,0,74,74,0
2,10,2019,9,0,8,"Braga",5,"Avenida João Paulo II",39,39,0,8,8,0
2,10,2019,9,0,8,"Braga",6,"Avenida Padre Júlio Fragata",60,60,0,21,21,0
2,10,2019,9,0,8,"Braga",7,"Rua Nova Santa Cruz",29,29,0,111,111,0
2,10,2019,9,0,8,"Braga",8,"Rua Costa Gomes",40,40,0,42,42,0
2,10,2019,10,0,8,"Braga",1,"Avenida da Liberdade",22,22,0,30,30,0
2,10,2019,10,0,8,"Braga",2,"Avenida Central",17,17,0,284,284,0
2,10,2019,10,0,8,"Braga",3,"Rua de Caires",34,34,0,37,37,0
2,10,2019,10,0,8,"Braga",4,"N14 Bosch",46,46,0,74,74,0
2,10,2019,10,0,8,"Braga",5,"Avenida João Paulo II",39,39,0,8,8,0
2,10,2019,10,0,8,"Braga",6,"Avenida Padre Júlio Fragata",60,60,0,21,21,0
2,10,2019,10,0,8,"Braga",7,"Rua Nova Santa Cruz",29,29,0,111,111,0
2,10,2019,10,0,8,"Braga",8,"Rua Costa Gomes",40,40,0,42,42,0
2,10,2019,11,0,8,"Braga",1,"Avenida da Liberdade",22,22,0,30,30,0
2,10,2019,11,0,8,"Braga",2,"Avenida Central",17,17,0,284,284,0
2,10,2019,11,0,8,"Braga",3,"Rua de Caires",34,34,0,37,37,0
2,10,2019,11,0,8,"Braga",4,"N14 Bosch",46,46,0,74,74,0
2,10,2019,11,0,8,"Braga",5,"Avenida João Paulo II",39,39,0,8,8,0
2,10,2019,11,0,8,"Braga",6,"Avenida Padre Júlio Fragata",60,60,0,21,21,0
2,10,2019,11,0,8,"Braga",7,"Rua Nova Santa Cruz",29,29,0,111,111,0
2,10,2019,11,0,8,"Braga",8,"Rua Costa Gomes",40,40,0,42,42,0
2,10,2019,12,0,8,"Braga",1,"Avenida da Liberdade",22,22,0,30,30,0
2,10,2019,12,0,8,"Braga",2,"Avenida Central",13,18,5,372,268,104
2,10,2019,12,0,8,"Braga",3,"Rua de Caires",27,34,7,47,37,10
2,10,2019,12,0,8,"Braga",4,"N14 Bosch",46,46,0,74,74,0
2,10,2019,12,0,8,"Braga",5,"Avenida João Paulo II",39,39,0,8,8,0
2,10,2019,12,0,8,"Braga",6,"Avenida Padre Júlio Fragata",61,61,0,20,20,0
2,10,2019,12,0,8,"Braga",7,"Rua Nova Santa Cruz",29,29,0,111,111,0
2,10,2019,12,0,8,"Braga",8,"Rua Costa Gomes",40,40,0,42,42,0
2,10,2019,13,0,8,"Braga",1,"Avenida da Liberdade",22,22,0,30,30,0
2,10,2019,13,0,8,"Braga",2,"Avenida Central",17,17,0,284,284,0
2,10,2019,13,0,8,"Braga",3,"Rua de Caires",34,34,0,37,37,0
2,10,2019,13,0,8,"Braga",4,"N14 Bosch",46,46,0,74,74,0
2,10,2019,13,0,8,"Braga",5,"Avenida João Paulo II",39,39,0,8,8,0
2,10,2019,13,0,8,"Braga",6,"Avenida Padre Júlio Fragata",61,61,0,20,20,0
2,10,2019,13,0,8,"Braga",7,"Rua Nova Santa Cruz",29,29,0,111,111,0
2,10,2019,13,0,8,"Braga",8,"Rua Costa Gomes",31,40,9,54,42,12
2,10,2019,14,0,8,"Braga",1,"Avenida da Liberdade",22,22,0,30,30,0
2,10,2019,14,0,8,"Braga",2,"Avenida Central",17,17,0,284,284,0
2,10,2019,14,0,8,"Braga",3,"Rua de Caires",35,35,0,36,36,0
2,10,2019,14,0,8,"Braga",4,"N14 Bosch",46,46,0,74,74,0
2,10,2019,14,0,8,"Braga",5,"Avenida João Paulo II",40,40,0,8,8,0
2,10,2019,14,0,8,"Braga",6,"Avenida Padre Júlio Fragata",61,61,0,20,20,0
2,10,2019,14,0,8,"Braga",7,"Rua Nova Santa Cruz",29,29,0,111,111,0
2,10,2019,14,0,8,"Braga",8,"Rua Costa Gomes",28,39,11,60,43,17
2,10,2019,15,0,8,"Braga",1,"Avenida da Liberdade",22,22,0,30,30,0
2,10,2019,15,0,8,"Braga",2,"Avenida Central",13,17,4,372,284,88
2,10,2019,15,0,8,"Braga",3,"Rua de Caires",35,35,0,36,36,0
2,10,2019,15,0,8,"Braga",4,"N14 Bosch",46,46,0,74,74,0
2,10,2019,15,0,8,"Braga",5,"Avenida João Paulo II",10,40,30,34,8,26
2,10,2019,15,0,8,"Braga",6,"Avenida Padre Júlio Fragata",39,61,22,32,20,12
2,10,2019,15,0,8,"Braga",7,"Rua Nova Santa Cruz",29,29,0,111,111,0
2,10,2019,15,0,8,"Braga",8,"Rua Costa Gomes",30,40,10,56,42,14
2,10,2019,16,0,8,"Braga",1,"Avenida da Liberdade",22,22,0,30,30,0
2,10,2019,16,0,8,"Braga",2,"Avenida Central",13,17,4,372,284,88
2,10,2019,16,0,8,"Braga",3,"Rua de Caires",35,35,0,36,36,0
2,10,2019,16,0,8,"Braga",4,"N14 Bosch",46,46,0,74,74,0
2,10,2019,16,0,8,"Braga",5,"Avenida João Paulo II",9,41,32,38,8,30
2,10,2019,16,0,8,"Braga",6,"Avenida Padre Júlio Fragata",60,60,0,21,21,0
2,10,2019,16,0,8,"Braga",7,"Rua Nova Santa Cruz",29,29,0,111,111,0
2,10,2019,16,0,8,"Braga",8,"Rua Costa Gomes",30,40,10,56,42,14
2,10,2019,17,0,8,"Braga",1,"Avenida da Liberdade",22,22,0,30,30,0
2,10,2019,17,0,8,"Braga",2,"Avenida Central",12,17,5,403,284,119
2,10,2019,17,0,8,"Braga",3,"Rua de Caires",35,35,0,36,36,0
2,10,2019,17,0,8,"Braga",4,"N14 Bosch",46,46,0,74,74,0
2,10,2019,17,0,8,"Braga",5,"Avenida João Paulo II",26,39,13,13,8,5
2,10,2019,17,0,8,"Braga",6,"Avenida Padre Júlio Fragata",43,60,17,29,21,8
2,10,2019,17,0,8,"Braga",7,"Rua Nova Santa Cruz",29,29,0,111,111,0
2,10,2019,17,0,8,"Braga",8,"Rua Costa Gomes",26,40,14,64,42,22
2,10,2019,18,0,8,"Braga",1,"Avenida da Liberdade",18,22,4,37,30,7
2,10,2019,18,0,8,"Braga",2,"Avenida Central",17,17,0,284,284,0
2,10,2019,18,0,8,"Braga",3,"Rua de Caires",25,34,9,51,37,14
2,10,2019,18,0,8,"Braga",4,"N14 Bosch",46,46,0,74,74,0
2,10,2019,18,0,8,"Braga",5,"Avenida João Paulo II",27,40,13,12,8,4
2,10,2019,18,0,8,"Braga",6,"Avenida Padre Júlio Fragata",35,60,25,36,21,15
2,10,2019,18,0,8,"Braga",7,"Rua Nova Santa Cruz",29,29,0,111,111,0
2,10,2019,18,0,8,"Braga",8,"Rua Costa Gomes",19,40,21,88,42,46
2,10,2019,19,0,8,"Braga",1,"Avenida da Liberdade",22,22,0,30,30,0
2,10,2019,19,0,8,"Braga",2,"Avenida Central",17,17,0,284,284,0
2,10,2019,19,0,8,"Braga",3,"Rua de Caires",35,35,0,36,36,0
2,10,2019,19,0,8,"Braga",4,"N14 Bosch",45,45,0,75,75,0
2,10,2019,19,0,8,"Braga",5,"Avenida João Paulo II",40,40,0,8,8,0
2,10,2019,19,0,8,"Braga",6,"Avenida Padre Júlio Fragata",35,61,26,36,20,16
2,10,2019,19,0,8,"Braga",7,"Rua Nova Santa Cruz",29,29,0,111,111,0
2,10,2019,19,0,8,"Braga",8,"Rua Costa Gomes",28,40,12,60,42,18
2,10,2019,20,0,8,"Braga",1,"Avenida da Liberdade",22,22,0,30,30,0
2,10,2019,20,0,8,"Braga",2,"Avenida Central",17,17,0,284,284,0
2,10,2019,20,0,8,"Braga",3,"Rua de Caires",35,35,0,36,36,0
2,10,2019,20,0,8,"Braga",4,"N14 Bosch",45,45,0,75,75,0
2,10,2019,20,0,8,"Braga",5,"Avenida João Paulo II",40,40,0,8,8,0
2,10,2019,20,0,8,"Braga",6,"Avenida Padre Júlio Fragata",61,61,0,20,20,0
2,10,2019,20,0,8,"Braga",7,"Rua Nova Santa Cruz",29,29,0,111,111,0
2,10,2019,20,0,8,"Braga",8,"Rua Costa Gomes",40,40,0,42,42,0
2,10,2019,21,0,8,"Braga",1,"Avenida da Liberdade",22,22,0,30,30,0
2,10,2019,21,0,8,"Braga",2,"Avenida Central",17,17,0,284,284,0
2,10,2019,21,0,8,"Braga",3,"Rua de Caires",35,35,0,36,36,0
2,10,2019,21,0,8,"Braga",4,"N14 Bosch",45,45,0,75,75,0
2,10,2019,21,0,8,"Braga",5,"Avenida João Paulo II",40,40,0,8,8,0
2,10,2019,21,0,8,"Braga",6,"Avenida Padre Júlio Fragata",61,61,0,20,20,0
2,10,2019,21,0,8,"Braga",7,"Rua Nova Santa Cruz",29,29,0,111,111,0
2,10,2019,21,0,8,"Braga",8,"Rua Costa Gomes",40,40,0,42,42,0
2,10,2019,22,0,8,"Braga",1,"Avenida da Liberdade",22,22,0,30,30,0
2,10,2019,22,0,8,"Braga",2,"Avenida Central",17,17,0,284,284,0
2,10,2019,22,0,8,"Braga",3,"Rua de Caires",35,35,0,36,36,0
2,10,2019,22,0,8,"Braga",4,"N14 Bosch",45,45,0,75,75,0
2,10,2019,22,0,8,"Braga",5,"Avenida João Paulo II",40,40,0,8,8,0
2,10,2019,22,0,8,"Braga",6,"Avenida Padre Júlio Fragata",61,61,0,20,20,0
2,10,2019,22,0,8,"Braga",7,"Rua Nova Santa Cruz",29,29,0,111,111,0
2,10,2019,22,0,8,"Braga",8,"Rua Costa Gomes",40,40,0,42,42,0
2,10,2019,23,0,8,"Braga",1,"Avenida da Liberdade",22,22,0,30,30,0
2,10,2019,23,0,8,"Braga",2,"Avenida Central",17,17,0,284,284,0
2,10,2019,23,0,8,"Braga",3,"Rua de Caires",35,35,0,36,36,0
2,10,2019,23,0,8,"Braga",4,"N14 Bosch",45,45,0,75,75,0
2,10,2019,23,0,8,"Braga",5,"Avenida João Paulo II",40,40,0,8,8,0
2,10,2019,23,0,8,"Braga",6,"Avenida Padre Júlio Fragata",61,61,0,20,20,0
2,10,2019,23,0,8,"Braga",7,"Rua Nova Santa Cruz",29,29,0,111,111,0
2,10,2019,23,0,8,"Braga",8,"Rua Costa Gomes",40,40,0,42,42,0
2,11,2019,0,0,2,"Braga",1,"Avenida da Liberdade",22,22,0,30,30,0
2,11,2019,0,0,2,"Braga",2,"Avenida Central",17,17,0,284,284,0
2,11,2019,0,0,2,"Braga",3,"Rua de Caires",35,35,0,36,36,0
2,11,2019,0,0,2,"Braga",4,"N14 Bosch",45,45,0,75,75,0
2,11,2019,0,0,2,"Braga",5,"Avenida João Paulo II",40,40,0,8,8,0
2,11,2019,0,0,2,"Braga",6,"Avenida Padre Júlio Fragata",61,61,0,20,20,0
2,11,2019,0,0,2,"Braga",7,"Rua Nova Santa Cruz",29,29,0,111,111,0
2,11,2019,0,0,2,"Braga",8,"Rua Costa Gomes",40,40,0,42,42,0
2,11,2019,1,0,2,"Braga",1,"Avenida da Liberdade",22,22,0,30,30,0
2,11,2019,1,0,2,"Braga",2,"Avenida Central",17,17,0,284,284,0
2,11,2019,1,0,2,"Braga",3,"Rua de Caires",35,35,0,36,36,0
2,11,2019,1,0,2,"Braga",4,"N14 Bosch",45,45,0,75,75,0
2,11,2019,1,0,2,"Braga",5,"Avenida João Paulo II",40,40,0,8,8,0
2,11,2019,1,0,2,"Braga",6,"Avenida Padre Júlio Fragata",61,61,0,20,20,0
2,11,2019,1,0,2,"Braga",7,"Rua Nova Santa Cruz",29,29,0,111,111,0
2,11,2019,1,0,2,"Braga",8,"Rua Costa Gomes",40,40,0,42,42,0
2,11,2019,2,0,2,"Braga",1,"Avenida da Liberdade",22,22,0,30,30,0
2,11,2019,2,0,2,"Braga",2,"Avenida Central",17,17,0,284,284,0
2,11,2019,2,0,2,"Braga",3,"Rua de Caires",35,35,0,36,36,0
2,11,2019,2,0,2,"Braga",4,"N14 Bosch",45,45,0,75,75,0
2,11,2019,2,0,2,"Braga",5,"Avenida João Paulo II",40,40,0,8,8,0
2,11,2019,2,0,2,"Braga",6,"Avenida Padre Júlio Fragata",61,61,0,20,20,0
2,11,2019,2,0,2,"Braga",7,"Rua Nova Santa Cruz",29,29,0,111,111,0
2,11,2019,2,0,2,"Braga",8,"Rua Costa Gomes",40,40,0,42,42,0
2,11,2019,3,0,2,"Braga",1,"Avenida da Liberdade",22,22,0,30,30,0
2,11,2019,3,0,2,"Braga",2,"Avenida Central",17,17,0,284,284,0
2,11,2019,3,0,2,"Braga",3,"Rua de Caires",35,35,0,36,36,0
2,11,2019,3,0,2,"Braga",4,"N14 Bosch",45,45,0,75,75,0
2,11,2019,3,0,2,"Braga",5,"Avenida João Paulo II",40,40,0,8,8,0
2,11,2019,3,0,2,"Braga",6,"Avenida Padre Júlio Fragata",61,61,0,20,20,0
2,11,2019,3,0,2,"Braga",7,"Rua Nova Santa Cruz",29,29,0,111,111,0
2,11,2019,3,0,2,"Braga",8,"Rua Costa Gomes",40,40,0,42,42,0
2,11,2019,4,0,2,"Braga",1,"Avenida da Liberdade",22,22,0,30,30,0
2,11,2019,4,0,2,"Braga",2,"Avenida Central",17,17,0,284,284,0
2,11,2019,4,0,2,"Braga",3,"Rua de Caires",35,35,0,36,36,0
2,11,2019,4,0,2,"Braga",4,"N14 Bosch",45,45,0,75,75,0
2,11,2019,4,0,2,"Braga",5,"Avenida João Paulo II",40,40,0,8,8,0
2,11,2019,4,0,2,"Braga",6,"Avenida Padre Júlio Fragata",61,61,0,20,20,0
2,11,2019,4,0,2,"Braga",7,"Rua Nova Santa Cruz",29,29,0,111,111,0
2,11,2019,4,0,2,"Braga",8,"Rua Costa Gomes",40,40,0,42,42,0
2,11,2019,5,0,2,"Braga",1,"Avenida da Liberdade",22,22,0,30,30,0
2,11,2019,5,0,2,"Braga",2,"Avenida Central",17,17,0,284,284,0
2,11,2019,5,0,2,"Braga",3,"Rua de Caires",35,35,0,36,36,0
2,11,2019,5,0,2,"Braga",4,"N14 Bosch",45,45,0,75,75,0
2,11,2019,5,0,2,"Braga",5,"Avenida João Paulo II",40,40,0,8,8,0
2,11,2019,5,0,2,"Braga",6,"Avenida Padre Júlio Fragata",61,61,0,20,20,0
2,11,2019,5,0,2,"Braga",7,"Rua Nova Santa Cruz",29,29,0,111,111,0
2,11,2019,5,0,2,"Braga",8,"Rua Costa Gomes",40,40,0,42,42,0
2,11,2019,6,0,2,"Braga",1,"Avenida da Liberdade",22,22,0,30,30,0
2,11,2019,6,0,2,"Braga",2,"Avenida Central",17,17,0,284,284,0
2,11,2019,6,0,2,"Braga",3,"Rua de Caires",35,35,0,36,36,0
2,11,2019,6,0,2,"Braga",4,"N14 Bosch",45,45,0,75,75,0
2,11,2019,6,0,2,"Braga",5,"Avenida João Paulo II",40,40,0,8,8,0
2,11,2019,6,0,2,"Braga",6,"Avenida Padre Júlio Fragata",61,61,0,20,20,0
2,11,2019,6,0,2,"Braga",7,"Rua Nova Santa Cruz",29,29,0,111,111,0
2,11,2019,6,0,2,"Braga",8,"Rua Costa Gomes",40,40,0,42,42,0
2,11,2019,7,0,2,"Braga",1,"Avenida da Liberdade",22,22,0,30,30,0
2,11,2019,7,0,2,"Braga",2,"Avenida Central",17,17,0,284,284,0
2,11,2019,7,0,2,"Braga",3,"Rua de Caires",35,35,0,36,36,0
2,11,2019,7,0,2,"Braga",4,"N14 Bosch",45,45,0,75,75,0
2,11,2019,7,0,2,"Braga",5,"Avenida João Paulo II",40,40,0,8,8,0
2,11,2019,7,0,2,"Braga",6,"Avenida Padre Júlio Fragata",61,61,0,20,20,0
2,11,2019,7,0,2,"Braga",7,"Rua Nova Santa Cruz",29,29,0,111,111,0
2,11,2019,7,0,2,"Braga",8,"Rua Costa Gomes",40,40,0,42,42,0
2,11,2019,8,0,2,"Braga",1,"Avenida da Liberdade",22,22,0,30,30,0
2,11,2019,8,0,2,"Braga",2,"Avenida Central",17,17,0,284,284,0
2,11,2019,8,0,2,"Braga",3,"Rua de Caires",27,35,8,47,36,11
2,11,2019,8,0,2,"Braga",4,"N14 Bosch",33,45,12,103,75,28
2,11,2019,8,0,2,"Braga",5,"Avenida João Paulo II",31,40,9,11,8,3
2,11,2019,8,0,2,"Braga",6,"Avenida Padre Júlio Fragata",61,61,0,20,20,0
2,11,2019,8,0,2,"Braga",7,"Rua Nova Santa Cruz",29,29,0,111,111,0
2,11,2019,8,0,2,"Braga",8,"Rua Costa Gomes",30,39,9,56,43,13
2,11,2019,9,0,2,"Braga",1,"Avenida da Liberdade",15,21,6,44,32,12
2,11,2019,9,0,2,"Braga",2,"Avenida Central",17,17,0,284,284,0
2,11,2019,9,0,2,"Braga",3,"Rua de Caires",24,35,11,53,36,17
2,11,2019,9,0,2,"Braga",4,"N14 Bosch",22,45,23,155,75,80
2,11,2019,9,0,2,"Braga",5,"Avenida João Paulo II",39,39,0,8,8,0
2,11,2019,9,0,2,"Braga",6,"Avenida Padre Júlio Fragata",36,61,25,35,20,15
2,11,2019,9,0,2,"Braga",7,"Rua Nova Santa Cruz",23,29,6,140,111,29
2,11,2019,9,0,2,"Braga",8,"Rua Costa Gomes",26,40,14,64,42,22
2,11,2019,10,0,2,"Braga",1,"Avenida da Liberdade",17,22,5,39,30,9
2,11,2019,10,0,2,"Braga",2,"Avenida Central",12,18,6,403,268,135
2,11,2019,10,0,2,"Braga",3,"Rua de Caires",19,34,15,67,37,30
2,11,2019,10,0,2,"Braga",4,"N14 Bosch",34,46,12,100,74,26
2,11,2019,10,0,2,"Braga",5,"Avenida João Paulo II",31,40,9,11,8,3
2,11,2019,10,0,2,"Braga",6,"Avenida Padre Júlio Fragata",60,60,0,21,21,0
2,11,2019,10,0,2,"Braga",7,"Rua Nova Santa Cruz",21,29,8,153,111,42
2,11,2019,10,0,2,"Braga",8,"Rua Costa Gomes",26,40,14,64,42,22
2,11,2019,11,0,2,"Braga",1,"Avenida da Liberdade",17,21,4,39,32,7
2,11,2019,11,0,2,"Braga",2,"Avenida Central",13,18,5,372,268,104
2,11,2019,11,0,2,"Braga",3,"Rua de Caires",23,35,12,55,36,19
2,11,2019,11,0,2,"Braga",4,"N14 Bosch",32,46,14,106,74,32
2,11,2019,11,0,2,"Braga",5,"Avenida João Paulo II",40,40,0,8,8,0
2,11,2019,11,0,2,"Braga",6,"Avenida Padre Júlio Fragata",60,60,0,21,21,0
2,11,2019,11,0,2,"Braga",7,"Rua Nova Santa Cruz",22,28,6,146,115,31
2,11,2019,11,0,2,"Braga",8,"Rua Costa Gomes",28,39,11,60,43,17
2,11,2019,12,0,2,"Braga",1,"Avenida da Liberdade",17,21,4,39,32,7
2,11,2019,12,0,2,"Braga",2,"Avenida Central",12,18,6,403,268,135
2,11,2019,12,0,2,"Braga",3,"Rua de Caires",24,35,11,53,36,17
2,11,2019,12,0,2,"Braga",4,"N14 Bosch",30,45,15,113,75,38
2,11,2019,12,0,2,"Braga",5,"Avenida João Paulo II",31,39,8,11,8,3
2,11,2019,12,0,2,"Braga",6,"Avenida Padre Júlio Fragata",60,60,0,21,21,0
2,11,2019,12,0,2,"Braga",7,"Rua Nova Santa Cruz",22,29,7,146,111,35
2,11,2019,12,0,2,"Braga",8,"Rua Costa Gomes",30,40,10,56,42,14
2,11,2019,13,0,2,"Braga",1,"Avenida da Liberdade",22,22,0,30,30,0
2,11,2019,13,0,2,"Braga",2,"Avenida Central",12,18,6,403,268,135
2,11,2019,13,0,2,"Braga",3,"Rua de Caires",34,34,0,37,37,0
2,11,2019,13,0,2,"Braga",4,"N14 Bosch",31,45,14,110,75,35
2,11,2019,13,0,2,"Braga",5,"Avenida João Paulo II",40,40,0,8,8,0
2,11,2019,13,0,2,"Braga",6,"Avenida Padre Júlio Fragata",42,60,18,30,21,9
2,11,2019,13,0,2,"Braga",7,"Rua Nova Santa Cruz",21,28,7,153,115,38
2,11,2019,13,0,2,"Braga",8,"Rua Costa Gomes",30,40,10,56,42,14
2,11,2019,14,0,2,"Braga",1,"Avenida da Liberdade",22,22,0,30,30,0
2,11,2019,14,0,2,"Braga",2,"Avenida Central",14,17,3,345,284,61
2,11,2019,14,0,2,"Braga",3,"Rua de Caires",23,34,11,55,37,18
2,11,2019,14,0,2,"Braga",4,"N14 Bosch",29,46,17,117,74,43
2,11,2019,14,0,2,"Braga",5,"Avenida João Paulo II",40,40,0,8,8,0
2,11,2019,14,0,2,"Braga",6,"Avenida Padre Júlio Fragata",47,61,14,27,20,7
2,11,2019,14,0,2,"Braga",7,"Rua Nova Santa Cruz",18,28,10,179,115,64
2,11,2019,14,0,2,"Braga",8,"Rua Costa Gomes",40,40,0,42,42,0
2,11,2019,15,0,2,"Braga",2,"Avenida Central",17,17,0,284,284,0
2,11,2019,15,0,2,"Braga",3,"Rua de Caires",27,34,7,47,37,10
2,11,2019,15,0,2,"Braga",4,"N14 Bosch",27,46,19,126,74,52
2,11,2019,15,0,2,"Braga",5,"Avenida João Paulo II",31,40,9,11,8,3
2,11,2019,15,0,2,"Braga",6,"Avenida Padre Júlio Fragata",47,60,13,27,21,6
2,11,2019,15,0,2,"Braga",7,"Rua Nova Santa Cruz",21,29,8,153,111,42
2,11,2019,15,0,2,"Braga",8,"Rua Costa Gomes",28,39,11,60,43,17
2,11,2019,15,0,2,"Braga",1,"Avenida da Liberdade",17,21,4,39,32,7
2,11,2019,15,0,2,"Braga",2,"Avenida Central",17,17,0,284,284,0
2,11,2019,16,0,2,"Braga",1,"Avenida da Liberdade",17,22,5,39,30,9
2,11,2019,16,0,2,"Braga",2,"Avenida Central",11,17,6,439,284,155
2,11,2019,16,0,2,"Braga",3,"Rua de Caires",23,35,12,55,36,19
2,11,2019,16,0,2,"Braga",4,"N14 Bosch",36,45,9,94,75,19
2,11,2019,16,0,2,"Braga",5,"Avenida João Paulo II",29,39,10,11,8,3
2,11,2019,16,0,2,"Braga",6,"Avenida Padre Júlio Fragata",61,61,0,20,20,0
2,11,2019,16,0,2,"Braga",7,"Rua Nova Santa Cruz",16,29,13,201,111,90
2,11,2019,16,0,2,"Braga",8,"Rua Costa Gomes",27,39,12,62,43,19
2,11,2019,17,0,2,"Braga",1,"Avenida da Liberdade",17,22,5,39,30,9
2,11,2019,17,0,2,"Braga",2,"Avenida Central",12,18,6,403,268,135
2,11,2019,17,0,2,"Braga",3,"Rua de Caires",26,34,8,49,37,12
2,11,2019,17,0,2,"Braga",4,"N14 Bosch",31,46,15,110,74,36
2,11,2019,17,0,2,"Braga",5,"Avenida João Paulo II",23,40,17,14,8,6
2,11,2019,17,0,2,"Braga",6,"Avenida Padre Júlio Fragata",45,60,15,28,21,7
2,11,2019,17,0,2,"Braga",7,"Rua Nova Santa Cruz",19,29,10,169,111,58
2,11,2019,17,0,2,"Braga",8,"Rua Costa Gomes",28,40,12,60,42,18
2,11,2019,18,0,2,"Braga",1,"Avenida da Liberdade",17,22,5,39,30,9
2,11,2019,18,0,2,"Braga",2,"Avenida Central",11,17,6,439,284,155
2,11,2019,18,0,2,"Braga",3,"Rua de Caires",25,34,9,51,37,14
2,11,2019,18,0,2,"Braga",4,"N14 Bosch",18,46,28,189,74,115
2,11,2019,18,0,2,"Braga",5,"Avenida João Paulo II",22,40,18,15,8,7
2,11,2019,18,0,2,"Braga",6,"Avenida Padre Júlio Fragata",41,61,20,31,20,11
2,11,2019,18,0,2,"Braga",7,"Rua Nova Santa Cruz",7,28,21,460,115,345
2,11,2019,18,0,2,"Braga",8,"Rua Costa Gomes",17,40,23,98,42,56
2,11,2019,19,0,2,"Braga",1,"Avenida da Liberdade",14,22,8,48,30,18
2,11,2019,19,0,2,"Braga",2,"Avenida Central",6,16,10,806,302,504
2,11,2019,19,0,2,"Braga",3,"Rua de Caires",23,35,12,55,36,19
2,11,2019,19,0,2,"Braga",4,"N14 Bosch",26,45,19,131,75,56
2,11,2019,19,0,2,"Braga",5,"Avenida João Paulo II",7,40,33,49,8,41
2,11,2019,19,0,2,"Braga",6,"Avenida Padre Júlio Fragata",21,60,39,60,21,39
2,11,2019,19,0,2,"Braga",7,"Rua Nova Santa Cruz",17,28,11,189,115,74
2,11,2019,19,0,2,"Braga",8,"Rua Costa Gomes",17,40,23,98,42,56
2,11,2019,20,0,2,"Braga",1,"Avenida da Liberdade",22,22,0,30,30,0
2,11,2019,20,0,2,"Braga",2,"Avenida Central",7,17,10,691,284,407
2,11,2019,20,0,2,"Braga",3,"Rua de Caires",26,34,8,49,37,12
2,11,2019,20,0,2,"Braga",4,"N14 Bosch",46,46,0,74,74,0
2,11,2019,20,0,2,"Braga",5,"Avenida João Paulo II",40,40,0,8,8,0
2,11,2019,20,0,2,"Braga",6,"Avenida Padre Júlio Fragata",60,60,0,21,21,0
2,11,2019,20,0,2,"Braga",7,"Rua Nova Santa Cruz",19,29,10,169,111,58
2,11,2019,20,0,2,"Braga",8,"Rua Costa Gomes",21,40,19,80,42,38
2,11,2019,21,0,2,"Braga",1,"Avenida da Liberdade",22,22,0,30,30,0
2,11,2019,21,0,2,"Braga",2,"Avenida Central",18,18,0,268,268,0
2,11,2019,21,0,2,"Braga",3,"Rua de Caires",35,35,0,36,36,0
2,11,2019,21,0,2,"Braga",4,"N14 Bosch",46,46,0,74,74,0
2,11,2019,21,0,2,"Braga",5,"Avenida João Paulo II",40,40,0,8,8,0
2,11,2019,21,0,2,"Braga",6,"Avenida Padre Júlio Fragata",61,61,0,20,20,0
2,11,2019,21,0,2,"Braga",7,"Rua Nova Santa Cruz",29,29,0,111,111,0
2,11,2019,21,0,2,"Braga",8,"Rua Costa Gomes",39,39,0,43,43,0
2,11,2019,22,0,2,"Braga",1,"Avenida da Liberdade",22,22,0,30,30,0
2,11,2019,22,0,2,"Braga",2,"Avenida Central",18,18,0,268,268,0
2,11,2019,22,0,2,"Braga",3,"Rua de Caires",35,35,0,36,36,0
2,11,2019,22,0,2,"Braga",4,"N14 Bosch",46,46,0,74,74,0
2,11,2019,22,0,2,"Braga",5,"Avenida João Paulo II",40,40,0,8,8,0
2,11,2019,22,0,2,"Braga",6,"Avenida Padre Júlio Fragata",61,61,0,20,20,0
2,11,2019,22,0,2,"Braga",7,"Rua Nova Santa Cruz",29,29,0,111,111,0
2,11,2019,22,0,2,"Braga",8,"Rua Costa Gomes",39,39,0,43,43,0
2,11,2019,23,0,2,"Braga",1,"Avenida da Liberdade",22,22,0,30,30,0
2,11,2019,23,0,2,"Braga",2,"Avenida Central",12,18,6,403,268,135
2,11,2019,23,0,2,"Braga",3,"Rua de Caires",35,35,0,36,36,0
2,11,2019,23,0,2,"Braga",4,"N14 Bosch",46,46,0,74,74,0
2,11,2019,23,0,2,"Braga",5,"Avenida João Paulo II",40,40,0,8,8,0
2,11,2019,23,0,2,"Braga",6,"Avenida Padre Júlio Fragata",61,61,0,20,20,0
2,11,2019,23,0,2,"Braga",7,"Rua Nova Santa Cruz",29,29,0,111,111,0
2,11,2019,23,0,2,"Braga",8,"Rua Costa Gomes",39,39,0,43,43,0
2,12,2019,0,0,3,"Braga",1,"Avenida da Liberdade",22,22,0,30,30,0
2,12,2019,0,0,3,"Braga",2,"Avenida Central",18,18,0,268,268,0
2,12,2019,0,0,3,"Braga",3,"Rua de Caires",35,35,0,36,36,0
2,12,2019,0,0,3,"Braga",4,"N14 Bosch",46,46,0,74,74,0
2,12,2019,0,0,3,"Braga",5,"Avenida João Paulo II",40,40,0,8,8,0
2,12,2019,0,0,3,"Braga",6,"Avenida Padre Júlio Fragata",61,61,0,20,20,0
2,12,2019,0,0,3,"Braga",7,"Rua Nova Santa Cruz",29,29,0,111,111,0
2,12,2019,0,0,3,"Braga",8,"Rua Costa Gomes",39,39,0,43,43,0
2,12,2019,1,0,3,"Braga",1,"Avenida da Liberdade",22,22,0,30,30,0
2,12,2019,1,0,3,"Braga",2,"Avenida Central",18,18,0,268,268,0
2,12,2019,1,0,3,"Braga",3,"Rua de Caires",35,35,0,36,36,0
2,12,2019,1,0,3,"Braga",4,"N14 Bosch",46,46,0,74,74,0
2,12,2019,1,0,3,"Braga",5,"Avenida João Paulo II",40,40,0,8,8,0
2,12,2019,1,0,3,"Braga",6,"Avenida Padre Júlio Fragata",61,61,0,20,20,0
2,12,2019,1,0,3,"Braga",7,"Rua Nova Santa Cruz",29,29,0,111,111,0
2,12,2019,1,0,3,"Braga",8,"Rua Costa Gomes",40,40,0,42,42,0
2,12,2019,2,0,3,"Braga",1,"Avenida da Liberdade",22,22,0,30,30,0
2,12,2019,2,0,3,"Braga",2,"Avenida Central",18,18,0,268,268,0
2,12,2019,2,0,3,"Braga",3,"Rua de Caires",35,35,0,36,36,0
2,12,2019,2,0,3,"Braga",4,"N14 Bosch",46,46,0,74,74,0
2,12,2019,2,0,3,"Braga",5,"Avenida João Paulo II",40,40,0,8,8,0
2,12,2019,2,0,3,"Braga",6,"Avenida Padre Júlio Fragata",61,61,0,20,20,0
2,12,2019,2,0,3,"Braga",7,"Rua Nova Santa Cruz",29,29,0,111,111,0
2,12,2019,2,0,3,"Braga",8,"Rua Costa Gomes",40,40,0,42,42,0
2,12,2019,3,0,3,"Braga",1,"Avenida da Liberdade",22,22,0,30,30,0
2,12,2019,3,0,3,"Braga",2,"Avenida Central",18,18,0,268,268,0
2,12,2019,3,0,3,"Braga",3,"Rua de Caires",35,35,0,36,36,0
2,12,2019,3,0,3,"Braga",4,"N14 Bosch",46,46,0,74,74,0
2,12,2019,3,0,3,"Braga",5,"Avenida João Paulo II",40,40,0,8,8,0
2,12,2019,3,0,3,"Braga",6,"Avenida Padre Júlio Fragata",61,61,0,20,20,0
2,12,2019,3,0,3,"Braga",7,"Rua Nova Santa Cruz",29,29,0,111,111,0
2,12,2019,3,0,3,"Braga",8,"Rua Costa Gomes",40,40,0,42,42,0
2,12,2019,4,0,3,"Braga",1,"Avenida da Liberdade",22,22,0,30,30,0
2,12,2019,4,0,3,"Braga",2,"Avenida Central",18,18,0,268,268,0
2,12,2019,4,0,3,"Braga",3,"Rua de Caires",35,35,0,36,36,0
2,12,2019,4,0,3,"Braga",4,"N14 Bosch",46,46,0,74,74,0
2,12,2019,4,0,3,"Braga",5,"Avenida João Paulo II",40,40,0,8,8,0
2,12,2019,4,0,3,"Braga",6,"Avenida Padre Júlio Fragata",61,61,0,20,20,0
2,12,2019,4,0,3,"Braga",7,"Rua Nova Santa Cruz",29,29,0,111,111,0
2,12,2019,4,0,3,"Braga",8,"Rua Costa Gomes",40,40,0,42,42,0
2,12,2019,5,0,3,"Braga",1,"Avenida da Liberdade",22,22,0,30,30,0
2,12,2019,5,0,3,"Braga",2,"Avenida Central",18,18,0,268,268,0
2,12,2019,5,0,3,"Braga",3,"Rua de Caires",35,35,0,36,36,0
2,12,2019,5,0,3,"Braga",4,"N14 Bosch",46,46,0,74,74,0
2,12,2019,5,0,3,"Braga",5,"Avenida João Paulo II",40,40,0,8,8,0
2,12,2019,5,0,3,"Braga",6,"Avenida Padre Júlio Fragata",61,61,0,20,20,0
2,12,2019,5,0,3,"Braga",7,"Rua Nova Santa Cruz",29,29,0,111,111,0
2,12,2019,5,0,3,"Braga",8,"Rua Costa Gomes",40,40,0,42,42,0
2,12,2019,6,0,3,"Braga",1,"Avenida da Liberdade",22,22,0,30,30,0
2,12,2019,6,0,3,"Braga",2,"Avenida Central",18,18,0,268,268,0
2,12,2019,6,0,3,"Braga",3,"Rua de Caires",35,35,0,36,36,0
2,12,2019,6,0,3,"Braga",4,"N14 Bosch",46,46,0,74,74,0
2,12,2019,6,0,3,"Braga",5,"Avenida João Paulo II",40,40,0,8,8,0
2,12,2019,6,0,3,"Braga",6,"Avenida Padre Júlio Fragata",61,61,0,20,20,0
2,12,2019,6,0,3,"Braga",7,"Rua Nova Santa Cruz",29,29,0,111,111,0
2,12,2019,6,0,3,"Braga",8,"Rua Costa Gomes",40,40,0,42,42,0
2,12,2019,7,0,3,"Braga",1,"Avenida da Liberdade",22,22,0,30,30,0
2,12,2019,7,0,3,"Braga",2,"Avenida Central",18,18,0,268,268,0
2,12,2019,7,0,3,"Braga",3,"Rua de Caires",35,35,0,36,36,0
2,12,2019,7,0,3,"Braga",4,"N14 Bosch",46,46,0,74,74,0
2,12,2019,7,0,3,"Braga",5,"Avenida João Paulo II",40,40,0,8,8,0
2,12,2019,7,0,3,"Braga",6,"Avenida Padre Júlio Fragata",61,61,0,20,20,0
2,12,2019,7,0,3,"Braga",7,"Rua Nova Santa Cruz",29,29,0,111,111,0
2,12,2019,7,0,3,"Braga",8,"Rua Costa Gomes",40,40,0,42,42,0
2,12,2019,8,0,3,"Braga",1,"Avenida da Liberdade",22,22,0,30,30,0
2,12,2019,8,0,3,"Braga",2,"Avenida Central",18,18,0,268,268,0
2,12,2019,8,0,3,"Braga",3,"Rua de Caires",25,35,10,51,36,15
2,12,2019,8,0,3,"Braga",4,"N14 Bosch",36,45,9,94,75,19
2,12,2019,8,0,3,"Braga",5,"Avenida João Paulo II",40,40,0,8,8,0
2,12,2019,8,0,3,"Braga",6,"Avenida Padre Júlio Fragata",61,61,0,20,20,0
2,12,2019,8,0,3,"Braga",7,"Rua Nova Santa Cruz",29,29,0,111,111,0
2,12,2019,8,0,3,"Braga",8,"Rua Costa Gomes",30,40,10,56,42,14
2,12,2019,9,0,3,"Braga",1,"Avenida da Liberdade",16,22,6,42,30,12
2,12,2019,9,0,3,"Braga",2,"Avenida Central",12,17,5,403,284,119
2,12,2019,9,0,3,"Braga",3,"Rua de Caires",24,35,11,53,36,17
2,12,2019,9,0,3,"Braga",4,"N14 Bosch",24,46,22,142,74,68
2,12,2019,9,0,3,"Braga",5,"Avenida João Paulo II",9,38,29,38,9,29
2,12,2019,9,0,3,"Braga",6,"Avenida Padre Júlio Fragata",39,60,21,32,21,11
2,12,2019,9,0,3,"Braga",7,"Rua Nova Santa Cruz",29,29,0,111,111,0
2,12,2019,9,0,3,"Braga",8,"Rua Costa Gomes",30,39,9,56,43,13
2,12,2019,10,0,3,"Braga",1,"Avenida da Liberdade",21,21,0,32,32,0
2,12,2019,10,0,3,"Braga",2,"Avenida Central",8,17,9,604,284,320
2,12,2019,10,0,3,"Braga",3,"Rua de Caires",22,35,13,58,36,22
2,12,2019,10,0,3,"Braga",4,"N14 Bosch",13,44,31,262,77,185
2,12,2019,10,0,3,"Braga",5,"Avenida João Paulo II",40,40,0,8,8,0
2,12,2019,10,0,3,"Braga",6,"Avenida Padre Júlio Fragata",61,61,0,20,20,0
2,12,2019,10,0,3,"Braga",7,"Rua Nova Santa Cruz",29,29,0,111,111,0
2,12,2019,10,0,3,"Braga",8,"Rua Costa Gomes",39,39,0,43,43,0
2,12,2019,11,0,3,"Braga",1,"Avenida da Liberdade",17,21,4,39,32,7
2,12,2019,11,0,3,"Braga",2,"Avenida Central",12,18,6,403,268,135
2,12,2019,11,0,3,"Braga",3,"Rua de Caires",25,34,9,51,37,14
2,12,2019,11,0,3,"Braga",4,"N14 Bosch",32,46,14,106,74,32
2,12,2019,11,0,3,"Braga",5,"Avenida João Paulo II",40,40,0,8,8,0
2,12,2019,11,0,3,"Braga",6,"Avenida Padre Júlio Fragata",61,61,0,20,20,0
2,12,2019,11,0,3,"Braga",7,"Rua Nova Santa Cruz",23,29,6,140,111,29
2,12,2019,11,0,3,"Braga",8,"Rua Costa Gomes",31,40,9,54,42,12
2,12,2019,12,0,3,"Braga",1,"Avenida da Liberdade",22,22,0,30,30,0
2,12,2019,12,0,3,"Braga",2,"Avenida Central",12,18,6,403,268,135
2,12,2019,12,0,3,"Braga",3,"Rua de Caires",23,35,12,55,36,19
2,12,2019,12,0,3,"Braga",4,"N14 Bosch",29,46,17,117,74,43
2,12,2019,12,0,3,"Braga",5,"Avenida João Paulo II",39,39,0,8,8,0
2,12,2019,12,0,3,"Braga",6,"Avenida Padre Júlio Fragata",60,60,0,21,21,0
2,12,2019,12,0,3,"Braga",7,"Rua Nova Santa Cruz",22,28,6,146,115,31
2,12,2019,12,0,3,"Braga",8,"Rua Costa Gomes",23,39,16,73,43,30
2,12,2019,13,0,3,"Braga",1,"Avenida da Liberdade",22,22,0,30,30,0
2,12,2019,13,0,3,"Braga",2,"Avenida Central",11,18,7,439,268,171
2,12,2019,13,0,3,"Braga",3,"Rua de Caires",27,34,7,47,37,10
2,12,2019,13,0,3,"Braga",4,"N14 Bosch",26,46,20,131,74,57
2,12,2019,13,0,3,"Braga",5,"Avenida João Paulo II",40,40,0,8,8,0
2,12,2019,13,0,3,"Braga",6,"Avenida Padre Júlio Fragata",47,60,13,27,21,6
2,12,2019,13,0,3,"Braga",7,"Rua Nova Santa Cruz",20,29,9,161,111,50
2,12,2019,13,0,3,"Braga",8,"Rua Costa Gomes",28,39,11,60,43,17
2,12,2019,14,0,3,"Braga",1,"Avenida da Liberdade",22,22,0,30,30,0
2,12,2019,14,0,3,"Braga",2,"Avenida Central",14,18,4,345,268,77
2,12,2019,14,0,3,"Braga",3,"Rua de Caires",27,35,8,47,36,11
2,12,2019,14,0,3,"Braga",4,"N14 Bosch",26,46,20,131,74,57
2,12,2019,14,0,3,"Braga",5,"Avenida João Paulo II",31,40,9,11,8,3
2,12,2019,14,0,3,"Braga",6,"Avenida Padre Júlio Fragata",61,61,0,20,20,0
2,12,2019,14,0,3,"Braga",7,"Rua Nova Santa Cruz",29,29,0,111,111,0
2,12,2019,14,0,3,"Braga",8,"Rua Costa Gomes",31,39,8,54,43,11
2,12,2019,15,0,3,"Braga",1,"Avenida da Liberdade",22,22,0,30,30,0
2,12,2019,15,0,3,"Braga",2,"Avenida Central",14,18,4,345,268,77
2,12,2019,15,0,3,"Braga",3,"Rua de Caires",25,34,9,51,37,14
2,12,2019,15,0,3,"Braga",4,"N14 Bosch",30,46,16,113,74,39
2,12,2019,15,0,3,"Braga",5,"Avenida João Paulo II",31,40,9,11,8,3
2,12,2019,15,0,3,"Braga",6,"Avenida Padre Júlio Fragata",61,61,0,20,20,0
2,12,2019,15,0,3,"Braga",7,"Rua Nova Santa Cruz",18,28,10,179,115,64
2,12,2019,15,0,3,"Braga",8,"Rua Costa Gomes",27,40,13,62,42,20
2,12,2019,16,0,3,"Braga",1,"Avenida da Liberdade",17,21,4,39,32,7
2,12,2019,16,0,3,"Braga",2,"Avenida Central",11,17,6,439,284,155
2,12,2019,16,0,3,"Braga",3,"Rua de Caires",24,34,10,53,37,16
2,12,2019,16,0,3,"Braga",4,"N14 Bosch",24,45,21,142,75,67
2,12,2019,16,0,3,"Braga",5,"Avenida João Paulo II",25,39,14,13,8,5
2,12,2019,16,0,3,"Braga",6,"Avenida Padre Júlio Fragata",47,61,14,27,20,7
2,12,2019,16,0,3,"Braga",7,"Rua Nova Santa Cruz",16,28,12,201,115,86
2,12,2019,16,0,3,"Braga",8,"Rua Costa Gomes",25,40,15,67,42,25
2,12,2019,17,0,3,"Braga",1,"Avenida da Liberdade",17,21,4,39,32,7
2,12,2019,17,0,3,"Braga",2,"Avenida Central",10,17,7,483,284,199
2,12,2019,17,0,3,"Braga",3,"Rua de Caires",24,35,11,53,36,17
2,12,2019,17,0,3,"Braga",4,"N14 Bosch",23,46,23,148,74,74
2,12,2019,17,0,3,"Braga",5,"Avenida João Paulo II",23,39,16,14,8,6
2,12,2019,17,0,3,"Braga",6,"Avenida Padre Júlio Fragata",39,61,22,32,20,12
2,12,2019,17,0,3,"Braga",7,"Rua Nova Santa Cruz",20,29,9,161,111,50
2,12,2019,17,0,3,"Braga",8,"Rua Costa Gomes",22,39,17,76,43,33
2,12,2019,18,0,3,"Braga",1,"Avenida da Liberdade",15,22,7,44,30,14
2,12,2019,18,0,3,"Braga",2,"Avenida Central",10,18,8,483,268,215
2,12,2019,18,0,3,"Braga",3,"Rua de Caires",18,35,17,71,36,35
2,12,2019,18,0,3,"Braga",4,"N14 Bosch",16,45,29,213,75,138
2,12,2019,18,0,3,"Braga",5,"Avenida João Paulo II",22,40,18,15,8,7
2,12,2019,18,0,3,"Braga",6,"Avenida Padre Júlio Fragata",40,60,20,31,21,10
2,12,2019,18,0,3,"Braga",7,"Rua Nova Santa Cruz",6,28,22,537,115,422
2,12,2019,18,0,3,"Braga",8,"Rua Costa Gomes",18,41,23,93,40,53
2,12,2019,19,0,3,"Braga",1,"Avenida da Liberdade",14,22,8,48,30,18
2,12,2019,19,0,3,"Braga",2,"Avenida Central",6,17,11,806,284,522
2,12,2019,19,0,3,"Braga",3,"Rua de Caires",23,34,11,55,37,18
2,12,2019,19,0,3,"Braga",4,"N14 Bosch",28,46,18,121,74,47
2,12,2019,19,0,3,"Braga",5,"Avenida João Paulo II",26,40,14,13,8,5
2,12,2019,19,0,3,"Braga",6,"Avenida Padre Júlio Fragata",37,61,24,34,20,14
2,12,2019,19,0,3,"Braga",7,"Rua Nova Santa Cruz",14,29,15,230,111,119
2,12,2019,19,0,3,"Braga",8,"Rua Costa Gomes",7,40,33,240,42,198
2,12,2019,20,0,3,"Braga",1,"Avenida da Liberdade",21,21,0,32,32,0
2,12,2019,20,0,3,"Braga",2,"Avenida Central",14,18,4,345,268,77
2,12,2019,20,0,3,"Braga",3,"Rua de Caires",35,35,0,36,36,0
2,12,2019,20,0,3,"Braga",4,"N14 Bosch",32,45,13,106,75,31
2,12,2019,20,0,3,"Braga",5,"Avenida João Paulo II",29,40,11,11,8,3
2,12,2019,20,0,3,"Braga",6,"Avenida Padre Júlio Fragata",60,60,0,21,21,0
2,12,2019,20,0,3,"Braga",7,"Rua Nova Santa Cruz",22,29,7,146,111,35
2,12,2019,20,0,3,"Braga",8,"Rua Costa Gomes",17,39,22,98,43,55
2,12,2019,21,0,3,"Braga",1,"Avenida da Liberdade",21,21,0,32,32,0
2,12,2019,21,0,3,"Braga",2,"Avenida Central",17,17,0,284,284,0
2,12,2019,21,0,3,"Braga",3,"Rua de Caires",35,35,0,36,36,0
2,12,2019,21,0,3,"Braga",4,"N14 Bosch",46,46,0,74,74,0
2,12,2019,21,0,3,"Braga",5,"Avenida João Paulo II",39,39,0,8,8,0
2,12,2019,21,0,3,"Braga",6,"Avenida Padre Júlio Fragata",60,60,0,21,21,0
2,12,2019,21,0,3,"Braga",7,"Rua Nova Santa Cruz",29,29,0,111,111,0
2,12,2019,21,0,3,"Braga",8,"Rua Costa Gomes",23,40,17,73,42,31
2,12,2019,22,0,3,"Braga",1,"Avenida da Liberdade",21,21,0,32,32,0
2,12,2019,22,0,3,"Braga",2,"Avenida Central",17,17,0,284,284,0
2,12,2019,22,0,3,"Braga",3,"Rua de Caires",35,35,0,36,36,0
2,12,2019,22,0,3,"Braga",4,"N14 Bosch",46,46,0,74,74,0
2,12,2019,22,0,3,"Braga",5,"Avenida João Paulo II",39,39,0,8,8,0
2,12,2019,22,0,3,"Braga",6,"Avenida Padre Júlio Fragata",60,60,0,21,21,0
2,12,2019,22,0,3,"Braga",7,"Rua Nova Santa Cruz",29,29,0,111,111,0
2,12,2019,22,0,3,"Braga",8,"Rua Costa Gomes",40,40,0,42,42,0
2,12,2019,23,0,3,"Braga",1,"Avenida da Liberdade",21,21,0,32,32,0
2,12,2019,23,0,3,"Braga",2,"Avenida Central",17,17,0,284,284,0
2,12,2019,23,0,3,"Braga",3,"Rua de Caires",35,35,0,36,36,0
2,12,2019,23,0,3,"Braga",4,"N14 Bosch",47,47,0,72,72,0
2,12,2019,23,0,3,"Braga",5,"Avenida João Paulo II",39,39,0,8,8,0
2,12,2019,23,0,3,"Braga",6,"Avenida Padre Júlio Fragata",60,60,0,21,21,0
2,12,2019,23,0,3,"Braga",7,"Rua Nova Santa Cruz",29,29,0,111,111,0
2,12,2019,23,0,3,"Braga",8,"Rua Costa Gomes",40,40,0,42,42,0
2,13,2019,0,0,4,"Braga",1,"Avenida da Liberdade",21,21,0,32,32,0
2,13,2019,0,0,4,"Braga",2,"Avenida Central",17,17,0,284,284,0
2,13,2019,0,0,4,"Braga",3,"Rua de Caires",35,35,0,36,36,0
2,13,2019,0,0,4,"Braga",4,"N14 Bosch",47,47,0,72,72,0
2,13,2019,0,0,4,"Braga",5,"Avenida João Paulo II",39,39,0,8,8,0
2,13,2019,0,0,4,"Braga",6,"Avenida Padre Júlio Fragata",60,60,0,21,21,0
2,13,2019,0,0,4,"Braga",7,"Rua Nova Santa Cruz",29,29,0,111,111,0
2,13,2019,0,0,4,"Braga",8,"Rua Costa Gomes",40,40,0,42,42,0
2,13,2019,1,0,4,"Braga",1,"Avenida da Liberdade",21,21,0,32,32,0
2,13,2019,1,0,4,"Braga",2,"Avenida Central",17,17,0,284,284,0
2,13,2019,1,0,4,"Braga",3,"Rua de Caires",35,35,0,36,36,0
2,13,2019,1,0,4,"Braga",4,"N14 Bosch",47,47,0,72,72,0
2,13,2019,1,0,4,"Braga",5,"Avenida João Paulo II",39,39,0,8,8,0
2,13,2019,1,0,4,"Braga",6,"Avenida Padre Júlio Fragata",60,60,0,21,21,0
2,13,2019,1,0,4,"Braga",7,"Rua Nova Santa Cruz",29,29,0,111,111,0
2,13,2019,1,0,4,"Braga",8,"Rua Costa Gomes",40,40,0,42,42,0
2,13,2019,2,0,4,"Braga",1,"Avenida da Liberdade",21,21,0,32,32,0
2,13,2019,2,0,4,"Braga",2,"Avenida Central",17,17,0,284,284,0
2,13,2019,2,0,4,"Braga",3,"Rua de Caires",35,35,0,36,36,0
2,13,2019,2,0,4,"Braga",4,"N14 Bosch",47,47,0,72,72,0
2,13,2019,2,0,4,"Braga",5,"Avenida João Paulo II",39,39,0,8,8,0
2,13,2019,2,0,4,"Braga",6,"Avenida Padre Júlio Fragata",60,60,0,21,21,0
2,13,2019,2,0,4,"Braga",7,"Rua Nova Santa Cruz",29,29,0,111,111,0
2,13,2019,2,0,4,"Braga",8,"Rua Costa Gomes",40,40,0,42,42,0
2,13,2019,3,0,4,"Braga",1,"Avenida da Liberdade",21,21,0,32,32,0
2,13,2019,3,0,4,"Braga",2,"Avenida Central",17,17,0,284,284,0
2,13,2019,3,0,4,"Braga",3,"Rua de Caires",35,35,0,36,36,0
2,13,2019,3,0,4,"Braga",4,"N14 Bosch",47,47,0,72,72,0
2,13,2019,3,0,4,"Braga",5,"Avenida João Paulo II",39,39,0,8,8,0
2,13,2019,3,0,4,"Braga",6,"Avenida Padre Júlio Fragata",60,60,0,21,21,0
2,13,2019,3,0,4,"Braga",7,"Rua Nova Santa Cruz",29,29,0,111,111,0
2,13,2019,3,0,4,"Braga",8,"Rua Costa Gomes",40,40,0,42,42,0
2,13,2019,4,0,4,"Braga",1,"Avenida da Liberdade",21,21,0,32,32,0
2,13,2019,4,0,4,"Braga",2,"Avenida Central",17,17,0,284,284,0
2,13,2019,4,0,4,"Braga",3,"Rua de Caires",35,35,0,36,36,0
2,13,2019,4,0,4,"Braga",4,"N14 Bosch",47,47,0,72,72,0
2,13,2019,4,0,4,"Braga",5,"Avenida João Paulo II",39,39,0,8,8,0
2,13,2019,4,0,4,"Braga",6,"Avenida Padre Júlio Fragata",60,60,0,21,21,0
2,13,2019,4,0,4,"Braga",7,"Rua Nova Santa Cruz",29,29,0,111,111,0
2,13,2019,4,0,4,"Braga",8,"Rua Costa Gomes",40,40,0,42,42,0
2,13,2019,5,0,4,"Braga",1,"Avenida da Liberdade",21,21,0,32,32,0
2,13,2019,5,0,4,"Braga",2,"Avenida Central",17,17,0,284,284,0
2,13,2019,5,0,4,"Braga",3,"Rua de Caires",35,35,0,36,36,0
2,13,2019,5,0,4,"Braga",4,"N14 Bosch",47,47,0,72,72,0
2,13,2019,5,0,4,"Braga",5,"Avenida João Paulo II",39,39,0,8,8,0
2,13,2019,5,0,4,"Braga",6,"Avenida Padre Júlio Fragata",60,60,0,21,21,0
2,13,2019,5,0,4,"Braga",7,"Rua Nova Santa Cruz",29,29,0,111,111,0
2,13,2019,5,0,4,"Braga",8,"Rua Costa Gomes",40,40,0,42,42,0
2,13,2019,6,0,4,"Braga",1,"Avenida da Liberdade",21,21,0,32,32,0
2,13,2019,6,0,4,"Braga",2,"Avenida Central",17,17,0,284,284,0
2,13,2019,6,0,4,"Braga",3,"Rua de Caires",35,35,0,36,36,0
2,13,2019,6,0,4,"Braga",4,"N14 Bosch",47,47,0,72,72,0
2,13,2019,6,0,4,"Braga",5,"Avenida João Paulo II",39,39,0,8,8,0
2,13,2019,6,0,4,"Braga",6,"Avenida Padre Júlio Fragata",60,60,0,21,21,0
2,13,2019,6,0,4,"Braga",7,"Rua Nova Santa Cruz",29,29,0,111,111,0
2,13,2019,6,0,4,"Braga",8,"Rua Costa Gomes",40,40,0,42,42,0
2,13,2019,7,0,4,"Braga",1,"Avenida da Liberdade",21,21,0,32,32,0
2,13,2019,7,0,4,"Braga",2,"Avenida Central",17,17,0,284,284,0
2,13,2019,7,0,4,"Braga",3,"Rua de Caires",35,35,0,36,36,0
2,13,2019,7,0,4,"Braga",4,"N14 Bosch",47,47,0,72,72,0
2,13,2019,7,0,4,"Braga",5,"Avenida João Paulo II",39,39,0,8,8,0
2,13,2019,7,0,4,"Braga",6,"Avenida Padre Júlio Fragata",60,60,0,21,21,0
2,13,2019,7,0,4,"Braga",7,"Rua Nova Santa Cruz",29,29,0,111,111,0
2,13,2019,7,0,4,"Braga",8,"Rua Costa Gomes",40,40,0,42,42,0
2,13,2019,9,0,4,"Braga",1,"Avenida da Liberdade",15,21,6,44,32,12
2,13,2019,9,0,4,"Braga",2,"Avenida Central",12,17,5,403,284,119
2,13,2019,9,0,4,"Braga",3,"Rua de Caires",34,34,0,37,37,0
2,13,2019,9,0,4,"Braga",4,"N14 Bosch",22,45,23,155,75,80
2,13,2019,9,0,4,"Braga",5,"Avenida João Paulo II",24,39,15,14,8,6
2,13,2019,9,0,4,"Braga",6,"Avenida Padre Júlio Fragata",33,61,28,38,20,18
2,13,2019,9,0,4,"Braga",7,"Rua Nova Santa Cruz",28,28,0,115,115,0
2,13,2019,9,0,4,"Braga",8,"Rua Costa Gomes",26,39,13,64,43,21
2,13,2019,10,0,4,"Braga",1,"Avenida da Liberdade",22,22,0,30,30,0
2,13,2019,10,0,4,"Braga",2,"Avenida Central",12,17,5,403,284,119
2,13,2019,10,0,4,"Braga",3,"Rua de Caires",27,34,7,47,37,10
2,13,2019,10,0,4,"Braga",4,"N14 Bosch",33,46,13,103,74,29
2,13,2019,10,0,4,"Braga",5,"Avenida João Paulo II",40,40,0,8,8,0
2,13,2019,10,0,4,"Braga",6,"Avenida Padre Júlio Fragata",60,60,0,21,21,0
2,13,2019,10,0,4,"Braga",7,"Rua Nova Santa Cruz",29,29,0,111,111,0
2,13,2019,10,0,4,"Braga",8,"Rua Costa Gomes",28,39,11,60,43,17
2,13,2019,11,0,4,"Braga",1,"Avenida da Liberdade",21,21,0,32,32,0
2,13,2019,11,0,4,"Braga",2,"Avenida Central",14,17,3,345,284,61
2,13,2019,11,0,4,"Braga",3,"Rua de Caires",26,34,8,49,37,12
2,13,2019,11,0,4,"Braga",4,"N14 Bosch",33,45,12,103,75,28
2,13,2019,11,0,4,"Braga",5,"Avenida João Paulo II",23,39,16,14,8,6
2,13,2019,11,0,4,"Braga",6,"Avenida Padre Júlio Fragata",60,60,0,21,21,0
2,13,2019,11,0,4,"Braga",7,"Rua Nova Santa Cruz",29,29,0,111,111,0
2,13,2019,11,0,4,"Braga",8,"Rua Costa Gomes",27,40,13,62,42,20
2,13,2019,12,0,4,"Braga",1,"Avenida da Liberdade",17,22,5,39,30,9
2,13,2019,12,0,4,"Braga",2,"Avenida Central",13,18,5,372,268,104
2,13,2019,12,0,4,"Braga",3,"Rua de Caires",34,34,0,37,37,0
2,13,2019,12,0,4,"Braga",4,"N14 Bosch",33,45,12,103,75,28
2,13,2019,12,0,4,"Braga",5,"Avenida João Paulo II",39,39,0,8,8,0
2,13,2019,12,0,4,"Braga",6,"Avenida Padre Júlio Fragata",60,60,0,21,21,0
2,13,2019,12,0,4,"Braga",7,"Rua Nova Santa Cruz",22,29,7,146,111,35
2,13,2019,12,0,4,"Braga",8,"Rua Costa Gomes",31,39,8,54,43,11
2,13,2019,13,0,4,"Braga",1,"Avenida da Liberdade",22,22,0,30,30,0
2,13,2019,13,0,4,"Braga",2,"Avenida Central",18,18,0,268,268,0
2,13,2019,13,0,4,"Braga",3,"Rua de Caires",26,34,8,49,37,12
2,13,2019,13,0,4,"Braga",4,"N14 Bosch",23,46,23,148,74,74
2,13,2019,13,0,4,"Braga",5,"Avenida João Paulo II",40,40,0,8,8,0
2,13,2019,13,0,4,"Braga",6,"Avenida Padre Júlio Fragata",61,61,0,20,20,0
2,13,2019,13,0,4,"Braga",7,"Rua Nova Santa Cruz",10,29,19,322,111,211
2,13,2019,13,0,4,"Braga",8,"Rua Costa Gomes",26,39,13,64,43,21
2,13,2019,14,0,4,"Braga",1,"Avenida da Liberdade",21,21,0,32,32,0
2,13,2019,14,0,4,"Braga",2,"Avenida Central",18,18,0,268,268,0
2,13,2019,14,0,4,"Braga",3,"Rua de Caires",35,35,0,36,36,0
2,13,2019,14,0,4,"Braga",4,"N14 Bosch",22,45,23,155,75,80
2,13,2019,14,0,4,"Braga",5,"Avenida João Paulo II",40,40,0,8,8,0
2,13,2019,14,0,4,"Braga",6,"Avenida Padre Júlio Fragata",60,60,0,21,21,0
2,13,2019,14,0,4,"Braga",7,"Rua Nova Santa Cruz",28,28,0,115,115,0
2,13,2019,14,0,4,"Braga",8,"Rua Costa Gomes",30,40,10,56,42,14
2,13,2019,15,0,4,"Braga",1,"Avenida da Liberdade",17,21,4,39,32,7
2,13,2019,15,0,4,"Braga",2,"Avenida Central",12,18,6,403,268,135
2,13,2019,15,0,4,"Braga",3,"Rua de Caires",25,34,9,51,37,14
2,13,2019,15,0,4,"Braga",4,"N14 Bosch",26,46,20,131,74,57
2,13,2019,15,0,4,"Braga",5,"Avenida João Paulo II",40,40,0,8,8,0
2,13,2019,15,0,4,"Braga",6,"Avenida Padre Júlio Fragata",60,60,0,21,21,0
2,13,2019,15,0,4,"Braga",7,"Rua Nova Santa Cruz",23,29,6,140,111,29
2,13,2019,15,0,4,"Braga",8,"Rua Costa Gomes",26,40,14,64,42,22
2,13,2019,16,0,4,"Braga",1,"Avenida da Liberdade",17,21,4,39,32,7
2,13,2019,16,0,4,"Braga",2,"Avenida Central",12,18,6,403,268,135
2,13,2019,16,0,4,"Braga",3,"Rua de Caires",26,34,8,49,37,12
2,13,2019,16,0,4,"Braga",4,"N14 Bosch",27,45,18,126,75,51
2,13,2019,16,0,4,"Braga",5,"Avenida João Paulo II",26,39,13,13,8,5
2,13,2019,16,0,4,"Braga",6,"Avenida Padre Júlio Fragata",61,61,0,20,20,0
2,13,2019,16,0,4,"Braga",7,"Rua Nova Santa Cruz",21,29,8,153,111,42
2,13,2019,16,0,4,"Braga",8,"Rua Costa Gomes",24,40,16,70,42,28
2,13,2019,17,0,4,"Braga",1,"Avenida da Liberdade",17,22,5,39,30,9
2,13,2019,17,0,4,"Braga",2,"Avenida Central",9,17,8,537,284,253
2,13,2019,17,0,4,"Braga",3,"Rua de Caires",26,35,9,49,36,13
2,13,2019,17,0,4,"Braga",4,"N14 Bosch",25,46,21,136,74,62
2,13,2019,17,0,4,"Braga",5,"Avenida João Paulo II",32,40,8,10,8,2
2,13,2019,17,0,4,"Braga",6,"Avenida Padre Júlio Fragata",60,60,0,21,21,0
2,13,2019,17,0,4,"Braga",7,"Rua Nova Santa Cruz",18,28,10,179,115,64
2,13,2019,17,0,4,"Braga",8,"Rua Costa Gomes",24,40,16,70,42,28
2,13,2019,18,0,4,"Braga",1,"Avenida da Liberdade",17,21,4,39,32,7
2,13,2019,18,0,4,"Braga",2,"Avenida Central",8,18,10,604,268,336
2,13,2019,18,0,4,"Braga",3,"Rua de Caires",20,35,15,64,36,28
2,13,2019,18,0,4,"Braga",4,"N14 Bosch",19,47,28,179,72,107
2,13,2019,18,0,4,"Braga",5,"Avenida João Paulo II",7,40,33,49,8,41
2,13,2019,18,0,4,"Braga",6,"Avenida Padre Júlio Fragata",18,61,43,70,20,50
2,13,2019,18,0,4,"Braga",7,"Rua Nova Santa Cruz",16,28,12,201,115,86
2,13,2019,18,0,4,"Braga",8,"Rua Costa Gomes",14,41,27,120,40,80
2,13,2019,19,0,4,"Braga",1,"Avenida da Liberdade",21,21,0,32,32,0
2,13,2019,19,0,4,"Braga",2,"Avenida Central",8,18,10,604,268,336
2,13,2019,19,0,4,"Braga",3,"Rua de Caires",24,34,10,53,37,16
2,13,2019,19,0,4,"Braga",4,"N14 Bosch",28,45,17,121,75,46
2,13,2019,19,0,4,"Braga",5,"Avenida João Paulo II",24,39,15,14,8,6
2,13,2019,19,0,4,"Braga",6,"Avenida Padre Júlio Fragata",26,61,35,49,20,29
2,13,2019,19,0,4,"Braga",7,"Rua Nova Santa Cruz",18,29,11,179,111,68
2,13,2019,19,0,4,"Braga",8,"Rua Costa Gomes",6,38,32,280,44,236
2,13,2019,20,0,4,"Braga",1,"Avenida da Liberdade",21,21,0,32,32,0
2,13,2019,20,0,4,"Braga",2,"Avenida Central",17,17,0,284,284,0
2,13,2019,20,0,4,"Braga",3,"Rua de Caires",35,35,0,36,36,0
2,13,2019,20,0,4,"Braga",4,"N14 Bosch",36,46,10,94,74,20
2,13,2019,20,0,4,"Braga",5,"Avenida João Paulo II",30,39,9,11,8,3
2,13,2019,20,0,4,"Braga",6,"Avenida Padre Júlio Fragata",45,60,15,28,21,7
2,13,2019,20,0,4,"Braga",7,"Rua Nova Santa Cruz",18,29,11,179,111,68
2,13,2019,20,0,4,"Braga",8,"Rua Costa Gomes",22,40,18,76,42,34
2,13,2019,21,0,4,"Braga",1,"Avenida da Liberdade",21,21,0,32,32,0
2,13,2019,21,0,4,"Braga",2,"Avenida Central",17,17,0,284,284,0
2,13,2019,21,0,4,"Braga",3,"Rua de Caires",34,34,0,37,37,0
2,13,2019,21,0,4,"Braga",4,"N14 Bosch",46,46,0,74,74,0
2,13,2019,21,0,4,"Braga",5,"Avenida João Paulo II",26,40,14,13,8,5
2,13,2019,21,0,4,"Braga",6,"Avenida Padre Júlio Fragata",61,61,0,20,20,0
2,13,2019,21,0,4,"Braga",7,"Rua Nova Santa Cruz",29,29,0,111,111,0
2,13,2019,21,0,4,"Braga",8,"Rua Costa Gomes",40,40,0,42,42,0
2,13,2019,22,0,4,"Braga",3,"Rua de Caires",34,34,0,37,37,0
2,13,2019,22,0,4,"Braga",4,"N14 Bosch",45,45,0,75,75,0
2,13,2019,22,0,4,"Braga",5,"Avenida João Paulo II",39,39,0,8,8,0
2,13,2019,22,0,4,"Braga",6,"Avenida Padre Júlio Fragata",61,61,0,20,20,0
2,13,2019,22,0,4,"Braga",7,"Rua Nova Santa Cruz",29,29,0,111,111,0
2,13,2019,22,0,4,"Braga",8,"Rua Costa Gomes",40,40,0,42,42,0
2,13,2019,22,0,4,"Braga",1,"Avenida da Liberdade",21,21,0,32,32,0
2,13,2019,22,0,4,"Braga",2,"Avenida Central",17,17,0,284,284,0
2,13,2019,22,0,4,"Braga",3,"Rua de Caires",34,34,0,37,37,0
2,13,2019,23,0,4,"Braga",1,"Avenida da Liberdade",21,21,0,32,32,0
2,13,2019,23,0,4,"Braga",2,"Avenida Central",17,17,0,284,284,0
2,13,2019,23,0,4,"Braga",3,"Rua de Caires",34,34,0,37,37,0
2,13,2019,23,0,4,"Braga",4,"N14 Bosch",45,45,0,75,75,0
2,13,2019,23,0,4,"Braga",5,"Avenida João Paulo II",40,40,0,8,8,0
2,13,2019,23,0,4,"Braga",6,"Avenida Padre Júlio Fragata",60,60,0,21,21,0
2,13,2019,23,0,4,"Braga",7,"Rua Nova Santa Cruz",29,29,0,111,111,0
2,13,2019,23,0,4,"Braga",8,"Rua Costa Gomes",40,40,0,42,42,0
2,14,2019,0,0,5,"Braga",1,"Avenida da Liberdade",21,21,0,32,32,0
2,14,2019,0,0,5,"Braga",2,"Avenida Central",17,17,0,284,284,0
2,14,2019,0,0,5,"Braga",3,"Rua de Caires",35,35,0,36,36,0
2,14,2019,0,0,5,"Braga",4,"N14 Bosch",45,45,0,75,75,0
2,14,2019,0,0,5,"Braga",5,"Avenida João Paulo II",40,40,0,8,8,0
2,14,2019,0,0,5,"Braga",6,"Avenida Padre Júlio Fragata",60,60,0,21,21,0
2,14,2019,0,0,5,"Braga",7,"Rua Nova Santa Cruz",28,28,0,115,115,0
2,14,2019,0,0,5,"Braga",8,"Rua Costa Gomes",40,40,0,42,42,0
2,14,2019,1,0,5,"Braga",1,"Avenida da Liberdade",21,21,0,32,32,0
2,14,2019,1,0,5,"Braga",2,"Avenida Central",17,17,0,284,284,0
2,14,2019,1,0,5,"Braga",3,"Rua de Caires",35,35,0,36,36,0
2,14,2019,1,0,5,"Braga",4,"N14 Bosch",45,45,0,75,75,0
2,14,2019,1,0,5,"Braga",5,"Avenida João Paulo II",40,40,0,8,8,0
2,14,2019,1,0,5,"Braga",6,"Avenida Padre Júlio Fragata",61,61,0,20,20,0
2,14,2019,1,0,5,"Braga",7,"Rua Nova Santa Cruz",29,29,0,111,111,0
2,14,2019,1,0,5,"Braga",8,"Rua Costa Gomes",40,40,0,42,42,0
2,14,2019,2,0,5,"Braga",1,"Avenida da Liberdade",21,21,0,32,32,0
2,14,2019,2,0,5,"Braga",2,"Avenida Central",17,17,0,284,284,0
2,14,2019,2,0,5,"Braga",3,"Rua de Caires",35,35,0,36,36,0
2,14,2019,2,0,5,"Braga",4,"N14 Bosch",45,45,0,75,75,0
2,14,2019,2,0,5,"Braga",5,"Avenida João Paulo II",40,40,0,8,8,0
2,14,2019,2,0,5,"Braga",6,"Avenida Padre Júlio Fragata",61,61,0,20,20,0
2,14,2019,2,0,5,"Braga",7,"Rua Nova Santa Cruz",29,29,0,111,111,0
2,14,2019,2,0,5,"Braga",8,"Rua Costa Gomes",40,40,0,42,42,0
2,14,2019,3,0,5,"Braga",1,"Avenida da Liberdade",21,21,0,32,32,0
2,14,2019,3,0,5,"Braga",2,"Avenida Central",17,17,0,284,284,0
2,14,2019,3,0,5,"Braga",3,"Rua de Caires",35,35,0,36,36,0
2,14,2019,3,0,5,"Braga",4,"N14 Bosch",45,45,0,75,75,0
2,14,2019,3,0,5,"Braga",5,"Avenida João Paulo II",40,40,0,8,8,0
2,14,2019,3,0,5,"Braga",6,"Avenida Padre Júlio Fragata",61,61,0,20,20,0
2,14,2019,3,0,5,"Braga",7,"Rua Nova Santa Cruz",29,29,0,111,111,0
2,14,2019,3,0,5,"Braga",8,"Rua Costa Gomes",40,40,0,42,42,0
2,14,2019,4,0,5,"Braga",1,"Avenida da Liberdade",21,21,0,32,32,0
2,14,2019,4,0,5,"Braga",2,"Avenida Central",17,17,0,284,284,0
2,14,2019,4,0,5,"Braga",3,"Rua de Caires",35,35,0,36,36,0
2,14,2019,4,0,5,"Braga",4,"N14 Bosch",45,45,0,75,75,0
2,14,2019,4,0,5,"Braga",5,"Avenida João Paulo II",40,40,0,8,8,0
2,14,2019,4,0,5,"Braga",6,"Avenida Padre Júlio Fragata",61,61,0,20,20,0
2,14,2019,4,0,5,"Braga",7,"Rua Nova Santa Cruz",29,29,0,111,111,0
2,14,2019,4,0,5,"Braga",8,"Rua Costa Gomes",40,40,0,42,42,0
2,14,2019,5,0,5,"Braga",1,"Avenida da Liberdade",21,21,0,32,32,0
2,14,2019,5,0,5,"Braga",2,"Avenida Central",17,17,0,284,284,0
2,14,2019,5,0,5,"Braga",3,"Rua de Caires",35,35,0,36,36,0
2,14,2019,5,0,5,"Braga",4,"N14 Bosch",45,45,0,75,75,0
2,14,2019,5,0,5,"Braga",5,"Avenida João Paulo II",40,40,0,8,8,0
2,14,2019,5,0,5,"Braga",6,"Avenida Padre Júlio Fragata",61,61,0,20,20,0
2,14,2019,5,0,5,"Braga",7,"Rua Nova Santa Cruz",29,29,0,111,111,0
2,14,2019,5,0,5,"Braga",8,"Rua Costa Gomes",40,40,0,42,42,0
2,14,2019,6,0,5,"Braga",1,"Avenida da Liberdade",21,21,0,32,32,0
2,14,2019,6,0,5,"Braga",2,"Avenida Central",17,17,0,284,284,0
2,14,2019,6,0,5,"Braga",3,"Rua de Caires",35,35,0,36,36,0
2,14,2019,6,0,5,"Braga",4,"N14 Bosch",45,45,0,75,75,0
2,14,2019,6,0,5,"Braga",5,"Avenida João Paulo II",40,40,0,8,8,0
2,14,2019,6,0,5,"Braga",6,"Avenida Padre Júlio Fragata",61,61,0,20,20,0
2,14,2019,6,0,5,"Braga",7,"Rua Nova Santa Cruz",29,29,0,111,111,0
2,14,2019,6,0,5,"Braga",8,"Rua Costa Gomes",40,40,0,42,42,0
2,14,2019,7,0,5,"Braga",1,"Avenida da Liberdade",21,21,0,32,32,0
2,14,2019,7,0,5,"Braga",2,"Avenida Central",17,17,0,284,284,0
2,14,2019,7,0,5,"Braga",3,"Rua de Caires",35,35,0,36,36,0
2,14,2019,7,0,5,"Braga",4,"N14 Bosch",45,45,0,75,75,0
2,14,2019,7,0,5,"Braga",5,"Avenida João Paulo II",40,40,0,8,8,0
2,14,2019,7,0,5,"Braga",6,"Avenida Padre Júlio Fragata",61,61,0,20,20,0
2,14,2019,7,0,5,"Braga",7,"Rua Nova Santa Cruz",29,29,0,111,111,0
2,14,2019,7,0,5,"Braga",8,"Rua Costa Gomes",40,40,0,42,42,0
2,14,2019,8,0,5,"Braga",1,"Avenida da Liberdade",21,21,0,32,32,0
2,14,2019,8,0,5,"Braga",2,"Avenida Central",17,17,0,284,284,0
2,14,2019,8,0,5,"Braga",3,"Rua de Caires",25,34,9,51,37,14
2,14,2019,8,0,5,"Braga",4,"N14 Bosch",45,45,0,75,75,0
2,14,2019,8,0,5,"Braga",5,"Avenida João Paulo II",40,40,0,8,8,0
2,14,2019,8,0,5,"Braga",6,"Avenida Padre Júlio Fragata",61,61,0,20,20,0
2,14,2019,8,0,5,"Braga",7,"Rua Nova Santa Cruz",29,29,0,111,111,0
2,14,2019,8,0,5,"Braga",8,"Rua Costa Gomes",29,39,10,57,43,14
2,14,2019,9,0,5,"Braga",1,"Avenida da Liberdade",21,21,0,32,32,0
2,14,2019,9,0,5,"Braga",2,"Avenida Central",12,18,6,403,268,135
2,14,2019,9,0,5,"Braga",3,"Rua de Caires",21,34,13,61,37,24
2,14,2019,9,0,5,"Braga",4,"N14 Bosch",21,46,25,162,74,88
2,14,2019,9,0,5,"Braga",5,"Avenida João Paulo II",4,40,36,85,8,77
2,14,2019,9,0,5,"Braga",6,"Avenida Padre Júlio Fragata",16,60,44,79,21,58
2,14,2019,9,0,5,"Braga",7,"Rua Nova Santa Cruz",19,29,10,169,111,58
2,14,2019,9,0,5,"Braga",8,"Rua Costa Gomes",18,40,22,93,42,51
2,14,2019,10,0,5,"Braga",4,"N14 Bosch",35,45,10,97,75,22
2,14,2019,10,0,5,"Braga",5,"Avenida João Paulo II",40,40,0,8,8,0
2,14,2019,10,0,5,"Braga",6,"Avenida Padre Júlio Fragata",46,61,15,27,20,7
2,14,2019,10,0,5,"Braga",7,"Rua Nova Santa Cruz",28,28,0,115,115,0
2,14,2019,10,0,5,"Braga",8,"Rua Costa Gomes",39,39,0,43,43,0
2,14,2019,10,0,5,"Braga",1,"Avenida da Liberdade",16,21,5,42,32,10
2,14,2019,10,0,5,"Braga",2,"Avenida Central",8,17,9,604,284,320
2,14,2019,10,0,5,"Braga",3,"Rua de Caires",27,34,7,47,37,10
2,14,2019,10,0,5,"Braga",4,"N14 Bosch",35,45,10,97,75,22
2,14,2019,11,0,5,"Braga",1,"Avenida da Liberdade",22,22,0,30,30,0
2,14,2019,11,0,5,"Braga",2,"Avenida Central",10,18,8,483,268,215
2,14,2019,11,0,5,"Braga",3,"Rua de Caires",28,35,7,45,36,9
2,14,2019,11,0,5,"Braga",4,"N14 Bosch",33,45,12,103,75,28
2,14,2019,11,0,5,"Braga",5,"Avenida João Paulo II",39,39,0,8,8,0
2,14,2019,11,0,5,"Braga",6,"Avenida Padre Júlio Fragata",61,61,0,20,20,0
2,14,2019,11,0,5,"Braga",7,"Rua Nova Santa Cruz",28,28,0,115,115,0
2,14,2019,11,0,5,"Braga",8,"Rua Costa Gomes",28,39,11,60,43,17
2,14,2019,12,0,5,"Braga",1,"Avenida da Liberdade",22,22,0,30,30,0
2,14,2019,12,0,5,"Braga",2,"Avenida Central",13,18,5,372,268,104
2,14,2019,12,0,5,"Braga",3,"Rua de Caires",23,35,12,55,36,19
2,14,2019,12,0,5,"Braga",4,"N14 Bosch",19,47,28,179,72,107
2,14,2019,12,0,5,"Braga",5,"Avenida João Paulo II",39,39,0,8,8,0
2,14,2019,12,0,5,"Braga",6,"Avenida Padre Júlio Fragata",61,61,0,20,20,0
2,14,2019,12,0,5,"Braga",7,"Rua Nova Santa Cruz",23,28,5,140,115,25
2,14,2019,12,0,5,"Braga",8,"Rua Costa Gomes",39,39,0,43,43,0
2,14,2019,14,0,5,"Braga",1,"Avenida da Liberdade",22,22,0,30,30,0
2,14,2019,14,0,5,"Braga",2,"Avenida Central",17,17,0,284,284,0
2,14,2019,14,0,5,"Braga",3,"Rua de Caires",19,35,16,67,36,31
2,14,2019,14,0,5,"Braga",4,"N14 Bosch",20,47,27,170,72,98
2,14,2019,14,0,5,"Braga",5,"Avenida João Paulo II",28,39,11,12,8,4
2,14,2019,14,0,5,"Braga",6,"Avenida Padre Júlio Fragata",46,60,14,27,21,6
2,14,2019,14,0,5,"Braga",7,"Rua Nova Santa Cruz",28,28,0,115,115,0
2,14,2019,14,0,5,"Braga",8,"Rua Costa Gomes",25,39,14,67,43,24
2,14,2019,15,0,5,"Braga",1,"Avenida da Liberdade",22,22,0,30,30,0
2,14,2019,15,0,5,"Braga",2,"Avenida Central",12,17,5,403,284,119
2,14,2019,15,0,5,"Braga",3,"Rua de Caires",21,34,13,61,37,24
2,14,2019,15,0,5,"Braga",4,"N14 Bosch",27,45,18,126,75,51
2,14,2019,15,0,5,"Braga",5,"Avenida João Paulo II",31,39,8,11,8,3
2,14,2019,15,0,5,"Braga",6,"Avenida Padre Júlio Fragata",61,61,0,20,20,0
2,14,2019,15,0,5,"Braga",7,"Rua Nova Santa Cruz",21,28,7,153,115,38
2,14,2019,15,0,5,"Braga",8,"Rua Costa Gomes",26,40,14,64,42,22
2,14,2019,16,0,5,"Braga",1,"Avenida da Liberdade",22,22,0,30,30,0
2,14,2019,16,0,5,"Braga",2,"Avenida Central",10,17,7,483,284,199
2,14,2019,16,0,5,"Braga",3,"Rua de Caires",34,34,0,37,37,0
2,14,2019,16,0,5,"Braga",4,"N14 Bosch",27,46,19,126,74,52
2,14,2019,16,0,5,"Braga",5,"Avenida João Paulo II",30,40,10,11,8,3
2,14,2019,16,0,5,"Braga",6,"Avenida Padre Júlio Fragata",43,60,17,29,21,8
2,14,2019,16,0,5,"Braga",7,"Rua Nova Santa Cruz",18,29,11,179,111,68
2,14,2019,16,0,5,"Braga",8,"Rua Costa Gomes",26,39,13,64,43,21
2,14,2019,17,0,5,"Braga",1,"Avenida da Liberdade",17,21,4,39,32,7
2,14,2019,17,0,5,"Braga",2,"Avenida Central",10,17,7,483,284,199
2,14,2019,17,0,5,"Braga",3,"Rua de Caires",15,34,19,85,37,48
2,14,2019,17,0,5,"Braga",4,"N14 Bosch",21,46,25,162,74,88
2,14,2019,17,0,5,"Braga",5,"Avenida João Paulo II",26,40,14,13,8,5
2,14,2019,17,0,5,"Braga",6,"Avenida Padre Júlio Fragata",61,61,0,20,20,0
2,14,2019,17,0,5,"Braga",7,"Rua Nova Santa Cruz",17,28,11,189,115,74
2,14,2019,17,0,5,"Braga",8,"Rua Costa Gomes",28,40,12,60,42,18
2,14,2019,18,0,5,"Braga",5,"Avenida João Paulo II",9,42,33,38,8,30
2,14,2019,18,0,5,"Braga",6,"Avenida Padre Júlio Fragata",25,62,37,51,20,31
2,14,2019,18,0,5,"Braga",7,"Rua Nova Santa Cruz",11,27,16,293,119,174
2,14,2019,18,0,5,"Braga",8,"Rua Costa Gomes",18,41,23,93,40,53
2,14,2019,18,0,5,"Braga",1,"Avenida da Liberdade",15,21,6,44,32,12
2,14,2019,18,0,5,"Braga",2,"Avenida Central",7,17,10,691,284,407
2,14,2019,18,0,5,"Braga",3,"Rua de Caires",24,35,11,53,36,17
2,14,2019,18,0,5,"Braga",4,"N14 Bosch",16,46,30,213,74,139
2,14,2019,18,0,5,"Braga",5,"Avenida João Paulo II",9,42,33,38,8,30
2,14,2019,19,0,5,"Braga",1,"Avenida da Liberdade",11,21,10,61,32,29
2,14,2019,19,0,5,"Braga",2,"Avenida Central",6,17,11,806,284,522
2,14,2019,19,0,5,"Braga",3,"Rua de Caires",23,34,11,55,37,18
2,14,2019,19,0,5,"Braga",4,"N14 Bosch",28,46,18,121,74,47
2,14,2019,19,0,5,"Braga",5,"Avenida João Paulo II",6,41,35,57,8,49
2,14,2019,19,0,5,"Braga",6,"Avenida Padre Júlio Fragata",12,60,48,106,21,85
2,14,2019,19,0,5,"Braga",7,"Rua Nova Santa Cruz",6,29,23,537,111,426
2,14,2019,19,0,5,"Braga",8,"Rua Costa Gomes",10,41,31,168,40,128
2,14,2019,20,0,5,"Braga",1,"Avenida da Liberdade",15,22,7,44,30,14
2,14,2019,20,0,5,"Braga",2,"Avenida Central",10,18,8,483,268,215
2,14,2019,20,0,5,"Braga",3,"Rua de Caires",26,34,8,49,37,12
2,14,2019,20,0,5,"Braga",4,"N14 Bosch",33,45,12,103,75,28
2,14,2019,20,0,5,"Braga",5,"Avenida João Paulo II",7,42,35,49,8,41
2,14,2019,20,0,5,"Braga",6,"Avenida Padre Júlio Fragata",22,61,39,58,20,38
2,14,2019,20,0,5,"Braga",7,"Rua Nova Santa Cruz",19,29,10,169,111,58
2,14,2019,20,0,5,"Braga",8,"Rua Costa Gomes",17,39,22,98,43,55
2,14,2019,21,0,5,"Braga",1,"Avenida da Liberdade",22,22,0,30,30,0
2,14,2019,21,0,5,"Braga",2,"Avenida Central",17,17,0,284,284,0
2,14,2019,21,0,5,"Braga",3,"Rua de Caires",35,35,0,36,36,0
2,14,2019,21,0,5,"Braga",4,"N14 Bosch",45,45,0,75,75,0
2,14,2019,21,0,5,"Braga",5,"Avenida João Paulo II",27,39,12,12,8,4
2,14,2019,21,0,5,"Braga",6,"Avenida Padre Júlio Fragata",61,61,0,20,20,0
2,14,2019,21,0,5,"Braga",7,"Rua Nova Santa Cruz",28,28,0,115,115,0
2,14,2019,21,0,5,"Braga",8,"Rua Costa Gomes",40,40,0,42,42,0
2,14,2019,22,0,5,"Braga",1,"Avenida da Liberdade",22,22,0,30,30,0
2,14,2019,22,0,5,"Braga",2,"Avenida Central",17,17,0,284,284,0
2,14,2019,22,0,5,"Braga",3,"Rua de Caires",35,35,0,36,36,0
2,14,2019,22,0,5,"Braga",4,"N14 Bosch",45,45,0,75,75,0
2,14,2019,22,0,5,"Braga",5,"Avenida João Paulo II",39,39,0,8,8,0
2,14,2019,22,0,5,"Braga",6,"Avenida Padre Júlio Fragata",61,61,0,20,20,0
2,14,2019,22,0,5,"Braga",7,"Rua Nova Santa Cruz",28,28,0,115,115,0
2,14,2019,22,0,5,"Braga",8,"Rua Costa Gomes",40,40,0,42,42,0
2,14,2019,23,0,5,"Braga",1,"Avenida da Liberdade",22,22,0,30,30,0
2,14,2019,23,0,5,"Braga",2,"Avenida Central",17,17,0,284,284,0
2,14,2019,23,0,5,"Braga",3,"Rua de Caires",36,36,0,35,35,0
2,14,2019,23,0,5,"Braga",4,"N14 Bosch",45,45,0,75,75,0
2,14,2019,23,0,5,"Braga",5,"Avenida João Paulo II",39,39,0,8,8,0
2,14,2019,23,0,5,"Braga",6,"Avenida Padre Júlio Fragata",60,60,0,21,21,0
2,14,2019,23,0,5,"Braga",7,"Rua Nova Santa Cruz",28,28,0,115,115,0
2,14,2019,23,0,5,"Braga",8,"Rua Costa Gomes",40,40,0,42,42,0
2,15,2019,0,0,6,"Braga",1,"Avenida da Liberdade",22,22,0,30,30,0
2,15,2019,0,0,6,"Braga",2,"Avenida Central",17,17,0,284,284,0
2,15,2019,0,0,6,"Braga",3,"Rua de Caires",36,36,0,35,35,0
2,15,2019,0,0,6,"Braga",4,"N14 Bosch",45,45,0,75,75,0
2,15,2019,0,0,6,"Braga",5,"Avenida João Paulo II",39,39,0,8,8,0
2,15,2019,0,0,6,"Braga",6,"Avenida Padre Júlio Fragata",61,61,0,20,20,0
2,15,2019,0,0,6,"Braga",7,"Rua Nova Santa Cruz",28,28,0,115,115,0
2,15,2019,0,0,6,"Braga",8,"Rua Costa Gomes",40,40,0,42,42,0
2,15,2019,2,0,6,"Braga",1,"Avenida da Liberdade",22,22,0,30,30,0
2,15,2019,2,0,6,"Braga",2,"Avenida Central",17,17,0,284,284,0
2,15,2019,2,0,6,"Braga",3,"Rua de Caires",36,36,0,35,35,0
2,15,2019,2,0,6,"Braga",4,"N14 Bosch",45,45,0,75,75,0
2,15,2019,2,0,6,"Braga",5,"Avenida João Paulo II",39,39,0,8,8,0
2,15,2019,2,0,6,"Braga",6,"Avenida Padre Júlio Fragata",61,61,0,20,20,0
2,15,2019,2,0,6,"Braga",7,"Rua Nova Santa Cruz",28,28,0,115,115,0
2,15,2019,2,0,6,"Braga",8,"Rua Costa Gomes",40,40,0,42,42,0
2,15,2019,3,0,6,"Braga",1,"Avenida da Liberdade",22,22,0,30,30,0
2,15,2019,3,0,6,"Braga",2,"Avenida Central",17,17,0,284,284,0
2,15,2019,3,0,6,"Braga",3,"Rua de Caires",36,36,0,35,35,0
2,15,2019,3,0,6,"Braga",4,"N14 Bosch",45,45,0,75,75,0
2,15,2019,3,0,6,"Braga",5,"Avenida João Paulo II",39,39,0,8,8,0
2,15,2019,3,0,6,"Braga",6,"Avenida Padre Júlio Fragata",61,61,0,20,20,0
2,15,2019,3,0,6,"Braga",7,"Rua Nova Santa Cruz",28,28,0,115,115,0
2,15,2019,3,0,6,"Braga",8,"Rua Costa Gomes",40,40,0,42,42,0
2,15,2019,4,0,6,"Braga",1,"Avenida da Liberdade",22,22,0,30,30,0
2,15,2019,4,0,6,"Braga",2,"Avenida Central",17,17,0,284,284,0
2,15,2019,4,0,6,"Braga",3,"Rua de Caires",36,36,0,35,35,0
2,15,2019,4,0,6,"Braga",4,"N14 Bosch",45,45,0,75,75,0
2,15,2019,4,0,6,"Braga",5,"Avenida João Paulo II",39,39,0,8,8,0
2,15,2019,4,0,6,"Braga",6,"Avenida Padre Júlio Fragata",61,61,0,20,20,0
2,15,2019,4,0,6,"Braga",7,"Rua Nova Santa Cruz",28,28,0,115,115,0
2,15,2019,4,0,6,"Braga",8,"Rua Costa Gomes",40,40,0,42,42,0
2,15,2019,5,0,6,"Braga",1,"Avenida da Liberdade",22,22,0,30,30,0
2,15,2019,5,0,6,"Braga",2,"Avenida Central",17,17,0,284,284,0
2,15,2019,5,0,6,"Braga",3,"Rua de Caires",36,36,0,35,35,0
2,15,2019,5,0,6,"Braga",4,"N14 Bosch",45,45,0,75,75,0
2,15,2019,5,0,6,"Braga",5,"Avenida João Paulo II",39,39,0,8,8,0
2,15,2019,5,0,6,"Braga",6,"Avenida Padre Júlio Fragata",61,61,0,20,20,0
2,15,2019,5,0,6,"Braga",7,"Rua Nova Santa Cruz",28,28,0,115,115,0
2,15,2019,5,0,6,"Braga",8,"Rua Costa Gomes",40,40,0,42,42,0
2,15,2019,6,0,6,"Braga",1,"Avenida da Liberdade",22,22,0,30,30,0
2,15,2019,6,0,6,"Braga",2,"Avenida Central",17,17,0,284,284,0
2,15,2019,6,0,6,"Braga",3,"Rua de Caires",35,35,0,36,36,0
2,15,2019,6,0,6,"Braga",4,"N14 Bosch",45,45,0,75,75,0
2,15,2019,6,0,6,"Braga",5,"Avenida João Paulo II",39,39,0,8,8,0
2,15,2019,6,0,6,"Braga",6,"Avenida Padre Júlio Fragata",61,61,0,20,20,0
2,15,2019,6,0,6,"Braga",7,"Rua Nova Santa Cruz",28,28,0,115,115,0
2,15,2019,6,0,6,"Braga",8,"Rua Costa Gomes",40,40,0,42,42,0
2,15,2019,7,0,6,"Braga",1,"Avenida da Liberdade",22,22,0,30,30,0
2,15,2019,7,0,6,"Braga",2,"Avenida Central",17,17,0,284,284,0
2,15,2019,7,0,6,"Braga",3,"Rua de Caires",35,35,0,36,36,0
2,15,2019,7,0,6,"Braga",4,"N14 Bosch",45,45,0,75,75,0
2,15,2019,7,0,6,"Braga",5,"Avenida João Paulo II",39,39,0,8,8,0
2,15,2019,7,0,6,"Braga",6,"Avenida Padre Júlio Fragata",61,61,0,20,20,0
2,15,2019,7,0,6,"Braga",7,"Rua Nova Santa Cruz",28,28,0,115,115,0
2,15,2019,7,0,6,"Braga",8,"Rua Costa Gomes",40,40,0,42,42,0
2,15,2019,8,0,6,"Braga",1,"Avenida da Liberdade",22,22,0,30,30,0
2,15,2019,8,0,6,"Braga",2,"Avenida Central",17,17,0,284,284,0
2,15,2019,8,0,6,"Braga",3,"Rua de Caires",34,34,0,37,37,0
2,15,2019,8,0,6,"Braga",4,"N14 Bosch",45,45,0,75,75,0
2,15,2019,8,0,6,"Braga",5,"Avenida João Paulo II",40,40,0,8,8,0
2,15,2019,8,0,6,"Braga",6,"Avenida Padre Júlio Fragata",61,61,0,20,20,0
2,15,2019,8,0,6,"Braga",7,"Rua Nova Santa Cruz",28,28,0,115,115,0
2,15,2019,8,0,6,"Braga",8,"Rua Costa Gomes",27,39,12,62,43,19
2,15,2019,9,0,6,"Braga",1,"Avenida da Liberdade",21,21,0,32,32,0
2,15,2019,9,0,6,"Braga",2,"Avenida Central",10,17,7,483,284,199
2,15,2019,9,0,6,"Braga",3,"Rua de Caires",19,35,16,67,36,31
2,15,2019,9,0,6,"Braga",4,"N14 Bosch",21,46,25,162,74,88
2,15,2019,9,0,6,"Braga",5,"Avenida João Paulo II",41,41,0,8,8,0
2,15,2019,9,0,6,"Braga",6,"Avenida Padre Júlio Fragata",38,61,23,33,20,13
2,15,2019,9,0,6,"Braga",7,"Rua Nova Santa Cruz",23,29,6,140,111,29
2,15,2019,9,0,6,"Braga",8,"Rua Costa Gomes",24,39,15,70,43,27
2,15,2019,10,0,6,"Braga",4,"N14 Bosch",33,46,13,103,74,29
2,15,2019,10,0,6,"Braga",5,"Avenida João Paulo II",40,40,0,8,8,0
2,15,2019,10,0,6,"Braga",6,"Avenida Padre Júlio Fragata",60,60,0,21,21,0
2,15,2019,10,0,6,"Braga",7,"Rua Nova Santa Cruz",28,28,0,115,115,0
2,15,2019,10,0,6,"Braga",8,"Rua Costa Gomes",21,40,19,80,42,38
2,15,2019,10,0,6,"Braga",1,"Avenida da Liberdade",22,22,0,30,30,0
2,15,2019,10,0,6,"Braga",2,"Avenida Central",17,17,0,284,284,0
2,15,2019,10,0,6,"Braga",3,"Rua de Caires",19,34,15,67,37,30
2,15,2019,10,0,6,"Braga",4,"N14 Bosch",33,46,13,103,74,29
2,15,2019,11,0,6,"Braga",1,"Avenida da Liberdade",18,22,4,37,30,7
2,15,2019,11,0,6,"Braga",2,"Avenida Central",12,18,6,403,268,135
2,15,2019,11,0,6,"Braga",3,"Rua de Caires",27,34,7,47,37,10
2,15,2019,11,0,6,"Braga",4,"N14 Bosch",36,46,10,94,74,20
2,15,2019,11,0,6,"Braga",5,"Avenida João Paulo II",40,40,0,8,8,0
2,15,2019,11,0,6,"Braga",6,"Avenida Padre Júlio Fragata",60,60,0,21,21,0
2,15,2019,11,0,6,"Braga",7,"Rua Nova Santa Cruz",29,29,0,111,111,0
2,15,2019,11,0,6,"Braga",8,"Rua Costa Gomes",29,40,11,57,42,15
2,15,2019,12,0,6,"Braga",1,"Avenida da Liberdade",12,22,10,56,30,26
2,15,2019,12,0,6,"Braga",2,"Avenida Central",13,18,5,372,268,104
2,15,2019,12,0,6,"Braga",3,"Rua de Caires",24,35,11,53,36,17
2,15,2019,12,0,6,"Braga",4,"N14 Bosch",31,45,14,110,75,35
2,15,2019,12,0,6,"Braga",5,"Avenida João Paulo II",40,40,0,8,8,0
2,15,2019,12,0,6,"Braga",6,"Avenida Padre Júlio Fragata",60,60,0,21,21,0
2,15,2019,12,0,6,"Braga",7,"Rua Nova Santa Cruz",23,29,6,140,111,29
2,15,2019,12,0,6,"Braga",8,"Rua Costa Gomes",31,40,9,54,42,12
2,15,2019,13,0,6,"Braga",1,"Avenida da Liberdade",21,21,0,32,32,0
2,15,2019,13,0,6,"Braga",2,"Avenida Central",17,17,0,284,284,0
2,15,2019,13,0,6,"Braga",3,"Rua de Caires",26,35,9,49,36,13
2,15,2019,13,0,6,"Braga",4,"N14 Bosch",32,46,14,106,74,32
2,15,2019,13,0,6,"Braga",5,"Avenida João Paulo II",40,40,0,8,8,0
2,15,2019,13,0,6,"Braga",6,"Avenida Padre Júlio Fragata",61,61,0,20,20,0
2,15,2019,13,0,6,"Braga",7,"Rua Nova Santa Cruz",16,29,13,201,111,90
2,15,2019,13,0,6,"Braga",8,"Rua Costa Gomes",30,40,10,56,42,14
2,15,2019,14,0,6,"Braga",1,"Avenida da Liberdade",17,21,4,39,32,7
2,15,2019,14,0,6,"Braga",2,"Avenida Central",17,17,0,284,284,0
2,15,2019,14,0,6,"Braga",3,"Rua de Caires",35,35,0,36,36,0
2,15,2019,14,0,6,"Braga",4,"N14 Bosch",25,46,21,136,74,62
2,15,2019,14,0,6,"Braga",5,"Avenida João Paulo II",40,40,0,8,8,0
2,15,2019,14,0,6,"Braga",6,"Avenida Padre Júlio Fragata",61,61,0,20,20,0
2,15,2019,14,0,6,"Braga",7,"Rua Nova Santa Cruz",20,28,8,161,115,46
2,15,2019,14,0,6,"Braga",8,"Rua Costa Gomes",29,39,10,57,43,14
2,15,2019,15,0,6,"Braga",1,"Avenida da Liberdade",17,21,4,39,32,7
2,15,2019,15,0,6,"Braga",2,"Avenida Central",12,18,6,403,268,135
2,15,2019,15,0,6,"Braga",3,"Rua de Caires",24,35,11,53,36,17
2,15,2019,15,0,6,"Braga",4,"N14 Bosch",28,45,17,121,75,46
2,15,2019,15,0,6,"Braga",5,"Avenida João Paulo II",40,40,0,8,8,0
2,15,2019,15,0,6,"Braga",6,"Avenida Padre Júlio Fragata",48,60,12,26,21,5
2,15,2019,15,0,6,"Braga",7,"Rua Nova Santa Cruz",21,29,8,153,111,42
2,15,2019,15,0,6,"Braga",8,"Rua Costa Gomes",25,40,15,67,42,25
2,15,2019,16,0,6,"Braga",1,"Avenida da Liberdade",17,22,5,39,30,9
2,15,2019,16,0,6,"Braga",2,"Avenida Central",10,17,7,483,284,199
2,15,2019,16,0,6,"Braga",3,"Rua de Caires",26,35,9,49,36,13
2,15,2019,16,0,6,"Braga",4,"N14 Bosch",26,45,19,131,75,56
2,15,2019,16,0,6,"Braga",5,"Avenida João Paulo II",28,40,12,12,8,4
2,15,2019,16,0,6,"Braga",6,"Avenida Padre Júlio Fragata",43,61,18,29,20,9
2,15,2019,16,0,6,"Braga",7,"Rua Nova Santa Cruz",16,28,12,201,115,86
2,15,2019,16,0,6,"Braga",8,"Rua Costa Gomes",19,40,21,88,42,46
2,15,2019,17,0,6,"Braga",1,"Avenida da Liberdade",22,22,0,30,30,0
2,15,2019,17,0,6,"Braga",2,"Avenida Central",11,18,7,439,268,171
2,15,2019,17,0,6,"Braga",3,"Rua de Caires",21,35,14,61,36,25
2,15,2019,17,0,6,"Braga",4,"N14 Bosch",22,47,25,155,72,83
2,15,2019,17,0,6,"Braga",5,"Avenida João Paulo II",27,40,13,12,8,4
2,15,2019,17,0,6,"Braga",6,"Avenida Padre Júlio Fragata",43,61,18,29,20,9
2,15,2019,17,0,6,"Braga",7,"Rua Nova Santa Cruz",20,29,9,161,111,50
2,15,2019,17,0,6,"Braga",8,"Rua Costa Gomes",26,40,14,64,42,22
2,15,2019,18,0,6,"Braga",1,"Avenida da Liberdade",15,21,6,44,32,12
2,15,2019,18,0,6,"Braga",2,"Avenida Central",13,17,4,372,284,88
2,15,2019,18,0,6,"Braga",3,"Rua de Caires",20,34,14,64,37,27
2,15,2019,18,0,6,"Braga",4,"N14 Bosch",14,46,32,243,74,169
2,15,2019,18,0,6,"Braga",5,"Avenida João Paulo II",10,40,30,34,8,26
2,15,2019,18,0,6,"Braga",6,"Avenida Padre Júlio Fragata",26,60,34,49,21,28
2,15,2019,18,0,6,"Braga",7,"Rua Nova Santa Cruz",13,30,17,248,107,141
2,15,2019,18,0,6,"Braga",8,"Rua Costa Gomes",14,39,25,120,43,77
2,15,2019,19,0,6,"Braga",1,"Avenida da Liberdade",16,21,5,42,32,10
2,15,2019,19,0,6,"Braga",2,"Avenida Central",11,18,7,439,268,171
2,15,2019,19,0,6,"Braga",3,"Rua de Caires",23,34,11,55,37,18
2,15,2019,19,0,6,"Braga",4,"N14 Bosch",25,45,20,136,75,61
2,15,2019,19,0,6,"Braga",5,"Avenida João Paulo II",12,40,28,28,8,20
2,15,2019,19,0,6,"Braga",6,"Avenida Padre Júlio Fragata",22,60,38,58,21,37
2,15,2019,19,0,6,"Braga",7,"Rua Nova Santa Cruz",15,28,13,215,115,100
2,15,2019,19,0,6,"Braga",8,"Rua Costa Gomes",9,41,32,186,40,146
2,15,2019,20,0,6,"Braga",1,"Avenida da Liberdade",21,21,0,32,32,0
2,15,2019,20,0,6,"Braga",2,"Avenida Central",17,17,0,284,284,0
2,15,2019,20,0,6,"Braga",3,"Rua de Caires",24,34,10,53,37,16
2,15,2019,20,0,6,"Braga",4,"N14 Bosch",34,45,11,100,75,25
2,15,2019,20,0,6,"Braga",5,"Avenida João Paulo II",20,40,20,17,8,9
2,15,2019,20,0,6,"Braga",6,"Avenida Padre Júlio Fragata",45,60,15,28,21,7
2,15,2019,20,0,6,"Braga",7,"Rua Nova Santa Cruz",19,28,9,169,115,54
2,15,2019,20,0,6,"Braga",8,"Rua Costa Gomes",21,40,19,80,42,38
2,15,2019,21,0,6,"Braga",1,"Avenida da Liberdade",21,21,0,32,32,0
2,15,2019,21,0,6,"Braga",2,"Avenida Central",18,18,0,268,268,0
2,15,2019,21,0,6,"Braga",3,"Rua de Caires",34,34,0,37,37,0
2,15,2019,21,0,6,"Braga",4,"N14 Bosch",45,45,0,75,75,0
2,15,2019,21,0,6,"Braga",5,"Avenida João Paulo II",31,40,9,11,8,3
2,15,2019,21,0,6,"Braga",6,"Avenida Padre Júlio Fragata",61,61,0,20,20,0
2,15,2019,21,0,6,"Braga",7,"Rua Nova Santa Cruz",28,28,0,115,115,0
2,15,2019,21,0,6,"Braga",8,"Rua Costa Gomes",40,40,0,42,42,0
2,15,2019,22,0,6,"Braga",1,"Avenida da Liberdade",21,21,0,32,32,0
2,15,2019,22,0,6,"Braga",2,"Avenida Central",17,17,0,284,284,0
2,15,2019,22,0,6,"Braga",3,"Rua de Caires",34,34,0,37,37,0
2,15,2019,22,0,6,"Braga",4,"N14 Bosch",45,45,0,75,75,0
2,15,2019,22,0,6,"Braga",5,"Avenida João Paulo II",39,39,0,8,8,0
2,15,2019,22,0,6,"Braga",6,"Avenida Padre Júlio Fragata",36,61,25,35,20,15
2,15,2019,22,0,6,"Braga",7,"Rua Nova Santa Cruz",28,28,0,115,115,0
2,15,2019,22,0,6,"Braga",8,"Rua Costa Gomes",40,40,0,42,42,0
2,15,2019,23,0,6,"Braga",1,"Avenida da Liberdade",21,21,0,32,32,0
2,15,2019,23,0,6,"Braga",2,"Avenida Central",17,17,0,284,284,0
2,15,2019,23,0,6,"Braga",3,"Rua de Caires",34,34,0,37,37,0
2,15,2019,23,0,6,"Braga",4,"N14 Bosch",45,45,0,75,75,0
2,15,2019,23,0,6,"Braga",5,"Avenida João Paulo II",39,39,0,8,8,0
2,15,2019,23,0,6,"Braga",6,"Avenida Padre Júlio Fragata",60,60,0,21,21,0
2,15,2019,23,0,6,"Braga",7,"Rua Nova Santa Cruz",29,29,0,111,111,0
2,15,2019,23,0,6,"Braga",8,"Rua Costa Gomes",40,40,0,42,42,0
2,16,2019,0,0,7,"Braga",1,"Avenida da Liberdade",21,21,0,32,32,0
2,16,2019,0,0,7,"Braga",2,"Avenida Central",17,17,0,284,284,0
2,16,2019,0,0,7,"Braga",3,"Rua de Caires",34,34,0,37,37,0
2,16,2019,0,0,7,"Braga",4,"N14 Bosch",46,46,0,74,74,0
2,16,2019,0,0,7,"Braga",5,"Avenida João Paulo II",39,39,0,8,8,0
2,16,2019,0,0,7,"Braga",6,"Avenida Padre Júlio Fragata",60,60,0,21,21,0
2,16,2019,0,0,7,"Braga",7,"Rua Nova Santa Cruz",29,29,0,111,111,0
2,16,2019,0,0,7,"Braga",8,"Rua Costa Gomes",40,40,0,42,42,0
2,16,2019,1,0,7,"Braga",4,"N14 Bosch",46,46,0,74,74,0
2,16,2019,1,0,7,"Braga",5,"Avenida João Paulo II",39,39,0,8,8,0
2,16,2019,1,0,7,"Braga",6,"Avenida Padre Júlio Fragata",59,59,0,21,21,0
2,16,2019,1,0,7,"Braga",7,"Rua Nova Santa Cruz",29,29,0,111,111,0
2,16,2019,1,0,7,"Braga",8,"Rua Costa Gomes",40,40,0,42,42,0
2,16,2019,1,0,7,"Braga",1,"Avenida da Liberdade",21,21,0,32,32,0
2,16,2019,1,0,7,"Braga",2,"Avenida Central",17,17,0,284,284,0
2,16,2019,1,0,7,"Braga",3,"Rua de Caires",34,34,0,37,37,0
2,16,2019,1,0,7,"Braga",4,"N14 Bosch",46,46,0,74,74,0
2,16,2019,2,0,7,"Braga",1,"Avenida da Liberdade",21,21,0,32,32,0
2,16,2019,2,0,7,"Braga",2,"Avenida Central",17,17,0,284,284,0
2,16,2019,2,0,7,"Braga",3,"Rua de Caires",34,34,0,37,37,0
2,16,2019,2,0,7,"Braga",4,"N14 Bosch",46,46,0,74,74,0
2,16,2019,2,0,7,"Braga",5,"Avenida João Paulo II",39,39,0,8,8,0
2,16,2019,2,0,7,"Braga",6,"Avenida Padre Júlio Fragata",60,60,0,21,21,0
2,16,2019,2,0,7,"Braga",7,"Rua Nova Santa Cruz",29,29,0,111,111,0
2,16,2019,2,0,7,"Braga",8,"Rua Costa Gomes",40,40,0,42,42,0
2,16,2019,3,0,7,"Braga",1,"Avenida da Liberdade",21,21,0,32,32,0
2,16,2019,3,0,7,"Braga",2,"Avenida Central",17,17,0,284,284,0
2,16,2019,3,0,7,"Braga",3,"Rua de Caires",34,34,0,37,37,0
2,16,2019,3,0,7,"Braga",4,"N14 Bosch",46,46,0,74,74,0
2,16,2019,3,0,7,"Braga",5,"Avenida João Paulo II",39,39,0,8,8,0
2,16,2019,3,0,7,"Braga",6,"Avenida Padre Júlio Fragata",60,60,0,21,21,0
2,16,2019,3,0,7,"Braga",7,"Rua Nova Santa Cruz",29,29,0,111,111,0
2,16,2019,3,0,7,"Braga",8,"Rua Costa Gomes",40,40,0,42,42,0
2,16,2019,4,0,7,"Braga",1,"Avenida da Liberdade",21,21,0,32,32,0
2,16,2019,4,0,7,"Braga",2,"Avenida Central",17,17,0,284,284,0
2,16,2019,4,0,7,"Braga",3,"Rua de Caires",34,34,0,37,37,0
2,16,2019,4,0,7,"Braga",4,"N14 Bosch",46,46,0,74,74,0
2,16,2019,4,0,7,"Braga",5,"Avenida João Paulo II",40,40,0,8,8,0
2,16,2019,4,0,7,"Braga",6,"Avenida Padre Júlio Fragata",60,60,0,21,21,0
2,16,2019,4,0,7,"Braga",7,"Rua Nova Santa Cruz",29,29,0,111,111,0
2,16,2019,4,0,7,"Braga",8,"Rua Costa Gomes",40,40,0,42,42,0
2,16,2019,5,0,7,"Braga",1,"Avenida da Liberdade",21,21,0,32,32,0
2,16,2019,5,0,7,"Braga",2,"Avenida Central",17,17,0,284,284,0
2,16,2019,5,0,7,"Braga",3,"Rua de Caires",34,34,0,37,37,0
2,16,2019,5,0,7,"Braga",4,"N14 Bosch",46,46,0,74,74,0
2,16,2019,5,0,7,"Braga",5,"Avenida João Paulo II",40,40,0,8,8,0
2,16,2019,5,0,7,"Braga",6,"Avenida Padre Júlio Fragata",60,60,0,21,21,0
2,16,2019,5,0,7,"Braga",7,"Rua Nova Santa Cruz",29,29,0,111,111,0
2,16,2019,5,0,7,"Braga",8,"Rua Costa Gomes",40,40,0,42,42,0
2,16,2019,6,0,7,"Braga",1,"Avenida da Liberdade",21,21,0,32,32,0
2,16,2019,6,0,7,"Braga",2,"Avenida Central",17,17,0,284,284,0
2,16,2019,6,0,7,"Braga",3,"Rua de Caires",34,34,0,37,37,0
2,16,2019,6,0,7,"Braga",4,"N14 Bosch",46,46,0,74,74,0
2,16,2019,6,0,7,"Braga",5,"Avenida João Paulo II",40,40,0,8,8,0
2,16,2019,6,0,7,"Braga",6,"Avenida Padre Júlio Fragata",60,60,0,21,21,0
2,16,2019,6,0,7,"Braga",7,"Rua Nova Santa Cruz",29,29,0,111,111,0
2,16,2019,6,0,7,"Braga",8,"Rua Costa Gomes",40,40,0,42,42,0
2,16,2019,7,0,7,"Braga",1,"Avenida da Liberdade",21,21,0,32,32,0
2,16,2019,7,0,7,"Braga",2,"Avenida Central",17,17,0,284,284,0
2,16,2019,7,0,7,"Braga",3,"Rua de Caires",34,34,0,37,37,0
2,16,2019,7,0,7,"Braga",4,"N14 Bosch",46,46,0,74,74,0
2,16,2019,7,0,7,"Braga",5,"Avenida João Paulo II",40,40,0,8,8,0
2,16,2019,7,0,7,"Braga",6,"Avenida Padre Júlio Fragata",60,60,0,21,21,0
2,16,2019,7,0,7,"Braga",7,"Rua Nova Santa Cruz",29,29,0,111,111,0
2,16,2019,7,0,7,"Braga",8,"Rua Costa Gomes",40,40,0,42,42,0
2,16,2019,8,0,7,"Braga",1,"Avenida da Liberdade",21,21,0,32,32,0
2,16,2019,8,0,7,"Braga",2,"Avenida Central",17,17,0,284,284,0
2,16,2019,8,0,7,"Braga",3,"Rua de Caires",34,34,0,37,37,0
2,16,2019,8,0,7,"Braga",4,"N14 Bosch",46,46,0,74,74,0
2,16,2019,8,0,7,"Braga",5,"Avenida João Paulo II",40,40,0,8,8,0
2,16,2019,8,0,7,"Braga",6,"Avenida Padre Júlio Fragata",60,60,0,21,21,0
2,16,2019,8,0,7,"Braga",7,"Rua Nova Santa Cruz",29,29,0,111,111,0
2,16,2019,8,0,7,"Braga",8,"Rua Costa Gomes",40,40,0,42,42,0
2,16,2019,9,0,7,"Braga",1,"Avenida da Liberdade",21,21,0,32,32,0
2,16,2019,9,0,7,"Braga",2,"Avenida Central",17,17,0,284,284,0
2,16,2019,9,0,7,"Braga",3,"Rua de Caires",34,34,0,37,37,0
2,16,2019,9,0,7,"Braga",4,"N14 Bosch",46,46,0,74,74,0
2,16,2019,9,0,7,"Braga",5,"Avenida João Paulo II",40,40,0,8,8,0
2,16,2019,9,0,7,"Braga",6,"Avenida Padre Júlio Fragata",60,60,0,21,21,0
2,16,2019,9,0,7,"Braga",7,"Rua Nova Santa Cruz",29,29,0,111,111,0
2,16,2019,9,0,7,"Braga",8,"Rua Costa Gomes",40,40,0,42,42,0
2,16,2019,10,0,7,"Braga",1,"Avenida da Liberdade",21,21,0,32,32,0
2,16,2019,10,0,7,"Braga",2,"Avenida Central",12,17,5,403,284,119
2,16,2019,10,0,7,"Braga",3,"Rua de Caires",25,35,10,51,36,15
2,16,2019,10,0,7,"Braga",4,"N14 Bosch",46,46,0,74,74,0
2,16,2019,10,0,7,"Braga",5,"Avenida João Paulo II",40,40,0,8,8,0
2,16,2019,10,0,7,"Braga",6,"Avenida Padre Júlio Fragata",60,60,0,21,21,0
2,16,2019,10,0,7,"Braga",7,"Rua Nova Santa Cruz",29,29,0,111,111,0
2,16,2019,10,0,7,"Braga",8,"Rua Costa Gomes",31,40,9,54,42,12
2,16,2019,11,0,7,"Braga",1,"Avenida da Liberdade",21,21,0,32,32,0
2,16,2019,11,0,7,"Braga",2,"Avenida Central",12,17,5,403,284,119
2,16,2019,11,0,7,"Braga",3,"Rua de Caires",23,34,11,55,37,18
2,16,2019,11,0,7,"Braga",4,"N14 Bosch",45,45,0,75,75,0
2,16,2019,11,0,7,"Braga",5,"Avenida João Paulo II",40,40,0,8,8,0
2,16,2019,11,0,7,"Braga",6,"Avenida Padre Júlio Fragata",60,60,0,21,21,0
2,16,2019,11,0,7,"Braga",7,"Rua Nova Santa Cruz",29,29,0,111,111,0
2,16,2019,11,0,7,"Braga",8,"Rua Costa Gomes",31,40,9,54,42,12
2,16,2019,12,0,7,"Braga",1,"Avenida da Liberdade",21,21,0,32,32,0
2,16,2019,12,0,7,"Braga",2,"Avenida Central",8,18,10,604,268,336
2,16,2019,12,0,7,"Braga",3,"Rua de Caires",24,34,10,53,37,16
2,16,2019,12,0,7,"Braga",4,"N14 Bosch",32,46,14,106,74,32
2,16,2019,12,0,7,"Braga",5,"Avenida João Paulo II",32,40,8,10,8,2
2,16,2019,12,0,7,"Braga",6,"Avenida Padre Júlio Fragata",48,61,13,26,20,6
2,16,2019,12,0,7,"Braga",7,"Rua Nova Santa Cruz",29,29,0,111,111,0
2,16,2019,12,0,7,"Braga",8,"Rua Costa Gomes",40,40,0,42,42,0
2,16,2019,13,0,7,"Braga",1,"Avenida da Liberdade",21,21,0,32,32,0
2,16,2019,13,0,7,"Braga",2,"Avenida Central",10,18,8,483,268,215
2,16,2019,13,0,7,"Braga",3,"Rua de Caires",35,35,0,36,36,0
2,16,2019,13,0,7,"Braga",4,"N14 Bosch",37,46,9,92,74,18
2,16,2019,13,0,7,"Braga",5,"Avenida João Paulo II",31,40,9,11,8,3
2,16,2019,13,0,7,"Braga",6,"Avenida Padre Júlio Fragata",31,60,29,41,21,20
2,16,2019,13,0,7,"Braga",7,"Rua Nova Santa Cruz",29,29,0,111,111,0
2,16,2019,13,0,7,"Braga",8,"Rua Costa Gomes",40,40,0,42,42,0
2,16,2019,14,0,7,"Braga",1,"Avenida da Liberdade",22,22,0,30,30,0
2,16,2019,14,0,7,"Braga",2,"Avenida Central",12,17,5,403,284,119
2,16,2019,14,0,7,"Braga",3,"Rua de Caires",34,34,0,37,37,0
2,16,2019,14,0,7,"Braga",4,"N14 Bosch",36,46,10,94,74,20
2,16,2019,14,0,7,"Braga",5,"Avenida João Paulo II",40,40,0,8,8,0
2,16,2019,14,0,7,"Braga",6,"Avenida Padre Júlio Fragata",61,61,0,20,20,0
2,16,2019,14,0,7,"Braga",7,"Rua Nova Santa Cruz",19,29,10,169,111,58
2,16,2019,14,0,7,"Braga",8,"Rua Costa Gomes",39,39,0,43,43,0
2,16,2019,15,0,7,"Braga",1,"Avenida da Liberdade",22,22,0,30,30,0
2,16,2019,15,0,7,"Braga",2,"Avenida Central",12,17,5,403,284,119
2,16,2019,15,0,7,"Braga",3,"Rua de Caires",34,34,0,37,37,0
2,16,2019,15,0,7,"Braga",4,"N14 Bosch",46,46,0,74,74,0
2,16,2019,15,0,7,"Braga",5,"Avenida João Paulo II",28,39,11,12,8,4
2,16,2019,15,0,7,"Braga",6,"Avenida Padre Júlio Fragata",60,60,0,21,21,0
2,16,2019,15,0,7,"Braga",7,"Rua Nova Santa Cruz",29,29,0,111,111,0
2,16,2019,15,0,7,"Braga",8,"Rua Costa Gomes",32,40,8,52,42,10
2,16,2019,16,0,7,"Braga",1,"Avenida da Liberdade",22,22,0,30,30,0
2,16,2019,16,0,7,"Braga",2,"Avenida Central",12,18,6,403,268,135
2,16,2019,16,0,7,"Braga",3,"Rua de Caires",26,34,8,49,37,12
2,16,2019,16,0,7,"Braga",4,"N14 Bosch",32,45,13,106,75,31
2,16,2019,16,0,7,"Braga",5,"Avenida João Paulo II",31,40,9,11,8,3
2,16,2019,16,0,7,"Braga",6,"Avenida Padre Júlio Fragata",41,61,20,31,20,11
2,16,2019,16,0,7,"Braga",7,"Rua Nova Santa Cruz",16,29,13,201,111,90
2,16,2019,16,0,7,"Braga",8,"Rua Costa Gomes",39,39,0,43,43,0
2,16,2019,17,0,7,"Braga",1,"Avenida da Liberdade",22,22,0,30,30,0
2,16,2019,17,0,7,"Braga",2,"Avenida Central",13,18,5,372,268,104
2,16,2019,17,0,7,"Braga",3,"Rua de Caires",27,34,7,47,37,10
2,16,2019,17,0,7,"Braga",4,"N14 Bosch",45,45,0,75,75,0
2,16,2019,17,0,7,"Braga",5,"Avenida João Paulo II",40,40,0,8,8,0
2,16,2019,17,0,7,"Braga",6,"Avenida Padre Júlio Fragata",60,60,0,21,21,0
2,16,2019,17,0,7,"Braga",7,"Rua Nova Santa Cruz",22,28,6,146,115,31
2,16,2019,17,0,7,"Braga",8,"Rua Costa Gomes",28,39,11,60,43,17
2,16,2019,18,0,7,"Braga",1,"Avenida da Liberdade",22,22,0,30,30,0
2,16,2019,18,0,7,"Braga",2,"Avenida Central",12,18,6,403,268,135
2,16,2019,18,0,7,"Braga",3,"Rua de Caires",24,34,10,53,37,16
2,16,2019,18,0,7,"Braga",4,"N14 Bosch",34,46,12,100,74,26
2,16,2019,18,0,7,"Braga",5,"Avenida João Paulo II",27,40,13,12,8,4
2,16,2019,18,0,7,"Braga",6,"Avenida Padre Júlio Fragata",60,60,0,21,21,0
2,16,2019,18,0,7,"Braga",7,"Rua Nova Santa Cruz",29,29,0,111,111,0
2,16,2019,18,0,7,"Braga",8,"Rua Costa Gomes",22,39,17,76,43,33
2,16,2019,19,0,7,"Braga",1,"Avenida da Liberdade",22,22,0,30,30,0
2,16,2019,19,0,7,"Braga",2,"Avenida Central",18,18,0,268,268,0
2,16,2019,19,0,7,"Braga",3,"Rua de Caires",27,34,7,47,37,10
2,16,2019,19,0,7,"Braga",4,"N14 Bosch",46,46,0,74,74,0
2,16,2019,19,0,7,"Braga",5,"Avenida João Paulo II",41,41,0,8,8,0
2,16,2019,19,0,7,"Braga",6,"Avenida Padre Júlio Fragata",20,61,41,63,20,43
2,16,2019,19,0,7,"Braga",7,"Rua Nova Santa Cruz",29,29,0,111,111,0
2,16,2019,19,0,7,"Braga",8,"Rua Costa Gomes",21,40,19,80,42,38
2,16,2019,20,0,7,"Braga",1,"Avenida da Liberdade",22,22,0,30,30,0
2,16,2019,20,0,7,"Braga",2,"Avenida Central",18,18,0,268,268,0
2,16,2019,20,0,7,"Braga",3,"Rua de Caires",21,34,13,61,37,24
2,16,2019,20,0,7,"Braga",4,"N14 Bosch",45,45,0,75,75,0
2,16,2019,20,0,7,"Braga",5,"Avenida João Paulo II",40,40,0,8,8,0
2,16,2019,20,0,7,"Braga",6,"Avenida Padre Júlio Fragata",61,61,0,20,20,0
2,16,2019,20,0,7,"Braga",7,"Rua Nova Santa Cruz",20,28,8,161,115,46
2,16,2019,20,0,7,"Braga",8,"Rua Costa Gomes",21,40,19,80,42,38
2,16,2019,21,0,7,"Braga",1,"Avenida da Liberdade",22,22,0,30,30,0
2,16,2019,21,0,7,"Braga",2,"Avenida Central",17,17,0,284,284,0
2,16,2019,21,0,7,"Braga",3,"Rua de Caires",34,34,0,37,37,0
2,16,2019,21,0,7,"Braga",4,"N14 Bosch",36,46,10,94,74,20
2,16,2019,21,0,7,"Braga",5,"Avenida João Paulo II",39,39,0,8,8,0
2,16,2019,21,0,7,"Braga",6,"Avenida Padre Júlio Fragata",30,61,31,42,20,22
2,16,2019,21,0,7,"Braga",7,"Rua Nova Santa Cruz",13,29,16,248,111,137
2,16,2019,21,0,7,"Braga",8,"Rua Costa Gomes",31,39,8,54,43,11
2,16,2019,22,0,7,"Braga",1,"Avenida da Liberdade",22,22,0,30,30,0
2,16,2019,22,0,7,"Braga",2,"Avenida Central",17,17,0,284,284,0
2,16,2019,22,0,7,"Braga",3,"Rua de Caires",34,34,0,37,37,0
2,16,2019,22,0,7,"Braga",4,"N14 Bosch",46,46,0,74,74,0
2,16,2019,22,0,7,"Braga",5,"Avenida João Paulo II",40,40,0,8,8,0
2,16,2019,22,0,7,"Braga",6,"Avenida Padre Júlio Fragata",46,61,15,27,20,7
2,16,2019,22,0,7,"Braga",7,"Rua Nova Santa Cruz",29,29,0,111,111,0
2,16,2019,22,0,7,"Braga",8,"Rua Costa Gomes",39,39,0,43,43,0
2,16,2019,23,0,7,"Braga",1,"Avenida da Liberdade",22,22,0,30,30,0
2,16,2019,23,0,7,"Braga",2,"Avenida Central",17,17,0,284,284,0
2,16,2019,23,0,7,"Braga",3,"Rua de Caires",34,34,0,37,37,0
2,16,2019,23,0,7,"Braga",4,"N14 Bosch",46,46,0,74,74,0
2,16,2019,23,0,7,"Braga",5,"Avenida João Paulo II",40,40,0,8,8,0
2,16,2019,23,0,7,"Braga",6,"Avenida Padre Júlio Fragata",61,61,0,20,20,0
2,16,2019,23,0,7,"Braga",7,"Rua Nova Santa Cruz",28,28,0,115,115,0
2,16,2019,23,0,7,"Braga",8,"Rua Costa Gomes",39,39,0,43,43,0
2,17,2019,0,0,8,"Braga",1,"Avenida da Liberdade",22,22,0,30,30,0
2,17,2019,0,0,8,"Braga",2,"Avenida Central",18,18,0,268,268,0
2,17,2019,0,0,8,"Braga",3,"Rua de Caires",34,34,0,37,37,0
2,17,2019,0,0,8,"Braga",4,"N14 Bosch",46,46,0,74,74,0
2,17,2019,0,0,8,"Braga",5,"Avenida João Paulo II",40,40,0,8,8,0
2,17,2019,0,0,8,"Braga",6,"Avenida Padre Júlio Fragata",61,61,0,20,20,0
2,17,2019,0,0,8,"Braga",7,"Rua Nova Santa Cruz",18,29,11,179,111,68
2,17,2019,0,0,8,"Braga",8,"Rua Costa Gomes",39,39,0,43,43,0
2,17,2019,1,0,8,"Braga",1,"Avenida da Liberdade",22,22,0,30,30,0
2,17,2019,1,0,8,"Braga",2,"Avenida Central",18,18,0,268,268,0
2,17,2019,1,0,8,"Braga",3,"Rua de Caires",34,34,0,37,37,0
2,17,2019,1,0,8,"Braga",4,"N14 Bosch",46,46,0,74,74,0
2,17,2019,1,0,8,"Braga",5,"Avenida João Paulo II",40,40,0,8,8,0
2,17,2019,1,0,8,"Braga",6,"Avenida Padre Júlio Fragata",61,61,0,20,20,0
2,17,2019,1,0,8,"Braga",7,"Rua Nova Santa Cruz",29,29,0,111,111,0
2,17,2019,1,0,8,"Braga",8,"Rua Costa Gomes",39,39,0,43,43,0
2,17,2019,2,0,8,"Braga",1,"Avenida da Liberdade",22,22,0,30,30,0
2,17,2019,2,0,8,"Braga",2,"Avenida Central",18,18,0,268,268,0
2,17,2019,2,0,8,"Braga",3,"Rua de Caires",34,34,0,37,37,0
2,17,2019,2,0,8,"Braga",4,"N14 Bosch",46,46,0,74,74,0
2,17,2019,2,0,8,"Braga",5,"Avenida João Paulo II",40,40,0,8,8,0
2,17,2019,2,0,8,"Braga",6,"Avenida Padre Júlio Fragata",61,61,0,20,20,0
2,17,2019,2,0,8,"Braga",7,"Rua Nova Santa Cruz",29,29,0,111,111,0
2,17,2019,2,0,8,"Braga",8,"Rua Costa Gomes",39,39,0,43,43,0
2,17,2019,3,0,8,"Braga",1,"Avenida da Liberdade",22,22,0,30,30,0
2,17,2019,3,0,8,"Braga",2,"Avenida Central",18,18,0,268,268,0
2,17,2019,3,0,8,"Braga",3,"Rua de Caires",34,34,0,37,37,0
2,17,2019,3,0,8,"Braga",4,"N14 Bosch",46,46,0,74,74,0
2,17,2019,3,0,8,"Braga",5,"Avenida João Paulo II",40,40,0,8,8,0
2,17,2019,3,0,8,"Braga",6,"Avenida Padre Júlio Fragata",61,61,0,20,20,0
2,17,2019,3,0,8,"Braga",7,"Rua Nova Santa Cruz",29,29,0,111,111,0
2,17,2019,3,0,8,"Braga",8,"Rua Costa Gomes",39,39,0,43,43,0
2,17,2019,4,0,8,"Braga",1,"Avenida da Liberdade",22,22,0,30,30,0
2,17,2019,4,0,8,"Braga",2,"Avenida Central",18,18,0,268,268,0
2,17,2019,4,0,8,"Braga",3,"Rua de Caires",34,34,0,37,37,0
2,17,2019,4,0,8,"Braga",4,"N14 Bosch",46,46,0,74,74,0
2,17,2019,4,0,8,"Braga",5,"Avenida João Paulo II",40,40,0,8,8,0
2,17,2019,4,0,8,"Braga",6,"Avenida Padre Júlio Fragata",61,61,0,20,20,0
2,17,2019,4,0,8,"Braga",7,"Rua Nova Santa Cruz",29,29,0,111,111,0
2,17,2019,4,0,8,"Braga",8,"Rua Costa Gomes",39,39,0,43,43,0
2,17,2019,5,0,8,"Braga",1,"Avenida da Liberdade",22,22,0,30,30,0
2,17,2019,5,0,8,"Braga",2,"Avenida Central",18,18,0,268,268,0
2,17,2019,5,0,8,"Braga",3,"Rua de Caires",34,34,0,37,37,0
2,17,2019,5,0,8,"Braga",4,"N14 Bosch",46,46,0,74,74,0
2,17,2019,5,0,8,"Braga",5,"Avenida João Paulo II",40,40,0,8,8,0
2,17,2019,5,0,8,"Braga",6,"Avenida Padre Júlio Fragata",61,61,0,20,20,0
2,17,2019,5,0,8,"Braga",7,"Rua Nova Santa Cruz",29,29,0,111,111,0
2,17,2019,5,0,8,"Braga",8,"Rua Costa Gomes",39,39,0,43,43,0
2,17,2019,6,0,8,"Braga",1,"Avenida da Liberdade",22,22,0,30,30,0
2,17,2019,6,0,8,"Braga",2,"Avenida Central",18,18,0,268,268,0
2,17,2019,6,0,8,"Braga",3,"Rua de Caires",34,34,0,37,37,0
2,17,2019,6,0,8,"Braga",4,"N14 Bosch",46,46,0,74,74,0
2,17,2019,6,0,8,"Braga",5,"Avenida João Paulo II",40,40,0,8,8,0
2,17,2019,6,0,8,"Braga",6,"Avenida Padre Júlio Fragata",61,61,0,20,20,0
2,17,2019,6,0,8,"Braga",7,"Rua Nova Santa Cruz",29,29,0,111,111,0
2,17,2019,6,0,8,"Braga",8,"Rua Costa Gomes",39,39,0,43,43,0
2,17,2019,7,0,8,"Braga",1,"Avenida da Liberdade",22,22,0,30,30,0
2,17,2019,7,0,8,"Braga",2,"Avenida Central",18,18,0,268,268,0
2,17,2019,7,0,8,"Braga",3,"Rua de Caires",34,34,0,37,37,0
2,17,2019,7,0,8,"Braga",4,"N14 Bosch",46,46,0,74,74,0
2,17,2019,7,0,8,"Braga",5,"Avenida João Paulo II",40,40,0,8,8,0
2,17,2019,7,0,8,"Braga",6,"Avenida Padre Júlio Fragata",61,61,0,20,20,0
2,17,2019,7,0,8,"Braga",7,"Rua Nova Santa Cruz",29,29,0,111,111,0
2,17,2019,7,0,8,"Braga",8,"Rua Costa Gomes",39,39,0,43,43,0
2,17,2019,8,0,8,"Braga",1,"Avenida da Liberdade",22,22,0,30,30,0
2,17,2019,8,0,8,"Braga",2,"Avenida Central",18,18,0,268,268,0
2,17,2019,8,0,8,"Braga",3,"Rua de Caires",34,34,0,37,37,0
2,17,2019,8,0,8,"Braga",4,"N14 Bosch",46,46,0,74,74,0
2,17,2019,8,0,8,"Braga",5,"Avenida João Paulo II",40,40,0,8,8,0
2,17,2019,8,0,8,"Braga",6,"Avenida Padre Júlio Fragata",61,61,0,20,20,0
2,17,2019,8,0,8,"Braga",7,"Rua Nova Santa Cruz",29,29,0,111,111,0
2,17,2019,8,0,8,"Braga",8,"Rua Costa Gomes",39,39,0,43,43,0
2,17,2019,9,0,8,"Braga",1,"Avenida da Liberdade",22,22,0,30,30,0
2,17,2019,9,0,8,"Braga",2,"Avenida Central",18,18,0,268,268,0
2,17,2019,9,0,8,"Braga",3,"Rua de Caires",34,34,0,37,37,0
2,17,2019,9,0,8,"Braga",4,"N14 Bosch",46,46,0,74,74,0
2,17,2019,9,0,8,"Braga",5,"Avenida João Paulo II",40,40,0,8,8,0
2,17,2019,9,0,8,"Braga",6,"Avenida Padre Júlio Fragata",61,61,0,20,20,0
2,17,2019,9,0,8,"Braga",7,"Rua Nova Santa Cruz",29,29,0,111,111,0
2,17,2019,9,0,8,"Braga",8,"Rua Costa Gomes",39,39,0,43,43,0
2,17,2019,10,0,8,"Braga",1,"Avenida da Liberdade",22,22,0,30,30,0
2,17,2019,10,0,8,"Braga",2,"Avenida Central",17,17,0,284,284,0
2,17,2019,10,0,8,"Braga",3,"Rua de Caires",34,34,0,37,37,0
2,17,2019,10,0,8,"Braga",4,"N14 Bosch",46,46,0,74,74,0
2,17,2019,10,0,8,"Braga",5,"Avenida João Paulo II",40,40,0,8,8,0
2,17,2019,10,0,8,"Braga",6,"Avenida Padre Júlio Fragata",61,61,0,20,20,0
2,17,2019,10,0,8,"Braga",7,"Rua Nova Santa Cruz",29,29,0,111,111,0
2,17,2019,10,0,8,"Braga",8,"Rua Costa Gomes",39,39,0,43,43,0
2,17,2019,11,0,8,"Braga",1,"Avenida da Liberdade",22,22,0,30,30,0
2,17,2019,11,0,8,"Braga",2,"Avenida Central",17,17,0,284,284,0
2,17,2019,11,0,8,"Braga",3,"Rua de Caires",34,34,0,37,37,0
2,17,2019,11,0,8,"Braga",4,"N14 Bosch",46,46,0,74,74,0
2,17,2019,11,0,8,"Braga",5,"Avenida João Paulo II",40,40,0,8,8,0
2,17,2019,11,0,8,"Braga",6,"Avenida Padre Júlio Fragata",61,61,0,20,20,0
2,17,2019,11,0,8,"Braga",7,"Rua Nova Santa Cruz",29,29,0,111,111,0
2,17,2019,11,0,8,"Braga",8,"Rua Costa Gomes",39,39,0,43,43,0
2,17,2019,12,0,8,"Braga",4,"N14 Bosch",46,46,0,74,74,0
2,17,2019,12,0,8,"Braga",5,"Avenida João Paulo II",40,40,0,8,8,0
2,17,2019,12,0,8,"Braga",6,"Avenida Padre Júlio Fragata",38,61,23,33,20,13
2,17,2019,12,0,8,"Braga",7,"Rua Nova Santa Cruz",29,29,0,111,111,0
2,17,2019,12,0,8,"Braga",8,"Rua Costa Gomes",29,39,10,57,43,14
2,17,2019,12,0,8,"Braga",1,"Avenida da Liberdade",22,22,0,30,30,0
2,17,2019,12,0,8,"Braga",2,"Avenida Central",17,17,0,284,284,0
2,17,2019,12,0,8,"Braga",3,"Rua de Caires",35,35,0,36,36,0
2,17,2019,12,0,8,"Braga",4,"N14 Bosch",46,46,0,74,74,0
2,17,2019,13,0,8,"Braga",1,"Avenida da Liberdade",22,22,0,30,30,0
2,17,2019,13,0,8,"Braga",2,"Avenida Central",17,17,0,284,284,0
2,17,2019,13,0,8,"Braga",3,"Rua de Caires",34,34,0,37,37,0
2,17,2019,13,0,8,"Braga",4,"N14 Bosch",45,45,0,75,75,0
2,17,2019,13,0,8,"Braga",5,"Avenida João Paulo II",40,40,0,8,8,0
2,17,2019,13,0,8,"Braga",6,"Avenida Padre Júlio Fragata",60,60,0,21,21,0
2,17,2019,13,0,8,"Braga",7,"Rua Nova Santa Cruz",29,29,0,111,111,0
2,17,2019,13,0,8,"Braga",8,"Rua Costa Gomes",40,40,0,42,42,0
2,17,2019,14,0,8,"Braga",1,"Avenida da Liberdade",22,22,0,30,30,0
2,17,2019,14,0,8,"Braga",2,"Avenida Central",17,17,0,284,284,0
2,17,2019,14,0,8,"Braga",3,"Rua de Caires",34,34,0,37,37,0
2,17,2019,14,0,8,"Braga",4,"N14 Bosch",45,45,0,75,75,0
2,17,2019,14,0,8,"Braga",5,"Avenida João Paulo II",40,40,0,8,8,0
2,17,2019,14,0,8,"Braga",6,"Avenida Padre Júlio Fragata",44,61,17,29,20,9
2,17,2019,14,0,8,"Braga",7,"Rua Nova Santa Cruz",29,29,0,111,111,0
2,17,2019,14,0,8,"Braga",8,"Rua Costa Gomes",39,39,0,43,43,0
2,17,2019,15,0,8,"Braga",1,"Avenida da Liberdade",22,22,0,30,30,0
2,17,2019,15,0,8,"Braga",2,"Avenida Central",17,17,0,284,284,0
2,17,2019,15,0,8,"Braga",3,"Rua de Caires",34,34,0,37,37,0
2,17,2019,15,0,8,"Braga",4,"N14 Bosch",35,45,10,97,75,22
2,17,2019,15,0,8,"Braga",5,"Avenida João Paulo II",29,40,11,11,8,3
2,17,2019,15,0,8,"Braga",6,"Avenida Padre Júlio Fragata",61,61,0,20,20,0
2,17,2019,15,0,8,"Braga",7,"Rua Nova Santa Cruz",29,29,0,111,111,0
2,17,2019,15,0,8,"Braga",8,"Rua Costa Gomes",22,40,18,76,42,34
2,17,2019,16,0,8,"Braga",1,"Avenida da Liberdade",22,22,0,30,30,0
2,17,2019,16,0,8,"Braga",2,"Avenida Central",13,17,4,372,284,88
2,17,2019,16,0,8,"Braga",3,"Rua de Caires",22,34,12,58,37,21
2,17,2019,16,0,8,"Braga",4,"N14 Bosch",33,45,12,103,75,28
2,17,2019,16,0,8,"Braga",5,"Avenida João Paulo II",25,40,15,13,8,5
2,17,2019,16,0,8,"Braga",6,"Avenida Padre Júlio Fragata",47,60,13,27,21,6
2,17,2019,16,0,8,"Braga",7,"Rua Nova Santa Cruz",29,29,0,111,111,0
2,17,2019,16,0,8,"Braga",8,"Rua Costa Gomes",29,40,11,57,42,15
2,17,2019,17,0,8,"Braga",1,"Avenida da Liberdade",22,22,0,30,30,0
2,17,2019,17,0,8,"Braga",2,"Avenida Central",17,17,0,284,284,0
2,17,2019,17,0,8,"Braga",3,"Rua de Caires",35,35,0,36,36,0
2,17,2019,17,0,8,"Braga",4,"N14 Bosch",45,45,0,75,75,0
2,17,2019,17,0,8,"Braga",5,"Avenida João Paulo II",23,39,16,14,8,6
2,17,2019,17,0,8,"Braga",6,"Avenida Padre Júlio Fragata",61,61,0,20,20,0
2,17,2019,17,0,8,"Braga",7,"Rua Nova Santa Cruz",23,29,6,140,111,29
2,17,2019,17,0,8,"Braga",8,"Rua Costa Gomes",30,39,9,56,43,13
2,17,2019,18,0,8,"Braga",1,"Avenida da Liberdade",22,22,0,30,30,0
2,17,2019,18,0,8,"Braga",2,"Avenida Central",18,18,0,268,268,0
2,17,2019,18,0,8,"Braga",3,"Rua de Caires",35,35,0,36,36,0
2,17,2019,18,0,8,"Braga",4,"N14 Bosch",46,46,0,74,74,0
2,17,2019,18,0,8,"Braga",5,"Avenida João Paulo II",29,39,10,11,8,3
2,17,2019,18,0,8,"Braga",6,"Avenida Padre Júlio Fragata",45,61,16,28,20,8
2,17,2019,18,0,8,"Braga",7,"Rua Nova Santa Cruz",28,28,0,115,115,0
2,17,2019,18,0,8,"Braga",8,"Rua Costa Gomes",30,39,9,56,43,13
2,17,2019,19,0,8,"Braga",1,"Avenida da Liberdade",22,22,0,30,30,0
2,17,2019,19,0,8,"Braga",2,"Avenida Central",18,18,0,268,268,0
2,17,2019,19,0,8,"Braga",3,"Rua de Caires",26,35,9,49,36,13
2,17,2019,19,0,8,"Braga",4,"N14 Bosch",45,45,0,75,75,0
2,17,2019,19,0,8,"Braga",5,"Avenida João Paulo II",39,39,0,8,8,0
2,17,2019,19,0,8,"Braga",6,"Avenida Padre Júlio Fragata",43,60,17,29,21,8
2,17,2019,19,0,8,"Braga",7,"Rua Nova Santa Cruz",28,28,0,115,115,0
2,17,2019,19,0,8,"Braga",8,"Rua Costa Gomes",31,40,9,54,42,12
2,17,2019,20,0,8,"Braga",1,"Avenida da Liberdade",22,22,0,30,30,0
2,17,2019,20,0,8,"Braga",2,"Avenida Central",17,17,0,284,284,0
2,17,2019,20,0,8,"Braga",3,"Rua de Caires",34,34,0,37,37,0
2,17,2019,20,0,8,"Braga",4,"N14 Bosch",45,45,0,75,75,0
2,17,2019,20,0,8,"Braga",5,"Avenida João Paulo II",39,39,0,8,8,0
2,17,2019,20,0,8,"Braga",6,"Avenida Padre Júlio Fragata",61,61,0,20,20,0
2,17,2019,20,0,8,"Braga",7,"Rua Nova Santa Cruz",28,28,0,115,115,0
2,17,2019,20,0,8,"Braga",8,"Rua Costa Gomes",40,40,0,42,42,0
2,17,2019,21,0,8,"Braga",1,"Avenida da Liberdade",22,22,0,30,30,0
2,17,2019,21,0,8,"Braga",2,"Avenida Central",17,17,0,284,284,0
2,17,2019,21,0,8,"Braga",3,"Rua de Caires",35,35,0,36,36,0
2,17,2019,21,0,8,"Braga",4,"N14 Bosch",45,45,0,75,75,0
2,17,2019,21,0,8,"Braga",5,"Avenida João Paulo II",39,39,0,8,8,0
2,17,2019,21,0,8,"Braga",6,"Avenida Padre Júlio Fragata",61,61,0,20,20,0
2,17,2019,21,0,8,"Braga",7,"Rua Nova Santa Cruz",28,28,0,115,115,0
2,17,2019,21,0,8,"Braga",8,"Rua Costa Gomes",40,40,0,42,42,0
2,17,2019,22,0,8,"Braga",1,"Avenida da Liberdade",22,22,0,30,30,0
2,17,2019,22,0,8,"Braga",2,"Avenida Central",17,17,0,284,284,0
2,17,2019,22,0,8,"Braga",3,"Rua de Caires",22,35,13,58,36,22
2,17,2019,22,0,8,"Braga",4,"N14 Bosch",45,45,0,75,75,0
2,17,2019,22,0,8,"Braga",5,"Avenida João Paulo II",39,39,0,8,8,0
2,17,2019,22,0,8,"Braga",6,"Avenida Padre Júlio Fragata",61,61,0,20,20,0
2,17,2019,22,0,8,"Braga",7,"Rua Nova Santa Cruz",28,28,0,115,115,0
2,17,2019,22,0,8,"Braga",8,"Rua Costa Gomes",40,40,0,42,42,0
2,17,2019,23,0,8,"Braga",1,"Avenida da Liberdade",22,22,0,30,30,0
2,17,2019,23,0,8,"Braga",2,"Avenida Central",17,17,0,284,284,0
2,17,2019,23,0,8,"Braga",3,"Rua de Caires",35,35,0,36,36,0
2,17,2019,23,0,8,"Braga",4,"N14 Bosch",45,45,0,75,75,0
2,17,2019,23,0,8,"Braga",5,"Avenida João Paulo II",39,39,0,8,8,0
2,17,2019,23,0,8,"Braga",6,"Avenida Padre Júlio Fragata",61,61,0,20,20,0
2,17,2019,23,0,8,"Braga",7,"Rua Nova Santa Cruz",28,28,0,115,115,0
2,17,2019,23,0,8,"Braga",8,"Rua Costa Gomes",40,40,0,42,42,0
2,18,2019,0,0,2,"Braga",1,"Avenida da Liberdade",22,22,0,30,30,0
2,18,2019,0,0,2,"Braga",2,"Avenida Central",17,17,0,284,284,0
2,18,2019,0,0,2,"Braga",3,"Rua de Caires",35,35,0,36,36,0
2,18,2019,0,0,2,"Braga",4,"N14 Bosch",45,45,0,75,75,0
2,18,2019,0,0,2,"Braga",5,"Avenida João Paulo II",39,39,0,8,8,0
2,18,2019,0,0,2,"Braga",6,"Avenida Padre Júlio Fragata",61,61,0,20,20,0
2,18,2019,0,0,2,"Braga",7,"Rua Nova Santa Cruz",28,28,0,115,115,0
2,18,2019,0,0,2,"Braga",8,"Rua Costa Gomes",40,40,0,42,42,0
2,18,2019,1,0,2,"Braga",1,"Avenida da Liberdade",22,22,0,30,30,0
2,18,2019,1,0,2,"Braga",2,"Avenida Central",17,17,0,284,284,0
2,18,2019,1,0,2,"Braga",3,"Rua de Caires",35,35,0,36,36,0
2,18,2019,1,0,2,"Braga",4,"N14 Bosch",45,45,0,75,75,0
2,18,2019,1,0,2,"Braga",5,"Avenida João Paulo II",39,39,0,8,8,0
2,18,2019,1,0,2,"Braga",6,"Avenida Padre Júlio Fragata",61,61,0,20,20,0
2,18,2019,1,0,2,"Braga",7,"Rua Nova Santa Cruz",28,28,0,115,115,0
2,18,2019,1,0,2,"Braga",8,"Rua Costa Gomes",40,40,0,42,42,0
2,18,2019,2,0,2,"Braga",1,"Avenida da Liberdade",22,22,0,30,30,0
2,18,2019,2,0,2,"Braga",2,"Avenida Central",17,17,0,284,284,0
2,18,2019,2,0,2,"Braga",3,"Rua de Caires",35,35,0,36,36,0
2,18,2019,2,0,2,"Braga",4,"N14 Bosch",45,45,0,75,75,0
2,18,2019,2,0,2,"Braga",5,"Avenida João Paulo II",39,39,0,8,8,0
2,18,2019,2,0,2,"Braga",6,"Avenida Padre Júlio Fragata",61,61,0,20,20,0
2,18,2019,2,0,2,"Braga",7,"Rua Nova Santa Cruz",28,28,0,115,115,0
2,18,2019,2,0,2,"Braga",8,"Rua Costa Gomes",40,40,0,42,42,0
2,18,2019,3,0,2,"Braga",1,"Avenida da Liberdade",22,22,0,30,30,0
2,18,2019,3,0,2,"Braga",2,"Avenida Central",17,17,0,284,284,0
2,18,2019,3,0,2,"Braga",3,"Rua de Caires",35,35,0,36,36,0
2,18,2019,3,0,2,"Braga",4,"N14 Bosch",45,45,0,75,75,0
2,18,2019,3,0,2,"Braga",5,"Avenida João Paulo II",39,39,0,8,8,0
2,18,2019,3,0,2,"Braga",6,"Avenida Padre Júlio Fragata",61,61,0,20,20,0
2,18,2019,3,0,2,"Braga",7,"Rua Nova Santa Cruz",28,28,0,115,115,0
2,18,2019,3,0,2,"Braga",8,"Rua Costa Gomes",40,40,0,42,42,0
2,18,2019,4,0,2,"Braga",1,"Avenida da Liberdade",22,22,0,30,30,0
2,18,2019,4,0,2,"Braga",2,"Avenida Central",17,17,0,284,284,0
2,18,2019,4,0,2,"Braga",3,"Rua de Caires",35,35,0,36,36,0
2,18,2019,4,0,2,"Braga",4,"N14 Bosch",45,45,0,75,75,0
2,18,2019,4,0,2,"Braga",5,"Avenida João Paulo II",39,39,0,8,8,0
2,18,2019,4,0,2,"Braga",6,"Avenida Padre Júlio Fragata",61,61,0,20,20,0
2,18,2019,4,0,2,"Braga",7,"Rua Nova Santa Cruz",28,28,0,115,115,0
2,18,2019,4,0,2,"Braga",8,"Rua Costa Gomes",40,40,0,42,42,0
2,18,2019,5,0,2,"Braga",1,"Avenida da Liberdade",22,22,0,30,30,0
2,18,2019,5,0,2,"Braga",2,"Avenida Central",17,17,0,284,284,0
2,18,2019,5,0,2,"Braga",3,"Rua de Caires",35,35,0,36,36,0
2,18,2019,5,0,2,"Braga",4,"N14 Bosch",45,45,0,75,75,0
2,18,2019,5,0,2,"Braga",5,"Avenida João Paulo II",39,39,0,8,8,0
2,18,2019,5,0,2,"Braga",6,"Avenida Padre Júlio Fragata",61,61,0,20,20,0
2,18,2019,5,0,2,"Braga",7,"Rua Nova Santa Cruz",28,28,0,115,115,0
2,18,2019,5,0,2,"Braga",8,"Rua Costa Gomes",40,40,0,42,42,0
2,18,2019,6,0,2,"Braga",1,"Avenida da Liberdade",22,22,0,30,30,0
2,18,2019,6,0,2,"Braga",2,"Avenida Central",17,17,0,284,284,0
2,18,2019,6,0,2,"Braga",3,"Rua de Caires",35,35,0,36,36,0
2,18,2019,6,0,2,"Braga",4,"N14 Bosch",45,45,0,75,75,0
2,18,2019,6,0,2,"Braga",5,"Avenida João Paulo II",39,39,0,8,8,0
2,18,2019,6,0,2,"Braga",6,"Avenida Padre Júlio Fragata",61,61,0,20,20,0
2,18,2019,6,0,2,"Braga",7,"Rua Nova Santa Cruz",28,28,0,115,115,0
2,18,2019,6,0,2,"Braga",8,"Rua Costa Gomes",40,40,0,42,42,0
2,18,2019,7,0,2,"Braga",1,"Avenida da Liberdade",22,22,0,30,30,0
2,18,2019,7,0,2,"Braga",2,"Avenida Central",17,17,0,284,284,0
2,18,2019,7,0,2,"Braga",3,"Rua de Caires",35,35,0,36,36,0
2,18,2019,7,0,2,"Braga",4,"N14 Bosch",45,45,0,75,75,0
2,18,2019,7,0,2,"Braga",5,"Avenida João Paulo II",39,39,0,8,8,0
2,18,2019,7,0,2,"Braga",6,"Avenida Padre Júlio Fragata",61,61,0,20,20,0
2,18,2019,7,0,2,"Braga",7,"Rua Nova Santa Cruz",28,28,0,115,115,0
2,18,2019,7,0,2,"Braga",8,"Rua Costa Gomes",40,40,0,42,42,0
2,18,2019,8,0,2,"Braga",1,"Avenida da Liberdade",22,22,0,30,30,0
2,18,2019,8,0,2,"Braga",2,"Avenida Central",17,17,0,284,284,0
2,18,2019,8,0,2,"Braga",3,"Rua de Caires",26,35,9,49,36,13
2,18,2019,8,0,2,"Braga",4,"N14 Bosch",35,46,11,97,74,23
2,18,2019,8,0,2,"Braga",5,"Avenida João Paulo II",39,39,0,8,8,0
2,18,2019,8,0,2,"Braga",6,"Avenida Padre Júlio Fragata",61,61,0,20,20,0
2,18,2019,8,0,2,"Braga",7,"Rua Nova Santa Cruz",28,28,0,115,115,0
2,18,2019,8,0,2,"Braga",8,"Rua Costa Gomes",28,39,11,60,43,17
2,18,2019,9,0,2,"Braga",1,"Avenida da Liberdade",15,21,6,44,32,12
2,18,2019,9,0,2,"Braga",2,"Avenida Central",14,18,4,345,268,77
2,18,2019,9,0,2,"Braga",3,"Rua de Caires",18,34,16,71,37,34
2,18,2019,9,0,2,"Braga",4,"N14 Bosch",27,45,18,126,75,51
2,18,2019,9,0,2,"Braga",5,"Avenida João Paulo II",21,39,18,16,8,8
2,18,2019,9,0,2,"Braga",6,"Avenida Padre Júlio Fragata",31,61,30,41,20,21
2,18,2019,9,0,2,"Braga",7,"Rua Nova Santa Cruz",18,29,11,179,111,68
2,18,2019,9,0,2,"Braga",8,"Rua Costa Gomes",39,39,0,43,43,0
2,18,2019,10,0,2,"Braga",4,"N14 Bosch",25,46,21,136,74,62
2,18,2019,10,0,2,"Braga",5,"Avenida João Paulo II",40,40,0,8,8,0
2,18,2019,10,0,2,"Braga",6,"Avenida Padre Júlio Fragata",61,61,0,20,20,0
2,18,2019,10,0,2,"Braga",7,"Rua Nova Santa Cruz",22,29,7,146,111,35
2,18,2019,10,0,2,"Braga",8,"Rua Costa Gomes",30,40,10,56,42,14
2,18,2019,10,0,2,"Braga",1,"Avenida da Liberdade",17,22,5,39,30,9
2,18,2019,10,0,2,"Braga",2,"Avenida Central",12,18,6,403,268,135
2,18,2019,10,0,2,"Braga",3,"Rua de Caires",24,35,11,53,36,17
2,18,2019,10,0,2,"Braga",4,"N14 Bosch",25,46,21,136,74,62
2,18,2019,11,0,2,"Braga",1,"Avenida da Liberdade",22,22,0,30,30,0
2,18,2019,11,0,2,"Braga",2,"Avenida Central",17,17,0,284,284,0
2,18,2019,11,0,2,"Braga",3,"Rua de Caires",17,34,17,75,37,38
2,18,2019,11,0,2,"Braga",4,"N14 Bosch",33,45,12,103,75,28
2,18,2019,11,0,2,"Braga",5,"Avenida João Paulo II",40,40,0,8,8,0
2,18,2019,11,0,2,"Braga",6,"Avenida Padre Júlio Fragata",61,61,0,20,20,0
2,18,2019,11,0,2,"Braga",7,"Rua Nova Santa Cruz",22,29,7,146,111,35
2,18,2019,11,0,2,"Braga",8,"Rua Costa Gomes",30,39,9,56,43,13
2,18,2019,12,0,2,"Braga",1,"Avenida da Liberdade",18,22,4,37,30,7
2,18,2019,12,0,2,"Braga",2,"Avenida Central",13,18,5,372,268,104
2,18,2019,12,0,2,"Braga",3,"Rua de Caires",25,34,9,51,37,14
2,18,2019,12,0,2,"Braga",4,"N14 Bosch",45,45,0,75,75,0
2,18,2019,12,0,2,"Braga",5,"Avenida João Paulo II",39,39,0,8,8,0
2,18,2019,12,0,2,"Braga",6,"Avenida Padre Júlio Fragata",61,61,0,20,20,0
2,18,2019,12,0,2,"Braga",7,"Rua Nova Santa Cruz",29,29,0,111,111,0
2,18,2019,12,0,2,"Braga",8,"Rua Costa Gomes",24,40,16,70,42,28
2,18,2019,13,0,2,"Braga",1,"Avenida da Liberdade",22,22,0,30,30,0
2,18,2019,13,0,2,"Braga",2,"Avenida Central",18,18,0,268,268,0
2,18,2019,13,0,2,"Braga",3,"Rua de Caires",24,35,11,53,36,17
2,18,2019,13,0,2,"Braga",4,"N14 Bosch",34,45,11,100,75,25
2,18,2019,13,0,2,"Braga",5,"Avenida João Paulo II",39,39,0,8,8,0
2,18,2019,13,0,2,"Braga",6,"Avenida Padre Júlio Fragata",61,61,0,20,20,0
2,18,2019,13,0,2,"Braga",7,"Rua Nova Santa Cruz",12,30,18,268,107,161
2,18,2019,13,0,2,"Braga",8,"Rua Costa Gomes",23,39,16,73,43,30
2,18,2019,14,0,2,"Braga",1,"Avenida da Liberdade",22,22,0,30,30,0
2,18,2019,14,0,2,"Braga",2,"Avenida Central",17,17,0,284,284,0
2,18,2019,14,0,2,"Braga",3,"Rua de Caires",35,35,0,36,36,0
2,18,2019,14,0,2,"Braga",4,"N14 Bosch",28,46,18,121,74,47
2,18,2019,14,0,2,"Braga",5,"Avenida João Paulo II",9,38,29,38,9,29
2,18,2019,14,0,2,"Braga",6,"Avenida Padre Júlio Fragata",13,59,46,98,21,77
2,18,2019,14,0,2,"Braga",7,"Rua Nova Santa Cruz",20,28,8,161,115,46
2,18,2019,14,0,2,"Braga",8,"Rua Costa Gomes",29,39,10,57,43,14
2,18,2019,15,0,2,"Braga",1,"Avenida da Liberdade",21,21,0,32,32,0
2,18,2019,15,0,2,"Braga",2,"Avenida Central",17,17,0,284,284,0
2,18,2019,15,0,2,"Braga",3,"Rua de Caires",26,35,9,49,36,13
2,18,2019,15,0,2,"Braga",4,"N14 Bosch",46,46,0,74,74,0
2,18,2019,15,0,2,"Braga",5,"Avenida João Paulo II",30,40,10,11,8,3
2,18,2019,15,0,2,"Braga",6,"Avenida Padre Júlio Fragata",60,60,0,21,21,0
2,18,2019,15,0,2,"Braga",7,"Rua Nova Santa Cruz",19,29,10,169,111,58
2,18,2019,15,0,2,"Braga",8,"Rua Costa Gomes",30,39,9,56,43,13
2,18,2019,16,0,2,"Braga",1,"Avenida da Liberdade",17,21,4,39,32,7
2,18,2019,16,0,2,"Braga",2,"Avenida Central",12,17,5,403,284,119
2,18,2019,16,0,2,"Braga",3,"Rua de Caires",25,35,10,51,36,15
2,18,2019,16,0,2,"Braga",4,"N14 Bosch",27,45,18,126,75,51
2,18,2019,16,0,2,"Braga",5,"Avenida João Paulo II",30,40,10,11,8,3
2,18,2019,16,0,2,"Braga",6,"Avenida Padre Júlio Fragata",61,61,0,20,20,0
2,18,2019,16,0,2,"Braga",7,"Rua Nova Santa Cruz",17,29,12,189,111,78
2,18,2019,16,0,2,"Braga",8,"Rua Costa Gomes",28,40,12,60,42,18
2,18,2019,17,0,2,"Braga",1,"Avenida da Liberdade",18,22,4,37,30,7
2,18,2019,17,0,2,"Braga",2,"Avenida Central",11,18,7,439,268,171
2,18,2019,17,0,2,"Braga",3,"Rua de Caires",22,35,13,58,36,22
2,18,2019,17,0,2,"Braga",4,"N14 Bosch",24,45,21,142,75,67
2,18,2019,17,0,2,"Braga",5,"Avenida João Paulo II",31,39,8,11,8,3
2,18,2019,17,0,2,"Braga",6,"Avenida Padre Júlio Fragata",61,61,0,20,20,0
2,18,2019,17,0,2,"Braga",7,"Rua Nova Santa Cruz",12,29,17,268,111,157
2,18,2019,17,0,2,"Braga",8,"Rua Costa Gomes",17,39,22,98,43,55
2,18,2019,18,0,2,"Braga",1,"Avenida da Liberdade",16,22,6,42,30,12
2,18,2019,18,0,2,"Braga",2,"Avenida Central",10,18,8,483,268,215
2,18,2019,18,0,2,"Braga",3,"Rua de Caires",24,35,11,53,36,17
2,18,2019,18,0,2,"Braga",4,"N14 Bosch",13,44,31,262,77,185
2,18,2019,18,0,2,"Braga",5,"Avenida João Paulo II",25,40,15,13,8,5
2,18,2019,18,0,2,"Braga",6,"Avenida Padre Júlio Fragata",40,60,20,31,21,10
2,18,2019,18,0,2,"Braga",7,"Rua Nova Santa Cruz",12,28,16,268,115,153
2,18,2019,18,0,2,"Braga",8,"Rua Costa Gomes",17,39,22,98,43,55
2,18,2019,19,0,2,"Braga",1,"Avenida da Liberdade",14,21,7,48,32,16
2,18,2019,19,0,2,"Braga",2,"Avenida Central",7,17,10,691,284,407
2,18,2019,19,0,2,"Braga",3,"Rua de Caires",24,35,11,53,36,17
2,18,2019,19,0,2,"Braga",4,"N14 Bosch",17,46,29,200,74,126
2,18,2019,19,0,2,"Braga",5,"Avenida João Paulo II",11,40,29,31,8,23
2,18,2019,19,0,2,"Braga",6,"Avenida Padre Júlio Fragata",26,61,35,49,20,29
2,18,2019,19,0,2,"Braga",7,"Rua Nova Santa Cruz",11,27,16,293,119,174
2,18,2019,19,0,2,"Braga",8,"Rua Costa Gomes",15,40,25,112,42,70
2,18,2019,20,0,2,"Braga",1,"Avenida da Liberdade",21,21,0,32,32,0
2,18,2019,20,0,2,"Braga",2,"Avenida Central",18,18,0,268,268,0
2,18,2019,20,0,2,"Braga",3,"Rua de Caires",35,35,0,36,36,0
2,18,2019,20,0,2,"Braga",4,"N14 Bosch",36,46,10,94,74,20
2,18,2019,20,0,2,"Braga",5,"Avenida João Paulo II",40,40,0,8,8,0
2,18,2019,20,0,2,"Braga",6,"Avenida Padre Júlio Fragata",48,60,12,26,21,5
2,18,2019,20,0,2,"Braga",7,"Rua Nova Santa Cruz",21,29,8,153,111,42
2,18,2019,20,0,2,"Braga",8,"Rua Costa Gomes",28,40,12,60,42,18
2,18,2019,21,0,2,"Braga",1,"Avenida da Liberdade",21,21,0,32,32,0
2,18,2019,21,0,2,"Braga",2,"Avenida Central",18,18,0,268,268,0
2,18,2019,21,0,2,"Braga",3,"Rua de Caires",35,35,0,36,36,0
2,18,2019,21,0,2,"Braga",4,"N14 Bosch",45,45,0,75,75,0
2,18,2019,21,0,2,"Braga",5,"Avenida João Paulo II",39,39,0,8,8,0
2,18,2019,21,0,2,"Braga",6,"Avenida Padre Júlio Fragata",60,60,0,21,21,0
2,18,2019,21,0,2,"Braga",7,"Rua Nova Santa Cruz",28,28,0,115,115,0
2,18,2019,21,0,2,"Braga",8,"Rua Costa Gomes",32,40,8,52,42,10
2,18,2019,22,0,2,"Braga",1,"Avenida da Liberdade",21,21,0,32,32,0
2,18,2019,22,0,2,"Braga",2,"Avenida Central",18,18,0,268,268,0
2,18,2019,22,0,2,"Braga",3,"Rua de Caires",35,35,0,36,36,0
2,18,2019,22,0,2,"Braga",4,"N14 Bosch",45,45,0,75,75,0
2,18,2019,22,0,2,"Braga",5,"Avenida João Paulo II",39,39,0,8,8,0
2,18,2019,22,0,2,"Braga",6,"Avenida Padre Júlio Fragata",60,60,0,21,21,0
2,18,2019,22,0,2,"Braga",7,"Rua Nova Santa Cruz",28,28,0,115,115,0
2,18,2019,22,0,2,"Braga",8,"Rua Costa Gomes",40,40,0,42,42,0
2,18,2019,23,0,2,"Braga",1,"Avenida da Liberdade",21,21,0,32,32,0
2,18,2019,23,0,2,"Braga",2,"Avenida Central",18,18,0,268,268,0
2,18,2019,23,0,2,"Braga",3,"Rua de Caires",35,35,0,36,36,0
2,18,2019,23,0,2,"Braga",4,"N14 Bosch",45,45,0,75,75,0
2,18,2019,23,0,2,"Braga",5,"Avenida João Paulo II",39,39,0,8,8,0
2,18,2019,23,0,2,"Braga",6,"Avenida Padre Júlio Fragata",60,60,0,21,21,0
2,18,2019,23,0,2,"Braga",7,"Rua Nova Santa Cruz",28,28,0,115,115,0
2,18,2019,23,0,2,"Braga",8,"Rua Costa Gomes",40,40,0,42,42,0
2,19,2019,0,0,3,"Braga",1,"Avenida da Liberdade",21,21,0,32,32,0
2,19,2019,0,0,3,"Braga",2,"Avenida Central",18,18,0,268,268,0
2,19,2019,0,0,3,"Braga",3,"Rua de Caires",35,35,0,36,36,0
2,19,2019,0,0,3,"Braga",4,"N14 Bosch",45,45,0,75,75,0
2,19,2019,0,0,3,"Braga",5,"Avenida João Paulo II",39,39,0,8,8,0
2,19,2019,0,0,3,"Braga",6,"Avenida Padre Júlio Fragata",60,60,0,21,21,0
2,19,2019,0,0,3,"Braga",7,"Rua Nova Santa Cruz",28,28,0,115,115,0
2,19,2019,0,0,3,"Braga",8,"Rua Costa Gomes",40,40,0,42,42,0
2,19,2019,1,0,3,"Braga",1,"Avenida da Liberdade",21,21,0,32,32,0
2,19,2019,1,0,3,"Braga",2,"Avenida Central",18,18,0,268,268,0
2,19,2019,1,0,3,"Braga",3,"Rua de Caires",35,35,0,36,36,0
2,19,2019,1,0,3,"Braga",4,"N14 Bosch",45,45,0,75,75,0
2,19,2019,1,0,3,"Braga",5,"Avenida João Paulo II",39,39,0,8,8,0
2,19,2019,1,0,3,"Braga",6,"Avenida Padre Júlio Fragata",60,60,0,21,21,0
2,19,2019,1,0,3,"Braga",7,"Rua Nova Santa Cruz",28,28,0,115,115,0
2,19,2019,1,0,3,"Braga",8,"Rua Costa Gomes",40,40,0,42,42,0
2,19,2019,2,0,3,"Braga",1,"Avenida da Liberdade",21,21,0,32,32,0
2,19,2019,2,0,3,"Braga",2,"Avenida Central",18,18,0,268,268,0
2,19,2019,2,0,3,"Braga",3,"Rua de Caires",35,35,0,36,36,0
2,19,2019,2,0,3,"Braga",4,"N14 Bosch",45,45,0,75,75,0
2,19,2019,2,0,3,"Braga",5,"Avenida João Paulo II",39,39,0,8,8,0
2,19,2019,2,0,3,"Braga",6,"Avenida Padre Júlio Fragata",60,60,0,21,21,0
2,19,2019,2,0,3,"Braga",7,"Rua Nova Santa Cruz",28,28,0,115,115,0
2,19,2019,2,0,3,"Braga",8,"Rua Costa Gomes",40,40,0,42,42,0
2,19,2019,3,0,3,"Braga",1,"Avenida da Liberdade",21,21,0,32,32,0
2,19,2019,3,0,3,"Braga",2,"Avenida Central",18,18,0,268,268,0
2,19,2019,3,0,3,"Braga",3,"Rua de Caires",35,35,0,36,36,0
2,19,2019,3,0,3,"Braga",4,"N14 Bosch",45,45,0,75,75,0
2,19,2019,3,0,3,"Braga",5,"Avenida João Paulo II",39,39,0,8,8,0
2,19,2019,3,0,3,"Braga",6,"Avenida Padre Júlio Fragata",60,60,0,21,21,0
2,19,2019,3,0,3,"Braga",7,"Rua Nova Santa Cruz",28,28,0,115,115,0
2,19,2019,3,0,3,"Braga",8,"Rua Costa Gomes",40,40,0,42,42,0
2,19,2019,4,0,3,"Braga",1,"Avenida da Liberdade",21,21,0,32,32,0
2,19,2019,4,0,3,"Braga",2,"Avenida Central",18,18,0,268,268,0
2,19,2019,4,0,3,"Braga",3,"Rua de Caires",35,35,0,36,36,0
2,19,2019,4,0,3,"Braga",4,"N14 Bosch",45,45,0,75,75,0
2,19,2019,4,0,3,"Braga",5,"Avenida João Paulo II",39,39,0,8,8,0
2,19,2019,4,0,3,"Braga",6,"Avenida Padre Júlio Fragata",60,60,0,21,21,0
2,19,2019,4,0,3,"Braga",7,"Rua Nova Santa Cruz",28,28,0,115,115,0
2,19,2019,4,0,3,"Braga",8,"Rua Costa Gomes",40,40,0,42,42,0
2,19,2019,5,0,3,"Braga",1,"Avenida da Liberdade",21,21,0,32,32,0
2,19,2019,5,0,3,"Braga",2,"Avenida Central",18,18,0,268,268,0
2,19,2019,5,0,3,"Braga",3,"Rua de Caires",35,35,0,36,36,0
2,19,2019,5,0,3,"Braga",4,"N14 Bosch",45,45,0,75,75,0
2,19,2019,5,0,3,"Braga",5,"Avenida João Paulo II",39,39,0,8,8,0
2,19,2019,5,0,3,"Braga",6,"Avenida Padre Júlio Fragata",60,60,0,21,21,0
2,19,2019,5,0,3,"Braga",7,"Rua Nova Santa Cruz",28,28,0,115,115,0
2,19,2019,5,0,3,"Braga",8,"Rua Costa Gomes",40,40,0,42,42,0
2,19,2019,6,0,3,"Braga",1,"Avenida da Liberdade",21,21,0,32,32,0
2,19,2019,6,0,3,"Braga",2,"Avenida Central",18,18,0,268,268,0
2,19,2019,6,0,3,"Braga",3,"Rua de Caires",35,35,0,36,36,0
2,19,2019,6,0,3,"Braga",4,"N14 Bosch",45,45,0,75,75,0
2,19,2019,6,0,3,"Braga",5,"Avenida João Paulo II",39,39,0,8,8,0
2,19,2019,6,0,3,"Braga",6,"Avenida Padre Júlio Fragata",60,60,0,21,21,0
2,19,2019,6,0,3,"Braga",7,"Rua Nova Santa Cruz",28,28,0,115,115,0
2,19,2019,6,0,3,"Braga",8,"Rua Costa Gomes",40,40,0,42,42,0
2,19,2019,7,0,3,"Braga",7,"Rua Nova Santa Cruz",28,28,0,115,115,0
2,19,2019,7,0,3,"Braga",8,"Rua Costa Gomes",40,40,0,42,42,0
2,19,2019,7,0,3,"Braga",1,"Avenida da Liberdade",21,21,0,32,32,0
2,19,2019,7,0,3,"Braga",2,"Avenida Central",18,18,0,268,268,0
2,19,2019,7,0,3,"Braga",3,"Rua de Caires",35,35,0,36,36,0
2,19,2019,7,0,3,"Braga",4,"N14 Bosch",45,45,0,75,75,0
2,19,2019,7,0,3,"Braga",5,"Avenida João Paulo II",39,39,0,8,8,0
2,19,2019,7,0,3,"Braga",6,"Avenida Padre Júlio Fragata",60,60,0,21,21,0
2,19,2019,7,0,3,"Braga",7,"Rua Nova Santa Cruz",28,28,0,115,115,0
2,19,2019,8,0,3,"Braga",1,"Avenida da Liberdade",21,21,0,32,32,0
2,19,2019,8,0,3,"Braga",2,"Avenida Central",18,18,0,268,268,0
2,19,2019,8,0,3,"Braga",3,"Rua de Caires",26,35,9,49,36,13
2,19,2019,8,0,3,"Braga",4,"N14 Bosch",33,46,13,103,74,29
2,19,2019,8,0,3,"Braga",5,"Avenida João Paulo II",39,39,0,8,8,0
2,19,2019,8,0,3,"Braga",6,"Avenida Padre Júlio Fragata",60,60,0,21,21,0
2,19,2019,8,0,3,"Braga",7,"Rua Nova Santa Cruz",28,28,0,115,115,0
2,19,2019,8,0,3,"Braga",8,"Rua Costa Gomes",28,40,12,60,42,18
2,19,2019,9,0,3,"Braga",1,"Avenida da Liberdade",21,21,0,32,32,0
2,19,2019,9,0,3,"Braga",2,"Avenida Central",12,18,6,403,268,135
2,19,2019,9,0,3,"Braga",3,"Rua de Caires",19,35,16,67,36,31
2,19,2019,9,0,3,"Braga",4,"N14 Bosch",33,46,13,103,74,29
2,19,2019,9,0,3,"Braga",5,"Avenida João Paulo II",39,39,0,8,8,0
2,19,2019,9,0,3,"Braga",6,"Avenida Padre Júlio Fragata",37,61,24,34,20,14
2,19,2019,9,0,3,"Braga",7,"Rua Nova Santa Cruz",28,28,0,115,115,0
2,19,2019,9,0,3,"Braga",8,"Rua Costa Gomes",28,39,11,60,43,17
2,19,2019,10,0,3,"Braga",1,"Avenida da Liberdade",22,22,0,30,30,0
2,19,2019,10,0,3,"Braga",2,"Avenida Central",13,18,5,372,268,104
2,19,2019,10,0,3,"Braga",3,"Rua de Caires",23,35,12,55,36,19
2,19,2019,10,0,3,"Braga",4,"N14 Bosch",22,47,25,155,72,83
2,19,2019,10,0,3,"Braga",5,"Avenida João Paulo II",32,40,8,10,8,2
2,19,2019,10,0,3,"Braga",6,"Avenida Padre Júlio Fragata",60,60,0,21,21,0
2,19,2019,10,0,3,"Braga",7,"Rua Nova Santa Cruz",28,28,0,115,115,0
2,19,2019,10,0,3,"Braga",8,"Rua Costa Gomes",30,40,10,56,42,14
2,19,2019,11,0,3,"Braga",1,"Avenida da Liberdade",17,21,4,39,32,7
2,19,2019,11,0,3,"Braga",2,"Avenida Central",14,18,4,345,268,77
2,19,2019,11,0,3,"Braga",3,"Rua de Caires",23,35,12,55,36,19
2,19,2019,11,0,3,"Braga",4,"N14 Bosch",29,46,17,117,74,43
2,19,2019,11,0,3,"Braga",5,"Avenida João Paulo II",40,40,0,8,8,0
2,19,2019,11,0,3,"Braga",6,"Avenida Padre Júlio Fragata",60,60,0,21,21,0
2,19,2019,11,0,3,"Braga",7,"Rua Nova Santa Cruz",28,28,0,115,115,0
2,19,2019,11,0,3,"Braga",8,"Rua Costa Gomes",29,39,10,57,43,14
2,19,2019,12,0,3,"Braga",1,"Avenida da Liberdade",22,22,0,30,30,0
2,19,2019,12,0,3,"Braga",2,"Avenida Central",12,17,5,403,284,119
2,19,2019,12,0,3,"Braga",3,"Rua de Caires",27,35,8,47,36,11
2,19,2019,12,0,3,"Braga",4,"N14 Bosch",28,46,18,121,74,47
2,19,2019,12,0,3,"Braga",5,"Avenida João Paulo II",32,40,8,10,8,2
2,19,2019,12,0,3,"Braga",6,"Avenida Padre Júlio Fragata",61,61,0,20,20,0
2,19,2019,12,0,3,"Braga",7,"Rua Nova Santa Cruz",21,28,7,153,115,38
2,19,2019,12,0,3,"Braga",8,"Rua Costa Gomes",29,39,10,57,43,14
2,19,2019,13,0,3,"Braga",1,"Avenida da Liberdade",22,22,0,30,30,0
2,19,2019,13,0,3,"Braga",2,"Avenida Central",12,17,5,403,284,119
2,19,2019,13,0,3,"Braga",3,"Rua de Caires",19,35,16,67,36,31
2,19,2019,13,0,3,"Braga",4,"N14 Bosch",30,45,15,113,75,38
2,19,2019,13,0,3,"Braga",5,"Avenida João Paulo II",40,40,0,8,8,0
2,19,2019,13,0,3,"Braga",6,"Avenida Padre Júlio Fragata",61,61,0,20,20,0
2,19,2019,13,0,3,"Braga",7,"Rua Nova Santa Cruz",15,28,13,215,115,100
2,19,2019,13,0,3,"Braga",8,"Rua Costa Gomes",30,40,10,56,42,14
2,19,2019,14,0,3,"Braga",1,"Avenida da Liberdade",22,22,0,30,30,0
2,19,2019,14,0,3,"Braga",2,"Avenida Central",17,17,0,284,284,0
2,19,2019,14,0,3,"Braga",3,"Rua de Caires",24,35,11,53,36,17
2,19,2019,14,0,3,"Braga",4,"N14 Bosch",17,47,30,200,72,128
2,19,2019,14,0,3,"Braga",5,"Avenida João Paulo II",40,40,0,8,8,0
2,19,2019,14,0,3,"Braga",6,"Avenida Padre Júlio Fragata",61,61,0,20,20,0
2,19,2019,14,0,3,"Braga",7,"Rua Nova Santa Cruz",19,29,10,169,111,58
2,19,2019,14,0,3,"Braga",8,"Rua Costa Gomes",31,40,9,54,42,12
2,19,2019,15,0,3,"Braga",1,"Avenida da Liberdade",22,22,0,30,30,0
2,19,2019,15,0,3,"Braga",2,"Avenida Central",18,18,0,268,268,0
2,19,2019,15,0,3,"Braga",3,"Rua de Caires",34,34,0,37,37,0
2,19,2019,15,0,3,"Braga",4,"N14 Bosch",28,45,17,121,75,46
2,19,2019,15,0,3,"Braga",5,"Avenida João Paulo II",27,40,13,12,8,4
2,19,2019,15,0,3,"Braga",6,"Avenida Padre Júlio Fragata",61,61,0,20,20,0
2,19,2019,15,0,3,"Braga",7,"Rua Nova Santa Cruz",12,28,16,268,115,153
2,19,2019,15,0,3,"Braga",8,"Rua Costa Gomes",30,39,9,56,43,13
2,19,2019,16,0,3,"Braga",1,"Avenida da Liberdade",17,21,4,39,32,7
2,19,2019,16,0,3,"Braga",2,"Avenida Central",11,17,6,439,284,155
2,19,2019,16,0,3,"Braga",3,"Rua de Caires",35,35,0,36,36,0
2,19,2019,16,0,3,"Braga",4,"N14 Bosch",15,45,30,227,75,152
2,19,2019,16,0,3,"Braga",5,"Avenida João Paulo II",28,40,12,12,8,4
2,19,2019,16,0,3,"Braga",6,"Avenida Padre Júlio Fragata",60,60,0,21,21,0
2,19,2019,16,0,3,"Braga",7,"Rua Nova Santa Cruz",20,28,8,161,115,46
2,19,2019,16,0,3,"Braga",8,"Rua Costa Gomes",30,39,9,56,43,13
2,19,2019,17,0,3,"Braga",1,"Avenida da Liberdade",18,22,4,37,30,7
2,19,2019,17,0,3,"Braga",2,"Avenida Central",11,18,7,439,268,171
2,19,2019,17,0,3,"Braga",3,"Rua de Caires",13,35,22,98,36,62
2,19,2019,17,0,3,"Braga",4,"N14 Bosch",30,46,16,113,74,39
2,19,2019,17,0,3,"Braga",5,"Avenida João Paulo II",27,39,12,12,8,4
2,19,2019,17,0,3,"Braga",6,"Avenida Padre Júlio Fragata",47,60,13,27,21,6
2,19,2019,17,0,3,"Braga",7,"Rua Nova Santa Cruz",16,29,13,201,111,90
2,19,2019,17,0,3,"Braga",8,"Rua Costa Gomes",23,39,16,73,43,30
2,19,2019,18,0,3,"Braga",1,"Avenida da Liberdade",17,21,4,39,32,7
2,19,2019,18,0,3,"Braga",2,"Avenida Central",7,17,10,691,284,407
2,19,2019,18,0,3,"Braga",3,"Rua de Caires",17,36,19,75,35,40
2,19,2019,18,0,3,"Braga",4,"N14 Bosch",19,46,27,179,74,105
2,19,2019,18,0,3,"Braga",5,"Avenida João Paulo II",9,41,32,38,8,30
2,19,2019,18,0,3,"Braga",6,"Avenida Padre Júlio Fragata",22,60,38,58,21,37
2,19,2019,18,0,3,"Braga",7,"Rua Nova Santa Cruz",6,28,22,537,115,422
2,19,2019,18,0,3,"Braga",8,"Rua Costa Gomes",17,40,23,98,42,56
2,19,2019,19,0,3,"Braga",7,"Rua Nova Santa Cruz",11,29,18,293,111,182
2,19,2019,19,0,3,"Braga",8,"Rua Costa Gomes",7,40,33,240,42,198
2,19,2019,19,0,3,"Braga",1,"Avenida da Liberdade",14,22,8,48,30,18
2,19,2019,19,0,3,"Braga",2,"Avenida Central",6,18,12,806,268,538
2,19,2019,19,0,3,"Braga",3,"Rua de Caires",19,35,16,67,36,31
2,19,2019,19,0,3,"Braga",4,"N14 Bosch",29,46,17,117,74,43
2,19,2019,19,0,3,"Braga",5,"Avenida João Paulo II",25,40,15,13,8,5
2,19,2019,19,0,3,"Braga",6,"Avenida Padre Júlio Fragata",19,61,42,67,20,47
2,19,2019,19,0,3,"Braga",7,"Rua Nova Santa Cruz",11,29,18,293,111,182
2,19,2019,20,0,3,"Braga",1,"Avenida da Liberdade",16,22,6,42,30,12
2,19,2019,20,0,3,"Braga",2,"Avenida Central",17,17,0,284,284,0
2,19,2019,20,0,3,"Braga",3,"Rua de Caires",28,35,7,45,36,9
2,19,2019,20,0,3,"Braga",4,"N14 Bosch",34,46,12,100,74,26
2,19,2019,20,0,3,"Braga",5,"Avenida João Paulo II",30,40,10,11,8,3
2,19,2019,20,0,3,"Braga",6,"Avenida Padre Júlio Fragata",60,60,0,21,21,0
2,19,2019,20,0,3,"Braga",7,"Rua Nova Santa Cruz",21,28,7,153,115,38
2,19,2019,20,0,3,"Braga",8,"Rua Costa Gomes",28,40,12,60,42,18
2,19,2019,21,0,3,"Braga",1,"Avenida da Liberdade",21,21,0,32,32,0
2,19,2019,21,0,3,"Braga",2,"Avenida Central",17,17,0,284,284,0
2,19,2019,21,0,3,"Braga",3,"Rua de Caires",34,34,0,37,37,0
2,19,2019,21,0,3,"Braga",4,"N14 Bosch",46,46,0,74,74,0
2,19,2019,21,0,3,"Braga",5,"Avenida João Paulo II",40,40,0,8,8,0
2,19,2019,21,0,3,"Braga",6,"Avenida Padre Júlio Fragata",48,61,13,26,20,6
2,19,2019,21,0,3,"Braga",7,"Rua Nova Santa Cruz",29,29,0,111,111,0
2,19,2019,21,0,3,"Braga",8,"Rua Costa Gomes",40,40,0,42,42,0
2,19,2019,22,0,3,"Braga",1,"Avenida da Liberdade",21,21,0,32,32,0
2,19,2019,22,0,3,"Braga",2,"Avenida Central",17,17,0,284,284,0
2,19,2019,22,0,3,"Braga",3,"Rua de Caires",34,34,0,37,37,0
2,19,2019,22,0,3,"Braga",4,"N14 Bosch",46,46,0,74,74,0
2,19,2019,22,0,3,"Braga",5,"Avenida João Paulo II",40,40,0,8,8,0
2,19,2019,22,0,3,"Braga",6,"Avenida Padre Júlio Fragata",46,60,14,27,21,6
2,19,2019,22,0,3,"Braga",7,"Rua Nova Santa Cruz",28,28,0,115,115,0
2,19,2019,22,0,3,"Braga",8,"Rua Costa Gomes",40,40,0,42,42,0
2,19,2019,23,0,3,"Braga",1,"Avenida da Liberdade",21,21,0,32,32,0
2,19,2019,23,0,3,"Braga",2,"Avenida Central",17,17,0,284,284,0
2,19,2019,23,0,3,"Braga",3,"Rua de Caires",34,34,0,37,37,0
2,19,2019,23,0,3,"Braga",4,"N14 Bosch",46,46,0,74,74,0
2,19,2019,23,0,3,"Braga",5,"Avenida João Paulo II",40,40,0,8,8,0
2,19,2019,23,0,3,"Braga",6,"Avenida Padre Júlio Fragata",61,61,0,20,20,0
2,19,2019,23,0,3,"Braga",7,"Rua Nova Santa Cruz",28,28,0,115,115,0
2,19,2019,23,0,3,"Braga",8,"Rua Costa Gomes",40,40,0,42,42,0
2,20,2019,0,0,4,"Braga",1,"Avenida da Liberdade",21,21,0,32,32,0
2,20,2019,0,0,4,"Braga",2,"Avenida Central",17,17,0,284,284,0
2,20,2019,0,0,4,"Braga",3,"Rua de Caires",34,34,0,37,37,0
2,20,2019,0,0,4,"Braga",4,"N14 Bosch",46,46,0,74,74,0
2,20,2019,0,0,4,"Braga",5,"Avenida João Paulo II",40,40,0,8,8,0
2,20,2019,0,0,4,"Braga",6,"Avenida Padre Júlio Fragata",61,61,0,20,20,0
2,20,2019,0,0,4,"Braga",7,"Rua Nova Santa Cruz",28,28,0,115,115,0
2,20,2019,0,0,4,"Braga",8,"Rua Costa Gomes",40,40,0,42,42,0
2,20,2019,1,0,4,"Braga",1,"Avenida da Liberdade",21,21,0,32,32,0
2,20,2019,1,0,4,"Braga",2,"Avenida Central",17,17,0,284,284,0
2,20,2019,1,0,4,"Braga",3,"Rua de Caires",34,34,0,37,37,0
2,20,2019,1,0,4,"Braga",4,"N14 Bosch",46,46,0,74,74,0
2,20,2019,1,0,4,"Braga",5,"Avenida João Paulo II",40,40,0,8,8,0
2,20,2019,1,0,4,"Braga",6,"Avenida Padre Júlio Fragata",61,61,0,20,20,0
2,20,2019,1,0,4,"Braga",7,"Rua Nova Santa Cruz",28,28,0,115,115,0
2,20,2019,1,0,4,"Braga",8,"Rua Costa Gomes",40,40,0,42,42,0
2,20,2019,2,0,4,"Braga",1,"Avenida da Liberdade",21,21,0,32,32,0
2,20,2019,2,0,4,"Braga",2,"Avenida Central",17,17,0,284,284,0
2,20,2019,2,0,4,"Braga",3,"Rua de Caires",34,34,0,37,37,0
2,20,2019,2,0,4,"Braga",4,"N14 Bosch",46,46,0,74,74,0
2,20,2019,2,0,4,"Braga",5,"Avenida João Paulo II",40,40,0,8,8,0
2,20,2019,2,0,4,"Braga",6,"Avenida Padre Júlio Fragata",61,61,0,20,20,0
2,20,2019,2,0,4,"Braga",7,"Rua Nova Santa Cruz",28,28,0,115,115,0
2,20,2019,2,0,4,"Braga",8,"Rua Costa Gomes",40,40,0,42,42,0
2,20,2019,3,0,4,"Braga",1,"Avenida da Liberdade",21,21,0,32,32,0
2,20,2019,3,0,4,"Braga",2,"Avenida Central",17,17,0,284,284,0
2,20,2019,3,0,4,"Braga",3,"Rua de Caires",34,34,0,37,37,0
2,20,2019,3,0,4,"Braga",4,"N14 Bosch",46,46,0,74,74,0
2,20,2019,3,0,4,"Braga",5,"Avenida João Paulo II",40,40,0,8,8,0
2,20,2019,3,0,4,"Braga",6,"Avenida Padre Júlio Fragata",61,61,0,20,20,0
2,20,2019,3,0,4,"Braga",7,"Rua Nova Santa Cruz",28,28,0,115,115,0
2,20,2019,3,0,4,"Braga",8,"Rua Costa Gomes",40,40,0,42,42,0
2,20,2019,4,0,4,"Braga",1,"Avenida da Liberdade",21,21,0,32,32,0
2,20,2019,4,0,4,"Braga",2,"Avenida Central",17,17,0,284,284,0
2,20,2019,4,0,4,"Braga",3,"Rua de Caires",34,34,0,37,37,0
2,20,2019,4,0,4,"Braga",4,"N14 Bosch",46,46,0,74,74,0
2,20,2019,4,0,4,"Braga",5,"Avenida João Paulo II",40,40,0,8,8,0
2,20,2019,4,0,4,"Braga",6,"Avenida Padre Júlio Fragata",61,61,0,20,20,0
2,20,2019,4,0,4,"Braga",7,"Rua Nova Santa Cruz",28,28,0,115,115,0
2,20,2019,4,0,4,"Braga",8,"Rua Costa Gomes",40,40,0,42,42,0
2,20,2019,5,0,4,"Braga",1,"Avenida da Liberdade",21,21,0,32,32,0
2,20,2019,5,0,4,"Braga",2,"Avenida Central",17,17,0,284,284,0
2,20,2019,5,0,4,"Braga",3,"Rua de Caires",34,34,0,37,37,0
2,20,2019,5,0,4,"Braga",4,"N14 Bosch",46,46,0,74,74,0
2,20,2019,5,0,4,"Braga",5,"Avenida João Paulo II",40,40,0,8,8,0
2,20,2019,5,0,4,"Braga",6,"Avenida Padre Júlio Fragata",61,61,0,20,20,0
2,20,2019,5,0,4,"Braga",7,"Rua Nova Santa Cruz",28,28,0,115,115,0
2,20,2019,5,0,4,"Braga",8,"Rua Costa Gomes",40,40,0,42,42,0
2,20,2019,6,0,4,"Braga",1,"Avenida da Liberdade",21,21,0,32,32,0
2,20,2019,6,0,4,"Braga",2,"Avenida Central",17,17,0,284,284,0
2,20,2019,6,0,4,"Braga",3,"Rua de Caires",34,34,0,37,37,0
2,20,2019,6,0,4,"Braga",4,"N14 Bosch",46,46,0,74,74,0
2,20,2019,6,0,4,"Braga",5,"Avenida João Paulo II",40,40,0,8,8,0
2,20,2019,6,0,4,"Braga",6,"Avenida Padre Júlio Fragata",61,61,0,20,20,0
2,20,2019,6,0,4,"Braga",7,"Rua Nova Santa Cruz",28,28,0,115,115,0
2,20,2019,6,0,4,"Braga",8,"Rua Costa Gomes",40,40,0,42,42,0
2,20,2019,7,0,4,"Braga",1,"Avenida da Liberdade",21,21,0,32,32,0
2,20,2019,7,0,4,"Braga",2,"Avenida Central",17,17,0,284,284,0
2,20,2019,7,0,4,"Braga",3,"Rua de Caires",34,34,0,37,37,0
2,20,2019,7,0,4,"Braga",4,"N14 Bosch",46,46,0,74,74,0
2,20,2019,7,0,4,"Braga",5,"Avenida João Paulo II",40,40,0,8,8,0
2,20,2019,7,0,4,"Braga",6,"Avenida Padre Júlio Fragata",61,61,0,20,20,0
2,20,2019,7,0,4,"Braga",7,"Rua Nova Santa Cruz",28,28,0,115,115,0
2,20,2019,7,0,4,"Braga",8,"Rua Costa Gomes",40,40,0,42,42,0
2,20,2019,8,0,4,"Braga",1,"Avenida da Liberdade",21,21,0,32,32,0
2,20,2019,8,0,4,"Braga",2,"Avenida Central",17,17,0,284,284,0
2,20,2019,8,0,4,"Braga",3,"Rua de Caires",27,34,7,47,37,10
2,20,2019,8,0,4,"Braga",4,"N14 Bosch",35,46,11,97,74,23
2,20,2019,8,0,4,"Braga",5,"Avenida João Paulo II",40,40,0,8,8,0
2,20,2019,8,0,4,"Braga",6,"Avenida Padre Júlio Fragata",61,61,0,20,20,0
2,20,2019,8,0,4,"Braga",7,"Rua Nova Santa Cruz",28,28,0,115,115,0
2,20,2019,8,0,4,"Braga",8,"Rua Costa Gomes",40,40,0,42,42,0
2,20,2019,9,0,4,"Braga",1,"Avenida da Liberdade",21,21,0,32,32,0
2,20,2019,9,0,4,"Braga",2,"Avenida Central",17,17,0,284,284,0
2,20,2019,9,0,4,"Braga",3,"Rua de Caires",13,35,22,98,36,62
2,20,2019,9,0,4,"Braga",4,"N14 Bosch",45,45,0,75,75,0
2,20,2019,9,0,4,"Braga",5,"Avenida João Paulo II",28,39,11,12,8,4
2,20,2019,9,0,4,"Braga",6,"Avenida Padre Júlio Fragata",31,61,30,41,20,21
2,20,2019,9,0,4,"Braga",7,"Rua Nova Santa Cruz",20,29,9,161,111,50
2,20,2019,9,0,4,"Braga",8,"Rua Costa Gomes",31,40,9,54,42,12
2,20,2019,10,0,4,"Braga",1,"Avenida da Liberdade",17,21,4,39,32,7
2,20,2019,10,0,4,"Braga",2,"Avenida Central",17,17,0,284,284,0
2,20,2019,10,0,4,"Braga",3,"Rua de Caires",26,34,8,49,37,12
2,20,2019,10,0,4,"Braga",4,"N14 Bosch",46,46,0,74,74,0
2,20,2019,10,0,4,"Braga",5,"Avenida João Paulo II",39,39,0,8,8,0
2,20,2019,10,0,4,"Braga",6,"Avenida Padre Júlio Fragata",60,60,0,21,21,0
2,20,2019,10,0,4,"Braga",7,"Rua Nova Santa Cruz",29,29,0,111,111,0
2,20,2019,10,0,4,"Braga",8,"Rua Costa Gomes",39,39,0,43,43,0
2,20,2019,11,0,4,"Braga",1,"Avenida da Liberdade",17,21,4,39,32,7
2,20,2019,11,0,4,"Braga",2,"Avenida Central",13,18,5,372,268,104
2,20,2019,11,0,4,"Braga",3,"Rua de Caires",28,35,7,45,36,9
2,20,2019,11,0,4,"Braga",4,"N14 Bosch",33,46,13,103,74,29
2,20,2019,11,0,4,"Braga",5,"Avenida João Paulo II",39,39,0,8,8,0
2,20,2019,11,0,4,"Braga",6,"Avenida Padre Júlio Fragata",60,60,0,21,21,0
2,20,2019,11,0,4,"Braga",7,"Rua Nova Santa Cruz",29,29,0,111,111,0
2,20,2019,11,0,4,"Braga",8,"Rua Costa Gomes",31,40,9,54,42,12
2,20,2019,12,0,4,"Braga",1,"Avenida da Liberdade",17,21,4,39,32,7
2,20,2019,12,0,4,"Braga",2,"Avenida Central",11,17,6,439,284,155
2,20,2019,12,0,4,"Braga",3,"Rua de Caires",26,35,9,49,36,13
2,20,2019,12,0,4,"Braga",4,"N14 Bosch",33,46,13,103,74,29
2,20,2019,12,0,4,"Braga",5,"Avenida João Paulo II",39,39,0,8,8,0
2,20,2019,12,0,4,"Braga",6,"Avenida Padre Júlio Fragata",60,60,0,21,21,0
2,20,2019,12,0,4,"Braga",7,"Rua Nova Santa Cruz",21,28,7,153,115,38
2,20,2019,12,0,4,"Braga",8,"Rua Costa Gomes",29,40,11,57,42,15
2,20,2019,14,0,4,"Braga",1,"Avenida da Liberdade",21,21,0,32,32,0
2,20,2019,14,0,4,"Braga",2,"Avenida Central",12,18,6,403,268,135
2,20,2019,14,0,4,"Braga",3,"Rua de Caires",26,34,8,49,37,12
2,20,2019,14,0,4,"Braga",4,"N14 Bosch",26,45,19,131,75,56
2,20,2019,14,0,4,"Braga",5,"Avenida João Paulo II",39,39,0,8,8,0
2,20,2019,14,0,4,"Braga",6,"Avenida Padre Júlio Fragata",60,60,0,21,21,0
2,20,2019,14,0,4,"Braga",7,"Rua Nova Santa Cruz",29,29,0,111,111,0
2,20,2019,14,0,4,"Braga",8,"Rua Costa Gomes",31,39,8,54,43,11
2,20,2019,15,0,4,"Braga",1,"Avenida da Liberdade",21,21,0,32,32,0
2,20,2019,15,0,4,"Braga",2,"Avenida Central",13,18,5,372,268,104
2,20,2019,15,0,4,"Braga",3,"Rua de Caires",21,34,13,61,37,24
2,20,2019,15,0,4,"Braga",4,"N14 Bosch",15,46,31,227,74,153
2,20,2019,15,0,4,"Braga",5,"Avenida João Paulo II",31,40,9,11,8,3
2,20,2019,15,0,4,"Braga",6,"Avenida Padre Júlio Fragata",60,60,0,21,21,0
2,20,2019,15,0,4,"Braga",7,"Rua Nova Santa Cruz",18,28,10,179,115,64
2,20,2019,15,0,4,"Braga",8,"Rua Costa Gomes",26,40,14,64,42,22
2,20,2019,16,0,4,"Braga",1,"Avenida da Liberdade",21,21,0,32,32,0
2,20,2019,16,0,4,"Braga",2,"Avenida Central",12,17,5,403,284,119
2,20,2019,16,0,4,"Braga",3,"Rua de Caires",34,34,0,37,37,0
2,20,2019,16,0,4,"Braga",4,"N14 Bosch",19,47,28,179,72,107
2,20,2019,16,0,4,"Braga",5,"Avenida João Paulo II",28,40,12,12,8,4
2,20,2019,16,0,4,"Braga",6,"Avenida Padre Júlio Fragata",61,61,0,20,20,0
2,20,2019,16,0,4,"Braga",7,"Rua Nova Santa Cruz",19,28,9,169,115,54
2,20,2019,16,0,4,"Braga",8,"Rua Costa Gomes",27,40,13,62,42,20
2,20,2019,17,0,4,"Braga",1,"Avenida da Liberdade",17,21,4,39,32,7
2,20,2019,17,0,4,"Braga",2,"Avenida Central",12,17,5,403,284,119
2,20,2019,17,0,4,"Braga",3,"Rua de Caires",26,34,8,49,37,12
2,20,2019,17,0,4,"Braga",4,"N14 Bosch",23,45,22,148,75,73
2,20,2019,17,0,4,"Braga",5,"Avenida João Paulo II",28,39,11,12,8,4
2,20,2019,17,0,4,"Braga",6,"Avenida Padre Júlio Fragata",49,61,12,26,20,6
2,20,2019,17,0,4,"Braga",7,"Rua Nova Santa Cruz",18,28,10,179,115,64
2,20,2019,17,0,4,"Braga",8,"Rua Costa Gomes",18,39,21,93,43,50
2,20,2019,18,0,4,"Braga",1,"Avenida da Liberdade",17,21,4,39,32,7
2,20,2019,18,0,4,"Braga",2,"Avenida Central",10,18,8,483,268,215
2,20,2019,18,0,4,"Braga",3,"Rua de Caires",21,34,13,61,37,24
2,20,2019,18,0,4,"Braga",4,"N14 Bosch",17,44,27,200,77,123
2,20,2019,18,0,4,"Braga",5,"Avenida João Paulo II",22,39,17,15,8,7
2,20,2019,18,0,4,"Braga",6,"Avenida Padre Júlio Fragata",29,61,32,44,20,24
2,20,2019,18,0,4,"Braga",7,"Rua Nova Santa Cruz",18,29,11,179,111,68
2,20,2019,18,0,4,"Braga",8,"Rua Costa Gomes",13,40,27,129,42,87
2,20,2019,19,0,4,"Braga",1,"Avenida da Liberdade",17,21,4,39,32,7
2,20,2019,19,0,4,"Braga",2,"Avenida Central",6,17,11,806,284,522
2,20,2019,19,0,4,"Braga",3,"Rua de Caires",21,34,13,61,37,24
2,20,2019,19,0,4,"Braga",4,"N14 Bosch",30,46,16,113,74,39
2,20,2019,19,0,4,"Braga",5,"Avenida João Paulo II",23,39,16,14,8,6
2,20,2019,19,0,4,"Braga",6,"Avenida Padre Júlio Fragata",39,60,21,32,21,11
2,20,2019,19,0,4,"Braga",7,"Rua Nova Santa Cruz",14,28,14,230,115,115
2,20,2019,19,0,4,"Braga",8,"Rua Costa Gomes",16,39,23,105,43,62
2,20,2019,20,0,4,"Braga",1,"Avenida da Liberdade",21,21,0,32,32,0
2,20,2019,20,0,4,"Braga",2,"Avenida Central",18,18,0,268,268,0
2,20,2019,20,0,4,"Braga",3,"Rua de Caires",35,35,0,36,36,0
2,20,2019,20,0,4,"Braga",4,"N14 Bosch",35,46,11,97,74,23
2,20,2019,20,0,4,"Braga",5,"Avenida João Paulo II",29,39,10,11,8,3
2,20,2019,20,0,4,"Braga",6,"Avenida Padre Júlio Fragata",60,60,0,21,21,0
2,20,2019,20,0,4,"Braga",7,"Rua Nova Santa Cruz",23,28,5,140,115,25
2,20,2019,20,0,4,"Braga",8,"Rua Costa Gomes",26,39,13,64,43,21
2,20,2019,21,0,4,"Braga",1,"Avenida da Liberdade",21,21,0,32,32,0
2,20,2019,21,0,4,"Braga",2,"Avenida Central",17,17,0,284,284,0
2,20,2019,21,0,4,"Braga",3,"Rua de Caires",35,35,0,36,36,0
2,20,2019,21,0,4,"Braga",4,"N14 Bosch",46,46,0,74,74,0
2,20,2019,21,0,4,"Braga",5,"Avenida João Paulo II",39,39,0,8,8,0
2,20,2019,21,0,4,"Braga",6,"Avenida Padre Júlio Fragata",60,60,0,21,21,0
2,20,2019,21,0,4,"Braga",7,"Rua Nova Santa Cruz",29,29,0,111,111,0
2,20,2019,21,0,4,"Braga",8,"Rua Costa Gomes",28,39,11,60,43,17
2,20,2019,22,0,4,"Braga",1,"Avenida da Liberdade",21,21,0,32,32,0
2,20,2019,22,0,4,"Braga",2,"Avenida Central",17,17,0,284,284,0
2,20,2019,22,0,4,"Braga",3,"Rua de Caires",36,36,0,35,35,0
2,20,2019,22,0,4,"Braga",4,"N14 Bosch",46,46,0,74,74,0
2,20,2019,22,0,4,"Braga",5,"Avenida João Paulo II",39,39,0,8,8,0
2,20,2019,22,0,4,"Braga",6,"Avenida Padre Júlio Fragata",60,60,0,21,21,0
2,20,2019,22,0,4,"Braga",7,"Rua Nova Santa Cruz",29,29,0,111,111,0
2,20,2019,22,0,4,"Braga",8,"Rua Costa Gomes",40,40,0,42,42,0
2,20,2019,23,0,4,"Braga",1,"Avenida da Liberdade",21,21,0,32,32,0
2,20,2019,23,0,4,"Braga",2,"Avenida Central",17,17,0,284,284,0
2,20,2019,23,0,4,"Braga",3,"Rua de Caires",36,36,0,35,35,0
2,20,2019,23,0,4,"Braga",4,"N14 Bosch",46,46,0,74,74,0
2,20,2019,23,0,4,"Braga",5,"Avenida João Paulo II",40,40,0,8,8,0
2,20,2019,23,0,4,"Braga",6,"Avenida Padre Júlio Fragata",60,60,0,21,21,0
2,20,2019,23,0,4,"Braga",7,"Rua Nova Santa Cruz",29,29,0,111,111,0
2,20,2019,23,0,4,"Braga",8,"Rua Costa Gomes",40,40,0,42,42,0
2,21,2019,0,0,5,"Braga",1,"Avenida da Liberdade",21,21,0,32,32,0
2,21,2019,0,0,5,"Braga",2,"Avenida Central",17,17,0,284,284,0
2,21,2019,0,0,5,"Braga",3,"Rua de Caires",36,36,0,35,35,0
2,21,2019,0,0,5,"Braga",4,"N14 Bosch",45,45,0,75,75,0
2,21,2019,0,0,5,"Braga",5,"Avenida João Paulo II",40,40,0,8,8,0
2,21,2019,0,0,5,"Braga",6,"Avenida Padre Júlio Fragata",60,60,0,21,21,0
2,21,2019,0,0,5,"Braga",7,"Rua Nova Santa Cruz",29,29,0,111,111,0
2,21,2019,0,0,5,"Braga",8,"Rua Costa Gomes",40,40,0,42,42,0
2,21,2019,1,0,5,"Braga",1,"Avenida da Liberdade",21,21,0,32,32,0
2,21,2019,1,0,5,"Braga",2,"Avenida Central",17,17,0,284,284,0
2,21,2019,1,0,5,"Braga",3,"Rua de Caires",36,36,0,35,35,0
2,21,2019,1,0,5,"Braga",4,"N14 Bosch",45,45,0,75,75,0
2,21,2019,1,0,5,"Braga",5,"Avenida João Paulo II",40,40,0,8,8,0
2,21,2019,1,0,5,"Braga",6,"Avenida Padre Júlio Fragata",60,60,0,21,21,0
2,21,2019,1,0,5,"Braga",7,"Rua Nova Santa Cruz",29,29,0,111,111,0
2,21,2019,1,0,5,"Braga",8,"Rua Costa Gomes",31,40,9,54,42,12
2,21,2019,2,0,5,"Braga",1,"Avenida da Liberdade",21,21,0,32,32,0
2,21,2019,2,0,5,"Braga",2,"Avenida Central",17,17,0,284,284,0
2,21,2019,2,0,5,"Braga",3,"Rua de Caires",36,36,0,35,35,0
2,21,2019,2,0,5,"Braga",4,"N14 Bosch",45,45,0,75,75,0
2,21,2019,2,0,5,"Braga",5,"Avenida João Paulo II",40,40,0,8,8,0
2,21,2019,2,0,5,"Braga",6,"Avenida Padre Júlio Fragata",60,60,0,21,21,0
2,21,2019,2,0,5,"Braga",7,"Rua Nova Santa Cruz",29,29,0,111,111,0
2,21,2019,2,0,5,"Braga",8,"Rua Costa Gomes",40,40,0,42,42,0
2,21,2019,3,0,5,"Braga",1,"Avenida da Liberdade",21,21,0,32,32,0
2,21,2019,3,0,5,"Braga",2,"Avenida Central",17,17,0,284,284,0
2,21,2019,3,0,5,"Braga",3,"Rua de Caires",36,36,0,35,35,0
2,21,2019,3,0,5,"Braga",4,"N14 Bosch",45,45,0,75,75,0
2,21,2019,3,0,5,"Braga",5,"Avenida João Paulo II",40,40,0,8,8,0
2,21,2019,3,0,5,"Braga",6,"Avenida Padre Júlio Fragata",60,60,0,21,21,0
2,21,2019,3,0,5,"Braga",7,"Rua Nova Santa Cruz",29,29,0,111,111,0
2,21,2019,3,0,5,"Braga",8,"Rua Costa Gomes",40,40,0,42,42,0
2,21,2019,4,0,5,"Braga",1,"Avenida da Liberdade",21,21,0,32,32,0
2,21,2019,4,0,5,"Braga",2,"Avenida Central",17,17,0,284,284,0
2,21,2019,4,0,5,"Braga",3,"Rua de Caires",36,36,0,35,35,0
2,21,2019,4,0,5,"Braga",4,"N14 Bosch",45,45,0,75,75,0
2,21,2019,4,0,5,"Braga",5,"Avenida João Paulo II",40,40,0,8,8,0
2,21,2019,4,0,5,"Braga",6,"Avenida Padre Júlio Fragata",60,60,0,21,21,0
2,21,2019,4,0,5,"Braga",7,"Rua Nova Santa Cruz",29,29,0,111,111,0
2,21,2019,4,0,5,"Braga",8,"Rua Costa Gomes",40,40,0,42,42,0
2,21,2019,5,0,5,"Braga",1,"Avenida da Liberdade",21,21,0,32,32,0
2,21,2019,5,0,5,"Braga",2,"Avenida Central",17,17,0,284,284,0
2,21,2019,5,0,5,"Braga",3,"Rua de Caires",36,36,0,35,35,0
2,21,2019,5,0,5,"Braga",4,"N14 Bosch",45,45,0,75,75,0
2,21,2019,5,0,5,"Braga",5,"Avenida João Paulo II",40,40,0,8,8,0
2,21,2019,5,0,5,"Braga",6,"Avenida Padre Júlio Fragata",60,60,0,21,21,0
2,21,2019,5,0,5,"Braga",7,"Rua Nova Santa Cruz",29,29,0,111,111,0
2,21,2019,5,0,5,"Braga",8,"Rua Costa Gomes",40,40,0,42,42,0
2,21,2019,6,0,5,"Braga",1,"Avenida da Liberdade",21,21,0,32,32,0
2,21,2019,6,0,5,"Braga",2,"Avenida Central",17,17,0,284,284,0
2,21,2019,6,0,5,"Braga",3,"Rua de Caires",36,36,0,35,35,0
2,21,2019,6,0,5,"Braga",4,"N14 Bosch",45,45,0,75,75,0
2,21,2019,6,0,5,"Braga",5,"Avenida João Paulo II",40,40,0,8,8,0
2,21,2019,6,0,5,"Braga",6,"Avenida Padre Júlio Fragata",60,60,0,21,21,0
2,21,2019,6,0,5,"Braga",7,"Rua Nova Santa Cruz",29,29,0,111,111,0
2,21,2019,6,0,5,"Braga",8,"Rua Costa Gomes",40,40,0,42,42,0
2,21,2019,7,0,5,"Braga",1,"Avenida da Liberdade",21,21,0,32,32,0
2,21,2019,7,0,5,"Braga",2,"Avenida Central",17,17,0,284,284,0
2,21,2019,7,0,5,"Braga",3,"Rua de Caires",36,36,0,35,35,0
2,21,2019,7,0,5,"Braga",4,"N14 Bosch",45,45,0,75,75,0
2,21,2019,7,0,5,"Braga",5,"Avenida João Paulo II",40,40,0,8,8,0
2,21,2019,7,0,5,"Braga",6,"Avenida Padre Júlio Fragata",60,60,0,21,21,0
2,21,2019,7,0,5,"Braga",7,"Rua Nova Santa Cruz",29,29,0,111,111,0
2,21,2019,7,0,5,"Braga",8,"Rua Costa Gomes",40,40,0,42,42,0
2,21,2019,8,0,5,"Braga",1,"Avenida da Liberdade",22,22,0,30,30,0
2,21,2019,8,0,5,"Braga",2,"Avenida Central",18,18,0,268,268,0
2,21,2019,8,0,5,"Braga",3,"Rua de Caires",27,35,8,47,36,11
2,21,2019,8,0,5,"Braga",4,"N14 Bosch",32,45,13,106,75,31
2,21,2019,8,0,5,"Braga",5,"Avenida João Paulo II",40,40,0,8,8,0
2,21,2019,8,0,5,"Braga",6,"Avenida Padre Júlio Fragata",60,60,0,21,21,0
2,21,2019,8,0,5,"Braga",7,"Rua Nova Santa Cruz",15,29,14,215,111,104
2,21,2019,8,0,5,"Braga",8,"Rua Costa Gomes",29,40,11,57,42,15
2,21,2019,9,0,5,"Braga",1,"Avenida da Liberdade",21,21,0,32,32,0
2,21,2019,9,0,5,"Braga",2,"Avenida Central",14,18,4,345,268,77
2,21,2019,9,0,5,"Braga",3,"Rua de Caires",22,35,13,58,36,22
2,21,2019,9,0,5,"Braga",4,"N14 Bosch",19,45,26,179,75,104
2,21,2019,9,0,5,"Braga",5,"Avenida João Paulo II",30,39,9,11,8,3
2,21,2019,9,0,5,"Braga",6,"Avenida Padre Júlio Fragata",24,61,37,53,20,33
2,21,2019,9,0,5,"Braga",7,"Rua Nova Santa Cruz",21,29,8,153,111,42
2,21,2019,9,0,5,"Braga",8,"Rua Costa Gomes",26,39,13,64,43,21
2,21,2019,10,0,5,"Braga",1,"Avenida da Liberdade",22,22,0,30,30,0
2,21,2019,10,0,5,"Braga",2,"Avenida Central",14,18,4,345,268,77
2,21,2019,10,0,5,"Braga",3,"Rua de Caires",26,34,8,49,37,12
2,21,2019,10,0,5,"Braga",4,"N14 Bosch",34,45,11,100,75,25
2,21,2019,10,0,5,"Braga",5,"Avenida João Paulo II",39,39,0,8,8,0
2,21,2019,10,0,5,"Braga",6,"Avenida Padre Júlio Fragata",60,60,0,21,21,0
2,21,2019,10,0,5,"Braga",7,"Rua Nova Santa Cruz",29,29,0,111,111,0
2,21,2019,10,0,5,"Braga",8,"Rua Costa Gomes",29,40,11,57,42,15
2,21,2019,11,0,5,"Braga",1,"Avenida da Liberdade",22,22,0,30,30,0
2,21,2019,11,0,5,"Braga",2,"Avenida Central",11,17,6,439,284,155
2,21,2019,11,0,5,"Braga",3,"Rua de Caires",27,35,8,47,36,11
2,21,2019,11,0,5,"Braga",4,"N14 Bosch",47,47,0,72,72,0
2,21,2019,11,0,5,"Braga",5,"Avenida João Paulo II",39,39,0,8,8,0
2,21,2019,11,0,5,"Braga",6,"Avenida Padre Júlio Fragata",60,60,0,21,21,0
2,21,2019,11,0,5,"Braga",7,"Rua Nova Santa Cruz",29,29,0,111,111,0
2,21,2019,11,0,5,"Braga",8,"Rua Costa Gomes",30,40,10,56,42,14
2,21,2019,12,0,5,"Braga",1,"Avenida da Liberdade",21,21,0,32,32,0
2,21,2019,12,0,5,"Braga",2,"Avenida Central",10,17,7,483,284,199
2,21,2019,12,0,5,"Braga",3,"Rua de Caires",19,34,15,67,37,30
2,21,2019,12,0,5,"Braga",4,"N14 Bosch",30,46,16,113,74,39
2,21,2019,12,0,5,"Braga",5,"Avenida João Paulo II",40,40,0,8,8,0
2,21,2019,12,0,5,"Braga",6,"Avenida Padre Júlio Fragata",46,61,15,27,20,7
2,21,2019,12,0,5,"Braga",7,"Rua Nova Santa Cruz",29,29,0,111,111,0
2,21,2019,12,0,5,"Braga",8,"Rua Costa Gomes",27,39,12,62,43,19
2,21,2019,13,0,5,"Braga",1,"Avenida da Liberdade",21,21,0,32,32,0
2,21,2019,13,0,5,"Braga",2,"Avenida Central",17,17,0,284,284,0
2,21,2019,13,0,5,"Braga",3,"Rua de Caires",34,34,0,37,37,0
2,21,2019,13,0,5,"Braga",4,"N14 Bosch",33,46,13,103,74,29
2,21,2019,13,0,5,"Braga",5,"Avenida João Paulo II",40,40,0,8,8,0
2,21,2019,13,0,5,"Braga",6,"Avenida Padre Júlio Fragata",60,60,0,21,21,0
2,21,2019,13,0,5,"Braga",7,"Rua Nova Santa Cruz",29,29,0,111,111,0
2,21,2019,13,0,5,"Braga",8,"Rua Costa Gomes",28,39,11,60,43,17
2,21,2019,14,0,5,"Braga",1,"Avenida da Liberdade",21,21,0,32,32,0
2,21,2019,14,0,5,"Braga",2,"Avenida Central",18,18,0,268,268,0
2,21,2019,14,0,5,"Braga",3,"Rua de Caires",15,35,20,85,36,49
2,21,2019,14,0,5,"Braga",4,"N14 Bosch",28,45,17,121,75,46
2,21,2019,14,0,5,"Braga",5,"Avenida João Paulo II",39,39,0,8,8,0
2,21,2019,14,0,5,"Braga",6,"Avenida Padre Júlio Fragata",61,61,0,20,20,0
2,21,2019,14,0,5,"Braga",7,"Rua Nova Santa Cruz",28,28,0,115,115,0
2,21,2019,14,0,5,"Braga",8,"Rua Costa Gomes",22,39,17,76,43,33
2,21,2019,16,0,5,"Braga",8,"Rua Costa Gomes",7,37,30,240,45,195
2,21,2019,16,0,5,"Braga",1,"Avenida da Liberdade",21,21,0,32,32,0
2,21,2019,16,0,5,"Braga",2,"Avenida Central",13,17,4,372,284,88
2,21,2019,16,0,5,"Braga",3,"Rua de Caires",27,35,8,47,36,11
2,21,2019,16,0,5,"Braga",4,"N14 Bosch",24,45,21,142,75,67
2,21,2019,16,0,5,"Braga",5,"Avenida João Paulo II",27,39,12,12,8,4
2,21,2019,16,0,5,"Braga",6,"Avenida Padre Júlio Fragata",60,60,0,21,21,0
2,21,2019,16,0,5,"Braga",7,"Rua Nova Santa Cruz",17,29,12,189,111,78
2,21,2019,16,0,5,"Braga",8,"Rua Costa Gomes",7,37,30,240,45,195
2,21,2019,17,0,5,"Braga",1,"Avenida da Liberdade",21,21,0,32,32,0
2,21,2019,17,0,5,"Braga",2,"Avenida Central",12,18,6,403,268,135
2,21,2019,17,0,5,"Braga",3,"Rua de Caires",25,35,10,51,36,15
2,21,2019,17,0,5,"Braga",4,"N14 Bosch",25,45,20,136,75,61
2,21,2019,17,0,5,"Braga",5,"Avenida João Paulo II",31,40,9,11,8,3
2,21,2019,17,0,5,"Braga",6,"Avenida Padre Júlio Fragata",60,60,0,21,21,0
2,21,2019,17,0,5,"Braga",7,"Rua Nova Santa Cruz",15,29,14,215,111,104
2,21,2019,17,0,5,"Braga",8,"Rua Costa Gomes",24,39,15,70,43,27
2,21,2019,18,0,5,"Braga",1,"Avenida da Liberdade",17,22,5,39,30,9
2,21,2019,18,0,5,"Braga",2,"Avenida Central",9,17,8,537,284,253
2,21,2019,18,0,5,"Braga",3,"Rua de Caires",23,35,12,55,36,19
2,21,2019,18,0,5,"Braga",4,"N14 Bosch",26,46,20,131,74,57
2,21,2019,18,0,5,"Braga",5,"Avenida João Paulo II",23,39,16,14,8,6
2,21,2019,18,0,5,"Braga",6,"Avenida Padre Júlio Fragata",46,61,15,27,20,7
2,21,2019,18,0,5,"Braga",7,"Rua Nova Santa Cruz",10,28,18,322,115,207
2,21,2019,18,0,5,"Braga",8,"Rua Costa Gomes",9,40,31,186,42,144
2,21,2019,19,0,5,"Braga",1,"Avenida da Liberdade",14,21,7,48,32,16
2,21,2019,19,0,5,"Braga",2,"Avenida Central",6,18,12,806,268,538
2,21,2019,19,0,5,"Braga",3,"Rua de Caires",22,34,12,58,37,21
2,21,2019,19,0,5,"Braga",4,"N14 Bosch",27,46,19,126,74,52
2,21,2019,19,0,5,"Braga",5,"Avenida João Paulo II",24,40,16,14,8,6
2,21,2019,19,0,5,"Braga",6,"Avenida Padre Júlio Fragata",36,61,25,35,20,15
2,21,2019,19,0,5,"Braga",7,"Rua Nova Santa Cruz",17,29,12,189,111,78
2,21,2019,19,0,5,"Braga",8,"Rua Costa Gomes",21,40,19,80,42,38
2,21,2019,20,0,5,"Braga",1,"Avenida da Liberdade",22,22,0,30,30,0
2,21,2019,20,0,5,"Braga",2,"Avenida Central",13,17,4,372,284,88
2,21,2019,20,0,5,"Braga",3,"Rua de Caires",34,34,0,37,37,0
2,21,2019,20,0,5,"Braga",4,"N14 Bosch",35,46,11,97,74,23
2,21,2019,20,0,5,"Braga",5,"Avenida João Paulo II",30,40,10,11,8,3
2,21,2019,20,0,5,"Braga",6,"Avenida Padre Júlio Fragata",60,60,0,21,21,0
2,21,2019,20,0,5,"Braga",7,"Rua Nova Santa Cruz",18,28,10,179,115,64
2,21,2019,20,0,5,"Braga",8,"Rua Costa Gomes",25,39,14,67,43,24
2,21,2019,21,0,5,"Braga",1,"Avenida da Liberdade",22,22,0,30,30,0
2,21,2019,21,0,5,"Braga",2,"Avenida Central",17,17,0,284,284,0
2,21,2019,21,0,5,"Braga",3,"Rua de Caires",34,34,0,37,37,0
2,21,2019,21,0,5,"Braga",4,"N14 Bosch",46,46,0,74,74,0
2,21,2019,21,0,5,"Braga",5,"Avenida João Paulo II",39,39,0,8,8,0
2,21,2019,21,0,5,"Braga",6,"Avenida Padre Júlio Fragata",60,60,0,21,21,0
2,21,2019,21,0,5,"Braga",7,"Rua Nova Santa Cruz",29,29,0,111,111,0
2,21,2019,21,0,5,"Braga",8,"Rua Costa Gomes",40,40,0,42,42,0
2,21,2019,22,0,5,"Braga",1,"Avenida da Liberdade",22,22,0,30,30,0
2,21,2019,22,0,5,"Braga",2,"Avenida Central",17,17,0,284,284,0
2,21,2019,22,0,5,"Braga",3,"Rua de Caires",34,34,0,37,37,0
2,21,2019,22,0,5,"Braga",4,"N14 Bosch",46,46,0,74,74,0
2,21,2019,22,0,5,"Braga",5,"Avenida João Paulo II",39,39,0,8,8,0
2,21,2019,22,0,5,"Braga",6,"Avenida Padre Júlio Fragata",60,60,0,21,21,0
2,21,2019,22,0,5,"Braga",7,"Rua Nova Santa Cruz",28,28,0,115,115,0
2,21,2019,22,0,5,"Braga",8,"Rua Costa Gomes",40,40,0,42,42,0
2,21,2019,23,0,5,"Braga",1,"Avenida da Liberdade",22,22,0,30,30,0
2,21,2019,23,0,5,"Braga",2,"Avenida Central",17,17,0,284,284,0
2,21,2019,23,0,5,"Braga",3,"Rua de Caires",34,34,0,37,37,0
2,21,2019,23,0,5,"Braga",4,"N14 Bosch",46,46,0,74,74,0
2,21,2019,23,0,5,"Braga",5,"Avenida João Paulo II",39,39,0,8,8,0
2,21,2019,23,0,5,"Braga",6,"Avenida Padre Júlio Fragata",60,60,0,21,21,0
2,21,2019,23,0,5,"Braga",7,"Rua Nova Santa Cruz",28,28,0,115,115,0
2,21,2019,23,0,5,"Braga",8,"Rua Costa Gomes",40,40,0,42,42,0
2,22,2019,0,0,6,"Braga",1,"Avenida da Liberdade",22,22,0,30,30,0
2,22,2019,0,0,6,"Braga",2,"Avenida Central",17,17,0,284,284,0
2,22,2019,0,0,6,"Braga",3,"Rua de Caires",34,34,0,37,37,0
2,22,2019,0,0,6,"Braga",4,"N14 Bosch",46,46,0,74,74,0
2,22,2019,0,0,6,"Braga",5,"Avenida João Paulo II",40,40,0,8,8,0
2,22,2019,0,0,6,"Braga",6,"Avenida Padre Júlio Fragata",60,60,0,21,21,0
2,22,2019,0,0,6,"Braga",7,"Rua Nova Santa Cruz",28,28,0,115,115,0
2,22,2019,0,0,6,"Braga",8,"Rua Costa Gomes",40,40,0,42,42,0
2,22,2019,1,0,6,"Braga",1,"Avenida da Liberdade",22,22,0,30,30,0
2,22,2019,1,0,6,"Braga",2,"Avenida Central",17,17,0,284,284,0
2,22,2019,1,0,6,"Braga",3,"Rua de Caires",34,34,0,37,37,0
2,22,2019,1,0,6,"Braga",4,"N14 Bosch",46,46,0,74,74,0
2,22,2019,1,0,6,"Braga",5,"Avenida João Paulo II",40,40,0,8,8,0
2,22,2019,1,0,6,"Braga",6,"Avenida Padre Júlio Fragata",60,60,0,21,21,0
2,22,2019,1,0,6,"Braga",7,"Rua Nova Santa Cruz",28,28,0,115,115,0
2,22,2019,1,0,6,"Braga",8,"Rua Costa Gomes",40,40,0,42,42,0
2,22,2019,2,0,6,"Braga",1,"Avenida da Liberdade",22,22,0,30,30,0
2,22,2019,2,0,6,"Braga",2,"Avenida Central",17,17,0,284,284,0
2,22,2019,2,0,6,"Braga",3,"Rua de Caires",34,34,0,37,37,0
2,22,2019,2,0,6,"Braga",4,"N14 Bosch",46,46,0,74,74,0
2,22,2019,2,0,6,"Braga",5,"Avenida João Paulo II",40,40,0,8,8,0
2,22,2019,2,0,6,"Braga",6,"Avenida Padre Júlio Fragata",60,60,0,21,21,0
2,22,2019,2,0,6,"Braga",7,"Rua Nova Santa Cruz",28,28,0,115,115,0
2,22,2019,2,0,6,"Braga",8,"Rua Costa Gomes",40,40,0,42,42,0
2,22,2019,3,0,6,"Braga",1,"Avenida da Liberdade",22,22,0,30,30,0
2,22,2019,3,0,6,"Braga",2,"Avenida Central",17,17,0,284,284,0
2,22,2019,3,0,6,"Braga",3,"Rua de Caires",34,34,0,37,37,0
2,22,2019,3,0,6,"Braga",4,"N14 Bosch",46,46,0,74,74,0
2,22,2019,3,0,6,"Braga",5,"Avenida João Paulo II",40,40,0,8,8,0
2,22,2019,3,0,6,"Braga",6,"Avenida Padre Júlio Fragata",60,60,0,21,21,0
2,22,2019,3,0,6,"Braga",7,"Rua Nova Santa Cruz",28,28,0,115,115,0
2,22,2019,3,0,6,"Braga",8,"Rua Costa Gomes",40,40,0,42,42,0
2,22,2019,4,0,6,"Braga",1,"Avenida da Liberdade",22,22,0,30,30,0
2,22,2019,4,0,6,"Braga",2,"Avenida Central",17,17,0,284,284,0
2,22,2019,4,0,6,"Braga",3,"Rua de Caires",34,34,0,37,37,0
2,22,2019,4,0,6,"Braga",4,"N14 Bosch",46,46,0,74,74,0
2,22,2019,4,0,6,"Braga",5,"Avenida João Paulo II",40,40,0,8,8,0
2,22,2019,4,0,6,"Braga",6,"Avenida Padre Júlio Fragata",60,60,0,21,21,0
2,22,2019,4,0,6,"Braga",7,"Rua Nova Santa Cruz",28,28,0,115,115,0
2,22,2019,4,0,6,"Braga",8,"Rua Costa Gomes",40,40,0,42,42,0
2,22,2019,5,0,6,"Braga",1,"Avenida da Liberdade",22,22,0,30,30,0
2,22,2019,5,0,6,"Braga",2,"Avenida Central",17,17,0,284,284,0
2,22,2019,5,0,6,"Braga",3,"Rua de Caires",34,34,0,37,37,0
2,22,2019,5,0,6,"Braga",4,"N14 Bosch",46,46,0,74,74,0
2,22,2019,5,0,6,"Braga",5,"Avenida João Paulo II",40,40,0,8,8,0
2,22,2019,5,0,6,"Braga",6,"Avenida Padre Júlio Fragata",60,60,0,21,21,0
2,22,2019,5,0,6,"Braga",7,"Rua Nova Santa Cruz",28,28,0,115,115,0
2,22,2019,5,0,6,"Braga",8,"Rua Costa Gomes",40,40,0,42,42,0
2,22,2019,6,0,6,"Braga",1,"Avenida da Liberdade",22,22,0,30,30,0
2,22,2019,6,0,6,"Braga",2,"Avenida Central",17,17,0,284,284,0
2,22,2019,6,0,6,"Braga",3,"Rua de Caires",34,34,0,37,37,0
2,22,2019,6,0,6,"Braga",4,"N14 Bosch",46,46,0,74,74,0
2,22,2019,6,0,6,"Braga",5,"Avenida João Paulo II",40,40,0,8,8,0
2,22,2019,6,0,6,"Braga",6,"Avenida Padre Júlio Fragata",60,60,0,21,21,0
2,22,2019,6,0,6,"Braga",7,"Rua Nova Santa Cruz",28,28,0,115,115,0
2,22,2019,6,0,6,"Braga",8,"Rua Costa Gomes",40,40,0,42,42,0
2,22,2019,7,0,6,"Braga",1,"Avenida da Liberdade",22,22,0,30,30,0
2,22,2019,7,0,6,"Braga",2,"Avenida Central",17,17,0,284,284,0
2,22,2019,7,0,6,"Braga",3,"Rua de Caires",34,34,0,37,37,0
2,22,2019,7,0,6,"Braga",4,"N14 Bosch",46,46,0,74,74,0
2,22,2019,7,0,6,"Braga",5,"Avenida João Paulo II",40,40,0,8,8,0
2,22,2019,7,0,6,"Braga",6,"Avenida Padre Júlio Fragata",60,60,0,21,21,0
2,22,2019,7,0,6,"Braga",7,"Rua Nova Santa Cruz",28,28,0,115,115,0
2,22,2019,7,0,6,"Braga",8,"Rua Costa Gomes",40,40,0,42,42,0
2,22,2019,8,0,6,"Braga",1,"Avenida da Liberdade",22,22,0,30,30,0
2,22,2019,8,0,6,"Braga",2,"Avenida Central",13,17,4,372,284,88
2,22,2019,8,0,6,"Braga",3,"Rua de Caires",26,34,8,49,37,12
2,22,2019,8,0,6,"Braga",4,"N14 Bosch",34,46,12,100,74,26
2,22,2019,8,0,6,"Braga",5,"Avenida João Paulo II",40,40,0,8,8,0
2,22,2019,8,0,6,"Braga",6,"Avenida Padre Júlio Fragata",60,60,0,21,21,0
2,22,2019,8,0,6,"Braga",7,"Rua Nova Santa Cruz",29,29,0,111,111,0
2,22,2019,8,0,6,"Braga",8,"Rua Costa Gomes",26,39,13,64,43,21
2,22,2019,9,0,6,"Braga",1,"Avenida da Liberdade",21,21,0,32,32,0
2,22,2019,9,0,6,"Braga",2,"Avenida Central",11,17,6,439,284,155
2,22,2019,9,0,6,"Braga",3,"Rua de Caires",19,35,16,67,36,31
2,22,2019,9,0,6,"Braga",4,"N14 Bosch",32,46,14,106,74,32
2,22,2019,9,0,6,"Braga",5,"Avenida João Paulo II",27,39,12,12,8,4
2,22,2019,9,0,6,"Braga",6,"Avenida Padre Júlio Fragata",44,61,17,29,20,9
2,22,2019,9,0,6,"Braga",7,"Rua Nova Santa Cruz",20,28,8,161,115,46
2,22,2019,9,0,6,"Braga",8,"Rua Costa Gomes",25,40,15,67,42,25
2,22,2019,10,0,6,"Braga",1,"Avenida da Liberdade",22,22,0,30,30,0
2,22,2019,10,0,6,"Braga",2,"Avenida Central",17,17,0,284,284,0
2,22,2019,10,0,6,"Braga",3,"Rua de Caires",23,35,12,55,36,19
2,22,2019,10,0,6,"Braga",4,"N14 Bosch",35,45,10,97,75,22
2,22,2019,10,0,6,"Braga",5,"Avenida João Paulo II",40,40,0,8,8,0
2,22,2019,10,0,6,"Braga",6,"Avenida Padre Júlio Fragata",61,61,0,20,20,0
2,22,2019,10,0,6,"Braga",7,"Rua Nova Santa Cruz",29,29,0,111,111,0
2,22,2019,10,0,6,"Braga",8,"Rua Costa Gomes",29,39,10,57,43,14
2,22,2019,11,0,6,"Braga",1,"Avenida da Liberdade",16,21,5,42,32,10
2,22,2019,11,0,6,"Braga",2,"Avenida Central",17,17,0,284,284,0
2,22,2019,11,0,6,"Braga",3,"Rua de Caires",24,34,10,53,37,16
2,22,2019,11,0,6,"Braga",4,"N14 Bosch",30,45,15,113,75,38
2,22,2019,11,0,6,"Braga",5,"Avenida João Paulo II",30,40,10,11,8,3
2,22,2019,11,0,6,"Braga",6,"Avenida Padre Júlio Fragata",41,61,20,31,20,11
2,22,2019,11,0,6,"Braga",7,"Rua Nova Santa Cruz",20,28,8,161,115,46
2,22,2019,11,0,6,"Braga",8,"Rua Costa Gomes",30,40,10,56,42,14
2,22,2019,12,0,6,"Braga",1,"Avenida da Liberdade",21,21,0,32,32,0
2,22,2019,12,0,6,"Braga",2,"Avenida Central",13,17,4,372,284,88
2,22,2019,12,0,6,"Braga",3,"Rua de Caires",28,35,7,45,36,9
2,22,2019,12,0,6,"Braga",4,"N14 Bosch",36,46,10,94,74,20
2,22,2019,12,0,6,"Braga",5,"Avenida João Paulo II",39,39,0,8,8,0
2,22,2019,12,0,6,"Braga",6,"Avenida Padre Júlio Fragata",61,61,0,20,20,0
2,22,2019,12,0,6,"Braga",7,"Rua Nova Santa Cruz",22,29,7,146,111,35
2,22,2019,12,0,6,"Braga",8,"Rua Costa Gomes",29,40,11,57,42,15
2,22,2019,13,0,6,"Braga",1,"Avenida da Liberdade",22,22,0,30,30,0
2,22,2019,13,0,6,"Braga",2,"Avenida Central",10,17,7,483,284,199
2,22,2019,13,0,6,"Braga",3,"Rua de Caires",26,35,9,49,36,13
2,22,2019,13,0,6,"Braga",4,"N14 Bosch",32,46,14,106,74,32
2,22,2019,13,0,6,"Braga",5,"Avenida João Paulo II",39,39,0,8,8,0
2,22,2019,13,0,6,"Braga",6,"Avenida Padre Júlio Fragata",61,61,0,20,20,0
2,22,2019,13,0,6,"Braga",7,"Rua Nova Santa Cruz",28,28,0,115,115,0
2,22,2019,13,0,6,"Braga",8,"Rua Costa Gomes",32,40,8,52,42,10
2,22,2019,14,0,6,"Braga",1,"Avenida da Liberdade",17,21,4,39,32,7
2,22,2019,14,0,6,"Braga",2,"Avenida Central",12,17,5,403,284,119
2,22,2019,14,0,6,"Braga",3,"Rua de Caires",26,35,9,49,36,13
2,22,2019,14,0,6,"Braga",4,"N14 Bosch",19,46,27,179,74,105
2,22,2019,14,0,6,"Braga",5,"Avenida João Paulo II",31,40,9,11,8,3
2,22,2019,14,0,6,"Braga",6,"Avenida Padre Júlio Fragata",60,60,0,21,21,0
2,22,2019,14,0,6,"Braga",7,"Rua Nova Santa Cruz",17,29,12,189,111,78
2,22,2019,14,0,6,"Braga",8,"Rua Costa Gomes",39,39,0,43,43,0
2,22,2019,16,0,6,"Braga",1,"Avenida da Liberdade",22,22,0,30,30,0
2,22,2019,16,0,6,"Braga",2,"Avenida Central",13,18,5,372,268,104
2,22,2019,16,0,6,"Braga",3,"Rua de Caires",20,35,15,64,36,28
2,22,2019,16,0,6,"Braga",4,"N14 Bosch",25,46,21,136,74,62
2,22,2019,16,0,6,"Braga",5,"Avenida João Paulo II",28,39,11,12,8,4
2,22,2019,16,0,6,"Braga",6,"Avenida Padre Júlio Fragata",61,61,0,20,20,0
2,22,2019,16,0,6,"Braga",7,"Rua Nova Santa Cruz",20,28,8,161,115,46
2,22,2019,16,0,6,"Braga",8,"Rua Costa Gomes",26,39,13,64,43,21
2,22,2019,17,0,6,"Braga",1,"Avenida da Liberdade",18,22,4,37,30,7
2,22,2019,17,0,6,"Braga",2,"Avenida Central",10,18,8,483,268,215
2,22,2019,17,0,6,"Braga",3,"Rua de Caires",21,35,14,61,36,25
2,22,2019,17,0,6,"Braga",4,"N14 Bosch",28,45,17,121,75,46
2,22,2019,17,0,6,"Braga",5,"Avenida João Paulo II",21,40,19,16,8,8
2,22,2019,17,0,6,"Braga",6,"Avenida Padre Júlio Fragata",35,60,25,36,21,15
2,22,2019,17,0,6,"Braga",7,"Rua Nova Santa Cruz",16,28,12,201,115,86
2,22,2019,17,0,6,"Braga",8,"Rua Costa Gomes",26,39,13,64,43,21
2,22,2019,18,0,6,"Braga",1,"Avenida da Liberdade",14,21,7,48,32,16
2,22,2019,18,0,6,"Braga",2,"Avenida Central",8,18,10,604,268,336
2,22,2019,18,0,6,"Braga",3,"Rua de Caires",23,34,11,55,37,18
2,22,2019,18,0,6,"Braga",4,"N14 Bosch",12,47,35,284,72,212
2,22,2019,18,0,6,"Braga",5,"Avenida João Paulo II",11,39,28,31,8,23
2,22,2019,18,0,6,"Braga",6,"Avenida Padre Júlio Fragata",18,62,44,70,20,50
2,22,2019,18,0,6,"Braga",7,"Rua Nova Santa Cruz",8,28,20,403,115,288
2,22,2019,18,0,6,"Braga",8,"Rua Costa Gomes",15,41,26,112,40,72
2,22,2019,19,0,6,"Braga",1,"Avenida da Liberdade",22,22,0,30,30,0
2,22,2019,19,0,6,"Braga",2,"Avenida Central",4,16,12,1209,302,907
2,22,2019,19,0,6,"Braga",3,"Rua de Caires",26,35,9,49,36,13
2,22,2019,19,0,6,"Braga",4,"N14 Bosch",20,45,25,170,75,95
2,22,2019,19,0,6,"Braga",5,"Avenida João Paulo II",12,41,29,28,8,20
2,22,2019,19,0,6,"Braga",6,"Avenida Padre Júlio Fragata",18,59,41,70,21,49
2,22,2019,19,0,6,"Braga",7,"Rua Nova Santa Cruz",16,29,13,201,111,90
2,22,2019,19,0,6,"Braga",8,"Rua Costa Gomes",8,38,30,210,44,166
2,22,2019,20,0,6,"Braga",1,"Avenida da Liberdade",21,21,0,32,32,0
2,22,2019,20,0,6,"Braga",2,"Avenida Central",12,18,6,403,268,135
2,22,2019,20,0,6,"Braga",3,"Rua de Caires",28,35,7,45,36,9
2,22,2019,20,0,6,"Braga",4,"N14 Bosch",35,46,11,97,74,23
2,22,2019,20,0,6,"Braga",5,"Avenida João Paulo II",20,39,19,17,8,9
2,22,2019,20,0,6,"Braga",6,"Avenida Padre Júlio Fragata",40,60,20,31,21,10
2,22,2019,20,0,6,"Braga",7,"Rua Nova Santa Cruz",9,29,20,358,111,247
2,22,2019,20,0,6,"Braga",8,"Rua Costa Gomes",29,39,10,57,43,14
2,22,2019,21,0,6,"Braga",1,"Avenida da Liberdade",21,21,0,32,32,0
2,22,2019,21,0,6,"Braga",2,"Avenida Central",18,18,0,268,268,0
2,22,2019,21,0,6,"Braga",3,"Rua de Caires",34,34,0,37,37,0
2,22,2019,21,0,6,"Braga",4,"N14 Bosch",46,46,0,74,74,0
2,22,2019,21,0,6,"Braga",5,"Avenida João Paulo II",32,40,8,10,8,2
2,22,2019,21,0,6,"Braga",6,"Avenida Padre Júlio Fragata",61,61,0,20,20,0
2,22,2019,21,0,6,"Braga",7,"Rua Nova Santa Cruz",29,29,0,111,111,0
2,22,2019,21,0,6,"Braga",8,"Rua Costa Gomes",40,40,0,42,42,0
2,22,2019,22,0,6,"Braga",1,"Avenida da Liberdade",21,21,0,32,32,0
2,22,2019,22,0,6,"Braga",2,"Avenida Central",18,18,0,268,268,0
2,22,2019,22,0,6,"Braga",3,"Rua de Caires",34,34,0,37,37,0
2,22,2019,22,0,6,"Braga",4,"N14 Bosch",46,46,0,74,74,0
2,22,2019,22,0,6,"Braga",5,"Avenida João Paulo II",40,40,0,8,8,0
2,22,2019,22,0,6,"Braga",6,"Avenida Padre Júlio Fragata",61,61,0,20,20,0
2,22,2019,22,0,6,"Braga",7,"Rua Nova Santa Cruz",29,29,0,111,111,0
2,22,2019,22,0,6,"Braga",8,"Rua Costa Gomes",40,40,0,42,42,0
2,22,2019,23,0,6,"Braga",1,"Avenida da Liberdade",21,21,0,32,32,0
2,22,2019,23,0,6,"Braga",2,"Avenida Central",18,18,0,268,268,0
2,22,2019,23,0,6,"Braga",3,"Rua de Caires",34,34,0,37,37,0
2,22,2019,23,0,6,"Braga",4,"N14 Bosch",46,46,0,74,74,0
2,22,2019,23,0,6,"Braga",5,"Avenida João Paulo II",40,40,0,8,8,0
2,22,2019,23,0,6,"Braga",6,"Avenida Padre Júlio Fragata",37,60,23,34,21,13
2,22,2019,23,0,6,"Braga",7,"Rua Nova Santa Cruz",29,29,0,111,111,0
2,22,2019,23,0,6,"Braga",8,"Rua Costa Gomes",40,40,0,42,42,0
2,23,2019,0,0,7,"Braga",1,"Avenida da Liberdade",21,21,0,32,32,0
2,23,2019,0,0,7,"Braga",2,"Avenida Central",18,18,0,268,268,0
2,23,2019,0,0,7,"Braga",3,"Rua de Caires",35,35,0,36,36,0
2,23,2019,0,0,7,"Braga",4,"N14 Bosch",46,46,0,74,74,0
2,23,2019,0,0,7,"Braga",5,"Avenida João Paulo II",40,40,0,8,8,0
2,23,2019,0,0,7,"Braga",6,"Avenida Padre Júlio Fragata",61,61,0,20,20,0
2,23,2019,0,0,7,"Braga",7,"Rua Nova Santa Cruz",29,29,0,111,111,0
2,23,2019,0,0,7,"Braga",8,"Rua Costa Gomes",40,40,0,42,42,0
2,23,2019,1,0,7,"Braga",1,"Avenida da Liberdade",21,21,0,32,32,0
2,23,2019,1,0,7,"Braga",2,"Avenida Central",17,17,0,284,284,0
2,23,2019,1,0,7,"Braga",3,"Rua de Caires",35,35,0,36,36,0
2,23,2019,1,0,7,"Braga",4,"N14 Bosch",46,46,0,74,74,0
2,23,2019,1,0,7,"Braga",5,"Avenida João Paulo II",40,40,0,8,8,0
2,23,2019,1,0,7,"Braga",6,"Avenida Padre Júlio Fragata",61,61,0,20,20,0
2,23,2019,1,0,7,"Braga",7,"Rua Nova Santa Cruz",29,29,0,111,111,0
2,23,2019,1,0,7,"Braga",8,"Rua Costa Gomes",40,40,0,42,42,0
2,23,2019,2,0,7,"Braga",1,"Avenida da Liberdade",21,21,0,32,32,0
2,23,2019,2,0,7,"Braga",2,"Avenida Central",17,17,0,284,284,0
2,23,2019,2,0,7,"Braga",3,"Rua de Caires",35,35,0,36,36,0
2,23,2019,2,0,7,"Braga",4,"N14 Bosch",46,46,0,74,74,0
2,23,2019,2,0,7,"Braga",5,"Avenida João Paulo II",40,40,0,8,8,0
2,23,2019,2,0,7,"Braga",6,"Avenida Padre Júlio Fragata",61,61,0,20,20,0
2,23,2019,2,0,7,"Braga",7,"Rua Nova Santa Cruz",29,29,0,111,111,0
2,23,2019,2,0,7,"Braga",8,"Rua Costa Gomes",40,40,0,42,42,0
2,23,2019,3,0,7,"Braga",1,"Avenida da Liberdade",21,21,0,32,32,0
2,23,2019,3,0,7,"Braga",2,"Avenida Central",13,17,4,372,284,88
2,23,2019,3,0,7,"Braga",3,"Rua de Caires",35,35,0,36,36,0
2,23,2019,3,0,7,"Braga",4,"N14 Bosch",46,46,0,74,74,0
2,23,2019,3,0,7,"Braga",5,"Avenida João Paulo II",40,40,0,8,8,0
2,23,2019,3,0,7,"Braga",6,"Avenida Padre Júlio Fragata",61,61,0,20,20,0
2,23,2019,3,0,7,"Braga",7,"Rua Nova Santa Cruz",29,29,0,111,111,0
2,23,2019,3,0,7,"Braga",8,"Rua Costa Gomes",40,40,0,42,42,0
2,23,2019,4,0,7,"Braga",1,"Avenida da Liberdade",21,21,0,32,32,0
2,23,2019,4,0,7,"Braga",2,"Avenida Central",18,18,0,268,268,0
2,23,2019,4,0,7,"Braga",3,"Rua de Caires",35,35,0,36,36,0
2,23,2019,4,0,7,"Braga",4,"N14 Bosch",46,46,0,74,74,0
2,23,2019,4,0,7,"Braga",5,"Avenida João Paulo II",40,40,0,8,8,0
2,23,2019,4,0,7,"Braga",6,"Avenida Padre Júlio Fragata",61,61,0,20,20,0
2,23,2019,4,0,7,"Braga",7,"Rua Nova Santa Cruz",29,29,0,111,111,0
2,23,2019,4,0,7,"Braga",8,"Rua Costa Gomes",40,40,0,42,42,0
2,23,2019,5,0,7,"Braga",1,"Avenida da Liberdade",21,21,0,32,32,0
2,23,2019,5,0,7,"Braga",2,"Avenida Central",18,18,0,268,268,0
2,23,2019,5,0,7,"Braga",3,"Rua de Caires",35,35,0,36,36,0
2,23,2019,5,0,7,"Braga",4,"N14 Bosch",46,46,0,74,74,0
2,23,2019,5,0,7,"Braga",5,"Avenida João Paulo II",40,40,0,8,8,0
2,23,2019,5,0,7,"Braga",6,"Avenida Padre Júlio Fragata",61,61,0,20,20,0
2,23,2019,5,0,7,"Braga",7,"Rua Nova Santa Cruz",29,29,0,111,111,0
2,23,2019,5,0,7,"Braga",8,"Rua Costa Gomes",40,40,0,42,42,0
2,23,2019,6,0,7,"Braga",1,"Avenida da Liberdade",21,21,0,32,32,0
2,23,2019,6,0,7,"Braga",2,"Avenida Central",18,18,0,268,268,0
2,23,2019,6,0,7,"Braga",3,"Rua de Caires",35,35,0,36,36,0
2,23,2019,6,0,7,"Braga",4,"N14 Bosch",46,46,0,74,74,0
2,23,2019,6,0,7,"Braga",5,"Avenida João Paulo II",40,40,0,8,8,0
2,23,2019,6,0,7,"Braga",6,"Avenida Padre Júlio Fragata",61,61,0,20,20,0
2,23,2019,6,0,7,"Braga",7,"Rua Nova Santa Cruz",29,29,0,111,111,0
2,23,2019,6,0,7,"Braga",8,"Rua Costa Gomes",40,40,0,42,42,0
2,23,2019,7,0,7,"Braga",1,"Avenida da Liberdade",21,21,0,32,32,0
2,23,2019,7,0,7,"Braga",2,"Avenida Central",18,18,0,268,268,0
2,23,2019,7,0,7,"Braga",3,"Rua de Caires",35,35,0,36,36,0
2,23,2019,7,0,7,"Braga",4,"N14 Bosch",46,46,0,74,74,0
2,23,2019,7,0,7,"Braga",5,"Avenida João Paulo II",40,40,0,8,8,0
2,23,2019,7,0,7,"Braga",6,"Avenida Padre Júlio Fragata",61,61,0,20,20,0
2,23,2019,7,0,7,"Braga",7,"Rua Nova Santa Cruz",29,29,0,111,111,0
2,23,2019,7,0,7,"Braga",8,"Rua Costa Gomes",40,40,0,42,42,0
2,23,2019,8,0,7,"Braga",1,"Avenida da Liberdade",21,21,0,32,32,0
2,23,2019,8,0,7,"Braga",2,"Avenida Central",18,18,0,268,268,0
2,23,2019,8,0,7,"Braga",3,"Rua de Caires",35,35,0,36,36,0
2,23,2019,8,0,7,"Braga",4,"N14 Bosch",46,46,0,74,74,0
2,23,2019,8,0,7,"Braga",5,"Avenida João Paulo II",40,40,0,8,8,0
2,23,2019,8,0,7,"Braga",6,"Avenida Padre Júlio Fragata",61,61,0,20,20,0
2,23,2019,8,0,7,"Braga",7,"Rua Nova Santa Cruz",29,29,0,111,111,0
2,23,2019,8,0,7,"Braga",8,"Rua Costa Gomes",40,40,0,42,42,0
2,23,2019,9,0,7,"Braga",1,"Avenida da Liberdade",21,21,0,32,32,0
2,23,2019,9,0,7,"Braga",2,"Avenida Central",13,17,4,372,284,88
2,23,2019,9,0,7,"Braga",3,"Rua de Caires",22,35,13,58,36,22
2,23,2019,9,0,7,"Braga",4,"N14 Bosch",46,46,0,74,74,0
2,23,2019,9,0,7,"Braga",5,"Avenida João Paulo II",40,40,0,8,8,0
2,23,2019,9,0,7,"Braga",6,"Avenida Padre Júlio Fragata",61,61,0,20,20,0
2,23,2019,9,0,7,"Braga",7,"Rua Nova Santa Cruz",29,29,0,111,111,0
2,23,2019,9,0,7,"Braga",8,"Rua Costa Gomes",40,40,0,42,42,0
2,23,2019,10,0,7,"Braga",1,"Avenida da Liberdade",21,21,0,32,32,0
2,23,2019,10,0,7,"Braga",2,"Avenida Central",14,18,4,345,268,77
2,23,2019,10,0,7,"Braga",3,"Rua de Caires",34,34,0,37,37,0
2,23,2019,10,0,7,"Braga",4,"N14 Bosch",45,45,0,75,75,0
2,23,2019,10,0,7,"Braga",5,"Avenida João Paulo II",39,39,0,8,8,0
2,23,2019,10,0,7,"Braga",6,"Avenida Padre Júlio Fragata",61,61,0,20,20,0
2,23,2019,10,0,7,"Braga",7,"Rua Nova Santa Cruz",29,29,0,111,111,0
2,23,2019,10,0,7,"Braga",8,"Rua Costa Gomes",40,40,0,42,42,0
2,23,2019,11,0,7,"Braga",5,"Avenida João Paulo II",39,39,0,8,8,0
2,23,2019,11,0,7,"Braga",6,"Avenida Padre Júlio Fragata",61,61,0,20,20,0
2,23,2019,11,0,7,"Braga",7,"Rua Nova Santa Cruz",29,29,0,111,111,0
2,23,2019,11,0,7,"Braga",8,"Rua Costa Gomes",19,40,21,88,42,46
2,23,2019,11,0,7,"Braga",1,"Avenida da Liberdade",21,21,0,32,32,0
2,23,2019,11,0,7,"Braga",2,"Avenida Central",11,18,7,439,268,171
2,23,2019,11,0,7,"Braga",3,"Rua de Caires",26,34,8,49,37,12
2,23,2019,11,0,7,"Braga",4,"N14 Bosch",32,46,14,106,74,32
2,23,2019,11,0,7,"Braga",5,"Avenida João Paulo II",39,39,0,8,8,0
2,23,2019,12,0,7,"Braga",1,"Avenida da Liberdade",21,21,0,32,32,0
2,23,2019,12,0,7,"Braga",2,"Avenida Central",10,17,7,483,284,199
2,23,2019,12,0,7,"Braga",3,"Rua de Caires",27,34,7,47,37,10
2,23,2019,12,0,7,"Braga",4,"N14 Bosch",45,45,0,75,75,0
2,23,2019,12,0,7,"Braga",5,"Avenida João Paulo II",39,39,0,8,8,0
2,23,2019,12,0,7,"Braga",6,"Avenida Padre Júlio Fragata",61,61,0,20,20,0
2,23,2019,12,0,7,"Braga",7,"Rua Nova Santa Cruz",29,29,0,111,111,0
2,23,2019,12,0,7,"Braga",8,"Rua Costa Gomes",19,40,21,88,42,46
2,23,2019,13,0,7,"Braga",1,"Avenida da Liberdade",21,21,0,32,32,0
2,23,2019,13,0,7,"Braga",2,"Avenida Central",10,18,8,483,268,215
2,23,2019,13,0,7,"Braga",3,"Rua de Caires",26,35,9,49,36,13
2,23,2019,13,0,7,"Braga",4,"N14 Bosch",35,46,11,97,74,23
2,23,2019,13,0,7,"Braga",5,"Avenida João Paulo II",40,40,0,8,8,0
2,23,2019,13,0,7,"Braga",6,"Avenida Padre Júlio Fragata",61,61,0,20,20,0
2,23,2019,13,0,7,"Braga",7,"Rua Nova Santa Cruz",21,29,8,153,111,42
2,23,2019,13,0,7,"Braga",8,"Rua Costa Gomes",30,40,10,56,42,14
2,23,2019,14,0,7,"Braga",1,"Avenida da Liberdade",21,21,0,32,32,0
2,23,2019,14,0,7,"Braga",2,"Avenida Central",13,18,5,372,268,104
2,23,2019,14,0,7,"Braga",3,"Rua de Caires",34,34,0,37,37,0
2,23,2019,14,0,7,"Braga",4,"N14 Bosch",46,46,0,74,74,0
2,23,2019,14,0,7,"Braga",5,"Avenida João Paulo II",40,40,0,8,8,0
2,23,2019,14,0,7,"Braga",6,"Avenida Padre Júlio Fragata",60,60,0,21,21,0
2,23,2019,14,0,7,"Braga",7,"Rua Nova Santa Cruz",29,29,0,111,111,0
2,23,2019,14,0,7,"Braga",8,"Rua Costa Gomes",40,40,0,42,42,0
2,23,2019,15,0,7,"Braga",1,"Avenida da Liberdade",21,21,0,32,32,0
2,23,2019,15,0,7,"Braga",2,"Avenida Central",11,17,6,439,284,155
2,23,2019,15,0,7,"Braga",3,"Rua de Caires",25,35,10,51,36,15
2,23,2019,15,0,7,"Braga",4,"N14 Bosch",22,46,24,155,74,81
2,23,2019,15,0,7,"Braga",5,"Avenida João Paulo II",40,40,0,8,8,0
2,23,2019,15,0,7,"Braga",6,"Avenida Padre Júlio Fragata",60,60,0,21,21,0
2,23,2019,15,0,7,"Braga",7,"Rua Nova Santa Cruz",29,29,0,111,111,0
2,23,2019,15,0,7,"Braga",8,"Rua Costa Gomes",39,39,0,43,43,0
2,23,2019,16,0,7,"Braga",1,"Avenida da Liberdade",21,21,0,32,32,0
2,23,2019,16,0,7,"Braga",2,"Avenida Central",14,17,3,345,284,61
2,23,2019,16,0,7,"Braga",3,"Rua de Caires",34,34,0,37,37,0
2,23,2019,16,0,7,"Braga",4,"N14 Bosch",36,46,10,94,74,20
2,23,2019,16,0,7,"Braga",5,"Avenida João Paulo II",28,39,11,12,8,4
2,23,2019,16,0,7,"Braga",6,"Avenida Padre Júlio Fragata",47,61,14,27,20,7
2,23,2019,16,0,7,"Braga",7,"Rua Nova Santa Cruz",28,28,0,115,115,0
2,23,2019,16,0,7,"Braga",8,"Rua Costa Gomes",40,40,0,42,42,0
2,23,2019,17,0,7,"Braga",1,"Avenida da Liberdade",21,21,0,32,32,0
2,23,2019,17,0,7,"Braga",2,"Avenida Central",11,17,6,439,284,155
2,23,2019,17,0,7,"Braga",3,"Rua de Caires",22,34,12,58,37,21
2,23,2019,17,0,7,"Braga",4,"N14 Bosch",46,46,0,74,74,0
2,23,2019,17,0,7,"Braga",5,"Avenida João Paulo II",28,39,11,12,8,4
2,23,2019,17,0,7,"Braga",6,"Avenida Padre Júlio Fragata",46,60,14,27,21,6
2,23,2019,17,0,7,"Braga",7,"Rua Nova Santa Cruz",28,28,0,115,115,0
2,23,2019,17,0,7,"Braga",8,"Rua Costa Gomes",30,40,10,56,42,14
2,23,2019,18,0,7,"Braga",1,"Avenida da Liberdade",21,21,0,32,32,0
2,23,2019,18,0,7,"Braga",2,"Avenida Central",14,18,4,345,268,77
2,23,2019,18,0,7,"Braga",3,"Rua de Caires",26,35,9,49,36,13
2,23,2019,18,0,7,"Braga",4,"N14 Bosch",36,45,9,94,75,19
2,23,2019,18,0,7,"Braga",5,"Avenida João Paulo II",30,39,9,11,8,3
2,23,2019,18,0,7,"Braga",6,"Avenida Padre Júlio Fragata",35,61,26,36,20,16
2,23,2019,18,0,7,"Braga",7,"Rua Nova Santa Cruz",28,28,0,115,115,0
2,23,2019,18,0,7,"Braga",8,"Rua Costa Gomes",26,39,13,64,43,21
2,23,2019,19,0,7,"Braga",1,"Avenida da Liberdade",21,21,0,32,32,0
2,23,2019,19,0,7,"Braga",2,"Avenida Central",17,17,0,284,284,0
2,23,2019,19,0,7,"Braga",3,"Rua de Caires",21,34,13,61,37,24
2,23,2019,19,0,7,"Braga",4,"N14 Bosch",32,45,13,106,75,31
2,23,2019,19,0,7,"Braga",5,"Avenida João Paulo II",28,39,11,12,8,4
2,23,2019,19,0,7,"Braga",6,"Avenida Padre Júlio Fragata",34,61,27,37,20,17
2,23,2019,19,0,7,"Braga",7,"Rua Nova Santa Cruz",28,28,0,115,115,0
2,23,2019,19,0,7,"Braga",8,"Rua Costa Gomes",26,40,14,64,42,22
2,23,2019,20,0,7,"Braga",1,"Avenida da Liberdade",21,21,0,32,32,0
2,23,2019,20,0,7,"Braga",2,"Avenida Central",18,18,0,268,268,0
2,23,2019,20,0,7,"Braga",3,"Rua de Caires",35,35,0,36,36,0
2,23,2019,20,0,7,"Braga",4,"N14 Bosch",45,45,0,75,75,0
2,23,2019,20,0,7,"Braga",5,"Avenida João Paulo II",28,40,12,12,8,4
2,23,2019,20,0,7,"Braga",6,"Avenida Padre Júlio Fragata",43,60,17,29,21,8
2,23,2019,20,0,7,"Braga",7,"Rua Nova Santa Cruz",29,29,0,111,111,0
2,23,2019,20,0,7,"Braga",8,"Rua Costa Gomes",25,40,15,67,42,25
2,23,2019,21,0,7,"Braga",1,"Avenida da Liberdade",21,21,0,32,32,0
2,23,2019,21,0,7,"Braga",2,"Avenida Central",18,18,0,268,268,0
2,23,2019,21,0,7,"Braga",3,"Rua de Caires",35,35,0,36,36,0
2,23,2019,21,0,7,"Braga",4,"N14 Bosch",46,46,0,74,74,0
2,23,2019,21,0,7,"Braga",5,"Avenida João Paulo II",40,40,0,8,8,0
2,23,2019,21,0,7,"Braga",6,"Avenida Padre Júlio Fragata",38,61,23,33,20,13
2,23,2019,21,0,7,"Braga",7,"Rua Nova Santa Cruz",29,29,0,111,111,0
2,23,2019,21,0,7,"Braga",8,"Rua Costa Gomes",40,40,0,42,42,0
2,23,2019,22,0,7,"Braga",1,"Avenida da Liberdade",21,21,0,32,32,0
2,23,2019,22,0,7,"Braga",2,"Avenida Central",18,18,0,268,268,0
2,23,2019,22,0,7,"Braga",3,"Rua de Caires",35,35,0,36,36,0
2,23,2019,22,0,7,"Braga",4,"N14 Bosch",46,46,0,74,74,0
2,23,2019,22,0,7,"Braga",5,"Avenida João Paulo II",40,40,0,8,8,0
2,23,2019,22,0,7,"Braga",6,"Avenida Padre Júlio Fragata",60,60,0,21,21,0
2,23,2019,22,0,7,"Braga",7,"Rua Nova Santa Cruz",29,29,0,111,111,0
2,23,2019,22,0,7,"Braga",8,"Rua Costa Gomes",40,40,0,42,42,0
2,23,2019,23,0,7,"Braga",1,"Avenida da Liberdade",21,21,0,32,32,0
2,23,2019,23,0,7,"Braga",2,"Avenida Central",17,17,0,284,284,0
2,23,2019,23,0,7,"Braga",3,"Rua de Caires",35,35,0,36,36,0
2,23,2019,23,0,7,"Braga",4,"N14 Bosch",46,46,0,74,74,0
2,23,2019,23,0,7,"Braga",5,"Avenida João Paulo II",40,40,0,8,8,0
2,23,2019,23,0,7,"Braga",6,"Avenida Padre Júlio Fragata",61,61,0,20,20,0
2,23,2019,23,0,7,"Braga",7,"Rua Nova Santa Cruz",29,29,0,111,111,0
2,23,2019,23,0,7,"Braga",8,"Rua Costa Gomes",40,40,0,42,42,0
2,24,2019,0,0,8,"Braga",1,"Avenida da Liberdade",21,21,0,32,32,0
2,24,2019,0,0,8,"Braga",2,"Avenida Central",17,17,0,284,284,0
2,24,2019,0,0,8,"Braga",3,"Rua de Caires",35,35,0,36,36,0
2,24,2019,0,0,8,"Braga",4,"N14 Bosch",46,46,0,74,74,0
2,24,2019,0,0,8,"Braga",5,"Avenida João Paulo II",40,40,0,8,8,0
2,24,2019,0,0,8,"Braga",6,"Avenida Padre Júlio Fragata",61,61,0,20,20,0
2,24,2019,0,0,8,"Braga",7,"Rua Nova Santa Cruz",29,29,0,111,111,0
2,24,2019,0,0,8,"Braga",8,"Rua Costa Gomes",40,40,0,42,42,0
2,24,2019,1,0,8,"Braga",1,"Avenida da Liberdade",21,21,0,32,32,0
2,24,2019,1,0,8,"Braga",2,"Avenida Central",17,17,0,284,284,0
2,24,2019,1,0,8,"Braga",3,"Rua de Caires",35,35,0,36,36,0
2,24,2019,1,0,8,"Braga",4,"N14 Bosch",46,46,0,74,74,0
2,24,2019,1,0,8,"Braga",5,"Avenida João Paulo II",40,40,0,8,8,0
2,24,2019,1,0,8,"Braga",6,"Avenida Padre Júlio Fragata",60,60,0,21,21,0
2,24,2019,1,0,8,"Braga",7,"Rua Nova Santa Cruz",29,29,0,111,111,0
2,24,2019,1,0,8,"Braga",8,"Rua Costa Gomes",40,40,0,42,42,0
2,24,2019,2,0,8,"Braga",1,"Avenida da Liberdade",21,21,0,32,32,0
2,24,2019,2,0,8,"Braga",2,"Avenida Central",17,17,0,284,284,0
2,24,2019,2,0,8,"Braga",3,"Rua de Caires",35,35,0,36,36,0
2,24,2019,2,0,8,"Braga",4,"N14 Bosch",46,46,0,74,74,0
2,24,2019,2,0,8,"Braga",5,"Avenida João Paulo II",40,40,0,8,8,0
2,24,2019,2,0,8,"Braga",6,"Avenida Padre Júlio Fragata",60,60,0,21,21,0
2,24,2019,2,0,8,"Braga",7,"Rua Nova Santa Cruz",19,29,10,169,111,58
2,24,2019,2,0,8,"Braga",8,"Rua Costa Gomes",40,40,0,42,42,0
2,24,2019,3,0,8,"Braga",1,"Avenida da Liberdade",21,21,0,32,32,0
2,24,2019,3,0,8,"Braga",2,"Avenida Central",17,17,0,284,284,0
2,24,2019,3,0,8,"Braga",3,"Rua de Caires",35,35,0,36,36,0
2,24,2019,3,0,8,"Braga",4,"N14 Bosch",46,46,0,74,74,0
2,24,2019,3,0,8,"Braga",5,"Avenida João Paulo II",40,40,0,8,8,0
2,24,2019,3,0,8,"Braga",6,"Avenida Padre Júlio Fragata",60,60,0,21,21,0
2,24,2019,3,0,8,"Braga",7,"Rua Nova Santa Cruz",29,29,0,111,111,0
2,24,2019,3,0,8,"Braga",8,"Rua Costa Gomes",40,40,0,42,42,0
2,24,2019,4,0,8,"Braga",1,"Avenida da Liberdade",21,21,0,32,32,0
2,24,2019,4,0,8,"Braga",2,"Avenida Central",17,17,0,284,284,0
2,24,2019,4,0,8,"Braga",3,"Rua de Caires",35,35,0,36,36,0
2,24,2019,4,0,8,"Braga",4,"N14 Bosch",46,46,0,74,74,0
2,24,2019,4,0,8,"Braga",5,"Avenida João Paulo II",40,40,0,8,8,0
2,24,2019,4,0,8,"Braga",6,"Avenida Padre Júlio Fragata",60,60,0,21,21,0
2,24,2019,4,0,8,"Braga",7,"Rua Nova Santa Cruz",29,29,0,111,111,0
2,24,2019,4,0,8,"Braga",8,"Rua Costa Gomes",40,40,0,42,42,0
2,24,2019,5,0,8,"Braga",1,"Avenida da Liberdade",21,21,0,32,32,0
2,24,2019,5,0,8,"Braga",2,"Avenida Central",17,17,0,284,284,0
2,24,2019,5,0,8,"Braga",3,"Rua de Caires",35,35,0,36,36,0
2,24,2019,5,0,8,"Braga",4,"N14 Bosch",46,46,0,74,74,0
2,24,2019,5,0,8,"Braga",5,"Avenida João Paulo II",40,40,0,8,8,0
2,24,2019,5,0,8,"Braga",6,"Avenida Padre Júlio Fragata",60,60,0,21,21,0
2,24,2019,5,0,8,"Braga",7,"Rua Nova Santa Cruz",29,29,0,111,111,0
2,24,2019,5,0,8,"Braga",8,"Rua Costa Gomes",40,40,0,42,42,0
2,24,2019,6,0,8,"Braga",1,"Avenida da Liberdade",21,21,0,32,32,0
2,24,2019,6,0,8,"Braga",2,"Avenida Central",17,17,0,284,284,0
2,24,2019,6,0,8,"Braga",3,"Rua de Caires",35,35,0,36,36,0
2,24,2019,6,0,8,"Braga",4,"N14 Bosch",46,46,0,74,74,0
2,24,2019,6,0,8,"Braga",5,"Avenida João Paulo II",40,40,0,8,8,0
2,24,2019,6,0,8,"Braga",6,"Avenida Padre Júlio Fragata",60,60,0,21,21,0
2,24,2019,6,0,8,"Braga",7,"Rua Nova Santa Cruz",29,29,0,111,111,0
2,24,2019,6,0,8,"Braga",8,"Rua Costa Gomes",40,40,0,42,42,0
2,24,2019,7,0,8,"Braga",1,"Avenida da Liberdade",21,21,0,32,32,0
2,24,2019,7,0,8,"Braga",2,"Avenida Central",17,17,0,284,284,0
2,24,2019,7,0,8,"Braga",3,"Rua de Caires",35,35,0,36,36,0
2,24,2019,7,0,8,"Braga",4,"N14 Bosch",46,46,0,74,74,0
2,24,2019,7,0,8,"Braga",5,"Avenida João Paulo II",40,40,0,8,8,0
2,24,2019,7,0,8,"Braga",6,"Avenida Padre Júlio Fragata",60,60,0,21,21,0
2,24,2019,7,0,8,"Braga",7,"Rua Nova Santa Cruz",29,29,0,111,111,0
2,24,2019,7,0,8,"Braga",8,"Rua Costa Gomes",40,40,0,42,42,0
2,24,2019,8,0,8,"Braga",1,"Avenida da Liberdade",21,21,0,32,32,0
2,24,2019,8,0,8,"Braga",2,"Avenida Central",17,17,0,284,284,0
2,24,2019,8,0,8,"Braga",3,"Rua de Caires",35,35,0,36,36,0
2,24,2019,8,0,8,"Braga",4,"N14 Bosch",46,46,0,74,74,0
2,24,2019,8,0,8,"Braga",5,"Avenida João Paulo II",40,40,0,8,8,0
2,24,2019,8,0,8,"Braga",6,"Avenida Padre Júlio Fragata",60,60,0,21,21,0
2,24,2019,8,0,8,"Braga",7,"Rua Nova Santa Cruz",29,29,0,111,111,0
2,24,2019,8,0,8,"Braga",8,"Rua Costa Gomes",40,40,0,42,42,0
2,24,2019,9,0,8,"Braga",1,"Avenida da Liberdade",21,21,0,32,32,0
2,24,2019,9,0,8,"Braga",2,"Avenida Central",17,17,0,284,284,0
2,24,2019,9,0,8,"Braga",3,"Rua de Caires",35,35,0,36,36,0
2,24,2019,9,0,8,"Braga",4,"N14 Bosch",46,46,0,74,74,0
2,24,2019,9,0,8,"Braga",5,"Avenida João Paulo II",40,40,0,8,8,0
2,24,2019,9,0,8,"Braga",6,"Avenida Padre Júlio Fragata",60,60,0,21,21,0
2,24,2019,9,0,8,"Braga",7,"Rua Nova Santa Cruz",29,29,0,111,111,0
2,24,2019,9,0,8,"Braga",8,"Rua Costa Gomes",40,40,0,42,42,0
2,24,2019,10,0,8,"Braga",1,"Avenida da Liberdade",21,21,0,32,32,0
2,24,2019,10,0,8,"Braga",2,"Avenida Central",17,17,0,284,284,0
2,24,2019,10,0,8,"Braga",3,"Rua de Caires",35,35,0,36,36,0
2,24,2019,10,0,8,"Braga",4,"N14 Bosch",46,46,0,74,74,0
2,24,2019,10,0,8,"Braga",5,"Avenida João Paulo II",40,40,0,8,8,0
2,24,2019,10,0,8,"Braga",6,"Avenida Padre Júlio Fragata",60,60,0,21,21,0
2,24,2019,10,0,8,"Braga",7,"Rua Nova Santa Cruz",29,29,0,111,111,0
2,24,2019,10,0,8,"Braga",8,"Rua Costa Gomes",29,40,11,57,42,15
2,24,2019,11,0,8,"Braga",1,"Avenida da Liberdade",21,21,0,32,32,0
2,24,2019,11,0,8,"Braga",2,"Avenida Central",17,17,0,284,284,0
2,24,2019,11,0,8,"Braga",3,"Rua de Caires",34,34,0,37,37,0
2,24,2019,11,0,8,"Braga",4,"N14 Bosch",26,46,20,131,74,57
2,24,2019,11,0,8,"Braga",5,"Avenida João Paulo II",40,40,0,8,8,0
2,24,2019,11,0,8,"Braga",6,"Avenida Padre Júlio Fragata",60,60,0,21,21,0
2,24,2019,11,0,8,"Braga",7,"Rua Nova Santa Cruz",29,29,0,111,111,0
2,24,2019,11,0,8,"Braga",8,"Rua Costa Gomes",40,40,0,42,42,0
2,24,2019,12,0,8,"Braga",1,"Avenida da Liberdade",21,21,0,32,32,0
2,24,2019,12,0,8,"Braga",2,"Avenida Central",17,17,0,284,284,0
2,24,2019,12,0,8,"Braga",3,"Rua de Caires",34,34,0,37,37,0
2,24,2019,12,0,8,"Braga",4,"N14 Bosch",45,45,0,75,75,0
2,24,2019,12,0,8,"Braga",5,"Avenida João Paulo II",39,39,0,8,8,0
2,24,2019,12,0,8,"Braga",6,"Avenida Padre Júlio Fragata",60,60,0,21,21,0
2,24,2019,12,0,8,"Braga",7,"Rua Nova Santa Cruz",29,29,0,111,111,0
2,24,2019,12,0,8,"Braga",8,"Rua Costa Gomes",27,40,13,62,42,20
2,24,2019,13,0,8,"Braga",1,"Avenida da Liberdade",21,21,0,32,32,0
2,24,2019,13,0,8,"Braga",2,"Avenida Central",18,18,0,268,268,0
2,24,2019,13,0,8,"Braga",3,"Rua de Caires",35,35,0,36,36,0
2,24,2019,13,0,8,"Braga",4,"N14 Bosch",45,45,0,75,75,0
2,24,2019,13,0,8,"Braga",5,"Avenida João Paulo II",31,39,8,11,8,3
2,24,2019,13,0,8,"Braga",6,"Avenida Padre Júlio Fragata",60,60,0,21,21,0
2,24,2019,13,0,8,"Braga",7,"Rua Nova Santa Cruz",29,29,0,111,111,0
2,24,2019,13,0,8,"Braga",8,"Rua Costa Gomes",40,40,0,42,42,0
2,24,2019,14,0,8,"Braga",1,"Avenida da Liberdade",21,21,0,32,32,0
2,24,2019,14,0,8,"Braga",2,"Avenida Central",18,18,0,268,268,0
2,24,2019,14,0,8,"Braga",3,"Rua de Caires",35,35,0,36,36,0
2,24,2019,14,0,8,"Braga",4,"N14 Bosch",45,45,0,75,75,0
2,24,2019,14,0,8,"Braga",5,"Avenida João Paulo II",40,40,0,8,8,0
2,24,2019,14,0,8,"Braga",6,"Avenida Padre Júlio Fragata",61,61,0,20,20,0
2,24,2019,14,0,8,"Braga",7,"Rua Nova Santa Cruz",29,29,0,111,111,0
2,24,2019,14,0,8,"Braga",8,"Rua Costa Gomes",40,40,0,42,42,0
2,24,2019,15,0,8,"Braga",1,"Avenida da Liberdade",21,21,0,32,32,0
2,24,2019,15,0,8,"Braga",2,"Avenida Central",17,17,0,284,284,0
2,24,2019,15,0,8,"Braga",3,"Rua de Caires",35,35,0,36,36,0
2,24,2019,15,0,8,"Braga",4,"N14 Bosch",45,45,0,75,75,0
2,24,2019,15,0,8,"Braga",5,"Avenida João Paulo II",29,39,10,11,8,3
2,24,2019,15,0,8,"Braga",6,"Avenida Padre Júlio Fragata",61,61,0,20,20,0
2,24,2019,15,0,8,"Braga",7,"Rua Nova Santa Cruz",29,29,0,111,111,0
2,24,2019,15,0,8,"Braga",8,"Rua Costa Gomes",29,39,10,57,43,14
2,24,2019,16,0,8,"Braga",1,"Avenida da Liberdade",21,21,0,32,32,0
2,24,2019,16,0,8,"Braga",2,"Avenida Central",12,18,6,403,268,135
2,24,2019,16,0,8,"Braga",3,"Rua de Caires",35,35,0,36,36,0
2,24,2019,16,0,8,"Braga",4,"N14 Bosch",36,46,10,94,74,20
2,24,2019,16,0,8,"Braga",5,"Avenida João Paulo II",30,40,10,11,8,3
2,24,2019,16,0,8,"Braga",6,"Avenida Padre Júlio Fragata",61,61,0,20,20,0
2,24,2019,16,0,8,"Braga",7,"Rua Nova Santa Cruz",29,29,0,111,111,0
2,24,2019,16,0,8,"Braga",8,"Rua Costa Gomes",22,39,17,76,43,33
2,24,2019,17,0,8,"Braga",1,"Avenida da Liberdade",21,21,0,32,32,0
2,24,2019,17,0,8,"Braga",2,"Avenida Central",18,18,0,268,268,0
2,24,2019,17,0,8,"Braga",3,"Rua de Caires",26,35,9,49,36,13
2,24,2019,17,0,8,"Braga",4,"N14 Bosch",46,46,0,74,74,0
2,24,2019,17,0,8,"Braga",5,"Avenida João Paulo II",21,39,18,16,8,8
2,24,2019,17,0,8,"Braga",6,"Avenida Padre Júlio Fragata",60,60,0,21,21,0
2,24,2019,17,0,8,"Braga",7,"Rua Nova Santa Cruz",29,29,0,111,111,0
2,24,2019,17,0,8,"Braga",8,"Rua Costa Gomes",29,39,10,57,43,14
2,24,2019,18,0,8,"Braga",1,"Avenida da Liberdade",21,21,0,32,32,0
2,24,2019,18,0,8,"Braga",2,"Avenida Central",17,17,0,284,284,0
2,24,2019,18,0,8,"Braga",3,"Rua de Caires",34,34,0,37,37,0
2,24,2019,18,0,8,"Braga",4,"N14 Bosch",36,46,10,94,74,20
2,24,2019,18,0,8,"Braga",5,"Avenida João Paulo II",23,39,16,14,8,6
2,24,2019,18,0,8,"Braga",6,"Avenida Padre Júlio Fragata",45,61,16,28,20,8
2,24,2019,18,0,8,"Braga",7,"Rua Nova Santa Cruz",29,29,0,111,111,0
2,24,2019,18,0,8,"Braga",8,"Rua Costa Gomes",26,39,13,64,43,21
2,24,2019,19,0,8,"Braga",1,"Avenida da Liberdade",21,21,0,32,32,0
2,24,2019,19,0,8,"Braga",2,"Avenida Central",13,17,4,372,284,88
2,24,2019,19,0,8,"Braga",3,"Rua de Caires",21,34,13,61,37,24
2,24,2019,19,0,8,"Braga",4,"N14 Bosch",37,46,9,92,74,18
2,24,2019,19,0,8,"Braga",5,"Avenida João Paulo II",25,39,14,13,8,5
2,24,2019,19,0,8,"Braga",6,"Avenida Padre Júlio Fragata",48,60,12,26,21,5
2,24,2019,19,0,8,"Braga",7,"Rua Nova Santa Cruz",29,29,0,111,111,0
2,24,2019,19,0,8,"Braga",8,"Rua Costa Gomes",40,40,0,42,42,0
2,24,2019,20,0,8,"Braga",1,"Avenida da Liberdade",21,21,0,32,32,0
2,24,2019,20,0,8,"Braga",2,"Avenida Central",18,18,0,268,268,0
2,24,2019,20,0,8,"Braga",3,"Rua de Caires",35,35,0,36,36,0
2,24,2019,20,0,8,"Braga",4,"N14 Bosch",46,46,0,74,74,0
2,24,2019,20,0,8,"Braga",5,"Avenida João Paulo II",40,40,0,8,8,0
2,24,2019,20,0,8,"Braga",6,"Avenida Padre Júlio Fragata",61,61,0,20,20,0
2,24,2019,20,0,8,"Braga",7,"Rua Nova Santa Cruz",29,29,0,111,111,0
2,24,2019,20,0,8,"Braga",8,"Rua Costa Gomes",39,39,0,43,43,0
2,24,2019,21,0,8,"Braga",1,"Avenida da Liberdade",21,21,0,32,32,0
2,24,2019,21,0,8,"Braga",2,"Avenida Central",18,18,0,268,268,0
2,24,2019,21,0,8,"Braga",3,"Rua de Caires",35,35,0,36,36,0
2,24,2019,21,0,8,"Braga",4,"N14 Bosch",46,46,0,74,74,0
2,24,2019,21,0,8,"Braga",5,"Avenida João Paulo II",40,40,0,8,8,0
2,24,2019,21,0,8,"Braga",6,"Avenida Padre Júlio Fragata",38,61,23,33,20,13
2,24,2019,21,0,8,"Braga",7,"Rua Nova Santa Cruz",29,29,0,111,111,0
2,24,2019,21,0,8,"Braga",8,"Rua Costa Gomes",39,39,0,43,43,0
2,24,2019,22,0,8,"Braga",1,"Avenida da Liberdade",21,21,0,32,32,0
2,24,2019,22,0,8,"Braga",2,"Avenida Central",18,18,0,268,268,0
2,24,2019,22,0,8,"Braga",3,"Rua de Caires",35,35,0,36,36,0
2,24,2019,22,0,8,"Braga",4,"N14 Bosch",46,46,0,74,74,0
2,24,2019,22,0,8,"Braga",5,"Avenida João Paulo II",40,40,0,8,8,0
2,24,2019,22,0,8,"Braga",6,"Avenida Padre Júlio Fragata",61,61,0,20,20,0
2,24,2019,22,0,8,"Braga",7,"Rua Nova Santa Cruz",29,29,0,111,111,0
2,24,2019,22,0,8,"Braga",8,"Rua Costa Gomes",39,39,0,43,43,0
2,24,2019,23,0,8,"Braga",1,"Avenida da Liberdade",21,21,0,32,32,0
2,24,2019,23,0,8,"Braga",2,"Avenida Central",18,18,0,268,268,0
2,24,2019,23,0,8,"Braga",3,"Rua de Caires",35,35,0,36,36,0
2,24,2019,23,0,8,"Braga",4,"N14 Bosch",46,46,0,74,74,0
2,24,2019,23,0,8,"Braga",5,"Avenida João Paulo II",40,40,0,8,8,0
2,24,2019,23,0,8,"Braga",6,"Avenida Padre Júlio Fragata",61,61,0,20,20,0
2,24,2019,23,0,8,"Braga",7,"Rua Nova Santa Cruz",29,29,0,111,111,0
2,24,2019,23,0,8,"Braga",8,"Rua Costa Gomes",39,39,0,43,43,0
2,25,2019,0,0,2,"Braga",1,"Avenida da Liberdade",21,21,0,32,32,0
2,25,2019,0,0,2,"Braga",2,"Avenida Central",18,18,0,268,268,0
2,25,2019,0,0,2,"Braga",3,"Rua de Caires",35,35,0,36,36,0
2,25,2019,0,0,2,"Braga",4,"N14 Bosch",46,46,0,74,74,0
2,25,2019,0,0,2,"Braga",5,"Avenida João Paulo II",40,40,0,8,8,0
2,25,2019,0,0,2,"Braga",6,"Avenida Padre Júlio Fragata",61,61,0,20,20,0
2,25,2019,0,0,2,"Braga",7,"Rua Nova Santa Cruz",29,29,0,111,111,0
2,25,2019,0,0,2,"Braga",8,"Rua Costa Gomes",39,39,0,43,43,0
2,25,2019,1,0,2,"Braga",1,"Avenida da Liberdade",21,21,0,32,32,0
2,25,2019,1,0,2,"Braga",2,"Avenida Central",18,18,0,268,268,0
2,25,2019,1,0,2,"Braga",3,"Rua de Caires",35,35,0,36,36,0
2,25,2019,1,0,2,"Braga",4,"N14 Bosch",46,46,0,74,74,0
2,25,2019,1,0,2,"Braga",5,"Avenida João Paulo II",40,40,0,8,8,0
2,25,2019,1,0,2,"Braga",6,"Avenida Padre Júlio Fragata",61,61,0,20,20,0
2,25,2019,1,0,2,"Braga",7,"Rua Nova Santa Cruz",29,29,0,111,111,0
2,25,2019,1,0,2,"Braga",8,"Rua Costa Gomes",39,39,0,43,43,0
2,25,2019,2,0,2,"Braga",1,"Avenida da Liberdade",21,21,0,32,32,0
2,25,2019,2,0,2,"Braga",2,"Avenida Central",18,18,0,268,268,0
2,25,2019,2,0,2,"Braga",3,"Rua de Caires",35,35,0,36,36,0
2,25,2019,2,0,2,"Braga",4,"N14 Bosch",46,46,0,74,74,0
2,25,2019,2,0,2,"Braga",5,"Avenida João Paulo II",40,40,0,8,8,0
2,25,2019,2,0,2,"Braga",6,"Avenida Padre Júlio Fragata",61,61,0,20,20,0
2,25,2019,2,0,2,"Braga",7,"Rua Nova Santa Cruz",29,29,0,111,111,0
2,25,2019,2,0,2,"Braga",8,"Rua Costa Gomes",39,39,0,43,43,0
2,25,2019,3,0,2,"Braga",1,"Avenida da Liberdade",21,21,0,32,32,0
2,25,2019,3,0,2,"Braga",2,"Avenida Central",18,18,0,268,268,0
2,25,2019,3,0,2,"Braga",3,"Rua de Caires",35,35,0,36,36,0
2,25,2019,3,0,2,"Braga",4,"N14 Bosch",46,46,0,74,74,0
2,25,2019,3,0,2,"Braga",5,"Avenida João Paulo II",40,40,0,8,8,0
2,25,2019,3,0,2,"Braga",6,"Avenida Padre Júlio Fragata",61,61,0,20,20,0
2,25,2019,3,0,2,"Braga",7,"Rua Nova Santa Cruz",29,29,0,111,111,0
2,25,2019,3,0,2,"Braga",8,"Rua Costa Gomes",39,39,0,43,43,0
2,25,2019,4,0,2,"Braga",1,"Avenida da Liberdade",21,21,0,32,32,0
2,25,2019,4,0,2,"Braga",2,"Avenida Central",18,18,0,268,268,0
2,25,2019,4,0,2,"Braga",3,"Rua de Caires",35,35,0,36,36,0
2,25,2019,4,0,2,"Braga",4,"N14 Bosch",46,46,0,74,74,0
2,25,2019,4,0,2,"Braga",5,"Avenida João Paulo II",40,40,0,8,8,0
2,25,2019,4,0,2,"Braga",6,"Avenida Padre Júlio Fragata",61,61,0,20,20,0
2,25,2019,4,0,2,"Braga",7,"Rua Nova Santa Cruz",29,29,0,111,111,0
2,25,2019,4,0,2,"Braga",8,"Rua Costa Gomes",39,39,0,43,43,0
2,25,2019,5,0,2,"Braga",1,"Avenida da Liberdade",21,21,0,32,32,0
2,25,2019,5,0,2,"Braga",2,"Avenida Central",18,18,0,268,268,0
2,25,2019,5,0,2,"Braga",3,"Rua de Caires",35,35,0,36,36,0
2,25,2019,5,0,2,"Braga",4,"N14 Bosch",46,46,0,74,74,0
2,25,2019,5,0,2,"Braga",5,"Avenida João Paulo II",40,40,0,8,8,0
2,25,2019,5,0,2,"Braga",6,"Avenida Padre Júlio Fragata",61,61,0,20,20,0
2,25,2019,5,0,2,"Braga",7,"Rua Nova Santa Cruz",29,29,0,111,111,0
2,25,2019,5,0,2,"Braga",8,"Rua Costa Gomes",39,39,0,43,43,0
2,25,2019,6,0,2,"Braga",1,"Avenida da Liberdade",21,21,0,32,32,0
2,25,2019,6,0,2,"Braga",2,"Avenida Central",18,18,0,268,268,0
2,25,2019,6,0,2,"Braga",3,"Rua de Caires",35,35,0,36,36,0
2,25,2019,6,0,2,"Braga",4,"N14 Bosch",46,46,0,74,74,0
2,25,2019,6,0,2,"Braga",5,"Avenida João Paulo II",40,40,0,8,8,0
2,25,2019,6,0,2,"Braga",6,"Avenida Padre Júlio Fragata",61,61,0,20,20,0
2,25,2019,6,0,2,"Braga",7,"Rua Nova Santa Cruz",29,29,0,111,111,0
2,25,2019,6,0,2,"Braga",8,"Rua Costa Gomes",39,39,0,43,43,0
2,25,2019,7,0,2,"Braga",1,"Avenida da Liberdade",21,21,0,32,32,0
2,25,2019,7,0,2,"Braga",2,"Avenida Central",18,18,0,268,268,0
2,25,2019,7,0,2,"Braga",3,"Rua de Caires",35,35,0,36,36,0
2,25,2019,7,0,2,"Braga",4,"N14 Bosch",46,46,0,74,74,0
2,25,2019,7,0,2,"Braga",5,"Avenida João Paulo II",40,40,0,8,8,0
2,25,2019,7,0,2,"Braga",6,"Avenida Padre Júlio Fragata",61,61,0,20,20,0
2,25,2019,7,0,2,"Braga",7,"Rua Nova Santa Cruz",29,29,0,111,111,0
2,25,2019,7,0,2,"Braga",8,"Rua Costa Gomes",39,39,0,43,43,0
2,25,2019,8,0,2,"Braga",1,"Avenida da Liberdade",21,21,0,32,32,0
2,25,2019,8,0,2,"Braga",2,"Avenida Central",18,18,0,268,268,0
2,25,2019,8,0,2,"Braga",3,"Rua de Caires",27,34,7,47,37,10
2,25,2019,8,0,2,"Braga",4,"N14 Bosch",46,46,0,74,74,0
2,25,2019,8,0,2,"Braga",5,"Avenida João Paulo II",40,40,0,8,8,0
2,25,2019,8,0,2,"Braga",6,"Avenida Padre Júlio Fragata",61,61,0,20,20,0
2,25,2019,8,0,2,"Braga",7,"Rua Nova Santa Cruz",29,29,0,111,111,0
2,25,2019,8,0,2,"Braga",8,"Rua Costa Gomes",16,40,24,105,42,63
2,25,2019,9,0,2,"Braga",1,"Avenida da Liberdade",22,22,0,30,30,0
2,25,2019,9,0,2,"Braga",2,"Avenida Central",11,18,7,439,268,171
2,25,2019,9,0,2,"Braga",3,"Rua de Caires",26,34,8,49,37,12
2,25,2019,9,0,2,"Braga",4,"N14 Bosch",32,45,13,106,75,31
2,25,2019,9,0,2,"Braga",5,"Avenida João Paulo II",39,39,0,8,8,0
2,25,2019,9,0,2,"Braga",6,"Avenida Padre Júlio Fragata",35,60,25,36,21,15
2,25,2019,9,0,2,"Braga",7,"Rua Nova Santa Cruz",23,29,6,140,111,29
2,25,2019,9,0,2,"Braga",8,"Rua Costa Gomes",40,40,0,42,42,0
2,25,2019,10,0,2,"Braga",1,"Avenida da Liberdade",17,21,4,39,32,7
2,25,2019,10,0,2,"Braga",2,"Avenida Central",18,18,0,268,268,0
2,25,2019,10,0,2,"Braga",3,"Rua de Caires",26,34,8,49,37,12
2,25,2019,10,0,2,"Braga",4,"N14 Bosch",33,46,13,103,74,29
2,25,2019,10,0,2,"Braga",5,"Avenida João Paulo II",39,39,0,8,8,0
2,25,2019,10,0,2,"Braga",6,"Avenida Padre Júlio Fragata",60,60,0,21,21,0
2,25,2019,10,0,2,"Braga",7,"Rua Nova Santa Cruz",17,29,12,189,111,78
2,25,2019,10,0,2,"Braga",8,"Rua Costa Gomes",28,39,11,60,43,17
2,25,2019,11,0,2,"Braga",1,"Avenida da Liberdade",16,21,5,42,32,10
2,25,2019,11,0,2,"Braga",2,"Avenida Central",11,18,7,439,268,171
2,25,2019,11,0,2,"Braga",3,"Rua de Caires",25,34,9,51,37,14
2,25,2019,11,0,2,"Braga",4,"N14 Bosch",33,46,13,103,74,29
2,25,2019,11,0,2,"Braga",5,"Avenida João Paulo II",39,39,0,8,8,0
2,25,2019,11,0,2,"Braga",6,"Avenida Padre Júlio Fragata",60,60,0,21,21,0
2,25,2019,11,0,2,"Braga",7,"Rua Nova Santa Cruz",21,29,8,153,111,42
2,25,2019,11,0,2,"Braga",8,"Rua Costa Gomes",39,39,0,43,43,0
2,25,2019,12,0,2,"Braga",1,"Avenida da Liberdade",18,22,4,37,30,7
2,25,2019,12,0,2,"Braga",2,"Avenida Central",9,18,9,537,268,269
2,25,2019,12,0,2,"Braga",3,"Rua de Caires",34,34,0,37,37,0
2,25,2019,12,0,2,"Braga",4,"N14 Bosch",33,46,13,103,74,29
2,25,2019,12,0,2,"Braga",5,"Avenida João Paulo II",31,40,9,11,8,3
2,25,2019,12,0,2,"Braga",6,"Avenida Padre Júlio Fragata",37,60,23,34,21,13
2,25,2019,12,0,2,"Braga",7,"Rua Nova Santa Cruz",18,28,10,179,115,64
2,25,2019,12,0,2,"Braga",8,"Rua Costa Gomes",30,39,9,56,43,13
2,25,2019,13,0,2,"Braga",1,"Avenida da Liberdade",21,21,0,32,32,0
2,25,2019,13,0,2,"Braga",2,"Avenida Central",17,17,0,284,284,0
2,25,2019,13,0,2,"Braga",3,"Rua de Caires",34,34,0,37,37,0
2,25,2019,13,0,2,"Braga",4,"N14 Bosch",29,46,17,117,74,43
2,25,2019,13,0,2,"Braga",5,"Avenida João Paulo II",40,40,0,8,8,0
2,25,2019,13,0,2,"Braga",6,"Avenida Padre Júlio Fragata",39,61,22,32,20,12
2,25,2019,13,0,2,"Braga",7,"Rua Nova Santa Cruz",21,28,7,153,115,38
2,25,2019,13,0,2,"Braga",8,"Rua Costa Gomes",30,39,9,56,43,13
2,25,2019,14,0,2,"Braga",1,"Avenida da Liberdade",22,22,0,30,30,0
2,25,2019,14,0,2,"Braga",2,"Avenida Central",13,17,4,372,284,88
2,25,2019,14,0,2,"Braga",3,"Rua de Caires",35,35,0,36,36,0
2,25,2019,14,0,2,"Braga",4,"N14 Bosch",25,45,20,136,75,61
2,25,2019,14,0,2,"Braga",5,"Avenida João Paulo II",40,40,0,8,8,0
2,25,2019,14,0,2,"Braga",6,"Avenida Padre Júlio Fragata",60,60,0,21,21,0
2,25,2019,14,0,2,"Braga",7,"Rua Nova Santa Cruz",20,28,8,161,115,46
2,25,2019,14,0,2,"Braga",8,"Rua Costa Gomes",32,40,8,52,42,10
2,25,2019,15,0,2,"Braga",1,"Avenida da Liberdade",22,22,0,30,30,0
2,25,2019,15,0,2,"Braga",2,"Avenida Central",13,18,5,372,268,104
2,25,2019,15,0,2,"Braga",3,"Rua de Caires",35,35,0,36,36,0
2,25,2019,15,0,2,"Braga",4,"N14 Bosch",27,46,19,126,74,52
2,25,2019,15,0,2,"Braga",5,"Avenida João Paulo II",29,39,10,11,8,3
2,25,2019,15,0,2,"Braga",6,"Avenida Padre Júlio Fragata",48,60,12,26,21,5
2,25,2019,15,0,2,"Braga",7,"Rua Nova Santa Cruz",19,28,9,169,115,54
2,25,2019,15,0,2,"Braga",8,"Rua Costa Gomes",23,39,16,73,43,30
2,25,2019,16,0,2,"Braga",1,"Avenida da Liberdade",21,21,0,32,32,0
2,25,2019,16,0,2,"Braga",2,"Avenida Central",11,18,7,439,268,171
2,25,2019,16,0,2,"Braga",3,"Rua de Caires",26,34,8,49,37,12
2,25,2019,16,0,2,"Braga",4,"N14 Bosch",31,45,14,110,75,35
2,25,2019,16,0,2,"Braga",5,"Avenida João Paulo II",27,39,12,12,8,4
2,25,2019,16,0,2,"Braga",6,"Avenida Padre Júlio Fragata",60,60,0,21,21,0
2,25,2019,16,0,2,"Braga",7,"Rua Nova Santa Cruz",20,29,9,161,111,50
2,25,2019,16,0,2,"Braga",8,"Rua Costa Gomes",26,39,13,64,43,21
2,25,2019,17,0,2,"Braga",1,"Avenida da Liberdade",17,22,5,39,30,9
2,25,2019,17,0,2,"Braga",2,"Avenida Central",10,17,7,483,284,199
2,25,2019,17,0,2,"Braga",3,"Rua de Caires",24,34,10,53,37,16
2,25,2019,17,0,2,"Braga",4,"N14 Bosch",28,45,17,121,75,46
2,25,2019,17,0,2,"Braga",5,"Avenida João Paulo II",29,40,11,11,8,3
2,25,2019,17,0,2,"Braga",6,"Avenida Padre Júlio Fragata",61,61,0,20,20,0
2,25,2019,17,0,2,"Braga",7,"Rua Nova Santa Cruz",19,28,9,169,115,54
2,25,2019,17,0,2,"Braga",8,"Rua Costa Gomes",23,39,16,73,43,30
2,25,2019,18,0,2,"Braga",3,"Rua de Caires",27,35,8,47,36,11
2,25,2019,18,0,2,"Braga",4,"N14 Bosch",21,47,26,162,72,90
2,25,2019,18,0,2,"Braga",5,"Avenida João Paulo II",24,40,16,14,8,6
2,25,2019,18,0,2,"Braga",6,"Avenida Padre Júlio Fragata",25,60,35,51,21,30
2,25,2019,18,0,2,"Braga",7,"Rua Nova Santa Cruz",12,28,16,268,115,153
2,25,2019,18,0,2,"Braga",8,"Rua Costa Gomes",11,41,30,152,40,112
2,25,2019,18,0,2,"Braga",1,"Avenida da Liberdade",15,22,7,44,30,14
2,25,2019,18,0,2,"Braga",2,"Avenida Central",12,18,6,403,268,135
2,25,2019,18,0,2,"Braga",3,"Rua de Caires",27,35,8,47,36,11
2,25,2019,19,0,2,"Braga",1,"Avenida da Liberdade",14,22,8,48,30,18
2,25,2019,19,0,2,"Braga",2,"Avenida Central",9,18,9,537,268,269
2,25,2019,19,0,2,"Braga",3,"Rua de Caires",21,34,13,61,37,24
2,25,2019,19,0,2,"Braga",4,"N14 Bosch",26,45,19,131,75,56
2,25,2019,19,0,2,"Braga",5,"Avenida João Paulo II",15,41,26,22,8,14
2,25,2019,19,0,2,"Braga",6,"Avenida Padre Júlio Fragata",22,62,40,58,20,38
2,25,2019,19,0,2,"Braga",7,"Rua Nova Santa Cruz",11,30,19,293,107,186
2,25,2019,19,0,2,"Braga",8,"Rua Costa Gomes",9,42,33,186,40,146
2,25,2019,20,0,2,"Braga",1,"Avenida da Liberdade",21,21,0,32,32,0
2,25,2019,20,0,2,"Braga",2,"Avenida Central",10,17,7,483,284,199
2,25,2019,20,0,2,"Braga",3,"Rua de Caires",35,35,0,36,36,0
2,25,2019,20,0,2,"Braga",4,"N14 Bosch",45,45,0,75,75,0
2,25,2019,20,0,2,"Braga",5,"Avenida João Paulo II",31,39,8,11,8,3
2,25,2019,20,0,2,"Braga",6,"Avenida Padre Júlio Fragata",61,61,0,20,20,0
2,25,2019,20,0,2,"Braga",7,"Rua Nova Santa Cruz",21,29,8,153,111,42
2,25,2019,20,0,2,"Braga",8,"Rua Costa Gomes",22,40,18,76,42,34
2,25,2019,21,0,2,"Braga",1,"Avenida da Liberdade",21,21,0,32,32,0
2,25,2019,21,0,2,"Braga",2,"Avenida Central",17,17,0,284,284,0
2,25,2019,21,0,2,"Braga",3,"Rua de Caires",35,35,0,36,36,0
2,25,2019,21,0,2,"Braga",4,"N14 Bosch",45,45,0,75,75,0
2,25,2019,21,0,2,"Braga",5,"Avenida João Paulo II",40,40,0,8,8,0
2,25,2019,21,0,2,"Braga",6,"Avenida Padre Júlio Fragata",30,60,30,42,21,21
2,25,2019,21,0,2,"Braga",7,"Rua Nova Santa Cruz",23,29,6,140,111,29
2,25,2019,21,0,2,"Braga",8,"Rua Costa Gomes",30,40,10,56,42,14
2,25,2019,22,0,2,"Braga",1,"Avenida da Liberdade",21,21,0,32,32,0
2,25,2019,22,0,2,"Braga",2,"Avenida Central",17,17,0,284,284,0
2,25,2019,22,0,2,"Braga",3,"Rua de Caires",35,35,0,36,36,0
2,25,2019,22,0,2,"Braga",4,"N14 Bosch",45,45,0,75,75,0
2,25,2019,22,0,2,"Braga",5,"Avenida João Paulo II",40,40,0,8,8,0
2,25,2019,22,0,2,"Braga",6,"Avenida Padre Júlio Fragata",61,61,0,20,20,0
2,25,2019,22,0,2,"Braga",7,"Rua Nova Santa Cruz",29,29,0,111,111,0
2,25,2019,22,0,2,"Braga",8,"Rua Costa Gomes",40,40,0,42,42,0
2,25,2019,23,0,2,"Braga",1,"Avenida da Liberdade",21,21,0,32,32,0
2,25,2019,23,0,2,"Braga",2,"Avenida Central",17,17,0,284,284,0
2,25,2019,23,0,2,"Braga",3,"Rua de Caires",35,35,0,36,36,0
2,25,2019,23,0,2,"Braga",4,"N14 Bosch",45,45,0,75,75,0
2,25,2019,23,0,2,"Braga",5,"Avenida João Paulo II",40,40,0,8,8,0
2,25,2019,23,0,2,"Braga",6,"Avenida Padre Júlio Fragata",45,60,15,28,21,7
2,25,2019,23,0,2,"Braga",7,"Rua Nova Santa Cruz",29,29,0,111,111,0
2,25,2019,23,0,2,"Braga",8,"Rua Costa Gomes",40,40,0,42,42,0
2,26,2019,0,0,3,"Braga",1,"Avenida da Liberdade",21,21,0,32,32,0
2,26,2019,0,0,3,"Braga",2,"Avenida Central",17,17,0,284,284,0
2,26,2019,0,0,3,"Braga",3,"Rua de Caires",35,35,0,36,36,0
2,26,2019,0,0,3,"Braga",4,"N14 Bosch",45,45,0,75,75,0
2,26,2019,0,0,3,"Braga",5,"Avenida João Paulo II",40,40,0,8,8,0
2,26,2019,0,0,3,"Braga",6,"Avenida Padre Júlio Fragata",60,60,0,21,21,0
2,26,2019,0,0,3,"Braga",7,"Rua Nova Santa Cruz",29,29,0,111,111,0
2,26,2019,0,0,3,"Braga",8,"Rua Costa Gomes",40,40,0,42,42,0
2,26,2019,1,0,3,"Braga",1,"Avenida da Liberdade",21,21,0,32,32,0
2,26,2019,1,0,3,"Braga",2,"Avenida Central",17,17,0,284,284,0
2,26,2019,1,0,3,"Braga",3,"Rua de Caires",35,35,0,36,36,0
2,26,2019,1,0,3,"Braga",4,"N14 Bosch",45,45,0,75,75,0
2,26,2019,1,0,3,"Braga",5,"Avenida João Paulo II",40,40,0,8,8,0
2,26,2019,1,0,3,"Braga",6,"Avenida Padre Júlio Fragata",60,60,0,21,21,0
2,26,2019,1,0,3,"Braga",7,"Rua Nova Santa Cruz",29,29,0,111,111,0
2,26,2019,1,0,3,"Braga",8,"Rua Costa Gomes",40,40,0,42,42,0
2,26,2019,2,0,3,"Braga",1,"Avenida da Liberdade",21,21,0,32,32,0
2,26,2019,2,0,3,"Braga",2,"Avenida Central",17,17,0,284,284,0
2,26,2019,2,0,3,"Braga",3,"Rua de Caires",35,35,0,36,36,0
2,26,2019,2,0,3,"Braga",4,"N14 Bosch",45,45,0,75,75,0
2,26,2019,2,0,3,"Braga",5,"Avenida João Paulo II",40,40,0,8,8,0
2,26,2019,2,0,3,"Braga",6,"Avenida Padre Júlio Fragata",60,60,0,21,21,0
2,26,2019,2,0,3,"Braga",7,"Rua Nova Santa Cruz",29,29,0,111,111,0
2,26,2019,2,0,3,"Braga",8,"Rua Costa Gomes",40,40,0,42,42,0
2,26,2019,3,0,3,"Braga",1,"Avenida da Liberdade",21,21,0,32,32,0
2,26,2019,3,0,3,"Braga",2,"Avenida Central",17,17,0,284,284,0
2,26,2019,3,0,3,"Braga",3,"Rua de Caires",35,35,0,36,36,0
2,26,2019,3,0,3,"Braga",4,"N14 Bosch",45,45,0,75,75,0
2,26,2019,3,0,3,"Braga",5,"Avenida João Paulo II",40,40,0,8,8,0
2,26,2019,3,0,3,"Braga",6,"Avenida Padre Júlio Fragata",60,60,0,21,21,0
2,26,2019,3,0,3,"Braga",7,"Rua Nova Santa Cruz",29,29,0,111,111,0
2,26,2019,3,0,3,"Braga",8,"Rua Costa Gomes",40,40,0,42,42,0
2,26,2019,4,0,3,"Braga",1,"Avenida da Liberdade",21,21,0,32,32,0
2,26,2019,4,0,3,"Braga",2,"Avenida Central",17,17,0,284,284,0
2,26,2019,4,0,3,"Braga",3,"Rua de Caires",35,35,0,36,36,0
2,26,2019,4,0,3,"Braga",4,"N14 Bosch",45,45,0,75,75,0
2,26,2019,4,0,3,"Braga",5,"Avenida João Paulo II",40,40,0,8,8,0
2,26,2019,4,0,3,"Braga",6,"Avenida Padre Júlio Fragata",60,60,0,21,21,0
2,26,2019,4,0,3,"Braga",7,"Rua Nova Santa Cruz",29,29,0,111,111,0
2,26,2019,4,0,3,"Braga",8,"Rua Costa Gomes",40,40,0,42,42,0
2,26,2019,5,0,3,"Braga",1,"Avenida da Liberdade",21,21,0,32,32,0
2,26,2019,5,0,3,"Braga",2,"Avenida Central",17,17,0,284,284,0
2,26,2019,5,0,3,"Braga",3,"Rua de Caires",35,35,0,36,36,0
2,26,2019,5,0,3,"Braga",4,"N14 Bosch",45,45,0,75,75,0
2,26,2019,5,0,3,"Braga",5,"Avenida João Paulo II",40,40,0,8,8,0
2,26,2019,5,0,3,"Braga",6,"Avenida Padre Júlio Fragata",60,60,0,21,21,0
2,26,2019,5,0,3,"Braga",7,"Rua Nova Santa Cruz",29,29,0,111,111,0
2,26,2019,5,0,3,"Braga",8,"Rua Costa Gomes",40,40,0,42,42,0
2,26,2019,6,0,3,"Braga",1,"Avenida da Liberdade",21,21,0,32,32,0
2,26,2019,6,0,3,"Braga",2,"Avenida Central",17,17,0,284,284,0
2,26,2019,6,0,3,"Braga",3,"Rua de Caires",35,35,0,36,36,0
2,26,2019,6,0,3,"Braga",4,"N14 Bosch",45,45,0,75,75,0
2,26,2019,6,0,3,"Braga",5,"Avenida João Paulo II",40,40,0,8,8,0
2,26,2019,6,0,3,"Braga",6,"Avenida Padre Júlio Fragata",60,60,0,21,21,0
2,26,2019,6,0,3,"Braga",7,"Rua Nova Santa Cruz",29,29,0,111,111,0
2,26,2019,6,0,3,"Braga",8,"Rua Costa Gomes",40,40,0,42,42,0
2,26,2019,7,0,3,"Braga",1,"Avenida da Liberdade",21,21,0,32,32,0
2,26,2019,7,0,3,"Braga",2,"Avenida Central",17,17,0,284,284,0
2,26,2019,7,0,3,"Braga",3,"Rua de Caires",35,35,0,36,36,0
2,26,2019,7,0,3,"Braga",4,"N14 Bosch",45,45,0,75,75,0
2,26,2019,7,0,3,"Braga",5,"Avenida João Paulo II",40,40,0,8,8,0
2,26,2019,7,0,3,"Braga",6,"Avenida Padre Júlio Fragata",60,60,0,21,21,0
2,26,2019,7,0,3,"Braga",7,"Rua Nova Santa Cruz",29,29,0,111,111,0
2,26,2019,7,0,3,"Braga",8,"Rua Costa Gomes",40,40,0,42,42,0
2,26,2019,8,0,3,"Braga",1,"Avenida da Liberdade",21,21,0,32,32,0
2,26,2019,8,0,3,"Braga",2,"Avenida Central",17,17,0,284,284,0
2,26,2019,8,0,3,"Braga",3,"Rua de Caires",35,35,0,36,36,0
2,26,2019,8,0,3,"Braga",4,"N14 Bosch",37,46,9,92,74,18
2,26,2019,8,0,3,"Braga",5,"Avenida João Paulo II",40,40,0,8,8,0
2,26,2019,8,0,3,"Braga",6,"Avenida Padre Júlio Fragata",60,60,0,21,21,0
2,26,2019,8,0,3,"Braga",7,"Rua Nova Santa Cruz",29,29,0,111,111,0
2,26,2019,8,0,3,"Braga",8,"Rua Costa Gomes",30,39,9,56,43,13
2,26,2019,9,0,3,"Braga",1,"Avenida da Liberdade",22,22,0,30,30,0
2,26,2019,9,0,3,"Braga",2,"Avenida Central",10,17,7,483,284,199
2,26,2019,9,0,3,"Braga",3,"Rua de Caires",24,34,10,53,37,16
2,26,2019,9,0,3,"Braga",4,"N14 Bosch",28,46,18,121,74,47
2,26,2019,9,0,3,"Braga",5,"Avenida João Paulo II",23,40,17,14,8,6
2,26,2019,9,0,3,"Braga",6,"Avenida Padre Júlio Fragata",33,61,28,38,20,18
2,26,2019,9,0,3,"Braga",7,"Rua Nova Santa Cruz",28,28,0,115,115,0
2,26,2019,9,0,3,"Braga",8,"Rua Costa Gomes",26,40,14,64,42,22
2,26,2019,10,0,3,"Braga",1,"Avenida da Liberdade",22,22,0,30,30,0
2,26,2019,10,0,3,"Braga",2,"Avenida Central",17,17,0,284,284,0
2,26,2019,10,0,3,"Braga",3,"Rua de Caires",22,35,13,58,36,22
2,26,2019,10,0,3,"Braga",4,"N14 Bosch",32,46,14,106,74,32
2,26,2019,10,0,3,"Braga",5,"Avenida João Paulo II",39,39,0,8,8,0
2,26,2019,10,0,3,"Braga",6,"Avenida Padre Júlio Fragata",61,61,0,20,20,0
2,26,2019,10,0,3,"Braga",7,"Rua Nova Santa Cruz",28,28,0,115,115,0
2,26,2019,10,0,3,"Braga",8,"Rua Costa Gomes",30,39,9,56,43,13
2,26,2019,11,0,3,"Braga",1,"Avenida da Liberdade",18,22,4,37,30,7
2,26,2019,11,0,3,"Braga",2,"Avenida Central",12,17,5,403,284,119
2,26,2019,11,0,3,"Braga",3,"Rua de Caires",27,35,8,47,36,11
2,26,2019,11,0,3,"Braga",4,"N14 Bosch",15,46,31,227,74,153
2,26,2019,11,0,3,"Braga",5,"Avenida João Paulo II",39,39,0,8,8,0
2,26,2019,11,0,3,"Braga",6,"Avenida Padre Júlio Fragata",61,61,0,20,20,0
2,26,2019,11,0,3,"Braga",7,"Rua Nova Santa Cruz",22,29,7,146,111,35
2,26,2019,11,0,3,"Braga",8,"Rua Costa Gomes",26,40,14,64,42,22
2,26,2019,12,0,3,"Braga",1,"Avenida da Liberdade",22,22,0,30,30,0
2,26,2019,12,0,3,"Braga",2,"Avenida Central",12,17,5,403,284,119
2,26,2019,12,0,3,"Braga",3,"Rua de Caires",35,35,0,36,36,0
2,26,2019,12,0,3,"Braga",4,"N14 Bosch",33,45,12,103,75,28
2,26,2019,12,0,3,"Braga",5,"Avenida João Paulo II",39,39,0,8,8,0
2,26,2019,12,0,3,"Braga",6,"Avenida Padre Júlio Fragata",61,61,0,20,20,0
2,26,2019,12,0,3,"Braga",7,"Rua Nova Santa Cruz",29,29,0,111,111,0
2,26,2019,12,0,3,"Braga",8,"Rua Costa Gomes",30,40,10,56,42,14
2,26,2019,13,0,3,"Braga",1,"Avenida da Liberdade",21,21,0,32,32,0
2,26,2019,13,0,3,"Braga",2,"Avenida Central",17,17,0,284,284,0
2,26,2019,13,0,3,"Braga",3,"Rua de Caires",27,34,7,47,37,10
2,26,2019,13,0,3,"Braga",4,"N14 Bosch",32,46,14,106,74,32
2,26,2019,13,0,3,"Braga",5,"Avenida João Paulo II",39,39,0,8,8,0
2,26,2019,13,0,3,"Braga",6,"Avenida Padre Júlio Fragata",60,60,0,21,21,0
2,26,2019,13,0,3,"Braga",7,"Rua Nova Santa Cruz",13,28,15,248,115,133
2,26,2019,13,0,3,"Braga",8,"Rua Costa Gomes",39,39,0,43,43,0
2,26,2019,14,0,3,"Braga",1,"Avenida da Liberdade",18,22,4,37,30,7
2,26,2019,14,0,3,"Braga",2,"Avenida Central",17,17,0,284,284,0
2,26,2019,14,0,3,"Braga",3,"Rua de Caires",34,34,0,37,37,0
2,26,2019,14,0,3,"Braga",4,"N14 Bosch",28,45,17,121,75,46
2,26,2019,14,0,3,"Braga",5,"Avenida João Paulo II",30,39,9,11,8,3
2,26,2019,14,0,3,"Braga",6,"Avenida Padre Júlio Fragata",48,60,12,26,21,5
2,26,2019,14,0,3,"Braga",7,"Rua Nova Santa Cruz",23,29,6,140,111,29
2,26,2019,14,0,3,"Braga",8,"Rua Costa Gomes",22,39,17,76,43,33
2,26,2019,15,0,3,"Braga",1,"Avenida da Liberdade",22,22,0,30,30,0
2,26,2019,15,0,3,"Braga",2,"Avenida Central",12,17,5,403,284,119
2,26,2019,15,0,3,"Braga",3,"Rua de Caires",25,35,10,51,36,15
2,26,2019,15,0,3,"Braga",4,"N14 Bosch",28,45,17,121,75,46
2,26,2019,15,0,3,"Braga",5,"Avenida João Paulo II",30,40,10,11,8,3
2,26,2019,15,0,3,"Braga",6,"Avenida Padre Júlio Fragata",60,60,0,21,21,0
2,26,2019,15,0,3,"Braga",7,"Rua Nova Santa Cruz",21,29,8,153,111,42
2,26,2019,15,0,3,"Braga",8,"Rua Costa Gomes",24,40,16,70,42,28
2,26,2019,16,0,3,"Braga",1,"Avenida da Liberdade",21,21,0,32,32,0
2,26,2019,16,0,3,"Braga",2,"Avenida Central",12,17,5,403,284,119
2,26,2019,16,0,3,"Braga",3,"Rua de Caires",26,35,9,49,36,13
2,26,2019,16,0,3,"Braga",4,"N14 Bosch",22,45,23,155,75,80
2,26,2019,16,0,3,"Braga",5,"Avenida João Paulo II",29,40,11,11,8,3
2,26,2019,16,0,3,"Braga",6,"Avenida Padre Júlio Fragata",49,61,12,26,20,6
2,26,2019,16,0,3,"Braga",7,"Rua Nova Santa Cruz",18,28,10,179,115,64
2,26,2019,16,0,3,"Braga",8,"Rua Costa Gomes",30,40,10,56,42,14
2,26,2019,17,0,3,"Braga",1,"Avenida da Liberdade",13,22,9,51,30,21
2,26,2019,17,0,3,"Braga",2,"Avenida Central",12,18,6,403,268,135
2,26,2019,17,0,3,"Braga",3,"Rua de Caires",26,35,9,49,36,13
2,26,2019,17,0,3,"Braga",4,"N14 Bosch",28,46,18,121,74,47
2,26,2019,17,0,3,"Braga",5,"Avenida João Paulo II",26,40,14,13,8,5
2,26,2019,17,0,3,"Braga",6,"Avenida Padre Júlio Fragata",48,60,12,26,21,5
2,26,2019,17,0,3,"Braga",7,"Rua Nova Santa Cruz",16,28,12,201,115,86
2,26,2019,17,0,3,"Braga",8,"Rua Costa Gomes",24,40,16,70,42,28
2,26,2019,18,0,3,"Braga",1,"Avenida da Liberdade",15,21,6,44,32,12
2,26,2019,18,0,3,"Braga",2,"Avenida Central",10,17,7,483,284,199
2,26,2019,18,0,3,"Braga",3,"Rua de Caires",21,34,13,61,37,24
2,26,2019,18,0,3,"Braga",4,"N14 Bosch",18,46,28,189,74,115
2,26,2019,18,0,3,"Braga",5,"Avenida João Paulo II",24,40,16,14,8,6
2,26,2019,18,0,3,"Braga",6,"Avenida Padre Júlio Fragata",38,60,22,33,21,12
2,26,2019,18,0,3,"Braga",7,"Rua Nova Santa Cruz",8,27,19,403,119,284
2,26,2019,18,0,3,"Braga",8,"Rua Costa Gomes",19,41,22,88,40,48
2,26,2019,19,0,3,"Braga",1,"Avenida da Liberdade",14,21,7,48,32,16
2,26,2019,19,0,3,"Braga",2,"Avenida Central",6,17,11,806,284,522
2,26,2019,19,0,3,"Braga",3,"Rua de Caires",21,35,14,61,36,25
2,26,2019,19,0,3,"Braga",4,"N14 Bosch",27,45,18,126,75,51
2,26,2019,19,0,3,"Braga",5,"Avenida João Paulo II",25,39,14,13,8,5
2,26,2019,19,0,3,"Braga",6,"Avenida Padre Júlio Fragata",29,61,32,44,20,24
2,26,2019,19,0,3,"Braga",7,"Rua Nova Santa Cruz",17,29,12,189,111,78
2,26,2019,19,0,3,"Braga",8,"Rua Costa Gomes",6,37,31,280,45,235
2,26,2019,20,0,3,"Braga",1,"Avenida da Liberdade",17,22,5,39,30,9
2,26,2019,20,0,3,"Braga",2,"Avenida Central",17,17,0,284,284,0
2,26,2019,20,0,3,"Braga",3,"Rua de Caires",35,35,0,36,36,0
2,26,2019,20,0,3,"Braga",4,"N14 Bosch",46,46,0,74,74,0
2,26,2019,20,0,3,"Braga",5,"Avenida João Paulo II",31,40,9,11,8,3
2,26,2019,20,0,3,"Braga",6,"Avenida Padre Júlio Fragata",29,61,32,44,20,24
2,26,2019,20,0,3,"Braga",7,"Rua Nova Santa Cruz",13,30,17,248,107,141
2,26,2019,20,0,3,"Braga",8,"Rua Costa Gomes",28,39,11,60,43,17
2,26,2019,21,0,3,"Braga",1,"Avenida da Liberdade",21,21,0,32,32,0
2,26,2019,21,0,3,"Braga",2,"Avenida Central",17,17,0,284,284,0
2,26,2019,21,0,3,"Braga",3,"Rua de Caires",35,35,0,36,36,0
2,26,2019,21,0,3,"Braga",4,"N14 Bosch",46,46,0,74,74,0
2,26,2019,21,0,3,"Braga",5,"Avenida João Paulo II",39,39,0,8,8,0
2,26,2019,21,0,3,"Braga",6,"Avenida Padre Júlio Fragata",61,61,0,20,20,0
2,26,2019,21,0,3,"Braga",7,"Rua Nova Santa Cruz",28,28,0,115,115,0
2,26,2019,21,0,3,"Braga",8,"Rua Costa Gomes",30,40,10,56,42,14
2,26,2019,22,0,3,"Braga",1,"Avenida da Liberdade",21,21,0,32,32,0
2,26,2019,22,0,3,"Braga",2,"Avenida Central",17,17,0,284,284,0
2,26,2019,22,0,3,"Braga",3,"Rua de Caires",35,35,0,36,36,0
2,26,2019,22,0,3,"Braga",4,"N14 Bosch",46,46,0,74,74,0
2,26,2019,22,0,3,"Braga",5,"Avenida João Paulo II",39,39,0,8,8,0
2,26,2019,22,0,3,"Braga",6,"Avenida Padre Júlio Fragata",60,60,0,21,21,0
2,26,2019,22,0,3,"Braga",7,"Rua Nova Santa Cruz",28,28,0,115,115,0
2,26,2019,22,0,3,"Braga",8,"Rua Costa Gomes",39,39,0,43,43,0
2,26,2019,23,0,3,"Braga",1,"Avenida da Liberdade",21,21,0,32,32,0
2,26,2019,23,0,3,"Braga",2,"Avenida Central",17,17,0,284,284,0
2,26,2019,23,0,3,"Braga",3,"Rua de Caires",35,35,0,36,36,0
2,26,2019,23,0,3,"Braga",4,"N14 Bosch",46,46,0,74,74,0
2,26,2019,23,0,3,"Braga",5,"Avenida João Paulo II",39,39,0,8,8,0
2,26,2019,23,0,3,"Braga",6,"Avenida Padre Júlio Fragata",60,60,0,21,21,0
2,26,2019,23,0,3,"Braga",7,"Rua Nova Santa Cruz",28,28,0,115,115,0
2,26,2019,23,0,3,"Braga",8,"Rua Costa Gomes",39,39,0,43,43,0
2,27,2019,0,0,4,"Braga",1,"Avenida da Liberdade",21,21,0,32,32,0
2,27,2019,0,0,4,"Braga",2,"Avenida Central",17,17,0,284,284,0
2,27,2019,0,0,4,"Braga",3,"Rua de Caires",35,35,0,36,36,0
2,27,2019,0,0,4,"Braga",4,"N14 Bosch",46,46,0,74,74,0
2,27,2019,0,0,4,"Braga",5,"Avenida João Paulo II",39,39,0,8,8,0
2,27,2019,0,0,4,"Braga",6,"Avenida Padre Júlio Fragata",61,61,0,20,20,0
2,27,2019,0,0,4,"Braga",7,"Rua Nova Santa Cruz",28,28,0,115,115,0
2,27,2019,0,0,4,"Braga",8,"Rua Costa Gomes",39,39,0,43,43,0
2,27,2019,1,0,4,"Braga",1,"Avenida da Liberdade",21,21,0,32,32,0
2,27,2019,1,0,4,"Braga",2,"Avenida Central",17,17,0,284,284,0
2,27,2019,1,0,4,"Braga",3,"Rua de Caires",35,35,0,36,36,0
2,27,2019,1,0,4,"Braga",4,"N14 Bosch",46,46,0,74,74,0
2,27,2019,1,0,4,"Braga",5,"Avenida João Paulo II",39,39,0,8,8,0
2,27,2019,1,0,4,"Braga",6,"Avenida Padre Júlio Fragata",61,61,0,20,20,0
2,27,2019,1,0,4,"Braga",7,"Rua Nova Santa Cruz",28,28,0,115,115,0
2,27,2019,1,0,4,"Braga",8,"Rua Costa Gomes",39,39,0,43,43,0
2,27,2019,2,0,4,"Braga",1,"Avenida da Liberdade",21,21,0,32,32,0
2,27,2019,2,0,4,"Braga",2,"Avenida Central",17,17,0,284,284,0
2,27,2019,2,0,4,"Braga",3,"Rua de Caires",35,35,0,36,36,0
2,27,2019,2,0,4,"Braga",4,"N14 Bosch",46,46,0,74,74,0
2,27,2019,2,0,4,"Braga",5,"Avenida João Paulo II",39,39,0,8,8,0
2,27,2019,2,0,4,"Braga",6,"Avenida Padre Júlio Fragata",61,61,0,20,20,0
2,27,2019,2,0,4,"Braga",7,"Rua Nova Santa Cruz",28,28,0,115,115,0
2,27,2019,2,0,4,"Braga",8,"Rua Costa Gomes",39,39,0,43,43,0
2,27,2019,3,0,4,"Braga",1,"Avenida da Liberdade",21,21,0,32,32,0
2,27,2019,3,0,4,"Braga",2,"Avenida Central",17,17,0,284,284,0
2,27,2019,3,0,4,"Braga",3,"Rua de Caires",35,35,0,36,36,0
2,27,2019,3,0,4,"Braga",4,"N14 Bosch",46,46,0,74,74,0
2,27,2019,3,0,4,"Braga",5,"Avenida João Paulo II",39,39,0,8,8,0
2,27,2019,3,0,4,"Braga",6,"Avenida Padre Júlio Fragata",61,61,0,20,20,0
2,27,2019,3,0,4,"Braga",7,"Rua Nova Santa Cruz",28,28,0,115,115,0
2,27,2019,3,0,4,"Braga",8,"Rua Costa Gomes",39,39,0,43,43,0
2,27,2019,4,0,4,"Braga",1,"Avenida da Liberdade",21,21,0,32,32,0
2,27,2019,4,0,4,"Braga",2,"Avenida Central",17,17,0,284,284,0
2,27,2019,4,0,4,"Braga",3,"Rua de Caires",35,35,0,36,36,0
2,27,2019,4,0,4,"Braga",4,"N14 Bosch",46,46,0,74,74,0
2,27,2019,4,0,4,"Braga",5,"Avenida João Paulo II",39,39,0,8,8,0
2,27,2019,4,0,4,"Braga",6,"Avenida Padre Júlio Fragata",61,61,0,20,20,0
2,27,2019,4,0,4,"Braga",7,"Rua Nova Santa Cruz",28,28,0,115,115,0
2,27,2019,4,0,4,"Braga",8,"Rua Costa Gomes",39,39,0,43,43,0
2,27,2019,5,0,4,"Braga",1,"Avenida da Liberdade",21,21,0,32,32,0
2,27,2019,5,0,4,"Braga",2,"Avenida Central",17,17,0,284,284,0
2,27,2019,5,0,4,"Braga",3,"Rua de Caires",35,35,0,36,36,0
2,27,2019,5,0,4,"Braga",4,"N14 Bosch",46,46,0,74,74,0
2,27,2019,5,0,4,"Braga",5,"Avenida João Paulo II",39,39,0,8,8,0
2,27,2019,5,0,4,"Braga",6,"Avenida Padre Júlio Fragata",61,61,0,20,20,0
2,27,2019,5,0,4,"Braga",7,"Rua Nova Santa Cruz",28,28,0,115,115,0
2,27,2019,5,0,4,"Braga",8,"Rua Costa Gomes",39,39,0,43,43,0
2,27,2019,6,0,4,"Braga",1,"Avenida da Liberdade",21,21,0,32,32,0
2,27,2019,6,0,4,"Braga",2,"Avenida Central",17,17,0,284,284,0
2,27,2019,6,0,4,"Braga",3,"Rua de Caires",35,35,0,36,36,0
2,27,2019,6,0,4,"Braga",4,"N14 Bosch",46,46,0,74,74,0
2,27,2019,6,0,4,"Braga",5,"Avenida João Paulo II",39,39,0,8,8,0
2,27,2019,6,0,4,"Braga",6,"Avenida Padre Júlio Fragata",61,61,0,20,20,0
2,27,2019,6,0,4,"Braga",7,"Rua Nova Santa Cruz",28,28,0,115,115,0
2,27,2019,6,0,4,"Braga",8,"Rua Costa Gomes",39,39,0,43,43,0
2,27,2019,7,0,4,"Braga",1,"Avenida da Liberdade",21,21,0,32,32,0
2,27,2019,7,0,4,"Braga",2,"Avenida Central",17,17,0,284,284,0
2,27,2019,7,0,4,"Braga",3,"Rua de Caires",35,35,0,36,36,0
2,27,2019,7,0,4,"Braga",4,"N14 Bosch",46,46,0,74,74,0
2,27,2019,7,0,4,"Braga",5,"Avenida João Paulo II",39,39,0,8,8,0
2,27,2019,7,0,4,"Braga",6,"Avenida Padre Júlio Fragata",61,61,0,20,20,0
2,27,2019,7,0,4,"Braga",7,"Rua Nova Santa Cruz",28,28,0,115,115,0
2,27,2019,7,0,4,"Braga",8,"Rua Costa Gomes",39,39,0,43,43,0
2,27,2019,8,0,4,"Braga",1,"Avenida da Liberdade",21,21,0,32,32,0
2,27,2019,8,0,4,"Braga",2,"Avenida Central",13,18,5,372,268,104
2,27,2019,8,0,4,"Braga",3,"Rua de Caires",25,34,9,51,37,14
2,27,2019,8,0,4,"Braga",4,"N14 Bosch",45,45,0,75,75,0
2,27,2019,8,0,4,"Braga",5,"Avenida João Paulo II",39,39,0,8,8,0
2,27,2019,8,0,4,"Braga",6,"Avenida Padre Júlio Fragata",61,61,0,20,20,0
2,27,2019,8,0,4,"Braga",7,"Rua Nova Santa Cruz",28,28,0,115,115,0
2,27,2019,8,0,4,"Braga",8,"Rua Costa Gomes",31,39,8,54,43,11
2,27,2019,9,0,4,"Braga",1,"Avenida da Liberdade",22,22,0,30,30,0
2,27,2019,9,0,4,"Braga",2,"Avenida Central",17,17,0,284,284,0
2,27,2019,9,0,4,"Braga",3,"Rua de Caires",25,35,10,51,36,15
2,27,2019,9,0,4,"Braga",4,"N14 Bosch",23,45,22,148,75,73
2,27,2019,9,0,4,"Braga",5,"Avenida João Paulo II",31,40,9,11,8,3
2,27,2019,9,0,4,"Braga",6,"Avenida Padre Júlio Fragata",35,61,26,36,20,16
2,27,2019,9,0,4,"Braga",7,"Rua Nova Santa Cruz",29,29,0,111,111,0
2,27,2019,9,0,4,"Braga",8,"Rua Costa Gomes",27,39,12,62,43,19
2,27,2019,10,0,4,"Braga",1,"Avenida da Liberdade",21,21,0,32,32,0
2,27,2019,10,0,4,"Braga",2,"Avenida Central",17,17,0,284,284,0
2,27,2019,10,0,4,"Braga",3,"Rua de Caires",27,34,7,47,37,10
2,27,2019,10,0,4,"Braga",4,"N14 Bosch",37,46,9,92,74,18
2,27,2019,10,0,4,"Braga",5,"Avenida João Paulo II",40,40,0,8,8,0
2,27,2019,10,0,4,"Braga",6,"Avenida Padre Júlio Fragata",61,61,0,20,20,0
2,27,2019,10,0,4,"Braga",7,"Rua Nova Santa Cruz",29,29,0,111,111,0
2,27,2019,10,0,4,"Braga",8,"Rua Costa Gomes",39,39,0,43,43,0
2,27,2019,11,0,4,"Braga",1,"Avenida da Liberdade",17,21,4,39,32,7
2,27,2019,11,0,4,"Braga",2,"Avenida Central",17,17,0,284,284,0
2,27,2019,11,0,4,"Braga",3,"Rua de Caires",27,34,7,47,37,10
2,27,2019,11,0,4,"Braga",4,"N14 Bosch",31,45,14,110,75,35
2,27,2019,11,0,4,"Braga",5,"Avenida João Paulo II",39,39,0,8,8,0
2,27,2019,11,0,4,"Braga",6,"Avenida Padre Júlio Fragata",61,61,0,20,20,0
2,27,2019,11,0,4,"Braga",7,"Rua Nova Santa Cruz",29,29,0,111,111,0
2,27,2019,11,0,4,"Braga",8,"Rua Costa Gomes",25,40,15,67,42,25
2,27,2019,12,0,4,"Braga",1,"Avenida da Liberdade",15,21,6,44,32,12
2,27,2019,12,0,4,"Braga",2,"Avenida Central",18,18,0,268,268,0
2,27,2019,12,0,4,"Braga",3,"Rua de Caires",35,35,0,36,36,0
2,27,2019,12,0,4,"Braga",4,"N14 Bosch",29,45,16,117,75,42
2,27,2019,12,0,4,"Braga",5,"Avenida João Paulo II",39,39,0,8,8,0
2,27,2019,12,0,4,"Braga",6,"Avenida Padre Júlio Fragata",60,60,0,21,21,0
2,27,2019,12,0,4,"Braga",7,"Rua Nova Santa Cruz",18,28,10,179,115,64
2,27,2019,12,0,4,"Braga",8,"Rua Costa Gomes",30,39,9,56,43,13
2,27,2019,13,0,4,"Braga",1,"Avenida da Liberdade",21,21,0,32,32,0
2,27,2019,13,0,4,"Braga",2,"Avenida Central",14,18,4,345,268,77
2,27,2019,13,0,4,"Braga",3,"Rua de Caires",15,35,20,85,36,49
2,27,2019,13,0,4,"Braga",4,"N14 Bosch",30,46,16,113,74,39
2,27,2019,13,0,4,"Braga",5,"Avenida João Paulo II",40,40,0,8,8,0
2,27,2019,13,0,4,"Braga",6,"Avenida Padre Júlio Fragata",60,60,0,21,21,0
2,27,2019,13,0,4,"Braga",7,"Rua Nova Santa Cruz",15,29,14,215,111,104
2,27,2019,13,0,4,"Braga",8,"Rua Costa Gomes",40,40,0,42,42,0
2,27,2019,14,0,4,"Braga",1,"Avenida da Liberdade",22,22,0,30,30,0
2,27,2019,14,0,4,"Braga",2,"Avenida Central",11,17,6,439,284,155
2,27,2019,14,0,4,"Braga",3,"Rua de Caires",24,35,11,53,36,17
2,27,2019,14,0,4,"Braga",4,"N14 Bosch",28,46,18,121,74,47
2,27,2019,14,0,4,"Braga",5,"Avenida João Paulo II",32,40,8,10,8,2
2,27,2019,14,0,4,"Braga",6,"Avenida Padre Júlio Fragata",60,60,0,21,21,0
2,27,2019,14,0,4,"Braga",7,"Rua Nova Santa Cruz",23,29,6,140,111,29
2,27,2019,14,0,4,"Braga",8,"Rua Costa Gomes",26,40,14,64,42,22
2,27,2019,15,0,4,"Braga",1,"Avenida da Liberdade",22,22,0,30,30,0
2,27,2019,15,0,4,"Braga",2,"Avenida Central",12,18,6,403,268,135
2,27,2019,15,0,4,"Braga",3,"Rua de Caires",26,35,9,49,36,13
2,27,2019,15,0,4,"Braga",4,"N14 Bosch",22,45,23,155,75,80
2,27,2019,15,0,4,"Braga",5,"Avenida João Paulo II",40,40,0,8,8,0
2,27,2019,15,0,4,"Braga",6,"Avenida Padre Júlio Fragata",60,60,0,21,21,0
2,27,2019,15,0,4,"Braga",7,"Rua Nova Santa Cruz",23,29,6,140,111,29
2,27,2019,15,0,4,"Braga",8,"Rua Costa Gomes",28,39,11,60,43,17
2,27,2019,16,0,4,"Braga",1,"Avenida da Liberdade",22,22,0,30,30,0
2,27,2019,16,0,4,"Braga",2,"Avenida Central",13,18,5,372,268,104
2,27,2019,16,0,4,"Braga",3,"Rua de Caires",27,35,8,47,36,11
2,27,2019,16,0,4,"Braga",4,"N14 Bosch",28,46,18,121,74,47
2,27,2019,16,0,4,"Braga",5,"Avenida João Paulo II",30,40,10,11,8,3
2,27,2019,16,0,4,"Braga",6,"Avenida Padre Júlio Fragata",60,60,0,21,21,0
2,27,2019,16,0,4,"Braga",7,"Rua Nova Santa Cruz",19,28,9,169,115,54
2,27,2019,16,0,4,"Braga",8,"Rua Costa Gomes",27,40,13,62,42,20
2,27,2019,17,0,4,"Braga",1,"Avenida da Liberdade",17,22,5,39,30,9
2,27,2019,17,0,4,"Braga",2,"Avenida Central",10,17,7,483,284,199
2,27,2019,17,0,4,"Braga",3,"Rua de Caires",27,35,8,47,36,11
2,27,2019,17,0,4,"Braga",4,"N14 Bosch",25,45,20,136,75,61
2,27,2019,17,0,4,"Braga",5,"Avenida João Paulo II",23,40,17,14,8,6
2,27,2019,17,0,4,"Braga",6,"Avenida Padre Júlio Fragata",61,61,0,20,20,0
2,27,2019,17,0,4,"Braga",7,"Rua Nova Santa Cruz",19,29,10,169,111,58
2,27,2019,17,0,4,"Braga",8,"Rua Costa Gomes",23,40,17,73,42,31
2,27,2019,18,0,4,"Braga",1,"Avenida da Liberdade",17,21,4,39,32,7
2,27,2019,18,0,4,"Braga",2,"Avenida Central",10,18,8,483,268,215
2,27,2019,18,0,4,"Braga",3,"Rua de Caires",22,35,13,58,36,22
2,27,2019,18,0,4,"Braga",4,"N14 Bosch",14,46,32,243,74,169
2,27,2019,18,0,4,"Braga",5,"Avenida João Paulo II",25,39,14,13,8,5
2,27,2019,18,0,4,"Braga",6,"Avenida Padre Júlio Fragata",61,61,0,20,20,0
2,27,2019,18,0,4,"Braga",7,"Rua Nova Santa Cruz",2,32,30,1612,100,1512
2,27,2019,18,0,4,"Braga",8,"Rua Costa Gomes",18,40,22,93,42,51
2,27,2019,19,0,4,"Braga",1,"Avenida da Liberdade",15,22,7,44,30,14
2,27,2019,19,0,4,"Braga",2,"Avenida Central",6,18,12,806,268,538
2,27,2019,19,0,4,"Braga",3,"Rua de Caires",26,35,9,49,36,13
2,27,2019,19,0,4,"Braga",4,"N14 Bosch",18,46,28,189,74,115
2,27,2019,19,0,4,"Braga",5,"Avenida João Paulo II",20,39,19,17,8,9
2,27,2019,19,0,4,"Braga",6,"Avenida Padre Júlio Fragata",27,60,33,47,21,26
2,27,2019,19,0,4,"Braga",7,"Rua Nova Santa Cruz",7,29,22,460,111,349
2,27,2019,19,0,4,"Braga",8,"Rua Costa Gomes",13,40,27,129,42,87
2,27,2019,20,0,4,"Braga",1,"Avenida da Liberdade",10,22,12,67,30,37
2,27,2019,20,0,4,"Braga",2,"Avenida Central",17,17,0,284,284,0
2,27,2019,20,0,4,"Braga",3,"Rua de Caires",35,35,0,36,36,0
2,27,2019,20,0,4,"Braga",4,"N14 Bosch",37,46,9,92,74,18
2,27,2019,20,0,4,"Braga",5,"Avenida João Paulo II",32,40,8,10,8,2
2,27,2019,20,0,4,"Braga",6,"Avenida Padre Júlio Fragata",61,61,0,20,20,0
2,27,2019,20,0,4,"Braga",7,"Rua Nova Santa Cruz",28,28,0,115,115,0
2,27,2019,20,0,4,"Braga",8,"Rua Costa Gomes",26,40,14,64,42,22
2,27,2019,21,0,4,"Braga",1,"Avenida da Liberdade",22,22,0,30,30,0
2,27,2019,21,0,4,"Braga",2,"Avenida Central",13,17,4,372,284,88
2,27,2019,21,0,4,"Braga",3,"Rua de Caires",34,34,0,37,37,0
2,27,2019,21,0,4,"Braga",4,"N14 Bosch",46,46,0,74,74,0
2,27,2019,21,0,4,"Braga",5,"Avenida João Paulo II",40,40,0,8,8,0
2,27,2019,21,0,4,"Braga",6,"Avenida Padre Júlio Fragata",61,61,0,20,20,0
2,27,2019,21,0,4,"Braga",7,"Rua Nova Santa Cruz",28,28,0,115,115,0
2,27,2019,21,0,4,"Braga",8,"Rua Costa Gomes",40,40,0,42,42,0
2,27,2019,22,0,4,"Braga",1,"Avenida da Liberdade",22,22,0,30,30,0
2,27,2019,22,0,4,"Braga",2,"Avenida Central",17,17,0,284,284,0
2,27,2019,22,0,4,"Braga",3,"Rua de Caires",34,34,0,37,37,0
2,27,2019,22,0,4,"Braga",4,"N14 Bosch",46,46,0,74,74,0
2,27,2019,22,0,4,"Braga",5,"Avenida João Paulo II",40,40,0,8,8,0
2,27,2019,22,0,4,"Braga",6,"Avenida Padre Júlio Fragata",61,61,0,20,20,0
2,27,2019,22,0,4,"Braga",7,"Rua Nova Santa Cruz",20,28,8,161,115,46
2,27,2019,22,0,4,"Braga",8,"Rua Costa Gomes",40,40,0,42,42,0
2,27,2019,23,0,4,"Braga",1,"Avenida da Liberdade",22,22,0,30,30,0
2,27,2019,23,0,4,"Braga",2,"Avenida Central",17,17,0,284,284,0
2,27,2019,23,0,4,"Braga",3,"Rua de Caires",34,34,0,37,37,0
2,27,2019,23,0,4,"Braga",4,"N14 Bosch",44,44,0,77,77,0
2,27,2019,23,0,4,"Braga",5,"Avenida João Paulo II",40,40,0,8,8,0
2,27,2019,23,0,4,"Braga",6,"Avenida Padre Júlio Fragata",61,61,0,20,20,0
2,27,2019,23,0,4,"Braga",7,"Rua Nova Santa Cruz",29,29,0,111,111,0
2,27,2019,23,0,4,"Braga",8,"Rua Costa Gomes",40,40,0,42,42,0
2,28,2019,0,0,5,"Braga",6,"Avenida Padre Júlio Fragata",60,60,0,21,21,0
2,28,2019,0,0,5,"Braga",7,"Rua Nova Santa Cruz",29,29,0,111,111,0
2,28,2019,0,0,5,"Braga",8,"Rua Costa Gomes",40,40,0,42,42,0
2,28,2019,0,0,5,"Braga",1,"Avenida da Liberdade",22,22,0,30,30,0
2,28,2019,0,0,5,"Braga",2,"Avenida Central",17,17,0,284,284,0
2,28,2019,0,0,5,"Braga",3,"Rua de Caires",34,34,0,37,37,0
2,28,2019,0,0,5,"Braga",4,"N14 Bosch",46,46,0,74,74,0
2,28,2019,0,0,5,"Braga",5,"Avenida João Paulo II",40,40,0,8,8,0
2,28,2019,0,0,5,"Braga",6,"Avenida Padre Júlio Fragata",60,60,0,21,21,0
2,28,2019,1,0,5,"Braga",1,"Avenida da Liberdade",22,22,0,30,30,0
2,28,2019,1,0,5,"Braga",2,"Avenida Central",17,17,0,284,284,0
2,28,2019,1,0,5,"Braga",3,"Rua de Caires",34,34,0,37,37,0
2,28,2019,1,0,5,"Braga",4,"N14 Bosch",46,46,0,74,74,0
2,28,2019,1,0,5,"Braga",5,"Avenida João Paulo II",40,40,0,8,8,0
2,28,2019,1,0,5,"Braga",6,"Avenida Padre Júlio Fragata",60,60,0,21,21,0
2,28,2019,1,0,5,"Braga",7,"Rua Nova Santa Cruz",29,29,0,111,111,0
2,28,2019,1,0,5,"Braga",8,"Rua Costa Gomes",40,40,0,42,42,0
2,28,2019,2,0,5,"Braga",1,"Avenida da Liberdade",22,22,0,30,30,0
2,28,2019,2,0,5,"Braga",2,"Avenida Central",17,17,0,284,284,0
2,28,2019,2,0,5,"Braga",3,"Rua de Caires",34,34,0,37,37,0
2,28,2019,2,0,5,"Braga",4,"N14 Bosch",46,46,0,74,74,0
2,28,2019,2,0,5,"Braga",5,"Avenida João Paulo II",40,40,0,8,8,0
2,28,2019,2,0,5,"Braga",6,"Avenida Padre Júlio Fragata",60,60,0,21,21,0
2,28,2019,2,0,5,"Braga",7,"Rua Nova Santa Cruz",29,29,0,111,111,0
2,28,2019,2,0,5,"Braga",8,"Rua Costa Gomes",40,40,0,42,42,0
2,28,2019,3,0,5,"Braga",1,"Avenida da Liberdade",22,22,0,30,30,0
2,28,2019,3,0,5,"Braga",2,"Avenida Central",17,17,0,284,284,0
2,28,2019,3,0,5,"Braga",3,"Rua de Caires",34,34,0,37,37,0
2,28,2019,3,0,5,"Braga",4,"N14 Bosch",46,46,0,74,74,0
2,28,2019,3,0,5,"Braga",5,"Avenida João Paulo II",40,40,0,8,8,0
2,28,2019,3,0,5,"Braga",6,"Avenida Padre Júlio Fragata",60,60,0,21,21,0
2,28,2019,3,0,5,"Braga",7,"Rua Nova Santa Cruz",29,29,0,111,111,0
2,28,2019,3,0,5,"Braga",8,"Rua Costa Gomes",40,40,0,42,42,0
2,28,2019,4,0,5,"Braga",1,"Avenida da Liberdade",22,22,0,30,30,0
2,28,2019,4,0,5,"Braga",2,"Avenida Central",17,17,0,284,284,0
2,28,2019,4,0,5,"Braga",3,"Rua de Caires",34,34,0,37,37,0
2,28,2019,4,0,5,"Braga",4,"N14 Bosch",46,46,0,74,74,0
2,28,2019,4,0,5,"Braga",5,"Avenida João Paulo II",40,40,0,8,8,0
2,28,2019,4,0,5,"Braga",6,"Avenida Padre Júlio Fragata",60,60,0,21,21,0
2,28,2019,4,0,5,"Braga",7,"Rua Nova Santa Cruz",29,29,0,111,111,0
2,28,2019,4,0,5,"Braga",8,"Rua Costa Gomes",40,40,0,42,42,0
2,28,2019,5,0,5,"Braga",1,"Avenida da Liberdade",22,22,0,30,30,0
2,28,2019,5,0,5,"Braga",2,"Avenida Central",17,17,0,284,284,0
2,28,2019,5,0,5,"Braga",3,"Rua de Caires",34,34,0,37,37,0
2,28,2019,5,0,5,"Braga",4,"N14 Bosch",46,46,0,74,74,0
2,28,2019,5,0,5,"Braga",5,"Avenida João Paulo II",40,40,0,8,8,0
2,28,2019,5,0,5,"Braga",6,"Avenida Padre Júlio Fragata",60,60,0,21,21,0
2,28,2019,5,0,5,"Braga",7,"Rua Nova Santa Cruz",29,29,0,111,111,0
2,28,2019,5,0,5,"Braga",8,"Rua Costa Gomes",40,40,0,42,42,0
2,28,2019,6,0,5,"Braga",1,"Avenida da Liberdade",22,22,0,30,30,0
2,28,2019,6,0,5,"Braga",2,"Avenida Central",17,17,0,284,284,0
2,28,2019,6,0,5,"Braga",3,"Rua de Caires",34,34,0,37,37,0
2,28,2019,6,0,5,"Braga",4,"N14 Bosch",46,46,0,74,74,0
2,28,2019,6,0,5,"Braga",5,"Avenida João Paulo II",40,40,0,8,8,0
2,28,2019,6,0,5,"Braga",6,"Avenida Padre Júlio Fragata",60,60,0,21,21,0
2,28,2019,6,0,5,"Braga",7,"Rua Nova Santa Cruz",29,29,0,111,111,0
2,28,2019,6,0,5,"Braga",8,"Rua Costa Gomes",40,40,0,42,42,0
2,28,2019,7,0,5,"Braga",1,"Avenida da Liberdade",22,22,0,30,30,0
2,28,2019,7,0,5,"Braga",2,"Avenida Central",17,17,0,284,284,0
2,28,2019,7,0,5,"Braga",3,"Rua de Caires",35,35,0,36,36,0
2,28,2019,7,0,5,"Braga",4,"N14 Bosch",46,46,0,74,74,0
2,28,2019,7,0,5,"Braga",5,"Avenida João Paulo II",40,40,0,8,8,0
2,28,2019,7,0,5,"Braga",6,"Avenida Padre Júlio Fragata",60,60,0,21,21,0
2,28,2019,7,0,5,"Braga",7,"Rua Nova Santa Cruz",29,29,0,111,111,0
2,28,2019,7,0,5,"Braga",8,"Rua Costa Gomes",40,40,0,42,42,0
2,28,2019,8,0,5,"Braga",1,"Avenida da Liberdade",22,22,0,30,30,0
2,28,2019,8,0,5,"Braga",2,"Avenida Central",18,18,0,268,268,0
2,28,2019,8,0,5,"Braga",3,"Rua de Caires",27,35,8,47,36,11
2,28,2019,8,0,5,"Braga",4,"N14 Bosch",36,46,10,94,74,20
2,28,2019,8,0,5,"Braga",5,"Avenida João Paulo II",40,40,0,8,8,0
2,28,2019,8,0,5,"Braga",6,"Avenida Padre Júlio Fragata",60,60,0,21,21,0
2,28,2019,8,0,5,"Braga",7,"Rua Nova Santa Cruz",29,29,0,111,111,0
2,28,2019,8,0,5,"Braga",8,"Rua Costa Gomes",40,40,0,42,42,0
2,28,2019,9,0,5,"Braga",1,"Avenida da Liberdade",13,21,8,51,32,19
2,28,2019,9,0,5,"Braga",2,"Avenida Central",9,17,8,537,284,253
2,28,2019,9,0,5,"Braga",3,"Rua de Caires",22,34,12,58,37,21
2,28,2019,9,0,5,"Braga",4,"N14 Bosch",29,46,17,117,74,43
2,28,2019,9,0,5,"Braga",5,"Avenida João Paulo II",32,40,8,10,8,2
2,28,2019,9,0,5,"Braga",6,"Avenida Padre Júlio Fragata",32,61,29,39,20,19
2,28,2019,9,0,5,"Braga",7,"Rua Nova Santa Cruz",22,28,6,146,115,31
2,28,2019,9,0,5,"Braga",8,"Rua Costa Gomes",26,39,13,64,43,21
2,28,2019,10,0,5,"Braga",1,"Avenida da Liberdade",17,21,4,39,32,7
2,28,2019,10,0,5,"Braga",2,"Avenida Central",14,18,4,345,268,77
2,28,2019,10,0,5,"Braga",3,"Rua de Caires",23,34,11,55,37,18
2,28,2019,10,0,5,"Braga",4,"N14 Bosch",36,45,9,94,75,19
2,28,2019,10,0,5,"Braga",5,"Avenida João Paulo II",39,39,0,8,8,0
2,28,2019,10,0,5,"Braga",6,"Avenida Padre Júlio Fragata",61,61,0,20,20,0
2,28,2019,10,0,5,"Braga",7,"Rua Nova Santa Cruz",28,28,0,115,115,0
2,28,2019,10,0,5,"Braga",8,"Rua Costa Gomes",30,39,9,56,43,13
2,28,2019,11,0,5,"Braga",1,"Avenida da Liberdade",18,22,4,37,30,7
2,28,2019,11,0,5,"Braga",2,"Avenida Central",17,17,0,284,284,0
2,28,2019,11,0,5,"Braga",3,"Rua de Caires",26,35,9,49,36,13
2,28,2019,11,0,5,"Braga",4,"N14 Bosch",30,46,16,113,74,39
2,28,2019,11,0,5,"Braga",5,"Avenida João Paulo II",40,40,0,8,8,0
2,28,2019,11,0,5,"Braga",6,"Avenida Padre Júlio Fragata",61,61,0,20,20,0
2,28,2019,11,0,5,"Braga",7,"Rua Nova Santa Cruz",28,28,0,115,115,0
2,28,2019,11,0,5,"Braga",8,"Rua Costa Gomes",22,39,17,76,43,33
2,28,2019,12,0,5,"Braga",1,"Avenida da Liberdade",22,22,0,30,30,0
2,28,2019,12,0,5,"Braga",2,"Avenida Central",11,18,7,439,268,171
2,28,2019,12,0,5,"Braga",3,"Rua de Caires",26,34,8,49,37,12
2,28,2019,12,0,5,"Braga",4,"N14 Bosch",31,46,15,110,74,36
2,28,2019,12,0,5,"Braga",5,"Avenida João Paulo II",31,40,9,11,8,3
2,28,2019,12,0,5,"Braga",6,"Avenida Padre Júlio Fragata",60,60,0,21,21,0
2,28,2019,12,0,5,"Braga",7,"Rua Nova Santa Cruz",23,28,5,140,115,25
2,28,2019,12,0,5,"Braga",8,"Rua Costa Gomes",23,39,16,73,43,30
2,28,2019,13,0,5,"Braga",1,"Avenida da Liberdade",22,22,0,30,30,0
2,28,2019,13,0,5,"Braga",2,"Avenida Central",13,18,5,372,268,104
2,28,2019,13,0,5,"Braga",3,"Rua de Caires",25,35,10,51,36,15
2,28,2019,13,0,5,"Braga",4,"N14 Bosch",28,46,18,121,74,47
2,28,2019,13,0,5,"Braga",5,"Avenida João Paulo II",40,40,0,8,8,0
2,28,2019,13,0,5,"Braga",6,"Avenida Padre Júlio Fragata",44,60,16,29,21,8
2,28,2019,13,0,5,"Braga",7,"Rua Nova Santa Cruz",21,29,8,153,111,42
2,28,2019,13,0,5,"Braga",8,"Rua Costa Gomes",26,40,14,64,42,22
2,28,2019,14,0,5,"Braga",1,"Avenida da Liberdade",22,22,0,30,30,0
2,28,2019,14,0,5,"Braga",2,"Avenida Central",17,17,0,284,284,0
2,28,2019,14,0,5,"Braga",3,"Rua de Caires",26,35,9,49,36,13
2,28,2019,14,0,5,"Braga",4,"N14 Bosch",19,46,27,179,74,105
2,28,2019,14,0,5,"Braga",5,"Avenida João Paulo II",31,39,8,11,8,3
2,28,2019,14,0,5,"Braga",6,"Avenida Padre Júlio Fragata",60,60,0,21,21,0
2,28,2019,14,0,5,"Braga",7,"Rua Nova Santa Cruz",28,28,0,115,115,0
2,28,2019,14,0,5,"Braga",8,"Rua Costa Gomes",40,40,0,42,42,0
2,28,2019,15,0,5,"Braga",1,"Avenida da Liberdade",22,22,0,30,30,0
2,28,2019,15,0,5,"Braga",2,"Avenida Central",10,17,7,483,284,199
2,28,2019,15,0,5,"Braga",3,"Rua de Caires",26,35,9,49,36,13
2,28,2019,15,0,5,"Braga",4,"N14 Bosch",23,45,22,148,75,73
2,28,2019,15,0,5,"Braga",5,"Avenida João Paulo II",39,39,0,8,8,0
2,28,2019,15,0,5,"Braga",6,"Avenida Padre Júlio Fragata",60,60,0,21,21,0
2,28,2019,15,0,5,"Braga",7,"Rua Nova Santa Cruz",22,29,7,146,111,35
2,28,2019,15,0,5,"Braga",8,"Rua Costa Gomes",40,40,0,42,42,0
2,28,2019,16,0,5,"Braga",1,"Avenida da Liberdade",22,22,0,30,30,0
2,28,2019,16,0,5,"Braga",2,"Avenida Central",12,18,6,403,268,135
2,28,2019,16,0,5,"Braga",3,"Rua de Caires",19,34,15,67,37,30
2,28,2019,16,0,5,"Braga",4,"N14 Bosch",25,46,21,136,74,62
2,28,2019,16,0,5,"Braga",5,"Avenida João Paulo II",27,39,12,12,8,4
2,28,2019,16,0,5,"Braga",6,"Avenida Padre Júlio Fragata",60,60,0,21,21,0
2,28,2019,16,0,5,"Braga",7,"Rua Nova Santa Cruz",21,29,8,153,111,42
2,28,2019,16,0,5,"Braga",8,"Rua Costa Gomes",25,39,14,67,43,24
2,28,2019,17,0,5,"Braga",1,"Avenida da Liberdade",21,21,0,32,32,0
2,28,2019,17,0,5,"Braga",2,"Avenida Central",10,18,8,483,268,215
2,28,2019,17,0,5,"Braga",3,"Rua de Caires",23,34,11,55,37,18
2,28,2019,17,0,5,"Braga",4,"N14 Bosch",25,46,21,136,74,62
2,28,2019,17,0,5,"Braga",5,"Avenida João Paulo II",26,40,14,13,8,5
2,28,2019,17,0,5,"Braga",6,"Avenida Padre Júlio Fragata",61,61,0,20,20,0
2,28,2019,17,0,5,"Braga",7,"Rua Nova Santa Cruz",17,28,11,189,115,74
2,28,2019,17,0,5,"Braga",8,"Rua Costa Gomes",23,39,16,73,43,30
2,28,2019,18,0,5,"Braga",1,"Avenida da Liberdade",21,21,0,32,32,0
2,28,2019,18,0,5,"Braga",2,"Avenida Central",10,17,7,483,284,199
2,28,2019,18,0,5,"Braga",3,"Rua de Caires",10,35,25,128,36,92
2,28,2019,18,0,5,"Braga",4,"N14 Bosch",12,45,33,284,75,209
2,28,2019,18,0,5,"Braga",5,"Avenida João Paulo II",20,40,20,17,8,9
2,28,2019,18,0,5,"Braga",6,"Avenida Padre Júlio Fragata",14,59,45,91,21,70
2,28,2019,18,0,5,"Braga",7,"Rua Nova Santa Cruz",6,29,23,537,111,426
2,28,2019,18,0,5,"Braga",8,"Rua Costa Gomes",20,39,19,84,43,41
2,28,2019,19,0,5,"Braga",1,"Avenida da Liberdade",15,21,6,44,32,12
2,28,2019,19,0,5,"Braga",2,"Avenida Central",4,16,12,1209,302,907
2,28,2019,19,0,5,"Braga",3,"Rua de Caires",19,34,15,67,37,30
2,28,2019,19,0,5,"Braga",4,"N14 Bosch",27,46,19,126,74,52
2,28,2019,19,0,5,"Braga",5,"Avenida João Paulo II",9,40,31,38,8,30
2,28,2019,19,0,5,"Braga",6,"Avenida Padre Júlio Fragata",18,59,41,70,21,49
2,28,2019,19,0,5,"Braga",7,"Rua Nova Santa Cruz",8,28,20,403,115,288
2,28,2019,19,0,5,"Braga",8,"Rua Costa Gomes",7,42,35,240,40,200
2,28,2019,20,0,5,"Braga",1,"Avenida da Liberdade",22,22,0,30,30,0
2,28,2019,20,0,5,"Braga",2,"Avenida Central",17,17,0,284,284,0
2,28,2019,20,0,5,"Braga",3,"Rua de Caires",25,35,10,51,36,15
2,28,2019,20,0,5,"Braga",4,"N14 Bosch",31,45,14,110,75,35
2,28,2019,20,0,5,"Braga",5,"Avenida João Paulo II",21,39,18,16,8,8
2,28,2019,20,0,5,"Braga",6,"Avenida Padre Júlio Fragata",60,60,0,21,21,0
2,28,2019,20,0,5,"Braga",7,"Rua Nova Santa Cruz",17,28,11,189,115,74
2,28,2019,20,0,5,"Braga",8,"Rua Costa Gomes",23,39,16,73,43,30
2,28,2019,21,0,5,"Braga",1,"Avenida da Liberdade",22,22,0,30,30,0
2,28,2019,21,0,5,"Braga",2,"Avenida Central",17,17,0,284,284,0
2,28,2019,21,0,5,"Braga",3,"Rua de Caires",35,35,0,36,36,0
2,28,2019,21,0,5,"Braga",4,"N14 Bosch",46,46,0,74,74,0
2,28,2019,21,0,5,"Braga",5,"Avenida João Paulo II",40,40,0,8,8,0
2,28,2019,21,0,5,"Braga",6,"Avenida Padre Júlio Fragata",60,60,0,21,21,0
2,28,2019,21,0,5,"Braga",7,"Rua Nova Santa Cruz",29,29,0,111,111,0
2,28,2019,21,0,5,"Braga",8,"Rua Costa Gomes",40,40,0,42,42,0
2,28,2019,22,0,5,"Braga",1,"Avenida da Liberdade",22,22,0,30,30,0
2,28,2019,22,0,5,"Braga",2,"Avenida Central",17,17,0,284,284,0
2,28,2019,22,0,5,"Braga",3,"Rua de Caires",35,35,0,36,36,0
2,28,2019,22,0,5,"Braga",4,"N14 Bosch",46,46,0,74,74,0
2,28,2019,22,0,5,"Braga",5,"Avenida João Paulo II",40,40,0,8,8,0
2,28,2019,22,0,5,"Braga",6,"Avenida Padre Júlio Fragata",61,61,0,20,20,0
2,28,2019,22,0,5,"Braga",7,"Rua Nova Santa Cruz",29,29,0,111,111,0
2,28,2019,22,0,5,"Braga",8,"Rua Costa Gomes",40,40,0,42,42,0
2,28,2019,23,0,5,"Braga",1,"Avenida da Liberdade",22,22,0,30,30,0
2,28,2019,23,0,5,"Braga",2,"Avenida Central",17,17,0,284,284,0
2,28,2019,23,0,5,"Braga",3,"Rua de Caires",35,35,0,36,36,0
2,28,2019,23,0,5,"Braga",4,"N14 Bosch",46,46,0,74,74,0
2,28,2019,23,0,5,"Braga",5,"Avenida João Paulo II",40,40,0,8,8,0
2,28,2019,23,0,5,"Braga",6,"Avenida Padre Júlio Fragata",60,60,0,21,21,0
2,28,2019,23,0,5,"Braga",7,"Rua Nova Santa Cruz",15,28,13,215,115,100
2,28,2019,23,0,5,"Braga",8,"Rua Costa Gomes",40,40,0,42,42,0
